Project Name,Package Name,Cyclic Dependency,Unstable Dependency,Ambiguous Interface,God Component,Feature Concentration,Scattered Functionality,Dense Structure,Total Architecture Smells
4pr0n_ripme,com.rarchives.ripme,0,0,0,0,0,0,0,0
4pr0n_ripme,com.rarchives.ripme.ripper,3,1,0,0,1,1,0,6
4pr0n_ripme,com.rarchives.ripme.ripper.rippers,2,1,0,1,1,1,0,6
4pr0n_ripme,com.rarchives.ripme.ripper.rippers.ripperhelpers,0,0,0,0,0,0,0,0
4pr0n_ripme,com.rarchives.ripme.ripper.rippers.video,2,0,0,0,1,0,0,3
4pr0n_ripme,com.rarchives.ripme.ui,2,0,0,0,1,0,0,3
4pr0n_ripme,com.rarchives.ripme.utils,5,1,0,0,0,0,0,6
4pr0n_ripme,com.rarchives.ripme.tst,0,0,0,0,0,0,0,0
4pr0n_ripme,com.rarchives.ripme.tst.ripper.rippers,0,0,0,0,0,1,0,1
aalmiray_gipsy,org.kordamp.gipsy.transform,0,0,0,0,1,0,0,1
aalmiray_gipsy,org.kordamp.gipsy.transform.service,0,0,0,0,0,0,0,0
aalmiray_gipsy,org.kordamp.gipsy.transform.type,0,0,0,0,0,0,0,0
abel533_ECharts,com.github.abel533.echarts,26,0,0,1,1,2,1,31
abel533_ECharts,com.github.abel533.echarts.axis,4,0,0,0,0,1,1,6
abel533_ECharts,com.github.abel533.echarts.data,3,1,0,0,1,1,1,7
abel533_ECharts,com.github.abel533.echarts.feature,6,1,0,0,0,0,1,8
abel533_ECharts,com.github.abel533.echarts.json,6,0,0,0,0,0,1,7
abel533_ECharts,com.github.abel533.echarts.option,2,0,0,0,0,0,1,3
abel533_ECharts,com.github.abel533.echarts.series,14,1,0,0,0,2,1,18
abel533_ECharts,com.github.abel533.echarts.series.event,0,0,0,0,0,0,1,1
abel533_ECharts,com.github.abel533.echarts.series.force,2,0,0,0,0,0,1,3
abel533_ECharts,com.github.abel533.echarts.series.gauge,2,0,0,0,0,0,1,3
abel533_ECharts,com.github.abel533.echarts.series.other,2,0,0,0,0,0,1,3
abel533_ECharts,com.github.abel533.echarts.style,20,1,0,0,1,2,1,25
abel533_ECharts,com.github.abel533.echarts.style.itemstyle,5,0,0,0,0,2,1,8
abel533_ECharts,com.github.abel533.echarts.util,3,1,0,0,1,0,1,6
abel533_Mapper,tk.mybatis.mapper,0,0,0,0,0,0,0,0
abel533_Mapper,tk.mybatis.mapper.common.base,0,0,0,0,0,0,0,0
abel533_Mapper,tk.mybatis.mapper.common.base.delete,0,0,0,0,0,0,0,0
abel533_Mapper,tk.mybatis.mapper.common.base.insert,0,0,0,0,0,0,0,0
abel533_Mapper,tk.mybatis.mapper.common.base.select,0,0,0,0,1,0,0,1
abel533_Mapper,tk.mybatis.mapper.common.base.update,0,0,0,0,0,0,0,0
abel533_Mapper,tk.mybatis.mapper.common,0,0,0,0,1,0,0,1
abel533_Mapper,tk.mybatis.mapper.common.condition,0,0,0,0,0,0,0,0
abel533_Mapper,tk.mybatis.mapper.common.example,0,0,0,0,1,0,0,1
abel533_Mapper,tk.mybatis.mapper.common.ids,0,0,0,0,0,0,0,0
abel533_Mapper,tk.mybatis.mapper.common.rowbounds,0,0,0,0,0,0,0,0
abel533_Mapper,tk.mybatis.mapper.common.special,0,0,0,0,0,0,0,0
abel533_Mapper,tk.mybatis.mapper.common.sqlserver,0,0,0,0,0,0,0,0
abel533_Mapper,tk.mybatis.mapper.provider.base,0,0,0,0,0,0,0,0
abel533_Mapper,tk.mybatis.mapper.provider,0,0,0,0,1,0,0,1
abel533_Mapper,tk.mybatis.mapper.base,0,0,0,0,1,0,0,1
abel533_Mapper,tk.mybatis.mapper.base.delete,0,0,0,0,1,0,0,1
abel533_Mapper,tk.mybatis.mapper.base.genid,0,0,0,0,1,0,0,1
abel533_Mapper,tk.mybatis.mapper.base.update,0,0,0,0,0,0,0,0
abel533_Mapper,tk.mybatis.mapper.cache,0,0,0,0,1,0,0,1
abel533_Mapper,tk.mybatis.mapper.defaultenumtypehandler,0,0,0,0,1,0,0,1
abel533_Mapper,tk.mybatis.mapper.entity.model,0,0,0,0,1,0,0,1
abel533_Mapper,tk.mybatis.mapper.generatedvalue,0,0,0,0,1,0,0,1
abel533_Mapper,tk.mybatis.mapper.helper,0,0,0,0,1,0,0,1
abel533_Mapper,tk.mybatis.mapper.hsqldb,0,0,0,0,0,0,0,0
abel533_Mapper,tk.mybatis.mapper.issues._216_datetime,0,0,0,0,1,0,0,1
abel533_Mapper,tk.mybatis.mapper.keysql,0,0,0,0,1,0,0,1
abel533_Mapper,tk.mybatis.mapper.mapper,0,0,0,1,1,0,0,2
abel533_Mapper,tk.mybatis.mapper.model,0,0,0,1,1,0,0,2
abel533_Mapper,tk.mybatis.mapper.typehandler,0,0,0,0,1,0,0,1
abel533_Mapper,tk.mybatis.mapper.version,0,0,0,0,1,0,0,1
abel533_Mapper,tk.mybatis.mapper.annotation,0,0,0,1,1,0,0,2
abel533_Mapper,tk.mybatis.mapper.entity,3,1,0,0,1,2,0,7
abel533_Mapper,tk.mybatis.mapper.genid,0,0,0,0,0,0,0,0
abel533_Mapper,tk.mybatis.mapper.gensql,0,0,0,0,0,0,0,0
abel533_Mapper,tk.mybatis.mapper.mapperhelper,3,0,0,0,1,0,0,4
abel533_Mapper,tk.mybatis.mapper.mapperhelper.resolve,0,0,0,0,0,0,0,0
abel533_Mapper,tk.mybatis.mapper.session,0,0,0,0,0,0,0,0
abel533_Mapper,tk.mybatis.mapper.util,4,1,0,0,1,1,0,7
abel533_Mapper,tk.mybatis.mapper.additional.aggregation,0,0,0,0,1,0,0,1
abel533_Mapper,tk.mybatis.mapper.additional.dialect.oracle,0,0,0,0,1,0,0,1
abel533_Mapper,tk.mybatis.mapper.additional.idlist,0,0,0,0,1,0,0,1
abel533_Mapper,tk.mybatis.mapper.additional.insert,0,0,0,0,0,0,0,0
abel533_Mapper,tk.mybatis.mapper.additional.select,0,0,0,0,1,0,0,1
abel533_Mapper,tk.mybatis.mapper.additional.update.differ,0,0,0,0,1,0,0,1
abel533_Mapper,tk.mybatis.mapper.additional.update.force,0,0,0,0,1,0,0,1
abel533_Mapper,tk.mybatis.mapper.additional,0,0,0,0,1,0,0,1
abel533_Mapper,tk.mybatis.mapper.additional.insertlist,0,0,0,0,1,0,0,1
abel533_Mapper,tk.mybatis.mapper.generator,0,0,0,0,1,0,0,1
abel533_Mapper,tk.mybatis.mapper.generator.file,0,0,0,0,0,0,0,0
abel533_Mapper,tk.mybatis.mapper.generator.formatter,0,0,0,0,0,0,0,0
abel533_Mapper,tk.mybatis.mapper.generator.model,0,0,0,0,0,0,0,0
abel533_Mapper,tk.mybatis.spring.annotation,0,1,0,0,0,0,0,1
abel533_Mapper,tk.mybatis.spring.mapper,0,0,0,0,1,0,0,1
abel533_Mapper,tk.mybatis.mapper.configuration,0,0,0,0,1,0,0,1
abel533_Mapper,tk.mybatis.mapper.xml,0,0,0,0,1,0,0,1
abel533_Mapper,tk.mybatis.mapper.autoconfigure,0,0,0,0,1,0,0,1
abel533_Mapper,tk.mybatis.mapper.weekend,0,0,0,0,1,2,0,3
abel533_Mapper,tk.mybatis.mapper.weekend.reflection,0,0,0,0,0,1,0,1
abel533_Mapper,tk.mybatis.mapper.weekend.entity,0,0,0,0,0,0,0,0
abel533_Mapper,tk.mybatis.mapper.weekend.mapper,0,0,0,0,0,0,0,0
abrensch_brouter,btools.codec,0,0,0,0,1,2,0,3
abrensch_brouter,btools.router,0,0,0,0,0,3,0,3
abrensch_brouter,btools.expressions,0,0,0,0,0,3,0,3
abrensch_brouter,btools.mapcreator,0,0,0,1,0,2,0,3
abrensch_brouter,btools.mapaccess,0,0,0,0,1,3,0,4
abrensch_brouter,btools.routingapp,0,0,0,0,0,0,0,0
abrensch_brouter,btools.server,0,0,0,0,1,0,0,1
abrensch_brouter,btools.server.request,0,0,0,0,0,0,0,0
abrensch_brouter,btools.util,0,0,0,1,1,6,0,8
abrensch_brouter,btools.mapsplitter,0,0,0,0,0,0,0,0
abrensch_brouter,(default package),0,0,0,0,0,0,0,0
acciente_oacc-core,com.acciente.oacc,10,1,0,2,0,0,1,14
acciente_oacc-core,com.acciente.oacc.encryptor.bcrypt,0,1,0,0,0,0,1,2
acciente_oacc-core,com.acciente.oacc.encryptor.jasypt,0,1,0,0,0,0,1,2
acciente_oacc-core,com.acciente.oacc.encryptor,0,0,0,0,0,0,1,1
acciente_oacc-core,com.acciente.oacc.normalizer.icu4j,1,0,0,0,1,0,1,3
acciente_oacc-core,com.acciente.oacc.normalizer.jdk,1,0,0,0,0,0,1,2
acciente_oacc-core,com.acciente.oacc.normalizer,2,1,0,0,0,0,1,4
acciente_oacc-core,com.acciente.oacc.sql.internal.encryptor,0,0,0,0,0,0,1,1
acciente_oacc-core,com.acciente.oacc.sql.internal,9,1,0,0,0,0,1,11
acciente_oacc-core,com.acciente.oacc.sql.internal.persister,4,0,0,1,0,0,1,6
acciente_oacc-core,com.acciente.oacc.sql.internal.persister.id,0,0,0,0,0,0,1,1
acciente_oacc-core,com.acciente.oacc.sql,8,1,0,0,1,0,1,11
acciente_oacc-core,com.acciente.oacc.helper,5,1,0,1,0,0,1,8
Accla_d4m_api_java,edu.mit.ll.cloud.connection,0,0,0,0,0,0,1,1
Accla_d4m_api_java,edu.mit.ll.d4m.db.cloud.accumulo,1,0,0,0,1,0,1,3
Accla_d4m_api_java,edu.mit.ll.d4m.db.cloud,1,1,0,0,1,0,1,4
Accla_d4m_api_java,edu.mit.ll.d4m.db.cloud.util,0,0,0,0,0,0,1,1
Accla_d4m_api_java,edu.mit.ll.graphulo.apply,4,1,0,0,1,0,1,7
Accla_d4m_api_java,edu.mit.ll.graphulo,16,1,0,1,1,0,1,20
Accla_d4m_api_java,edu.mit.ll.graphulo.ewise,3,0,0,0,0,0,1,4
Accla_d4m_api_java,edu.mit.ll.graphulo.reducer,2,0,0,0,0,0,1,3
Accla_d4m_api_java,edu.mit.ll.graphulo.rowmult,2,0,0,0,1,0,1,4
Accla_d4m_api_java,edu.mit.ll.graphulo.simplemult,4,1,0,0,0,0,1,6
Accla_d4m_api_java,edu.mit.ll.graphulo.skvi,15,1,0,1,1,0,1,19
Accla_d4m_api_java,edu.mit.ll.graphulo.skvi.ktruss,0,0,0,0,0,0,1,1
Accla_d4m_api_java,edu.mit.ll.graphulo.tricount,2,0,0,0,1,0,1,4
Accla_d4m_api_java,edu.mit.ll.graphulo.util,19,1,0,0,1,0,1,22
Accla_d4m_api_java,edu.mit.ll.graphulo_ndsi,2,0,0,0,0,0,1,3
Accla_d4m_api_java,edu.mit.ll.graphulo_ocean,6,0,0,1,1,0,1,9
Accla_d4m_api_java,edu.mit.ll.graphulo_ocean.parfile,0,0,0,0,0,0,1,1
Accla_d4m_api_java,edu.mit.ll.graphulo.examples,4,1,0,0,0,0,1,6
aceleradora6-tw_RegistroLivre,br.com.aceleradora.registrolivre.controller,0,0,0,0,0,2,0,2
aceleradora6-tw_RegistroLivre,br.com.aceleradora.registrolivre.dao,0,0,0,0,0,1,0,1
aceleradora6-tw_RegistroLivre,br.com.aceleradora.registrolivre.model,0,0,0,0,0,3,0,3
aceleradora6-tw_RegistroLivre,br.com.aceleradora.registrolivre.util,0,0,0,0,1,2,0,3
aceleradora6-tw_RegistroLivre,br.com.aceleradora.registrolivre.validador.validacoes,0,0,0,0,0,0,0,0
aceleradora6-tw_RegistroLivre,funcional,0,0,0,0,0,0,0,0
aceleradora6-tw_RegistroLivre,unitario,0,0,0,0,0,1,0,1
aceleradora6-tw_RegistroLivre,unitario.validador,0,0,0,0,0,0,0,0
addthis_hydra,com.addthis.hydra.job,20,1,0,1,1,0,1,24
addthis_hydra,com.addthis.hydra.job.mq,4,1,0,0,0,0,1,6
addthis_hydra,com.addthis.hydra.job.store,3,1,0,0,1,0,1,6
addthis_hydra,com.addthis.hydra.task.output,1,1,0,1,0,0,1,4
addthis_hydra,com.addthis.hydra.task.source,0,0,0,1,1,0,1,3
addthis_hydra,com.addthis.hydra.data.channel,1,0,0,0,0,0,1,2
addthis_hydra,com.addthis.hydra.data.io,0,0,0,0,1,0,1,2
addthis_hydra,com.addthis.hydra.data,0,0,0,0,0,0,1,1
addthis_hydra,com.addthis.hydra.data.query,2,1,0,1,0,0,1,5
addthis_hydra,com.addthis.hydra.data.query.engine,0,0,0,0,0,0,1,1
addthis_hydra,com.addthis.hydra.data.query.op.merge,2,1,0,0,0,0,1,4
addthis_hydra,com.addthis.hydra.data.query.op,2,1,0,1,1,0,1,6
addthis_hydra,com.addthis.hydra.data.query.source,0,0,0,0,1,0,1,2
addthis_hydra,com.addthis.hydra.data.tree,1,1,0,0,1,0,1,4
addthis_hydra,com.addthis.hydra.data.tree.concurrent,1,0,0,0,1,0,1,3
addthis_hydra,com.addthis.hydra.data.tree.nonconcurrent,0,0,0,0,0,0,1,1
addthis_hydra,com.addthis.hydra.data.tree.prop,0,0,0,1,0,0,1,2
addthis_hydra,com.addthis.hydra.data.util,0,0,0,1,1,0,1,3
addthis_hydra,com.addthis.hydra.util,2,1,0,0,1,0,1,5
addthis_hydra,com.yammer.metrics.stats,0,0,0,0,0,0,1,1
addthis_hydra,com.addthis.hydra.common,0,0,0,0,0,0,1,1
addthis_hydra,com.addthis.hydra.common.hash,0,0,0,0,0,0,1,1
addthis_hydra,com.addthis.hydra.common.util,0,0,0,0,0,0,1,1
addthis_hydra,com.addthis.hydra.data.compiler,0,0,0,0,0,0,1,1
addthis_hydra,com.addthis.hydra.data.filter.bundle,1,1,0,1,0,0,1,4
addthis_hydra,com.addthis.hydra.data.filter.bundle.unary,1,0,0,0,0,0,1,2
addthis_hydra,com.addthis.hydra.data.filter.closeablebundle,0,0,0,0,1,0,1,2
addthis_hydra,com.addthis.hydra.data.filter.eval,0,0,0,0,1,0,1,2
addthis_hydra,com.addthis.hydra.data.filter.lambda,0,0,0,0,0,0,1,1
addthis_hydra,com.addthis.hydra.data.filter.util,0,0,0,0,0,0,1,1
addthis_hydra,com.addthis.hydra.data.filter.value,0,0,0,1,0,0,1,2
addthis_hydra,com.addthis.hydra.job.alert,5,1,0,0,0,0,1,7
addthis_hydra,com.addthis.hydra.job.alert.types,3,1,0,0,1,0,1,6
addthis_hydra,com.addthis.hydra.job.alias,2,1,0,0,0,0,1,4
addthis_hydra,com.addthis.hydra.job.auth,2,1,0,0,0,0,1,4
addthis_hydra,com.addthis.hydra.job.backup,0,0,0,0,1,0,1,2
addthis_hydra,com.addthis.hydra.job.entity,5,1,0,0,1,0,1,8
addthis_hydra,com.addthis.hydra.job.spawn,23,1,0,1,0,0,1,26
addthis_hydra,com.addthis.hydra.job.spawn.balancer,3,0,0,0,0,0,1,4
addthis_hydra,com.addthis.hydra.job.spawn.search,0,0,0,0,1,0,1,2
addthis_hydra,com.addthis.hydra.job.web.entities,0,0,0,0,0,0,1,1
addthis_hydra,com.addthis.hydra.job.web.jersey,0,0,0,0,0,0,1,1
addthis_hydra,com.addthis.hydra.job.web,11,1,0,0,0,0,1,13
addthis_hydra,com.addthis.hydra.job.web.resources,5,0,0,0,1,0,1,7
addthis_hydra,com.addthis.hydra.job.web.websocket,2,1,0,0,0,0,1,4
addthis_hydra,com.addthis.hydra,0,0,0,0,0,0,1,1
addthis_hydra,com.addthis.hydra.minion,8,0,0,1,0,0,1,10
addthis_hydra,com.addthis.hydra.query.aggregate,8,1,0,0,0,0,1,10
addthis_hydra,com.addthis.hydra.query,11,0,0,0,1,0,1,13
addthis_hydra,com.addthis.hydra.query.loadbalance,8,1,0,0,0,0,1,10
addthis_hydra,com.addthis.hydra.query.spawndatastore,5,0,0,0,0,0,1,6
addthis_hydra,com.addthis.hydra.query.tracker,8,0,0,0,0,0,1,9
addthis_hydra,com.addthis.hydra.query.util,0,0,0,0,0,0,1,1
addthis_hydra,com.addthis.hydra.query.web,11,1,0,0,0,0,1,13
addthis_hydra,com.addthis.hydra.meshy.http,0,0,0,0,0,0,1,1
addthis_hydra,com.addthis.hydra.mq,0,0,0,0,1,0,1,2
addthis_hydra,com.addthis.hydra.store.common,0,0,0,0,1,0,1,2
addthis_hydra,com.addthis.hydra.store.compress,0,0,0,0,0,0,1,1
addthis_hydra,com.addthis.hydra.store.db,0,0,0,0,1,0,1,2
addthis_hydra,com.addthis.hydra.store.kv,0,0,0,0,0,0,1,1
addthis_hydra,com.addthis.hydra.store.kv.metrics,0,0,0,0,0,0,1,1
addthis_hydra,com.addthis.hydra.store.nonconcurrent,0,0,0,0,0,0,1,1
addthis_hydra,com.addthis.hydra.store.skiplist,0,1,0,0,1,0,1,3
addthis_hydra,com.addthis.hydra.store.util,0,0,0,0,1,0,1,2
addthis_hydra,com.addthis.hydra.store,0,0,0,0,0,0,1,1
addthis_hydra,com.addthis.hydra.task.hoover,0,0,0,0,0,0,1,1
addthis_hydra,com.addthis.hydra.task.map,1,1,0,0,1,0,1,4
addthis_hydra,com.addthis.hydra.task.output.tree,0,0,0,0,0,0,1,1
addthis_hydra,com.addthis.hydra.task.pipeline,0,0,0,0,0,0,1,1
addthis_hydra,com.addthis.hydra.task.run,0,0,0,0,1,0,1,2
addthis_hydra,com.addthis.hydra.task.source.bundleizer,0,0,0,0,0,0,1,1
addthis_hydra,com.addthis.hydra.task.stream,0,0,0,0,1,0,1,2
addthis_hydra,com.addthis.hydra.task.util,0,0,0,0,0,0,1,1
addthis_hydra,com.addthis.hydra.uber,0,0,0,0,0,0,1,1
addthis_hydra,com.addthis.hydra.vault,0,0,0,0,0,0,1,1
addthis_meshy,com.addthis.meshy,1,1,0,1,1,0,0,4
addthis_meshy,com.addthis.meshy.service.file,0,0,0,0,1,0,0,1
addthis_meshy,com.addthis.meshy.service.host,0,0,0,0,0,0,0,0
addthis_meshy,com.addthis.meshy.service.message,0,0,0,0,1,0,0,1
addthis_meshy,com.addthis.meshy.service.peer,1,0,0,0,0,0,0,1
addthis_meshy,com.addthis.meshy.service.stream,0,0,0,0,0,0,0,0
AdoptOpenJDK_mjprof,com.performizeit.jmxsupport,0,0,0,0,0,0,0,0
AdoptOpenJDK_mjprof,com.performizeit.mjprof.api,0,0,0,0,0,0,0,0
AdoptOpenJDK_mjprof,com.performizeit.mjprof,1,0,0,0,0,0,0,1
AdoptOpenJDK_mjprof,com.performizeit.mjprof.model,1,0,0,0,1,4,0,6
AdoptOpenJDK_mjprof,com.performizeit.mjprof.monads,0,0,0,0,0,0,0,0
AdoptOpenJDK_mjprof,com.performizeit.mjprof.parser,1,1,0,0,1,5,0,8
AdoptOpenJDK_mjprof,com.performizeit.mjprof.plugin,1,1,0,0,0,0,0,2
AdoptOpenJDK_mjprof,com.performizeit.mjprof.plugin.types,0,0,0,0,1,0,0,1
AdoptOpenJDK_mjprof,com.performizeit.mjprof.plugins.combiners,0,0,0,0,0,1,0,1
AdoptOpenJDK_mjprof,com.performizeit.mjprof.plugins.comparators,0,0,0,0,0,0,0,0
AdoptOpenJDK_mjprof,com.performizeit.mjprof.plugins.dataSource,0,0,0,0,1,0,0,1
AdoptOpenJDK_mjprof,com.performizeit.mjprof.plugins.filters,0,0,0,0,0,0,0,0
AdoptOpenJDK_mjprof,com.performizeit.mjprof.plugins.mappers,0,0,0,0,0,2,0,2
AdoptOpenJDK_mjprof,com.performizeit.mjprof.plugins.mappers.singlethread,0,0,0,0,0,2,0,2
AdoptOpenJDK_mjprof,com.performizeit.mjprof.plugins.mappers.singlethread.stackframe,0,0,0,0,0,1,0,1
AdoptOpenJDK_mjprof,com.performizeit.mjprof.plugins.mergers,0,0,0,0,0,0,0,0
AdoptOpenJDK_mjprof,com.performizeit.mjprof.plugins.output,0,0,0,0,0,0,0,0
AdoptOpenJDK_mjprof,com.performizeit.mjprof.plugins.terminals,0,0,0,0,0,0,0,0
AdoptOpenJDK_mjprof,com.performizeit.plumbing,0,0,0,0,0,0,0,0
akquinet_vaadinator,$,0,0,0,0,0,0,0,0
akquinet_vaadinator,de.akquinet.engineering.vaadinator.example.address,0,0,0,0,0,0,0,0
akquinet_vaadinator,de.akquinet.engineering.vaadinator.example.address.dao,0,0,0,0,1,0,0,1
akquinet_vaadinator,de.akquinet.engineering.vaadinator.example.address.model,0,0,0,0,0,0,0,0
akquinet_vaadinator,de.akquinet.engineering.vaadinator.example.address.ui.std.presenter,0,0,0,0,1,0,0,1
akquinet_vaadinator,de.akquinet.engineering.vaadinator.example.address.ui.std.view,0,0,0,0,1,0,0,1
akquinet_vaadinator,de.akquinet.engineering.vaadinator.example.address.service,0,0,0,0,1,0,0,1
akquinet_vaadinator,de.akquinet.engineering.vaadinator.example.contractapplication,0,0,0,0,0,0,0,0
akquinet_vaadinator,de.akquinet.engineering.vaadinator.example.contractapplication.model,0,0,0,0,0,0,0,0
akquinet_vaadinator,de.akquinet.engineering.vaadinator.example.contractapplication.ui.std.presenter,0,0,0,0,0,0,0,0
akquinet_vaadinator,de.akquinet.engineering.vaadinator.example.contractapplication.ui.std.view,0,0,0,0,1,0,0,1
akquinet_vaadinator,de.akquinet.engineering.vaadinator.example.crmws.dto,0,0,0,0,0,0,0,0
akquinet_vaadinator,de.akquinet.engineering.vaadinator.example.crmws.model,0,0,0,0,0,0,0,0
akquinet_vaadinator,de.akquinet.engineering.vaadinator.example.crmws.websrv,0,0,0,0,0,0,0,0
akquinet_vaadinator,de.akquinet.engineering.vaadinator.example.crmws.dao,0,0,0,0,0,0,0,0
akquinet_vaadinator,de.akquinet.engineering.vaadinator.timesheet,1,1,0,0,0,0,0,2
akquinet_vaadinator,de.akquinet.engineering.vaadinator.timesheet.context,0,0,0,0,0,0,0,0
akquinet_vaadinator,de.akquinet.engineering.vaadinator.timesheet.model,0,0,0,0,0,0,0,0
akquinet_vaadinator,de.akquinet.engineering.vaadinator.timesheet.service,1,0,0,0,0,0,0,1
akquinet_vaadinator,de.akquinet.engineering.vaadinator.timesheet.ui.std.presenter,0,0,0,0,0,0,0,0
akquinet_vaadinator,de.akquinet.engineering.vaadinator.timesheet.ui.std.view,0,0,0,0,1,0,0,1
akquinet_vaadinator,de.akquinet.engineering.vaadinator.timesheet.widgetset.client,0,0,0,0,0,0,0,0
akquinet_vaadinator,de.akquinet.engineering.vaadinator.timesheet.widgetset,0,0,0,0,0,0,0,0
akquinet_vaadinator,org.vergien.vaadinator.example.webdriver.model,0,0,0,0,0,0,0,0
akquinet_vaadinator,org.vergien.vaadinator.example.webdriver,0,0,0,0,0,0,0,0
akquinet_vaadinator,org.vergien.vaadinator.webdriver.touchkit.model,0,0,0,0,0,0,0,0
akquinet_vaadinator,org.vergien.vaadinator.webdriver.touchkit,0,0,0,0,1,0,0,1
akquinet_vaadinator,de.akquinet.engineering.vaadinator.annotations,0,0,0,0,0,0,0,0
akquinet_vaadinator,de.akquinet.engineering.vaadinator.dao,0,0,0,0,0,0,0,0
akquinet_vaadinator,de.akquinet.engineering.vaadinator.generator,1,0,0,0,0,0,0,1
akquinet_vaadinator,de.akquinet.engineering.vaadinator.mojo,1,1,0,0,0,0,0,2
akquinet_vaadinator,de.akquinet.engineering.vaadinator.model,0,0,0,0,1,0,0,1
akquinet_vaadinator,de.akquinet.engineering.vaadinator.util,0,0,0,0,0,0,0,0
akquinet_vaadinator,org.vergien.vaadinator.codegenerator.lazyquerycontainer,0,0,0,0,0,0,0,0
akquinet_vaadinator,de.akquinet.engineering.vaadinator.generator.te,0,0,0,0,0,0,0,0
akquinet_vaadinator,org.vergien.vaadinator.codegenerator.webdriver,0,0,0,0,0,0,0,0
Alexey1Gavrilov_expectit,net.sf.expectit.java8,0,0,0,0,0,0,0,0
Alexey1Gavrilov_expectit,net.sf.expectit.ant,0,0,0,0,1,0,0,1
Alexey1Gavrilov_expectit,net.sf.expectit.ant.filter,0,0,0,0,0,0,0,0
Alexey1Gavrilov_expectit,net.sf.expectit.ant.matcher,0,0,0,0,0,0,0,0
Alexey1Gavrilov_expectit,net.sf.expectit,2,1,0,1,0,3,0,7
Alexey1Gavrilov_expectit,net.sf.expectit.echo,0,0,0,0,0,0,0,0
Alexey1Gavrilov_expectit,net.sf.expectit.filter,1,1,0,0,0,2,0,4
Alexey1Gavrilov_expectit,net.sf.expectit.interact,1,0,0,0,0,1,0,2
Alexey1Gavrilov_expectit,net.sf.expectit.matcher,0,0,0,0,0,3,0,3
allanbank_mongodb-async-driver,com.allanbank.mongodb,51,1,0,1,1,56,1,111
allanbank_mongodb-async-driver,com.allanbank.mongodb.bson.builder,13,1,0,0,0,76,1,91
allanbank_mongodb-async-driver,com.allanbank.mongodb.bson.builder.impl,3,0,0,0,1,2,1,7
allanbank_mongodb-async-driver,com.allanbank.mongodb.bson,8,1,0,0,1,25,1,36
allanbank_mongodb-async-driver,com.allanbank.mongodb.bson.element,27,1,0,1,0,12,1,42
allanbank_mongodb-async-driver,com.allanbank.mongodb.bson.impl,18,1,0,0,0,1,1,21
allanbank_mongodb-async-driver,com.allanbank.mongodb.bson.io,11,0,0,0,0,4,1,16
allanbank_mongodb-async-driver,com.allanbank.mongodb.bson.json,0,0,0,0,0,0,1,1
allanbank_mongodb-async-driver,com.allanbank.mongodb.builder,20,1,0,1,0,37,1,60
allanbank_mongodb-async-driver,com.allanbank.mongodb.builder.expression,2,0,0,0,1,5,1,9
allanbank_mongodb-async-driver,com.allanbank.mongodb.builder.write,2,1,0,0,1,2,1,7
allanbank_mongodb-async-driver,com.allanbank.mongodb.client,37,1,0,1,0,39,1,79
allanbank_mongodb-async-driver,com.allanbank.mongodb.client.callback,4,1,0,1,0,13,1,20
allanbank_mongodb-async-driver,com.allanbank.mongodb.client.connection.auth,5,0,0,0,0,10,1,16
allanbank_mongodb-async-driver,com.allanbank.mongodb.client.connection.bootstrap,10,0,0,0,0,1,1,12
allanbank_mongodb-async-driver,com.allanbank.mongodb.client.connection,4,0,0,0,1,21,1,27
allanbank_mongodb-async-driver,com.allanbank.mongodb.client.connection.proxy,5,1,0,0,1,11,1,19
allanbank_mongodb-async-driver,com.allanbank.mongodb.client.connection.rs,3,0,0,0,0,6,1,10
allanbank_mongodb-async-driver,com.allanbank.mongodb.client.connection.sharded,3,0,0,0,0,5,1,9
allanbank_mongodb-async-driver,com.allanbank.mongodb.client.connection.socket,12,1,0,0,0,9,1,23
allanbank_mongodb-async-driver,com.allanbank.mongodb.client.message,10,1,0,1,0,28,1,41
allanbank_mongodb-async-driver,com.allanbank.mongodb.client.metrics,10,1,0,0,1,2,1,15
allanbank_mongodb-async-driver,com.allanbank.mongodb.client.metrics.basic,3,1,0,0,0,2,1,7
allanbank_mongodb-async-driver,com.allanbank.mongodb.client.metrics.jmx,4,0,0,0,0,0,1,5
allanbank_mongodb-async-driver,com.allanbank.mongodb.client.metrics.noop,2,0,0,0,0,0,1,3
allanbank_mongodb-async-driver,com.allanbank.mongodb.client.state,8,1,0,0,0,14,1,24
allanbank_mongodb-async-driver,com.allanbank.mongodb.client.transport.bio,2,0,0,0,0,0,1,3
allanbank_mongodb-async-driver,com.allanbank.mongodb.client.transport.bio.one,3,1,0,0,0,0,1,5
allanbank_mongodb-async-driver,com.allanbank.mongodb.client.transport.bio.two,2,0,0,0,0,0,1,3
allanbank_mongodb-async-driver,com.allanbank.mongodb.client.transport,0,0,0,0,1,2,1,4
allanbank_mongodb-async-driver,com.allanbank.mongodb.error,10,1,0,1,1,10,1,24
allanbank_mongodb-async-driver,com.allanbank.mongodb.gridfs,0,0,0,0,0,4,1,5
allanbank_mongodb-async-driver,com.allanbank.mongodb.util,20,1,0,0,1,0,1,23
allanbank_mongodb-async-driver,com.allanbank.mongodb.util.log,2,0,0,0,1,0,1,4
allanbank_mongodb-async-driver,(default package),0,0,0,0,0,2,1,3
allanbank_mongodb-async-driver,com.allanbank.mongodb.acceptance,0,0,0,0,0,13,1,14
altamiracorp_honeycomb,com.nearinfinity.honeycomb.hbase.bulkload,0,0,0,0,0,0,0,0
altamiracorp_honeycomb,com.nearinfinity.honeycomb.hbase.config,0,0,0,0,0,0,0,0
altamiracorp_honeycomb,com.nearinfinity.honeycomb.hbase,2,0,0,0,1,1,0,4
altamiracorp_honeycomb,com.nearinfinity.honeycomb.hbase.rowkey,2,1,0,0,0,2,0,5
altamiracorp_honeycomb,com.nearinfinity.honeycomb.hbase.generators,1,0,0,0,0,1,0,2
altamiracorp_honeycomb,com.nearinfinity.honeycomb,0,0,0,0,0,1,0,1
altamiracorp_honeycomb,com.nearinfinity.honeycomb.config,0,0,0,0,0,0,0,0
altamiracorp_honeycomb,com.nearinfinity.honeycomb.exceptions,0,0,0,0,0,0,0,0
altamiracorp_honeycomb,com.nearinfinity.honeycomb.metrics,0,0,0,0,0,0,0,0
altamiracorp_honeycomb,com.nearinfinity.honeycomb.mysql,2,0,0,0,1,3,0,6
altamiracorp_honeycomb,com.nearinfinity.honeycomb.mysql.gen,0,0,0,0,1,0,0,1
altamiracorp_honeycomb,com.nearinfinity.honeycomb.mysql.schema,3,0,0,0,1,1,0,5
altamiracorp_honeycomb,com.nearinfinity.honeycomb.mysql.schema.versioning,0,0,0,0,1,0,0,1
altamiracorp_honeycomb,com.nearinfinity.honeycomb.util,2,1,0,0,0,0,0,3
altamiracorp_honeycomb,com.nearinfinity.honeycomb.mysql.generators,0,0,0,0,1,0,0,1
andrewgaul_modernizer-maven-plugin,org.gaul.modernizer_maven_plugin,0,0,0,1,0,0,0,1
andrewgaul_modernizer-maven-plugin,(default package),0,0,0,0,0,0,0,0
andrewgaul_s3proxy,org.gaul.s3proxy,0,0,0,1,1,0,0,2
andrewgaul_s3proxy,org.gaul.s3proxy.junit,0,0,0,0,0,0,0,0
andytill_erlyberly,com.ericsson.otp.erlang,0,0,0,0,0,0,0,0
andytill_erlyberly,erlyberly,1,0,0,1,1,0,0,3
andytill_erlyberly,erlyberly.format,0,0,0,0,0,0,0,0
andytill_erlyberly,erlyberly.node,1,1,0,0,1,0,0,3
andytill_erlyberly,hextstar,0,0,0,0,0,0,0,0
andytill_erlyberly,ui,0,0,0,0,0,0,0,0
antoniomaria_gazpachoquest,net.sf.gazpachoquest.api,0,0,0,0,0,0,0,0
antoniomaria_gazpachoquest,(default package),0,0,0,0,0,0,0,0
antoniomaria_gazpachoquest,net.sf.gazpachoquest.aspects,0,0,0,0,0,0,0,0
antoniomaria_gazpachoquest,net.sf.gazpachoquest.bootstrap,0,0,0,0,0,0,0,0
antoniomaria_gazpachoquest,net.sf.gazpachoquest.util,0,0,0,0,0,0,0,0
antoniomaria_gazpachoquest,net.sf.gazpachoquest.util.impl,0,0,0,0,0,0,0,0
antoniomaria_gazpachoquest,net.sf.gazpachoquest.velocity.loader,0,0,0,0,0,0,0,0
antoniomaria_gazpachoquest,net.sf.gazpachoquest.dto,1,0,0,1,1,3,0,6
antoniomaria_gazpachoquest,net.sf.gazpachoquest.dto.answers,0,0,0,0,0,1,0,1
antoniomaria_gazpachoquest,net.sf.gazpachoquest.dto.auth,0,0,0,0,0,0,0,0
antoniomaria_gazpachoquest,net.sf.gazpachoquest.dto.embeddables,1,1,0,0,1,2,0,5
antoniomaria_gazpachoquest,net.sf.gazpachoquest.dto.error,0,0,0,0,0,0,0,0
antoniomaria_gazpachoquest,net.sf.gazpachoquest.dto.support,0,0,0,0,1,2,0,3
antoniomaria_gazpachoquest,net.sf.gazpachoquest.dto.uml,0,0,0,0,0,0,0,0
antoniomaria_gazpachoquest,net.sf.gazpachoquest.facades,0,0,0,0,1,3,0,4
antoniomaria_gazpachoquest,net.sf.gazpachoquest.facades.impl,0,0,0,0,1,1,0,2
antoniomaria_gazpachoquest,net.sf.gazpachoquest.facades.support,0,0,0,0,0,0,0,0
antoniomaria_gazpachoquest,net.sf.gazpachoquest.jaas.auth,0,0,0,0,0,0,0,0
antoniomaria_gazpachoquest,net.sf.gazpachoquest.jaas,0,0,0,0,0,0,0,0
antoniomaria_gazpachoquest,net.sf.gazpachoquest.repository,0,0,0,0,1,0,0,1
antoniomaria_gazpachoquest,net.sf.gazpachoquest.repository.dynamic,0,0,0,0,0,1,0,1
antoniomaria_gazpachoquest,net.sf.gazpachoquest.repository.i18,0,0,1,0,1,0,0,2
antoniomaria_gazpachoquest,net.sf.gazpachoquest.repository.permission,0,0,0,0,0,0,0,0
antoniomaria_gazpachoquest,net.sf.gazpachoquest.repository.support,0,0,0,0,1,0,0,1
antoniomaria_gazpachoquest,net.sf.gazpachoquest.repository.user,0,0,0,0,0,0,0,0
antoniomaria_gazpachoquest,net.sf.gazpachoquest.repository.impl,0,0,0,0,0,0,0,0
antoniomaria_gazpachoquest,net.sf.gazpachoquest.domain.audit,0,0,0,0,0,0,0,0
antoniomaria_gazpachoquest,net.sf.gazpachoquest.domain.core,0,0,0,1,1,3,0,5
antoniomaria_gazpachoquest,net.sf.gazpachoquest.domain.core.embeddables,0,0,0,0,1,0,0,1
antoniomaria_gazpachoquest,net.sf.gazpachoquest.domain.i18,0,0,0,0,1,1,0,2
antoniomaria_gazpachoquest,net.sf.gazpachoquest.domain.permission,0,0,0,0,1,0,0,1
antoniomaria_gazpachoquest,net.sf.gazpachoquest.domain.support,0,0,0,0,1,5,0,6
antoniomaria_gazpachoquest,net.sf.gazpachoquest.domain.uml,0,0,0,0,1,0,0,1
antoniomaria_gazpachoquest,net.sf.gazpachoquest.domain.user,0,0,0,0,1,1,0,2
antoniomaria_gazpachoquest,net.sf.gazpachoquest.jpa.converter,0,0,0,0,1,0,0,1
antoniomaria_gazpachoquest,net.sf.gazpachoquest.jpa.converter.support,0,0,0,0,0,0,0,0
antoniomaria_gazpachoquest,net.sf.gazpachoquest.jpa.eclipselink,0,0,0,0,0,0,0,0
antoniomaria_gazpachoquest,net.sf.gazpachoquest.qbe,0,0,0,0,1,0,0,1
antoniomaria_gazpachoquest,org.itim.smsgateway.qbe,0,0,0,0,0,0,0,0
antoniomaria_gazpachoquest,net.sf.gazpachoquest.questionnaire.resolver,0,0,0,0,1,3,0,4
antoniomaria_gazpachoquest,net.sf.gazpachoquest.questionnaire.support,0,0,0,0,1,0,0,1
antoniomaria_gazpachoquest,net.sf.gazpachoquest.questionnaires.bootstrap,0,0,0,0,0,0,0,0
antoniomaria_gazpachoquest,net.sf.gazpachoquest.questionnaires.components.question,0,1,0,0,0,0,0,1
antoniomaria_gazpachoquest,net.sf.gazpachoquest.questionnaires.components.question.type,0,0,0,0,0,1,0,1
antoniomaria_gazpachoquest,net.sf.gazpachoquest.questionnaires.components.util,0,0,0,0,0,0,0,0
antoniomaria_gazpachoquest,net.sf.gazpachoquest.questionnaires.events,0,0,0,0,0,0,0,0
antoniomaria_gazpachoquest,net.sf.gazpachoquest.questionnaires,0,0,0,0,0,0,0,0
antoniomaria_gazpachoquest,net.sf.gazpachoquest.questionnaires.i18.impl,0,0,0,0,0,0,0,0
antoniomaria_gazpachoquest,net.sf.gazpachoquest.questionnaires.i18,0,0,0,0,0,0,0,0
antoniomaria_gazpachoquest,net.sf.gazpachoquest.questionnaires.listener,0,0,0,0,0,0,0,0
antoniomaria_gazpachoquest,net.sf.gazpachoquest.questionnaires.log,0,0,0,0,0,0,0,0
antoniomaria_gazpachoquest,net.sf.gazpachoquest.questionnaires.resource,0,0,0,0,0,0,0,0
antoniomaria_gazpachoquest,net.sf.gazpachoquest.questionnaires.views,0,1,0,0,0,0,0,1
antoniomaria_gazpachoquest,net.sf.gazpachoquest.questionnaires.views.login,0,0,0,0,0,0,0,0
antoniomaria_gazpachoquest,com.vaadin.cdi,0,0,0,0,0,0,0,0
antoniomaria_gazpachoquest,net.sf.gazpachoquest.cxf.interceptor,0,0,0,0,0,0,0,0
antoniomaria_gazpachoquest,net.sf.gazpachoquest.security,0,1,0,0,0,0,0,1
antoniomaria_gazpachoquest,net.sf.gazpachoquest.security.impl,0,0,0,0,0,0,0,0
antoniomaria_gazpachoquest,net.sf.gazpachoquest.security.shiro,0,0,0,0,1,0,0,1
antoniomaria_gazpachoquest,net.sf.gazpachoquest.security.support,0,0,0,0,0,0,0,0
antoniomaria_gazpachoquest,net.sf.gazpachoquest.rest,0,0,0,0,0,0,0,0
antoniomaria_gazpachoquest,net.sf.gazpachoquest.rest.exception,0,0,0,0,0,0,0,0
antoniomaria_gazpachoquest,net.sf.gazpachoquest.rest.filter,0,0,0,0,0,0,0,0
antoniomaria_gazpachoquest,net.sf.gazpachoquest.rest.resources,0,0,0,0,1,1,0,2
antoniomaria_gazpachoquest,net.sf.gazpachoquest.rest.support,0,0,0,0,0,0,0,0
antoniomaria_gazpachoquest,net.sf.gazpachoquest.rest.resource,0,0,0,0,0,0,0,0
antoniomaria_gazpachoquest,net.sf.gazpachoquest.rest.auth,0,0,0,0,1,0,0,1
antoniomaria_gazpachoquest,net.sf.gazpachoquest.rest.feature,0,0,0,0,0,0,0,0
antoniomaria_gazpachoquest,net.sf.gazpachoquest.rest.resources.runtime,0,0,0,0,0,0,0,0
antoniomaria_gazpachoquest,net.sf.gazpachoquest.services,0,0,0,1,1,2,0,4
antoniomaria_gazpachoquest,net.sf.gazpachoquest.services.core.impl,0,0,0,0,1,1,0,2
antoniomaria_gazpachoquest,net.sf.gazpachoquest.services.permission.impl,0,0,0,0,0,0,0,0
antoniomaria_gazpachoquest,net.sf.gazpachoquest.services.permission,0,0,0,0,0,0,0,0
antoniomaria_gazpachoquest,net.sf.gazpachoquest.services.user.impl,0,0,0,0,0,0,0,0
antoniomaria_gazpachoquest,net.sf.gazpachoquest.services.impl,0,0,0,0,0,0,0,0
antoniomaria_gazpachoquest,net.sf.gazpachoquest.services.support,0,0,0,0,0,0,0,0
antoniomaria_gazpachoquest,net.sf.gazpachoquest.codelab,0,0,0,0,1,0,0,1
antoniomaria_gazpachoquest,net.sf.gazpachoquest.codelab.massive,0,0,0,0,0,0,0,0
antoniomaria_gazpachoquest,net.sf.gazpachoquest.codelab.randomuser,0,0,0,0,0,0,0,0
antoniomaria_gazpachoquest,net.sf.gazpachoquest.codelab.randomuser.support,0,0,0,0,0,0,0,0
antoniomaria_gazpachoquest,net.sf.gazpachoquest.extractor.dbunit,0,0,0,0,0,0,0,0
antoniomaria_gazpachoquest,net.sf.gazpachoquest.dbpopulator,0,0,0,0,0,2,0,2
antoniomaria_gazpachoquest,net.sf.gazpachoquest.dbpopulator.support,0,0,0,0,0,0,0,0
antoniomaria_gazpachoquest,net.sf.gazpachoquest.ddlgenerator,0,0,0,0,0,0,0,0
antoniomaria_gazpachoquest,net.sf.gazpachoquest.exporter,0,0,0,0,0,0,0,0
antoniomaria_gazpachoquest,net.sf.gazpachoquest.importer,0,0,0,0,0,0,0,0
antoniomaria_gazpachoquest,net.sf.gazpachoquest.types,0,0,0,0,0,0,0,0
apache_airavata,org.apache.airavata.api.server,0,1,0,0,0,0,0,1
apache_airavata,org.apache.airavata.api.server.handler,0,0,0,0,0,0,0,0
apache_airavata,(default package),0,0,0,0,0,0,0,0
apache_airavata,org.apache.airavata.api.server.util,0,0,0,0,0,0,0,0
apache_airavata,org.apache.airavata.api,0,0,0,2,1,0,0,3
apache_airavata,org.apache.airavata.api.client,0,0,0,0,0,0,0,0
apache_airavata,org.apache.airavata.base.api,0,0,0,0,0,0,0,0
apache_airavata,org.apache.airavata.client.secure.client,0,0,0,0,0,0,0,0
apache_airavata,org.apache.airavata.client.tools,0,1,0,0,0,0,0,1
apache_airavata,org.apache.airavata.model.appcatalog.accountprovisioning,0,0,0,0,1,0,0,1
apache_airavata,org.apache.airavata.model.appcatalog.appdeployment,0,0,0,0,1,0,0,1
apache_airavata,org.apache.airavata.model.appcatalog.appinterface,0,0,0,0,1,0,0,1
apache_airavata,org.apache.airavata.model.appcatalog.computeresource,0,0,0,1,1,0,0,2
apache_airavata,org.apache.airavata.model.appcatalog.gatewaygroups,0,0,0,0,0,0,0,0
apache_airavata,org.apache.airavata.model.appcatalog.gatewayprofile,0,0,0,0,1,0,0,1
apache_airavata,org.apache.airavata.model.appcatalog.groupresourceprofile,0,0,0,0,1,0,0,1
apache_airavata,org.apache.airavata.model.appcatalog.parser,0,0,0,1,1,0,0,2
apache_airavata,org.apache.airavata.model.appcatalog.storageresource,0,0,0,0,0,0,0,0
apache_airavata,org.apache.airavata.model.appcatalog.userresourceprofile,0,0,0,0,1,0,0,1
apache_airavata,org.apache.airavata.model.application.io,0,0,0,0,1,0,0,1
apache_airavata,org.apache.airavata.model.commons,0,0,0,0,1,0,0,1
apache_airavata,org.apache.airavata.model,0,0,0,1,1,0,0,2
apache_airavata,org.apache.airavata.model.credential.store,0,0,0,1,1,0,0,2
apache_airavata,org.apache.airavata.model.data.movement,0,0,0,0,1,0,0,1
apache_airavata,org.apache.airavata.model.data.replica,0,0,0,0,1,0,0,1
apache_airavata,org.apache.airavata.model.dbevent,0,0,0,0,1,0,0,1
apache_airavata,org.apache.airavata.model.error,0,0,0,1,1,0,0,2
apache_airavata,org.apache.airavata.model.experiment,0,0,0,0,1,0,0,1
apache_airavata,org.apache.airavata.model.group,0,0,0,0,0,0,0,0
apache_airavata,org.apache.airavata.model.job,0,0,0,0,0,0,0,0
apache_airavata,org.apache.airavata.model.messaging.event,0,0,0,1,1,0,0,2
apache_airavata,org.apache.airavata.model.process,0,0,0,0,1,0,0,1
apache_airavata,org.apache.airavata.model.scheduling,0,0,0,0,0,0,0,0
apache_airavata,org.apache.airavata.model.security,0,0,0,0,0,0,0,0
apache_airavata,org.apache.airavata.model.status,0,0,0,0,1,0,0,1
apache_airavata,org.apache.airavata.model.task,0,0,0,0,1,0,0,1
apache_airavata,org.apache.airavata.model.tenant,0,0,0,0,1,0,0,1
apache_airavata,org.apache.airavata.model.user,0,0,0,0,1,0,0,1
apache_airavata,org.apache.airavata.model.workflow,0,0,0,1,1,0,0,2
apache_airavata,org.apache.airavata.model.workspace,0,0,0,0,1,0,0,1
apache_airavata,org.apache.airavata.model.util,0,0,0,0,0,0,0,0
apache_airavata,org.apache.airavata.service.profile.iam.admin.services.core.impl,0,0,0,0,0,0,0,0
apache_airavata,org.apache.airavata.service.profile.iam.admin.services.core.interfaces,0,0,0,0,0,0,0,0
apache_airavata,org.apache.airavata.service.profile.client.util,0,0,0,0,0,0,0,0
apache_airavata,org.apache.airavata.service.profile.commons.repositories,0,0,0,0,0,0,0,0
apache_airavata,org.apache.airavata.service.profile.commons.tenant.entities,0,0,0,0,0,0,0,0
apache_airavata,org.apache.airavata.service.profile.commons.user.entities,0,0,0,0,0,0,0,0
apache_airavata,org.apache.airavata.service.profile.commons.utils,0,0,0,0,1,0,0,1
apache_airavata,org.apache.airavata.service.profile.handlers,0,0,0,0,0,0,0,0
apache_airavata,org.apache.airavata.service.profile.server,0,0,0,0,0,0,0,0
apache_airavata,org.apache.airavata.service.profile.client,0,0,0,0,0,0,0,0
apache_airavata,org.apache.airavata.service.profile.groupmanager.cpi.exception,0,0,0,0,0,0,0,0
apache_airavata,org.apache.airavata.service.profile.groupmanager.cpi,0,0,0,2,1,0,0,3
apache_airavata,org.apache.airavata.service.profile.iam.admin.services.cpi.exception,0,0,0,0,0,0,0,0
apache_airavata,org.apache.airavata.service.profile.iam.admin.services.cpi,0,0,0,2,1,0,0,3
apache_airavata,org.apache.airavata.service.profile.tenant.cpi.exception,0,0,0,0,0,0,0,0
apache_airavata,org.apache.airavata.service.profile.tenant.cpi,0,0,0,1,1,0,0,2
apache_airavata,org.apache.airavata.service.profile.user.cpi.exception,0,0,0,0,0,0,0,0
apache_airavata,org.apache.airavata.service.profile.user.cpi,0,0,0,1,1,0,0,2
apache_airavata,org.apache.airavata.service.profile.tenant.core.repositories,0,0,0,0,0,0,0,0
apache_airavata,org.apache.airavata.service.profile.user.core.exceptions,0,0,0,0,0,0,0,0
apache_airavata,org.apache.airavata.service.profile.user.core.repositories,0,0,0,0,0,0,0,0
apache_airavata,org.apache.airavata.service.profile.user.core.utils,0,0,0,0,0,0,0,0
apache_airavata,org.apache.airavata.registry.core.repositories,0,0,0,0,0,0,0,0
apache_airavata,org.apache.airavata.service.security,0,1,0,0,1,0,0,2
apache_airavata,org.apache.airavata.service.security.authzcache,0,0,0,0,1,0,0,1
apache_airavata,org.apache.airavata.service.security.interceptor,0,0,0,0,0,0,0,0
apache_airavata,org.apache.airavata.agents.api,0,0,0,0,1,0,0,1
apache_airavata,org.apache.airavata.agents.streaming,0,0,0,0,0,0,0,0
apache_airavata,org.apache.airavata.helix.agent.ssh,0,0,0,0,0,0,0,0
apache_airavata,org.apache.airavata.helix.agent.storage,0,0,0,0,0,0,0,0
apache_airavata,org.apache.airavata.helix.adaptor,0,0,0,0,0,0,0,0
apache_airavata,org.apache.airavata.helix.adaptor.wrapper,0,0,0,0,0,0,0,0
apache_airavata,org.apache.airavata.helix.impl.controller,0,0,0,0,0,0,0,0
apache_airavata,org.apache.airavata.helix.impl.participant,0,0,0,0,0,0,0,0
apache_airavata,org.apache.airavata.helix.impl.task,0,0,0,0,0,0,0,0
apache_airavata,org.apache.airavata.helix.impl.task.cancel,0,0,0,0,0,0,0,0
apache_airavata,org.apache.airavata.helix.impl.task.completing,0,0,0,0,0,0,0,0
apache_airavata,org.apache.airavata.helix.impl.task.env,0,0,0,0,0,0,0,0
apache_airavata,org.apache.airavata.helix.impl.task.mock,0,0,0,0,0,0,0,0
apache_airavata,org.apache.airavata.helix.impl.task.parsing,1,0,0,0,0,0,0,1
apache_airavata,org.apache.airavata.helix.impl.task.parsing.kafka,1,1,0,0,0,0,0,2
apache_airavata,org.apache.airavata.helix.impl.task.parsing.models,0,0,0,0,0,0,0,0
apache_airavata,org.apache.airavata.helix.impl.task.staging,0,0,0,0,0,0,0,0
apache_airavata,org.apache.airavata.helix.impl.task.submission.config.app,0,0,0,0,1,0,0,1
apache_airavata,org.apache.airavata.helix.impl.task.submission.config.app.parser,0,0,0,0,1,0,0,1
apache_airavata,org.apache.airavata.helix.impl.task.submission.config,0,0,0,0,1,0,0,1
apache_airavata,org.apache.airavata.helix.impl.task.submission,0,0,0,0,0,0,0,0
apache_airavata,org.apache.airavata.helix.impl.workflow,0,0,0,0,0,0,0,0
apache_airavata,org.apache.airavata.helix.cluster.monitoring.agents,0,0,0,0,0,0,0,0
apache_airavata,org.apache.airavata.helix.cluster.monitoring,0,0,0,0,0,0,0,0
apache_airavata,org.apache.airavata.helix.task.api.support,0,0,0,0,0,0,0,0
apache_airavata,org.apache.airavata.helix.task.api,0,0,0,0,0,0,0,0
apache_airavata,org.apache.airavata.helix.core,1,0,0,0,0,0,0,1
apache_airavata,org.apache.airavata.helix.core.participant,0,0,0,0,0,0,0,0
apache_airavata,org.apache.airavata.helix.core.support.adaptor,0,0,0,0,0,0,0,0
apache_airavata,org.apache.airavata.helix.core.support,0,0,0,0,0,0,0,0
apache_airavata,org.apache.airavata.helix.core.util,1,1,0,0,0,0,0,2
apache_airavata,org.apache.airavata.helix.workflow,0,0,0,0,0,0,0,0
apache_airavata,org.apache.airavata.cluster.monitoring,0,0,0,0,0,0,0,0
apache_airavata,org.apache.airavata.common.context,0,0,0,0,0,0,0,0
apache_airavata,org.apache.airavata.common.exception,0,0,0,0,0,0,0,0
apache_airavata,org.apache.airavata.common.logging,0,0,0,0,0,0,0,0
apache_airavata,org.apache.airavata.common.logging.kafka,0,0,0,0,0,0,0,0
apache_airavata,org.apache.airavata.common.utils,0,0,0,1,1,1,0,3
apache_airavata,org.apache.airavata.common.utils.listener,0,0,0,0,0,0,0,0
apache_airavata,org.apache.airavata.accountprovisioning,1,0,0,0,1,0,0,2
apache_airavata,org.apache.airavata.accountprovisioning.provisioner,1,1,0,0,0,0,0,2
apache_airavata,org.apache.airavata.credential.store.credential,0,0,0,0,0,1,0,1
apache_airavata,org.apache.airavata.credential.store.credential.impl.certificate,0,0,0,0,0,0,0,0
apache_airavata,org.apache.airavata.credential.store.credential.impl.password,0,0,0,0,0,0,0,0
apache_airavata,org.apache.airavata.credential.store.credential.impl.ssh,0,0,0,0,0,0,0,0
apache_airavata,org.apache.airavata.credential.store.notifier,0,0,0,0,0,0,0,0
apache_airavata,org.apache.airavata.credential.store.notifier.impl,0,0,0,0,0,0,0,0
apache_airavata,org.apache.airavata.credential.store.server,0,0,0,0,0,0,0,0
apache_airavata,org.apache.airavata.credential.store.servlet,0,0,0,0,0,0,0,0
apache_airavata,org.apache.airavata.credential.store.store,2,1,0,0,0,0,0,3
apache_airavata,org.apache.airavata.credential.store.store.impl,3,1,0,0,0,0,0,4
apache_airavata,org.apache.airavata.credential.store.store.impl.db,2,0,0,0,1,1,0,4
apache_airavata,org.apache.airavata.credential.store.store.impl.util,0,0,0,0,0,0,0,0
apache_airavata,org.apache.airavata.credential.store.util,1,1,0,0,1,0,0,3
apache_airavata,org.apache.airavata.credential.store.client,0,0,0,0,0,0,0,0
apache_airavata,org.apache.airavata.credential.store.cpi,0,0,0,2,1,0,0,3
apache_airavata,org.apache.airavata.credential.store.exception,0,0,0,0,0,0,0,0
apache_airavata,org.apache.airavata.db.event.manager,0,0,0,0,0,0,0,0
apache_airavata,org.apache.airavata.db.event.manager.messaging,0,0,0,0,0,0,0,0
apache_airavata,org.apache.airavata.db.event.manager.messaging.impl,0,0,0,0,0,0,0,0
apache_airavata,org.apache.airavata.db.event.manager.utils,0,0,0,0,0,0,0,0
apache_airavata,org.apache.airavata.ide.integration,0,0,0,0,0,0,0,0
apache_airavata,org.apache.airavata.monitor.email,0,0,0,0,0,0,0,0
apache_airavata,org.apache.airavata.monitor.email.parser,0,0,0,0,1,0,0,1
apache_airavata,org.apache.airavata.monitor,0,0,0,0,0,0,0,0
apache_airavata,org.apache.airavata.monitor.kafka,0,0,0,0,0,0,0,0
apache_airavata,org.apache.airavata.monitor.realtime.parser,0,0,0,0,0,0,0,0
apache_airavata,org.apache.airavata.monitor.realtime,0,0,0,0,0,0,0,0
apache_airavata,org.apache.airavata.messaging.client,0,0,0,0,0,0,0,0
apache_airavata,org.apache.airavata.messaging.core.impl,0,0,0,0,1,0,0,1
apache_airavata,org.apache.airavata.messaging.core,0,0,0,0,1,0,0,1
apache_airavata,org.apache.airavata.messaging.core.stats,0,0,0,0,0,0,0,0
apache_airavata,org.apache.airavata.messaging.core.util,0,0,0,0,0,0,0,0
apache_airavata,org.apache.airavata.orchestrator.client,0,0,0,0,0,0,0,0
apache_airavata,org.apache.airavata.orchestrator.cpi,0,0,0,1,1,0,0,2
apache_airavata,org.apache.airavata.orchestrator.core.context,0,0,0,0,0,0,0,0
apache_airavata,org.apache.airavata.orchestrator.core.exception,0,0,0,0,0,0,0,0
apache_airavata,org.apache.airavata.orchestrator.core.impl,0,0,0,0,0,0,0,0
apache_airavata,org.apache.airavata.orchestrator.core.job,0,0,0,0,0,0,0,0
apache_airavata,org.apache.airavata.orchestrator.core,0,0,0,0,0,0,0,0
apache_airavata,org.apache.airavata.orchestrator.core.schedule,0,0,0,0,0,0,0,0
apache_airavata,org.apache.airavata.orchestrator.core.utils,0,0,0,0,0,0,0,0
apache_airavata,org.apache.airavata.orchestrator.core.validator.impl,0,0,0,0,0,0,0,0
apache_airavata,org.apache.airavata.orchestrator.core.validator,0,0,0,0,0,0,0,0
apache_airavata,org.apache.airavata.orchestrator.cpi.impl,0,0,0,0,0,0,0,0
apache_airavata,org.apache.airavata.orchestrator.server,0,0,0,0,0,0,0,0
apache_airavata,org.apache.airavata.orchestrator.util,0,0,0,0,0,0,0,0
apache_airavata,org.apache.airavata.registry.core.entities.airavataworkflowcatalog,0,0,0,0,1,0,0,1
apache_airavata,org.apache.airavata.registry.core.entities.appcatalog,0,0,0,1,1,0,0,2
apache_airavata,org.apache.airavata.registry.core.entities.expcatalog,0,0,0,1,1,0,0,2
apache_airavata,org.apache.airavata.registry.core.entities.replicacatalog,0,0,0,0,1,0,0,1
apache_airavata,org.apache.airavata.registry.core.entities.workflowcatalog,0,0,0,0,1,0,0,1
apache_airavata,org.apache.airavata.registry.core,0,0,0,0,0,0,0,0
apache_airavata,org.apache.airavata.registry.core.repositories.appcatalog,0,0,0,1,1,0,0,2
apache_airavata,org.apache.airavata.registry.core.repositories.expcatalog,0,0,0,1,1,0,0,2
apache_airavata,org.apache.airavata.registry.core.repositories.replicacatalog,0,0,0,0,0,0,0,0
apache_airavata,org.apache.airavata.registry.core.repositories.workflowcatalog,0,0,0,0,0,0,0,0
apache_airavata,org.apache.airavata.registry.core.utils,0,0,0,1,1,0,0,2
apache_airavata,org.apache.airavata.registry.core.utils.DozerConverter,0,0,0,0,0,0,0,0
apache_airavata,org.apache.airavata.registry.core.utils.JPAUtil,0,0,0,0,0,0,0,0
apache_airavata,org.apache.airavata.registry.core.repositories.common,0,0,0,0,0,0,0,0
apache_airavata,org.apache.airavata.registry.cpi,0,0,0,0,1,0,0,1
apache_airavata,org.apache.airavata.registry.cpi.utils,0,0,0,0,1,0,0,1
apache_airavata,org.apache.airavata.registry.api.service.handler,0,0,0,0,0,0,0,0
apache_airavata,org.apache.airavata.registry.api.service.messaging,0,0,0,0,0,0,0,0
apache_airavata,org.apache.airavata.registry.api.service,0,0,0,0,0,0,0,0
apache_airavata,org.apache.airavata.registry.api.service.util,0,0,0,0,0,0,0,0
apache_airavata,org.apache.airavata.registry.api.client,0,0,0,0,0,0,0,0
apache_airavata,org.apache.airavata.registry.api.exception,0,0,0,0,0,0,0,0
apache_airavata,org.apache.airavata.registry.api,0,0,0,2,1,0,0,3
apache_airavata,appcatalog.computeresource,0,0,0,0,1,0,0,1
apache_airavata,generators,0,0,0,0,0,0,0,0
apache_airavata,model,0,0,0,0,1,0,0,1
apache_airavata,org.apache.airavata.registry.tool,0,0,0,0,0,0,0,0
apache_airavata,org.apache.airavata.security,0,0,0,0,1,0,0,1
apache_airavata,org.apache.airavata.security.configurations,0,0,0,0,1,0,0,1
apache_airavata,org.apache.airavata.security.userstore,0,0,0,0,1,0,0,1
apache_airavata,org.apache.airavata.security.util,0,0,0,0,0,0,0,0
apache_airavata,org.apache.airavata.server,0,0,0,0,0,0,0,0
apache_airavata,org.apache.airavata.sharing.registry.migrator.airavata,0,0,0,0,0,0,0,0
apache_airavata,org.apache.airavata.sharing.registry.db.entities,0,0,0,0,1,0,0,1
apache_airavata,org.apache.airavata.sharing.registry.db.repositories,0,0,0,0,1,0,0,1
apache_airavata,org.apache.airavata.sharing.registry.db.utils,0,0,0,0,1,0,0,1
apache_airavata,org.apache.airavata.sharing.registry.messaging,1,0,0,0,0,0,0,1
apache_airavata,org.apache.airavata.sharing.registry.server,1,1,0,0,0,0,0,2
apache_airavata,org.apache.airavata.sharing.registry.utils,0,0,0,0,0,0,0,0
apache_airavata,org.apache.airavata.sharing.registry,0,0,0,0,0,0,0,0
apache_airavata,org.apache.airavata.sharing.registry.client,0,0,0,0,0,0,0,0
apache_airavata,org.apache.airavata.sharing.registry.models,0,0,0,1,1,0,0,2
apache_airavata,org.apache.airavata.sharing.registry.service.cpi,0,0,0,2,1,0,0,3
apache_airavata,org.apache.airavata.tools.load,0,0,0,0,1,0,0,1
apache_curator,org.apache.curator.connection,1,0,0,0,0,0,1,2
apache_curator,org.apache.curator,5,1,0,0,1,0,1,8
apache_curator,org.apache.curator.drivers,0,0,0,0,0,0,1,1
apache_curator,org.apache.curator.ensemble,0,0,0,0,0,0,1,1
apache_curator,org.apache.curator.ensemble.exhibitor,0,0,0,0,1,0,1,2
apache_curator,org.apache.curator.ensemble.fixed,0,0,0,0,0,0,1,1
apache_curator,org.apache.curator.retry,0,0,0,0,1,0,1,2
apache_curator,org.apache.curator.utils,4,1,0,0,1,0,1,7
apache_curator,async,0,0,0,0,0,0,1,1
apache_curator,cache,0,0,0,0,0,0,1,1
apache_curator,discovery,0,0,0,0,0,0,1,1
apache_curator,framework,0,0,0,0,0,0,1,1
apache_curator,leader,0,0,0,0,0,0,1,1
apache_curator,locking,0,0,0,0,0,1,1,2
apache_curator,modeled,0,0,0,0,1,0,1,2
apache_curator,pubsub,0,0,0,0,0,1,1,2
apache_curator,pubsub.messages,0,0,0,0,0,0,1,1
apache_curator,pubsub.models,0,0,0,0,0,0,1,1
apache_curator,org.apache.curator.framework.api,0,0,0,1,1,3,1,6
apache_curator,org.apache.curator.framework.api.transaction,0,0,0,0,1,1,1,3
apache_curator,org.apache.curator.framework,4,1,0,0,1,14,1,21
apache_curator,org.apache.curator.framework.imps,2,0,0,1,1,3,1,8
apache_curator,org.apache.curator.framework.listen,0,0,0,0,1,0,1,2
apache_curator,org.apache.curator.framework.schema,0,0,0,0,1,0,1,2
apache_curator,org.apache.curator.framework.state,3,0,0,0,0,0,1,4
apache_curator,org.apache.curator.framework.ensemble,0,0,0,0,0,1,1,2
apache_curator,org.apache.curator.framework.recipes,0,0,0,0,0,0,1,1
apache_curator,org.apache.curator.framework.recipes.atomic,0,0,0,0,0,1,1,2
apache_curator,org.apache.curator.framework.recipes.barriers,0,0,0,0,0,1,1,2
apache_curator,org.apache.curator.framework.recipes.cache,0,0,0,0,1,0,1,2
apache_curator,org.apache.curator.framework.recipes.leader,2,0,0,0,1,2,1,6
apache_curator,org.apache.curator.framework.recipes.locks,3,1,0,1,1,1,1,8
apache_curator,org.apache.curator.framework.recipes.nodes,0,0,0,0,1,1,1,3
apache_curator,org.apache.curator.framework.recipes.queue,0,0,0,1,0,1,1,3
apache_curator,org.apache.curator.framework.recipes.shared,0,0,0,0,1,0,1,2
apache_curator,org.apache.curator.framework.client,0,0,0,0,0,0,1,1
apache_curator,org.apache.curator.x.async.api,0,0,0,0,1,0,1,2
apache_curator,org.apache.curator.x.async,2,1,0,0,1,0,1,5
apache_curator,org.apache.curator.x.async.details,0,0,0,0,1,0,1,2
apache_curator,org.apache.curator.x.async.migrations,0,0,0,0,0,0,1,1
apache_curator,org.apache.curator.x.async.modeled.cached,0,0,0,0,0,1,1,2
apache_curator,org.apache.curator.x.async.modeled.details,1,0,0,0,1,0,1,3
apache_curator,org.apache.curator.x.async.modeled,1,1,0,0,1,1,1,5
apache_curator,org.apache.curator.x.async.modeled.typed,0,0,0,1,1,0,1,3
apache_curator,org.apache.curator.x.async.modeled.versioned,0,0,0,0,0,0,1,1
apache_curator,org.apache.curator.x.async.migrations.models,0,0,0,0,0,0,1,1
apache_curator,org.apache.curator.x.async.modeled.models,0,0,0,0,0,0,1,1
apache_curator,org.apache.curator.x.discovery.details,2,0,0,0,1,1,1,5
apache_curator,org.apache.curator.x.discovery,2,1,0,0,1,2,1,7
apache_curator,org.apache.curator.x.discovery.strategies,1,1,0,0,0,0,1,3
apache_curator,org.apache.curator.x.discovery.server.contexts,0,0,0,0,0,0,1,1
apache_curator,org.apache.curator.x.discovery.server.entity,0,1,0,0,0,0,1,2
apache_curator,org.apache.curator.x.discovery.server.rest,0,0,0,0,0,0,1,1
apache_curator,org.apache.curator.x.discovery.server.jetty_jersey,0,0,0,0,1,0,1,2
apache_curator,org.apache.curator.x.discovery.server.jetty_resteasy,0,0,0,0,0,0,1,1
apache_curator,org.apache.curator.x.discovery.server.mocks,0,0,0,0,0,0,1,1
apache_drill,org.apache.drill.common,0,0,0,0,1,1,1,3
apache_drill,org.apache.drill.common.collections,0,0,0,0,0,0,1,1
apache_drill,org.apache.drill.common.concurrent,0,0,0,0,0,1,1,2
apache_drill,org.apache.drill.common.config,1,1,0,0,1,4,1,8
apache_drill,org.apache.drill.common.exceptions,0,1,0,0,1,1,1,4
apache_drill,org.apache.drill.common.map,0,0,0,0,0,0,1,1
apache_drill,org.apache.drill.common.scanner,1,0,0,0,1,2,1,5
apache_drill,org.apache.drill.common.scanner.persistence,0,0,0,0,1,0,1,2
apache_drill,org.apache.drill.common.types,0,0,0,0,0,0,1,1
apache_drill,org.apache.drill.common.util,0,1,0,0,1,0,1,3
apache_drill,org.apache.drill.common.util.function,0,0,1,0,0,0,1,2
apache_drill,org.apache.drill.exec.metrics,0,0,0,0,1,0,1,2
apache_drill,org.apache.drill.exec.util,50,1,0,1,1,4,1,58
apache_drill,org.apache.drill.categories,0,0,0,0,1,0,1,2
apache_drill,com.esri.core.geometry,0,0,0,0,0,0,1,1
apache_drill,org.apache.drill.exec.store.esri,0,0,0,0,1,0,1,2
apache_drill,org.apache.drill.exec.store.excel,0,0,0,0,1,0,1,2
apache_drill,org.apache.drill.exec.store.ltsv,0,0,0,0,1,0,1,2
apache_drill,org.apache.drill.exec.planner.index,1,1,0,1,1,0,1,5
apache_drill,org.apache.drill.exec.store.mapr.db.binary,0,0,0,0,1,0,1,2
apache_drill,org.apache.drill.exec.store.mapr.db.json,1,0,0,1,1,0,1,4
apache_drill,org.apache.drill.exec.store.mapr.db,0,0,0,1,1,0,1,3
apache_drill,org.apache.drill.exec.store.mapr.db.util,0,0,0,0,0,0,1,1
apache_drill,org.apache.drill.exec.store.mapr,0,0,0,0,1,0,1,2
apache_drill,org.apache.drill.exec.store.mapr.streams,0,0,0,0,1,0,1,2
apache_drill,org.apache.drill.exec.udf.mapr.db,0,0,0,0,1,0,1,2
apache_drill,org.apache.drill.exec.store.syslog,0,0,0,0,1,0,1,2
apache_drill,org.apache.drill.exec.expr.fn.impl.conv,0,0,0,1,1,0,1,3
apache_drill,org.apache.drill.exec.store.hbase,0,0,0,0,1,0,1,2
apache_drill,org.apache.drill.exec.store.hbase.config,0,0,0,0,0,0,1,1
apache_drill,org.apache.drill.hbase,0,0,0,0,1,0,1,2
apache_drill,org.apache.drill.exec.planner.sql.logical,3,0,0,0,0,0,1,4
apache_drill,org.apache.drill.exec.expr.fn.impl.hive,2,0,0,1,1,0,1,5
apache_drill,org.apache.drill.exec.expr.fn,24,1,0,1,1,0,1,28
apache_drill,org.apache.drill.exec.expr,67,1,0,1,1,0,1,71
apache_drill,org.apache.drill.exec.planner.sql,17,1,0,1,1,0,1,21
apache_drill,org.apache.drill.exec.planner.types,0,0,0,0,1,0,1,2
apache_drill,org.apache.drill.exec.store.hive.client,0,0,0,0,1,0,1,2
apache_drill,org.apache.drill.exec.store.hive,9,1,0,0,1,0,1,12
apache_drill,org.apache.drill.exec.store.hive.readers,2,0,0,0,0,0,1,3
apache_drill,org.apache.drill.exec.store.hive.readers.inspectors,0,0,0,0,0,0,1,1
apache_drill,org.apache.drill.exec.store.hive.schema,0,0,0,0,1,0,1,2
apache_drill,org.apache.drill.exec.store.hive.writers.complex,0,0,0,0,0,1,1,2
apache_drill,org.apache.drill.exec.store.hive.writers,0,0,0,0,0,1,1,2
apache_drill,org.apache.drill.exec.store.hive.writers.primitive,0,0,0,0,1,0,1,2
apache_drill,org.apache.drill.exec.fn.hive,0,0,0,0,1,0,1,2
apache_drill,org.apache.drill.exec.hive.complex_types,0,0,0,0,0,0,1,1
apache_drill,org.apache.drill.exec.hive,0,0,0,0,1,0,1,2
apache_drill,org.apache.drill.exec.impersonation.hive,0,0,0,0,0,0,1,1
apache_drill,org.apache.drill.exec.sql.hive,0,0,0,0,0,0,1,1
apache_drill,org.apache.drill.exec.store.hive.inspectors,0,0,0,0,0,0,1,1
apache_drill,org.apache.drill.exec,115,1,0,1,1,1,1,120
apache_drill,org.apache.drill.exec.store.jdbc,0,0,0,1,1,0,1,3
apache_drill,org.apache.drill.exec.store.kafka.decoders,0,0,0,0,0,0,1,1
apache_drill,org.apache.drill.exec.store.kafka,0,0,0,0,1,0,1,2
apache_drill,org.apache.drill.exec.store.kafka.schema,0,0,0,0,0,0,1,1
apache_drill,org.apache.drill.exec.store.kafka.cluster,0,0,0,0,0,0,1,1
apache_drill,org.apache.drill.exec.store.kudu,0,0,0,1,1,0,1,3
apache_drill,org.apache.drill.store.kudu,0,0,0,0,0,0,1,1
apache_drill,org.apache.drill.exec.store.mongo.common,0,0,0,0,0,0,1,1
apache_drill,org.apache.drill.exec.store.mongo.config,0,0,0,0,0,0,1,1
apache_drill,org.apache.drill.exec.store.mongo,0,0,0,0,1,0,1,2
apache_drill,org.apache.drill.exec.store.mongo.schema,0,0,0,0,0,0,1,1
apache_drill,org.apache.drill.exec.store.openTSDB.client,0,1,0,0,0,0,1,2
apache_drill,org.apache.drill.exec.store.openTSDB.client.query,0,0,0,0,0,0,1,1
apache_drill,org.apache.drill.exec.store.openTSDB.client.services,0,0,0,0,0,0,1,1
apache_drill,org.apache.drill.exec.store.openTSDB,0,0,0,0,1,0,1,2
apache_drill,org.apache.drill.exec.store.openTSDB.dto,0,0,0,0,0,0,1,1
apache_drill,org.apache.drill.exec.store.openTSDB.schema,0,0,0,0,0,0,1,1
apache_drill,org.apache.drill.store.openTSDB,0,0,0,0,0,0,1,1
apache_drill,org.apache.drill.exec.udfs,0,0,0,1,1,0,1,3
apache_drill,org.apache.drill.exec.udfs.gis,0,0,0,1,1,0,1,3
apache_drill,org.apache.drill.yarn.appMaster,1,1,0,1,1,0,1,5
apache_drill,org.apache.drill.yarn.appMaster.http,1,0,0,1,1,0,1,4
apache_drill,org.apache.drill.yarn.client,0,0,0,0,1,0,1,2
apache_drill,org.apache.drill.yarn.core,0,0,0,0,1,0,1,2
apache_drill,org.apache.drill.yarn.zk,0,0,0,0,1,0,1,2
apache_drill,org.apache.drill.yarn.scripts,0,0,0,0,0,0,1,1
apache_drill,org.apache.drill.exec.store,34,1,0,2,1,5,1,44
apache_drill,org.apache.drill.exec.expr.fn.impl.gaggr,0,0,0,2,1,0,1,4
apache_drill,org.apache.drill.exec.expr.fn.impl.gcast,0,0,0,1,1,0,1,3
apache_drill,org.apache.drill.exec.expr.fn.impl,50,1,0,2,1,3,1,58
apache_drill,org.apache.drill.exec.store.parquet,16,1,0,1,1,0,1,20
apache_drill,org.apache.drill.exec.record,94,1,0,1,1,27,1,125
apache_drill,org.apache.drill.exec.vector.accessor,2,0,0,1,1,11,1,16
apache_drill,org.apache.calcite.jdbc,3,0,0,0,1,0,1,5
apache_drill,org.apache.commons.logging.impl,0,0,0,0,0,0,1,1
apache_drill,org.apache.drill.exec.cache,3,0,0,1,1,0,1,6
apache_drill,org.apache.drill.exec.client,4,0,0,1,1,0,1,7
apache_drill,org.apache.drill.exec.compile,6,1,0,1,1,1,1,11
apache_drill,org.apache.drill.exec.compile.bytecode,2,0,0,0,1,0,1,4
apache_drill,org.apache.drill.exec.compile.sig,4,1,0,0,1,1,1,8
apache_drill,org.apache.drill.exec.coord,3,0,0,0,1,0,1,5
apache_drill,org.apache.drill.exec.coord.local,0,0,0,0,1,0,1,2
apache_drill,org.apache.drill.exec.coord.store,0,0,0,0,1,1,1,3
apache_drill,org.apache.drill.exec.coord.zk,2,0,0,1,1,1,1,6
apache_drill,org.apache.drill.exec.disk,0,0,0,0,0,0,1,1
apache_drill,org.apache.drill.exec.dotdrill,2,0,0,0,1,0,1,4
apache_drill,org.apache.drill.exec.exception,4,1,0,0,1,0,1,7
apache_drill,org.apache.drill.exec.expr.fn.interpreter,3,1,0,0,1,0,1,6
apache_drill,org.apache.drill.exec.expr.fn.output,0,0,0,1,1,0,1,3
apache_drill,org.apache.drill.exec.expr.fn.registry,3,0,0,0,1,0,1,5
apache_drill,org.apache.drill.exec.memory,15,1,0,0,1,4,1,22
apache_drill,org.apache.drill.exec.metastore.analyze,4,0,0,0,1,0,1,6
apache_drill,org.apache.drill.exec.metastore,4,1,0,0,1,0,1,7
apache_drill,org.apache.drill.exec.ops,38,1,0,1,1,5,1,47
apache_drill,org.apache.drill.exec.opt,2,0,0,0,1,1,1,5
apache_drill,org.apache.drill.exec.physical.base,13,1,0,1,1,0,1,17
apache_drill,org.apache.drill.exec.physical.config,5,1,0,1,1,0,1,9
apache_drill,org.apache.drill.exec.physical,2,0,0,0,1,1,1,5
apache_drill,org.apache.drill.exec.physical.impl.aggregate,7,1,0,0,1,0,1,10
apache_drill,org.apache.drill.exec.physical.impl,18,1,0,1,1,2,1,24
apache_drill,org.apache.drill.exec.physical.impl.broadcastsender,3,0,0,0,1,0,1,5
apache_drill,org.apache.drill.exec.physical.impl.common,17,1,0,1,1,0,1,21
apache_drill,org.apache.drill.exec.physical.impl.filter,3,0,0,0,1,2,1,7
apache_drill,org.apache.drill.exec.physical.impl.flatten,3,0,0,0,1,0,1,5
apache_drill,org.apache.drill.exec.physical.impl.join,12,1,0,1,1,0,1,16
apache_drill,org.apache.drill.exec.physical.impl.limit,0,0,0,0,1,3,1,5
apache_drill,org.apache.drill.exec.physical.impl.materialize,0,0,0,0,1,0,1,2
apache_drill,org.apache.drill.exec.physical.impl.mergereceiver,4,0,0,0,1,0,1,6
apache_drill,org.apache.drill.exec.physical.impl.metadata,0,0,0,0,1,0,1,2
apache_drill,org.apache.drill.exec.physical.impl.orderedpartitioner,0,0,0,0,1,0,1,2
apache_drill,org.apache.drill.exec.physical.impl.partitionsender,6,1,0,0,1,0,1,9
apache_drill,org.apache.drill.exec.physical.impl.producer,0,0,0,0,1,0,1,2
apache_drill,org.apache.drill.exec.physical.impl.project,8,1,0,1,1,2,1,14
apache_drill,org.apache.drill.exec.physical.impl.protocol,0,0,0,0,1,5,1,7
apache_drill,org.apache.drill.exec.physical.impl.rangepartitioner,0,0,0,0,0,0,1,1
apache_drill,org.apache.drill.exec.physical.impl.scan.columns,0,1,0,0,1,0,1,3
apache_drill,org.apache.drill.exec.physical.impl.scan.file,0,0,0,0,1,1,1,3
apache_drill,org.apache.drill.exec.physical.impl.scan.framework,0,0,0,0,1,0,1,2
apache_drill,org.apache.drill.exec.physical.impl.scan,1,0,0,1,1,1,1,5
apache_drill,org.apache.drill.exec.physical.impl.scan.project,1,1,0,1,1,3,1,8
apache_drill,org.apache.drill.exec.physical.impl.scan.project.projSet,2,1,0,1,0,1,1,6
apache_drill,org.apache.drill.exec.physical.impl.sort,4,0,0,0,1,2,1,8
apache_drill,org.apache.drill.exec.physical.impl.spill,0,0,0,0,1,0,1,2
apache_drill,org.apache.drill.exec.physical.impl.statistics,0,0,0,1,1,0,1,3
apache_drill,org.apache.drill.exec.physical.impl.svremover,1,0,0,1,1,2,1,6
apache_drill,org.apache.drill.exec.physical.impl.TopN,3,0,0,0,1,0,1,5
apache_drill,org.apache.drill.exec.physical.impl.trace,0,0,0,0,1,0,1,2
apache_drill,org.apache.drill.exec.physical.impl.union,0,0,0,0,1,0,1,2
apache_drill,org.apache.drill.exec.physical.impl.unnest,3,0,0,0,1,1,1,6
apache_drill,org.apache.drill.exec.physical.impl.unorderedreceiver,0,0,0,0,1,0,1,2
apache_drill,org.apache.drill.exec.physical.impl.unpivot,0,0,0,0,0,0,1,1
apache_drill,org.apache.drill.exec.physical.impl.validate,3,0,0,0,1,0,1,5
apache_drill,org.apache.drill.exec.physical.impl.values,0,0,0,0,0,0,1,1
apache_drill,org.apache.drill.exec.physical.impl.window,0,0,0,1,1,1,1,4
apache_drill,org.apache.drill.exec.physical.impl.xsort,5,0,0,1,1,1,1,9
apache_drill,org.apache.drill.exec.physical.resultSet.impl,2,1,0,1,1,18,1,24
apache_drill,org.apache.drill.exec.physical.resultSet.model,2,0,0,1,1,1,1,6
apache_drill,org.apache.drill.exec.physical.resultSet.model.hyper,2,0,0,0,1,1,1,5
apache_drill,org.apache.drill.exec.physical.resultSet.model.single,2,0,0,0,1,0,1,4
apache_drill,org.apache.drill.exec.physical.resultSet,0,0,0,0,1,6,1,8
apache_drill,org.apache.drill.exec.physical.resultSet.project,1,1,0,0,1,2,1,6
apache_drill,org.apache.drill.exec.physical.rowSet,17,1,0,1,1,15,1,36
apache_drill,org.apache.drill.exec.planner,15,1,0,1,1,1,1,20
apache_drill,org.apache.drill.exec.planner.common,17,1,0,1,1,0,1,21
apache_drill,org.apache.drill.exec.planner.cost,13,1,0,0,1,0,1,16
apache_drill,org.apache.drill.exec.planner.fragment.contrib,0,0,0,0,1,0,1,2
apache_drill,org.apache.drill.exec.planner.fragment,6,0,0,1,1,0,1,9
apache_drill,org.apache.drill.exec.planner.index.generators,0,0,0,0,1,0,1,2
apache_drill,org.apache.drill.exec.planner.index.rules,0,0,0,0,1,0,1,2
apache_drill,org.apache.drill.exec.planner.logical,27,1,0,1,1,1,1,32
apache_drill,org.apache.drill.exec.planner.logical.partition,0,0,0,0,1,0,1,2
apache_drill,org.apache.drill.exec.planner.physical,41,1,0,1,1,1,1,46
apache_drill,org.apache.drill.exec.planner.physical.explain,0,0,0,0,1,1,1,3
apache_drill,org.apache.drill.exec.planner.physical.visitor,2,0,0,1,1,0,1,5
apache_drill,org.apache.drill.exec.planner.sql.conversion,0,0,0,0,1,0,1,2
apache_drill,org.apache.drill.exec.planner.sql.handlers,17,1,0,1,1,0,1,21
apache_drill,org.apache.drill.exec.planner.sql.parser,5,1,0,1,1,0,1,9
apache_drill,org.apache.drill.exec.planner.sql.parser.impl,2,0,0,1,1,0,1,5
apache_drill,org.apache.drill.exec.planner.torel,0,0,0,0,0,0,1,1
apache_drill,org.apache.drill.exec.planner.types.decimal,0,0,0,0,1,0,1,2
apache_drill,org.apache.drill.exec.proto.helper,0,0,0,0,0,0,1,1
apache_drill,org.apache.drill.exec.record.metadata.schema,3,1,0,0,1,1,1,7
apache_drill,org.apache.drill.exec.record.selection,3,1,0,0,1,8,1,14
apache_drill,org.apache.drill.exec.resolver,2,0,0,0,1,0,1,4
apache_drill,org.apache.drill.exec.resourcemgr.config.exception,0,0,0,0,0,0,1,1
apache_drill,org.apache.drill.exec.resourcemgr.config,2,1,0,0,1,1,1,6
apache_drill,org.apache.drill.exec.resourcemgr.config.selectionpolicy,1,0,0,0,1,1,1,4
apache_drill,org.apache.drill.exec.resourcemgr.config.selectors,0,0,0,0,1,0,1,2
apache_drill,org.apache.drill.exec.resourcemgr,1,0,0,0,1,1,1,4
apache_drill,org.apache.drill.exec.resourcemgr.util,0,0,0,0,0,0,1,1
apache_drill,org.apache.drill.exec.rpc,8,1,0,1,1,0,1,12
apache_drill,org.apache.drill.exec.rpc.control,5,1,0,1,1,0,1,9
apache_drill,org.apache.drill.exec.rpc.data,3,0,0,1,1,0,1,6
apache_drill,org.apache.drill.exec.rpc.security,14,1,0,1,1,0,1,18
apache_drill,org.apache.drill.exec.rpc.security.kerberos,0,0,0,0,0,0,1,1
apache_drill,org.apache.drill.exec.rpc.security.plain,3,1,0,0,0,0,1,5
apache_drill,org.apache.drill.exec.rpc.user,12,1,0,1,1,1,1,17
apache_drill,org.apache.drill.exec.rpc.user.security,7,1,0,0,1,0,1,10
apache_drill,org.apache.drill.exec.schema,0,0,0,0,1,0,1,2
apache_drill,org.apache.drill.exec.schema.json.jackson,0,0,0,0,0,0,1,1
apache_drill,org.apache.drill.exec.serialization,0,0,0,0,1,1,1,3
apache_drill,org.apache.drill.exec.server,23,1,0,1,1,0,1,27
apache_drill,org.apache.drill.exec.server.options,8,1,0,1,1,2,1,14
apache_drill,org.apache.drill.exec.server.rest.auth,2,1,0,0,1,0,1,5
apache_drill,org.apache.drill.exec.server.rest,6,1,0,1,1,0,1,10
apache_drill,org.apache.drill.exec.server.rest.profile,4,0,0,1,1,0,1,7
apache_drill,org.apache.drill.exec.service,0,0,0,0,0,0,1,1
apache_drill,org.apache.drill.exec.ssl,2,0,0,0,1,0,1,4
apache_drill,org.apache.drill.exec.store.avro,2,0,0,0,1,0,1,4
apache_drill,org.apache.drill.exec.store.bson,0,0,0,0,0,0,1,1
apache_drill,org.apache.drill.exec.store.dfs,29,1,0,1,1,3,1,36
apache_drill,org.apache.drill.exec.store.dfs.easy,0,0,0,0,1,1,1,3
apache_drill,org.apache.drill.exec.store.direct,0,0,0,0,1,0,1,2
apache_drill,org.apache.drill.exec.store.easy.json,6,0,0,1,1,0,1,9
apache_drill,org.apache.drill.exec.store.easy.json.reader,0,0,0,0,1,0,1,2
apache_drill,org.apache.drill.exec.store.easy.sequencefile,2,0,0,0,1,0,1,4
apache_drill,org.apache.drill.exec.store.easy.text.reader,0,0,0,0,1,2,1,4
apache_drill,org.apache.drill.exec.store.easy.text,4,1,0,0,1,1,1,8
apache_drill,org.apache.drill.exec.store.easy.text.writer,0,0,0,0,0,0,1,1
apache_drill,org.apache.drill.exec.store.httpd,0,0,0,0,1,0,1,2
apache_drill,org.apache.drill.exec.store.image,2,0,0,0,1,0,1,4
apache_drill,org.apache.drill.exec.store.ischema,3,0,0,1,1,0,1,6
apache_drill,org.apache.drill.exec.store.log,0,0,0,0,1,0,1,2
apache_drill,org.apache.drill.exec.store.mock,4,0,0,1,1,0,1,7
apache_drill,org.apache.drill.exec.store.parquet.columnreaders,6,0,0,1,1,1,1,10
apache_drill,org.apache.drill.exec.store.parquet.columnreaders.batchsizing,2,0,0,1,1,2,1,7
apache_drill,org.apache.drill.exec.store.parquet.decimal,2,0,0,0,1,0,1,4
apache_drill,org.apache.drill.exec.store.parquet.metadata,7,1,0,1,1,0,1,11
apache_drill,org.apache.drill.exec.store.parquet2,0,0,0,1,1,0,1,3
apache_drill,org.apache.drill.exec.store.pcap.decoder,1,1,0,0,1,0,1,4
apache_drill,org.apache.drill.exec.store.pcap.dto,0,0,0,0,0,0,1,1
apache_drill,org.apache.drill.exec.store.pcap,1,0,0,0,1,0,1,3
apache_drill,org.apache.drill.exec.store.pcap.schema,0,0,0,0,0,0,1,1
apache_drill,org.apache.drill.exec.store.pcapng.decoder,0,0,0,0,0,0,1,1
apache_drill,org.apache.drill.exec.store.pcapng,0,0,0,0,1,0,1,2
apache_drill,org.apache.drill.exec.store.pcapng.schema,0,0,0,1,0,0,1,2
apache_drill,org.apache.drill.exec.store.pojo,3,0,0,1,1,0,1,6
apache_drill,org.apache.drill.exec.store.schedule,3,1,0,0,1,0,1,6
apache_drill,org.apache.drill.exec.store.sys,6,1,0,1,1,2,1,12
apache_drill,org.apache.drill.exec.store.sys.local,0,0,0,0,0,0,1,1
apache_drill,org.apache.drill.exec.store.sys.store,5,1,0,0,1,1,1,9
apache_drill,org.apache.drill.exec.store.sys.store.provider,3,0,0,0,1,0,1,5
apache_drill,org.apache.drill.exec.store.sys.zk,0,0,0,0,0,0,1,1
apache_drill,org.apache.drill.exec.store.table.function,0,0,0,0,1,0,1,2
apache_drill,org.apache.drill.exec.util.concurrent,0,0,0,0,0,0,1,1
apache_drill,org.apache.drill.exec.util.filereader,0,0,0,0,0,0,1,1
apache_drill,org.apache.drill.exec.util.record,3,0,0,0,0,0,1,4
apache_drill,org.apache.drill.exec.vector.accessor.sql,0,0,0,0,0,0,1,1
apache_drill,org.apache.drill.exec.vector.complex,12,1,0,1,1,5,1,21
apache_drill,org.apache.drill.exec.vector.complex.fn,3,1,0,1,1,6,1,13
apache_drill,org.apache.drill.exec.vector.complex.impl,5,0,0,2,1,0,1,9
apache_drill,org.apache.drill.exec.vector,29,1,0,2,0,13,1,46
apache_drill,org.apache.drill.exec.work.batch,3,0,0,1,1,0,1,6
apache_drill,org.apache.drill.exec.work,3,0,0,0,1,0,1,5
apache_drill,org.apache.drill.exec.work.filter,2,0,0,0,1,0,1,4
apache_drill,org.apache.drill.exec.work.foreman,9,1,0,1,1,0,1,13
apache_drill,org.apache.drill.exec.work.foreman.rm,0,0,0,1,1,1,1,4
apache_drill,org.apache.drill.exec.work.fragment,6,0,0,0,1,0,1,8
apache_drill,org.apache.drill.exec.work.metadata,0,0,0,0,1,0,1,2
apache_drill,org.apache.drill.exec.work.prepare,0,0,0,0,1,0,1,2
apache_drill,org.apache.drill.exec.work.user,0,0,0,0,0,0,1,1
apache_drill,org.apache.parquet.hadoop,0,0,0,0,1,0,1,2
apache_drill,org.apache.drill,22,1,0,1,1,0,1,26
apache_drill,org.apache.drill.exec.fn.impl,0,0,0,1,1,2,1,5
apache_drill,org.apache.drill.exec.fn.interp,0,0,0,0,1,0,1,2
apache_drill,org.apache.drill.exec.impersonation,0,0,0,0,1,0,1,2
apache_drill,org.apache.drill.exec.nested,0,0,0,0,0,0,1,1
apache_drill,org.apache.drill.exec.physical.impl.agg,0,0,0,0,1,0,1,2
apache_drill,org.apache.drill.exec.physical.impl.lateraljoin,0,0,0,0,0,0,1,1
apache_drill,org.apache.drill.exec.physical.impl.PartitionLimit,0,0,0,0,0,2,1,3
apache_drill,org.apache.drill.exec.physical.impl.writer,0,0,0,0,1,0,1,2
apache_drill,org.apache.drill.exec.physical.unit,0,0,0,0,1,0,1,2
apache_drill,org.apache.drill.exec.planner.rm,0,0,0,0,0,0,1,1
apache_drill,org.apache.drill.exec.pop,3,0,0,0,1,1,1,6
apache_drill,org.apache.drill.exec.record.metadata,18,1,0,0,1,13,1,34
apache_drill,org.apache.drill.exec.record.vector,0,0,0,0,1,0,1,2
apache_drill,org.apache.drill.exec.server.rest.spnego,0,0,0,0,0,0,1,1
apache_drill,org.apache.drill.exec.sql,0,0,0,0,1,1,1,3
apache_drill,org.apache.drill.exec.store.easy.text.compliant,0,0,0,0,1,0,1,2
apache_drill,org.apache.drill.exec.store.json,0,0,0,0,0,0,1,1
apache_drill,org.apache.drill.exec.store.sequencefile,0,0,0,0,0,0,1,1
apache_drill,org.apache.drill.exec.store.store,0,0,0,0,0,0,1,1
apache_drill,org.apache.drill.exec.udf.dynamic,0,0,0,0,1,0,1,2
apache_drill,org.apache.drill.exec.vector.complex.writer,15,1,0,1,1,4,1,23
apache_drill,org.apache.drill.vector,0,0,0,0,0,0,1,1
apache_drill,org.apache.hadoop.security,0,0,0,0,0,0,1,1
apache_drill,org.apache.drill.udf.dynamic,0,0,0,0,1,0,1,2
apache_drill,org.apache.drill.jdbc,0,1,0,1,1,0,1,4
apache_drill,org.apache.drill.jdbc.impl,0,0,0,1,1,0,1,3
apache_drill,org.apache.drill.jdbc.proxy,0,0,0,0,1,0,1,2
apache_drill,io.netty.buffer,4,0,0,0,1,3,1,9
apache_drill,org.apache.drill.exec.vector.complex.reader,2,1,0,1,1,6,1,12
apache_drill,org.apache.drill.exec.expr.holders,3,1,0,1,1,0,1,7
apache_drill,org.apache.drill.exec.record.metadata.schema.parser,4,0,0,1,0,1,1,7
apache_drill,org.apache.drill.exec.vector.accessor.convert,3,1,0,0,1,1,1,7
apache_drill,org.apache.drill.exec.vector.accessor.impl,0,0,0,0,0,5,1,6
apache_drill,org.apache.drill.exec.vector.accessor.reader,3,1,0,1,1,2,1,9
apache_drill,org.apache.drill.exec.vector.accessor.writer,4,1,0,1,1,8,1,16
apache_drill,org.apache.drill.exec.vector.accessor.writer.dummy,1,0,0,0,0,1,1,3
apache_drill,org.apache.drill.common.expression,2,1,0,1,1,2,1,8
apache_drill,org.apache.drill.common.expression.fn,0,0,0,0,0,2,1,3
apache_drill,org.apache.drill.common.expression.types,0,0,0,0,1,0,1,2
apache_drill,org.apache.drill.common.expression.visitors,1,0,0,0,1,0,1,3
apache_drill,org.apache.drill.common.graph,1,0,0,0,1,0,1,3
apache_drill,org.apache.drill.common.logical.data,0,0,0,1,1,0,1,3
apache_drill,org.apache.drill.common.logical.data.visitors,0,0,0,0,0,0,1,1
apache_drill,org.apache.drill.common.logical,1,1,0,0,1,3,1,7
apache_drill,org.apache.drill.common.parser,2,1,0,0,0,0,1,4
apache_drill,org.apache.drill.common.expression.parser,2,0,0,1,0,0,1,4
apache_drill,org.apache.drill.storage,0,0,0,0,0,0,1,1
apache_drill,org.apache.drill.metastore.iceberg.components.tables,0,0,0,0,1,0,1,2
apache_drill,org.apache.drill.metastore.iceberg.config,0,0,0,0,0,0,1,1
apache_drill,org.apache.drill.metastore.iceberg.exceptions,0,0,0,0,0,0,1,1
apache_drill,org.apache.drill.metastore.iceberg,0,0,0,0,0,0,1,1
apache_drill,org.apache.drill.metastore.iceberg.operate,0,0,0,0,1,0,1,2
apache_drill,org.apache.drill.metastore.iceberg.schema,0,0,0,0,0,0,1,1
apache_drill,org.apache.drill.metastore.iceberg.transform,0,0,0,0,1,0,1,2
apache_drill,org.apache.drill.metastore.iceberg.write,0,0,0,0,0,0,1,1
apache_drill,org.apache.drill.metastore.components.tables,1,0,0,0,0,1,1,3
apache_drill,org.apache.drill.metastore.components.views,0,0,0,0,0,0,1,1
apache_drill,org.apache.drill.metastore.config,0,0,0,0,0,0,1,1
apache_drill,org.apache.drill.metastore.exceptions,0,0,0,0,0,0,1,1
apache_drill,org.apache.drill.metastore.expressions,0,0,0,0,0,0,1,1
apache_drill,org.apache.drill.metastore.metadata,2,1,0,0,1,1,1,6
apache_drill,org.apache.drill.metastore,0,0,0,0,0,0,1,1
apache_drill,org.apache.drill.metastore.operate,0,0,0,0,0,0,1,1
apache_drill,org.apache.drill.metastore.statistics,5,1,0,0,1,0,1,8
apache_drill,org.apache.drill.metastore.util,9,0,0,0,0,0,1,10
apache_drill,org.apache.drill.exec.proto,0,0,0,2,0,0,1,3
apache_drill,bsh,0,0,0,0,0,0,1,1
apache_drill,org.apache.drill.fmpp.mojo,0,0,0,0,0,0,1,1
apache_incubator-samoa,org.apache.samoa.apex,0,0,0,0,0,0,0,0
apache_incubator-samoa,org.apache.samoa.apex.topology.impl,0,0,0,0,0,0,0,0
apache_incubator-samoa,org.apache.samoa.core,0,0,0,0,1,2,0,3
apache_incubator-samoa,org.apache.samoa.evaluation,0,1,0,0,1,2,0,4
apache_incubator-samoa,org.apache.samoa.evaluation.measures,0,0,0,0,1,5,0,6
apache_incubator-samoa,org.apache.samoa.examples,0,0,0,0,0,0,0,0
apache_incubator-samoa,org.apache.samoa.learners,0,0,0,0,1,3,0,4
apache_incubator-samoa,org.apache.samoa.learners.classifiers.ensemble,0,0,0,0,1,1,0,2
apache_incubator-samoa,org.apache.samoa.learners.classifiers,0,0,0,0,0,1,0,1
apache_incubator-samoa,org.apache.samoa.learners.classifiers.rules,0,0,0,0,0,0,0,0
apache_incubator-samoa,org.apache.samoa.learners.classifiers.rules.centralized,0,0,0,0,0,0,0,0
apache_incubator-samoa,org.apache.samoa.learners.classifiers.rules.common,0,0,0,0,0,2,0,2
apache_incubator-samoa,org.apache.samoa.learners.classifiers.rules.distributed,0,0,0,0,0,2,0,2
apache_incubator-samoa,org.apache.samoa.learners.classifiers.trees,0,0,0,0,0,0,0,0
apache_incubator-samoa,org.apache.samoa.learners.clusterers,0,0,0,0,0,0,0,0
apache_incubator-samoa,org.apache.samoa.learners.clusterers.simple,0,0,0,0,0,0,0,0
apache_incubator-samoa,org.apache.samoa.moa,1,0,0,0,0,1,0,2
apache_incubator-samoa,org.apache.samoa.moa.classifiers,0,0,0,0,0,0,0,0
apache_incubator-samoa,org.apache.samoa.moa.classifiers.core.attributeclassobservers,0,0,0,0,1,1,0,2
apache_incubator-samoa,org.apache.samoa.moa.classifiers.core,0,0,0,0,0,0,0,0
apache_incubator-samoa,org.apache.samoa.moa.classifiers.core.driftdetection,0,0,0,0,1,0,0,1
apache_incubator-samoa,org.apache.samoa.moa.classifiers.core.splitcriteria,0,0,0,0,1,0,0,1
apache_incubator-samoa,org.apache.samoa.moa.classifiers.functions,0,0,0,0,0,0,0,0
apache_incubator-samoa,org.apache.samoa.moa.classifiers.rules.core.attributeclassobservers,0,0,0,0,0,0,0,0
apache_incubator-samoa,org.apache.samoa.moa.classifiers.rules.core,0,0,0,0,0,0,0,0
apache_incubator-samoa,org.apache.samoa.moa.classifiers.rules.core.splitcriteria,0,0,0,0,0,0,0,0
apache_incubator-samoa,org.apache.samoa.moa.classifiers.rules.core.voting,0,0,0,0,0,1,0,1
apache_incubator-samoa,org.apache.samoa.moa.classifiers.rules.driftdetection,0,0,0,0,0,0,0,0
apache_incubator-samoa,org.apache.samoa.moa.cluster,0,0,0,0,0,4,0,4
apache_incubator-samoa,org.apache.samoa.moa.clusterers,0,0,0,0,0,0,0,0
apache_incubator-samoa,org.apache.samoa.moa.clusterers.clustream,0,0,0,0,0,0,0,0
apache_incubator-samoa,org.apache.samoa.moa.core,1,1,0,0,1,5,0,8
apache_incubator-samoa,org.apache.samoa.moa.evaluation,0,0,0,0,0,3,0,3
apache_incubator-samoa,org.apache.samoa.moa.learners,0,0,0,0,0,0,0,0
apache_incubator-samoa,org.apache.samoa.moa.options,0,0,0,0,0,1,0,1
apache_incubator-samoa,org.apache.samoa.moa.tasks,0,0,0,0,0,0,0,0
apache_incubator-samoa,org.apache.samoa.streams,0,1,0,0,1,1,0,3
apache_incubator-samoa,org.apache.samoa.streams.clustering,0,0,0,0,0,0,0,0
apache_incubator-samoa,org.apache.samoa.streams.fs,0,0,0,0,1,0,0,1
apache_incubator-samoa,org.apache.samoa.streams.generators,0,0,0,0,0,0,0,0
apache_incubator-samoa,org.apache.samoa.streams.kafka,0,0,0,0,0,0,0,0
apache_incubator-samoa,org.apache.samoa.tasks,0,1,0,0,1,0,0,2
apache_incubator-samoa,org.apache.samoa.topology,0,0,0,0,1,4,0,5
apache_incubator-samoa,org.apache.samoa.utils,1,0,0,0,1,1,0,3
apache_incubator-samoa,org.apache.samoa.flink,0,0,0,0,0,0,0,0
apache_incubator-samoa,org.apache.samoa.flink.helpers,1,1,0,0,0,0,0,2
apache_incubator-samoa,org.apache.samoa.flink.topology.impl,1,0,0,0,1,0,0,2
apache_incubator-samoa,org.apache.samoa.instances,0,0,0,0,0,6,0,6
apache_incubator-samoa,org.apache.samoa,0,0,0,0,1,0,0,1
apache_incubator-samoa,org.apache.samoa.topology.impl,1,1,0,1,0,2,0,5
apache_incubator-tamaya,org.apache.tamaya,1,0,0,1,1,7,0,10
apache_incubator-tamaya,org.apache.tamaya.spi,1,1,0,1,0,8,0,11
apache_incubator-tamaya,org.apache.tamaya.core.internal,0,0,0,1,1,4,0,6
apache_incubator-tamaya,org.apache.tamaya.core.internal.converters,0,0,0,1,1,1,0,3
apache_incubator-tamaya,org.apache.tamaya.core,0,0,0,0,1,2,0,3
apache_incubator-tamaya,org.apache.tamaya.core.propertysource,0,0,0,0,0,0,0,0
apache_incubator-tamaya,org.apache.tamaya.spisupport,1,0,0,1,1,6,0,9
apache_incubator-tamaya,org.apache.tamaya.spisupport.propertysource,1,1,0,1,0,1,0,4
apache_incubator-tamaya,org.apache.tamaya.spisupport.services,0,0,0,0,0,0,0,0
apache_incubator-tamaya,org.apache.tamaya.examples.minimal,0,0,0,0,0,0,0,0
apache_incubator-tamaya,org.apache.tamaya.examples.custompropertysource,0,0,0,0,1,0,0,1
apache_incubator-twill,org.apache.twill.api,2,1,0,1,1,3,1,9
apache_incubator-twill,org.apache.twill.api.logging,0,0,0,0,0,1,1,2
apache_incubator-twill,org.apache.twill.internal,10,1,0,1,1,0,1,14
apache_incubator-twill,org.apache.twill.common,0,0,0,0,0,2,1,3
apache_incubator-twill,org.apache.twill.filesystem,0,0,0,0,1,0,1,2
apache_incubator-twill,org.apache.twill.internal.json,0,0,0,0,1,0,1,2
apache_incubator-twill,org.apache.twill.internal.kafka.client,0,0,0,0,1,1,1,3
apache_incubator-twill,org.apache.twill.internal.kafka,0,0,0,0,0,0,1,1
apache_incubator-twill,org.apache.twill.internal.logging,3,0,0,0,0,0,1,4
apache_incubator-twill,org.apache.twill.internal.state,1,0,0,0,1,0,1,3
apache_incubator-twill,org.apache.twill.internal.utils,3,1,0,0,1,0,1,6
apache_incubator-twill,org.apache.twill.kafka.client,4,1,0,0,1,1,1,8
apache_incubator-twill,org.apache.twill.launcher,1,1,0,0,0,0,1,3
apache_incubator-twill,org.apache.twill.discovery,1,0,0,0,0,2,1,4
apache_incubator-twill,echo,0,0,0,0,0,0,1,1
apache_incubator-twill,org.apache.twill.example.yarn,0,0,0,0,0,0,1,1
apache_incubator-twill,org.apache.twill.ext,0,0,0,0,1,0,1,2
apache_incubator-twill,org.apache.twill.internal.yarn,0,1,0,1,1,0,1,4
apache_incubator-twill,org.apache.twill.internal.yarn.ports,0,0,0,0,0,0,1,1
apache_incubator-twill,org.apache.twill.internal.appmaster,0,0,0,0,1,0,1,2
apache_incubator-twill,org.apache.twill.internal.container,0,0,0,0,0,0,1,1
apache_incubator-twill,org.apache.twill.yarn,0,0,0,1,1,3,1,6
apache_incubator-twill,org.apache.twill.internal.zookeeper,1,0,0,0,1,0,1,3
apache_incubator-twill,org.apache.twill.zookeeper,1,1,0,0,1,0,1,4
apache_jackrabbit-filevault,org.apache.jackrabbit.vault.cli,0,0,0,1,1,0,1,3
apache_jackrabbit-filevault,org.apache.jackrabbit.vault.cli.extended,0,0,0,0,0,0,1,1
apache_jackrabbit-filevault,org.apache.jackrabbit.vault.util.console,1,0,0,0,1,0,1,3
apache_jackrabbit-filevault,org.apache.jackrabbit.vault.util.console.commands,0,0,0,0,1,0,1,2
apache_jackrabbit-filevault,org.apache.jackrabbit.vault.util.console.examples,0,0,0,0,0,0,1,1
apache_jackrabbit-filevault,org.apache.jackrabbit.vault.util.console.platform,0,0,0,0,0,0,1,1
apache_jackrabbit-filevault,org.apache.jackrabbit.vault.util.console.util,1,1,0,0,1,0,1,4
apache_jackrabbit-filevault,org.apache.jackrabbit.vault.fs,4,1,0,0,1,2,1,9
apache_jackrabbit-filevault,org.apache.jackrabbit.vault.fs.api,27,1,0,1,1,7,1,38
apache_jackrabbit-filevault,org.apache.jackrabbit.vault.fs.config,6,0,0,0,1,1,1,9
apache_jackrabbit-filevault,org.apache.jackrabbit.vault.fs.filter,1,0,0,0,1,2,1,5
apache_jackrabbit-filevault,org.apache.jackrabbit.vault.fs.impl,9,1,0,0,1,1,1,13
apache_jackrabbit-filevault,org.apache.jackrabbit.vault.fs.impl.aggregator,0,0,0,0,1,0,1,2
apache_jackrabbit-filevault,org.apache.jackrabbit.vault.fs.impl.io,5,0,0,1,1,0,1,8
apache_jackrabbit-filevault,org.apache.jackrabbit.vault.fs.impl.io.legacycnd,0,0,0,0,0,0,1,1
apache_jackrabbit-filevault,org.apache.jackrabbit.vault.fs.io,25,1,0,1,1,1,1,30
apache_jackrabbit-filevault,org.apache.jackrabbit.vault.fs.spi,7,1,0,0,1,0,1,10
apache_jackrabbit-filevault,org.apache.jackrabbit.vault.fs.spi.impl.jcr20,3,0,0,0,1,0,1,5
apache_jackrabbit-filevault,org.apache.jackrabbit.vault.packaging,3,1,0,1,1,2,1,9
apache_jackrabbit-filevault,org.apache.jackrabbit.vault.packaging.events.impl,0,0,0,0,0,0,1,1
apache_jackrabbit-filevault,org.apache.jackrabbit.vault.packaging.events,0,0,0,0,0,0,1,1
apache_jackrabbit-filevault,org.apache.jackrabbit.vault.packaging.impl,4,1,0,0,1,2,1,9
apache_jackrabbit-filevault,org.apache.jackrabbit.vault.packaging.registry,0,0,0,0,1,1,1,3
apache_jackrabbit-filevault,org.apache.jackrabbit.vault.packaging.registry.impl,9,0,0,0,1,1,1,12
apache_jackrabbit-filevault,org.apache.jackrabbit.vault.util,13,1,0,1,1,3,1,20
apache_jackrabbit-filevault,org.apache.jackrabbit.vault.util.xml.serialize,2,0,0,0,1,0,1,4
apache_jackrabbit-filevault,org.apache.jackrabbit.vault.packaging.integration,0,0,0,1,1,0,1,3
apache_jackrabbit-filevault,org.apache.jackrabbit.vault.davex,0,0,0,0,0,0,1,1
apache_jackrabbit-filevault,org.apache.jackrabbit.vault.util.diff,0,0,0,0,0,1,1,2
apache_jackrabbit-filevault,org.apache.jackrabbit.vault.packaging.hooks,0,0,0,0,0,0,1,1
apache_jackrabbit-filevault,org.apache.jackrabbit.vault.rcp.impl,0,0,0,0,0,0,1,1
apache_jackrabbit-filevault,org.apache.jackrabbit.vault.sync.impl,0,0,0,0,1,0,1,2
apache_jackrabbit-filevault,org.apache.jackrabbit.vault.validation.impl.util,2,1,0,0,1,0,1,5
apache_jackrabbit-filevault,org.apache.jackrabbit.vault.validation,3,1,0,0,1,0,1,6
apache_jackrabbit-filevault,org.apache.jackrabbit.vault.validation.spi,0,0,0,0,1,0,1,2
apache_jackrabbit-filevault,org.apache.jackrabbit.vault.validation.spi.impl,2,0,0,0,1,0,1,4
apache_jackrabbit-filevault,org.apache.jackrabbit.vault.vlt.actions,0,0,0,0,1,1,1,3
apache_jackrabbit-filevault,org.apache.jackrabbit.vault.vlt,5,1,0,0,1,3,1,11
apache_jackrabbit-filevault,org.apache.jackrabbit.vault.vlt.meta,5,1,0,0,1,4,1,12
apache_jackrabbit-filevault,org.apache.jackrabbit.vault.vlt.meta.xml.file,0,0,0,0,0,0,1,1
apache_jackrabbit-filevault,org.apache.jackrabbit.vault.vlt.meta.xml,5,0,0,0,0,1,1,7
apache_jackrabbit-filevault,org.apache.jackrabbit.vault.vlt.meta.xml.zip,5,0,0,0,0,0,1,6
apache_knox,org.apache.hadoop.gateway.audit.log4j.layout,0,0,0,0,0,0,0,0
apache_knox,org.apache.hadoop.gateway.dispatch,0,0,0,0,0,0,0,0
apache_knox,org.apache.hadoop.gateway.hadoopauth.filter,0,0,0,0,0,0,0,0
apache_knox,org.apache.hadoop.gateway.hbase,0,0,0,0,0,0,0,0
apache_knox,org.apache.hadoop.gateway.hdfs.dispatch,0,0,0,0,0,0,0,0
apache_knox,org.apache.hadoop.gateway.hive,0,0,0,0,0,0,0,0
apache_knox,org.apache.hadoop.gateway.provider.federation.jwt.filter,0,0,0,0,0,0,0,0
apache_knox,org.apache.hadoop.gateway.rm.dispatch,0,0,0,0,0,0,0,0
apache_knox,org.apache.hadoop.gateway.shirorealm,0,0,0,0,0,0,0,0
apache_knox,org.apache.hadoop.gateway.storm,0,0,0,0,0,0,0,0
apache_knox,org.apache.hadoop.gateway.topology,0,0,0,0,0,0,0,0
apache_knox,org.apache.hadoop.gateway.util,0,0,0,0,0,0,0,0
apache_knox,org.apache.knox.gateway.security.ldap,0,0,0,0,0,0,0,0
apache_knox,org.apache.knox.gateway.topology.discovery.ambari,0,0,0,1,0,0,0,1
apache_knox,org.apache.knox.gateway.topology.discovery.cm.auth,0,0,0,0,1,0,0,1
apache_knox,org.apache.knox.gateway.topology.discovery.cm,0,1,0,0,1,0,0,2
apache_knox,org.apache.knox.gateway.topology.discovery.cm.model,0,0,0,0,0,0,0,0
apache_knox,org.apache.knox.gateway.topology.discovery.cm.model.atlas,0,0,0,0,0,0,0,0
apache_knox,org.apache.knox.gateway.topology.discovery.cm.model.hbase,0,0,0,0,0,0,0,0
apache_knox,org.apache.knox.gateway.topology.discovery.cm.model.hdfs,0,0,0,0,0,0,0,0
apache_knox,org.apache.knox.gateway.topology.discovery.cm.model.hive,0,0,0,0,0,0,0,0
apache_knox,org.apache.knox.gateway.topology.discovery.cm.model.hue,0,0,0,0,0,0,0,0
apache_knox,org.apache.knox.gateway.topology.discovery.cm.model.livy,0,0,0,0,0,0,0,0
apache_knox,org.apache.knox.gateway.topology.discovery.cm.model.oozie,0,0,0,0,0,0,0,0
apache_knox,org.apache.knox.gateway.topology.discovery.cm.model.phoenix,0,0,0,0,0,0,0,0
apache_knox,org.apache.knox.gateway.topology.discovery.cm.model.ranger,0,0,0,0,0,0,0,0
apache_knox,org.apache.knox.gateway.topology.discovery.cm.model.solr,0,0,0,0,0,0,0,0
apache_knox,org.apache.knox.gateway.topology.discovery.cm.model.spark,0,0,0,0,0,0,0,0
apache_knox,org.apache.knox.gateway.topology.discovery.cm.model.yarn,0,0,0,0,1,0,0,1
apache_knox,org.apache.knox.gateway.topology.discovery.cm.model.zeppelin,0,0,0,0,0,0,0,0
apache_knox,org.apache.knox.gateway.i18n.messages.loggers.jdk,0,0,0,0,0,0,0,0
apache_knox,org.apache.knox.gateway.i18n.messages.loggers.sout,0,0,0,0,0,0,0,0
apache_knox,org.apache.knox.gateway.i18n.messages,0,0,0,0,1,0,0,1
apache_knox,org.apache.knox.gateway.i18n.resources,0,0,0,0,1,0,0,1
apache_knox,org.apache.knox.gateway.i18n.messages.loggers.log4j,0,0,0,0,0,0,0,0
apache_knox,org.apache.knox.gateway.i18n.messages.loggers.sl4j,0,0,0,0,0,0,0,0
apache_knox,org.apache.knox.gateway.ha.deploy,0,0,0,0,0,0,0,0
apache_knox,org.apache.knox.gateway.ha.dispatch,0,0,0,0,1,0,0,1
apache_knox,org.apache.knox.gateway.ha.dispatch.i18n,0,0,0,0,0,0,0,0
apache_knox,org.apache.knox.gateway.ha.provider,1,1,0,0,1,3,0,6
apache_knox,org.apache.knox.gateway.ha.provider.impl,1,1,0,0,0,1,0,3
apache_knox,org.apache.knox.gateway.ha.provider.impl.i18n,0,0,0,0,0,1,0,1
apache_knox,org.apache.knox.gateway.identityasserter.common.filter,0,0,0,0,0,0,0,0
apache_knox,org.apache.knox.gateway.identityasserter.common.function,0,0,0,0,0,0,0,0
apache_knox,org.apache.knox.gateway,33,1,0,1,1,9,0,45
apache_knox,org.apache.knox.gateway.identityasserter.filter,0,0,0,0,1,0,0,1
apache_knox,org.apache.knox.gateway.identityasserter.function,0,0,0,0,0,0,0,0
apache_knox,org.apache.knox.gateway.identityasserter.concat.filter,0,0,0,0,0,0,0,0
apache_knox,org.apache.knox.gateway.identityasserter.hadoop.groups.filter,0,0,0,0,1,0,0,1
apache_knox,org.apache.knox.gateway.identityasserter.regex.filter,0,0,0,0,1,0,0,1
apache_knox,org.apache.knox.gateway.identityasserter.switchcase,0,0,0,0,0,0,0,0
apache_knox,org.apache.knox.gateway.jersey,0,0,0,0,0,0,0,0
apache_knox,org.apache.knox.gateway.filter.rewrite.api,11,1,0,1,1,13,0,27
apache_knox,org.apache.knox.gateway.filter.rewrite.ext,0,0,0,0,1,5,0,6
apache_knox,org.apache.knox.gateway.filter.rewrite.i18n,0,0,0,0,0,4,0,4
apache_knox,org.apache.knox.gateway.filter.rewrite.impl,7,0,0,1,1,5,0,14
apache_knox,org.apache.knox.gateway.filter.rewrite.impl.form,0,0,0,0,0,0,0,0
apache_knox,org.apache.knox.gateway.filter.rewrite.impl.html,0,0,0,0,1,3,0,4
apache_knox,org.apache.knox.gateway.filter.rewrite.impl.javascript,0,0,0,0,0,0,0,0
apache_knox,org.apache.knox.gateway.filter.rewrite.impl.json,0,0,0,0,1,0,0,1
apache_knox,org.apache.knox.gateway.filter.rewrite.impl.xml,6,0,0,0,1,3,0,10
apache_knox,org.apache.knox.gateway.filter.rewrite.spi,2,1,0,0,1,10,0,14
apache_knox,org.apache.knox.gateway.hostmap.api,0,0,0,0,0,0,0,0
apache_knox,org.apache.knox.gateway.hostmap.impl,0,0,0,0,0,1,0,1
apache_knox,org.apache.knox.gateway.inboundurl.api,0,0,0,0,0,0,0,0
apache_knox,org.apache.knox.gateway.inboundurl.impl,0,0,0,0,0,0,0,0
apache_knox,org.apache.knox.gateway.svcregfunc.api,0,0,0,0,1,0,0,1
apache_knox,org.apache.knox.gateway.svcregfunc.impl,0,0,0,0,0,3,0,3
apache_knox,org.apache.knox.gateway.encrypturi.api,0,0,0,0,0,1,0,1
apache_knox,org.apache.knox.gateway.encrypturi,0,0,0,0,0,1,0,1
apache_knox,org.apache.knox.gateway.encrypturi.impl,0,0,0,0,0,2,0,2
apache_knox,org.apache.knox.gateway.securequery,0,0,0,0,1,4,0,5
apache_knox,org.apache.knox.gateway.deploy,9,1,0,0,1,1,0,12
apache_knox,org.apache.knox.gateway.filter,4,0,0,1,1,0,0,6
apache_knox,org.apache.knox.gateway.deploy.impl,3,0,0,0,1,1,0,5
apache_knox,org.apache.knox.gateway.clientcert.deploy,0,0,0,0,0,0,0,0
apache_knox,org.apache.knox.gateway.clientcert.filter,0,0,0,0,0,0,0,0
apache_knox,org.apache.knox.gateway.clientcert,0,0,0,0,0,0,0,0
apache_knox,org.apache.knox.gateway.hadoopauth.deploy,0,0,0,0,0,0,0,0
apache_knox,org.apache.knox.gateway.hadoopauth.filter,0,0,0,0,0,0,0,0
apache_knox,org.apache.knox.gateway.hadoopauth,0,0,0,0,0,0,0,0
apache_knox,org.apache.knox.gateway.provider.federation.jwt.deploy,0,0,0,0,0,0,0,0
apache_knox,org.apache.knox.gateway.provider.federation.jwt.filter,0,0,0,0,1,1,0,2
apache_knox,org.apache.knox.gateway.provider.federation.jwt,0,0,0,0,0,1,0,1
apache_knox,org.apache.knox.gateway.provider.federation,0,0,0,0,1,0,0,1
apache_knox,org.apache.knox.gateway.pac4j.deploy,0,0,0,0,0,0,0,0
apache_knox,org.apache.knox.gateway.pac4j.filter,1,0,0,0,0,0,0,1
apache_knox,org.apache.knox.gateway.pac4j,0,0,0,0,0,0,0,0
apache_knox,org.apache.knox.gateway.pac4j.session,1,1,0,0,0,0,0,2
apache_knox,org.apache.knox.gateway.preauth.deploy,0,0,0,0,0,0,0,0
apache_knox,org.apache.knox.gateway.preauth.filter,0,0,0,0,1,0,0,1
apache_knox,org.apache.knox.gateway.preauth,0,0,0,0,0,0,0,0
apache_knox,org.apache.knox.gateway.shirorealm.impl.i18n,0,0,0,0,0,0,0,0
apache_knox,org.apache.knox.gateway.shirorealm,0,0,0,0,1,0,0,1
apache_knox,org.apache.knox.gateway.webappsec.deploy,0,0,0,0,0,0,0,0
apache_knox,org.apache.knox.gateway.webappsec.filter,0,0,0,0,1,0,0,1
apache_knox,org.apache.knox.gateway.webappsec,0,0,0,0,1,0,0,1
apache_knox,org.apache.knox.gateway.config.impl,10,1,0,0,1,0,0,12
apache_knox,org.apache.knox.gateway.descriptor,3,1,0,0,1,1,0,6
apache_knox,org.apache.knox.gateway.descriptor.impl,0,0,0,0,0,1,0,1
apache_knox,org.apache.knox.gateway.descriptor.xml,3,0,0,0,1,0,0,4
apache_knox,org.apache.knox.gateway.dispatch,1,0,0,1,1,0,0,3
apache_knox,org.apache.knox.gateway.services,6,1,0,0,1,12,0,20
apache_knox,org.apache.knox.gateway.services.hostmap.impl,0,0,0,0,0,0,0,0
apache_knox,org.apache.knox.gateway.services.metrics.impl,2,1,0,0,0,1,0,4
apache_knox,org.apache.knox.gateway.services.metrics.impl.instr,0,0,0,0,1,0,0,1
apache_knox,org.apache.knox.gateway.services.metrics.impl.reporters,0,0,0,0,0,0,0,0
apache_knox,org.apache.knox.gateway.services.registry.impl,2,0,0,0,0,0,0,2
apache_knox,org.apache.knox.gateway.services.security.impl,20,1,0,0,1,13,0,35
apache_knox,org.apache.knox.gateway.services.token.impl,0,0,0,0,0,2,0,2
apache_knox,org.apache.knox.gateway.services.topology.impl,4,0,0,0,0,2,0,6
apache_knox,org.apache.knox.gateway.topology.builder,0,1,0,0,0,2,0,3
apache_knox,org.apache.knox.gateway.topology.builder.property.interpreter,0,0,0,0,0,1,0,1
apache_knox,org.apache.knox.gateway.topology.builder.property,0,0,0,0,0,0,0,0
apache_knox,org.apache.knox.gateway.topology.discovery,6,1,0,0,1,0,0,8
apache_knox,org.apache.knox.gateway.topology.monitor,1,0,0,0,1,3,0,5
apache_knox,org.apache.knox.gateway.topology.simple,4,1,0,0,1,0,0,6
apache_knox,org.apache.knox.gateway.topology.validation,0,0,0,0,0,0,0,0
apache_knox,org.apache.knox.gateway.topology.xml,0,0,0,0,0,2,0,2
apache_knox,org.apache.knox.gateway.trace,0,0,0,0,0,0,0,0
apache_knox,org.apache.knox.gateway.util,23,1,0,1,1,0,0,26
apache_knox,org.apache.knox.gateway.websockets,0,0,0,0,1,0,0,1
apache_knox,org.apache.knox.gateway.mock,0,0,0,0,0,0,0,0
apache_knox,org.apache.knox.gateway.service.config.remote,1,0,0,0,1,1,0,3
apache_knox,org.apache.knox.gateway.services.registry,2,1,0,0,0,2,0,5
apache_knox,org.apache.knox.gateway.services.security,6,1,0,0,1,12,0,20
apache_knox,org.apache.knox.gateway.services.topology,6,1,0,0,0,3,0,10
apache_knox,org.apache.knox.gateway.service.admin,0,0,0,0,1,2,0,3
apache_knox,org.apache.knox.gateway.service.admin.beans,0,0,0,0,0,0,0,0
apache_knox,org.apache.knox.gateway.service.admin.deploy,0,0,0,0,0,0,0,0
apache_knox,org.apache.knox.gateway.as,0,0,0,0,0,0,0,0
apache_knox,org.apache.knox.gateway.service.definition,0,0,0,0,1,2,0,3
apache_knox,org.apache.knox.gateway.backend.hashicorp.vault.authentication,1,1,0,0,0,0,0,2
apache_knox,org.apache.knox.gateway.backend.hashicorp.vault,1,0,0,0,0,1,0,2
apache_knox,org.apache.knox.gateway.hbase,0,0,0,0,0,0,0,0
apache_knox,org.apache.knox.gateway.service.health.deploy,0,0,0,0,0,0,0,0
apache_knox,org.apache.knox.gateway.service.health,0,0,0,0,0,0,0,0
apache_knox,org.apache.knox.gateway.hive,0,0,0,0,0,0,0,0
apache_knox,org.apache.knox.gateway.impala,0,0,0,0,0,0,0,0
apache_knox,org.apache.knox.gateway.jkg,0,0,0,0,0,0,0,0
apache_knox,org.apache.knox.gateway.service.knoxsso.deploy,0,0,0,0,0,0,0,0
apache_knox,org.apache.knox.gateway.service.knoxsso,0,0,0,0,1,0,0,1
apache_knox,org.apache.knox.gateway.service.knoxtoken.deploy,0,0,0,0,0,0,0,0
apache_knox,org.apache.knox.gateway.service.knoxtoken,0,0,0,0,0,0,0,0
apache_knox,org.apache.knox.gateway.livy,0,0,0,0,0,0,0,0
apache_knox,org.apache.knox.gateway.service.config.remote.config,1,0,0,0,0,0,0,1
apache_knox,org.apache.knox.gateway.service.config.remote.zk,3,0,0,0,0,3,0,6
apache_knox,org.apache.knox.gateway.service.config.remote.util,0,0,0,0,0,0,0,0
apache_knox,org.apache.knox.gateway.rm.dispatch,0,0,0,0,1,0,0,1
apache_knox,org.apache.knox.gateway.rm.i18n,0,0,0,0,0,0,0,0
apache_knox,org.apache.knox.gateway.storm,0,0,0,0,0,0,0,0
apache_knox,org.apache.knox.gateway.tgs,0,0,0,0,0,0,0,0
apache_knox,org.apache.knox.gateway.service.vault,0,0,0,0,0,1,0,1
apache_knox,org.apache.knox.gateway.service.vault.deploy,0,0,0,0,0,0,0,0
apache_knox,org.apache.knox.gateway.hdfs.dispatch,0,0,0,0,1,0,0,1
apache_knox,org.apache.knox.gateway.hdfs.i18n,0,0,0,0,0,0,0,0
apache_knox,org.apache.knox.gateway.hdfs,0,0,0,0,0,0,0,0
apache_knox,org.apache.knox.gateway.shell,1,0,0,1,0,0,0,2
apache_knox,org.apache.knox.gateway.shell.hbase,3,1,0,0,1,0,0,5
apache_knox,org.apache.knox.gateway.shell.hbase.table,3,0,0,0,1,0,0,4
apache_knox,org.apache.knox.gateway.shell.hbase.table.row,1,0,0,0,1,0,0,2
apache_knox,org.apache.knox.gateway.shell.hbase.table.scanner,1,0,0,0,1,0,0,2
apache_knox,org.apache.knox.gateway.shell.hdfs,0,0,0,0,1,0,0,1
apache_knox,org.apache.knox.gateway.shell.job,0,0,0,0,1,0,0,1
apache_knox,org.apache.knox.gateway.shell.knox.token,1,1,0,0,1,0,0,3
apache_knox,org.apache.knox.gateway.shell.manager,0,0,0,0,1,0,0,1
apache_knox,org.apache.knox.gateway.shell.util,0,0,0,0,0,0,0,0
apache_knox,org.apache.knox.gateway.shell.workflow,0,0,0,0,1,0,0,1
apache_knox,org.apache.knox.gateway.shell.yarn,0,0,0,0,1,0,0,1
apache_knox,(default package),0,0,0,0,0,0,0,0
apache_knox,org.apache.knox.gateway.shell.hive,0,0,0,0,0,0,0,0
apache_knox,org.apache.knox.gateway.config,6,1,0,1,1,10,0,19
apache_knox,org.apache.knox.gateway.filter.security,0,0,0,0,0,0,0,0
apache_knox,org.apache.knox.gateway.i18n,0,0,0,0,0,1,0,1
apache_knox,org.apache.knox.gateway.security,0,0,0,0,1,0,0,1
apache_knox,org.apache.knox.gateway.security.principal,0,0,0,0,0,0,0,0
apache_knox,org.apache.knox.gateway.services.config.client,0,0,0,0,0,7,0,7
apache_knox,org.apache.knox.gateway.services.hostmap,0,0,0,0,0,2,0,2
apache_knox,org.apache.knox.gateway.services.metrics,0,0,0,0,1,1,0,2
apache_knox,org.apache.knox.gateway.services.security.token.impl,0,0,0,0,0,2,0,2
apache_knox,org.apache.knox.gateway.services.security.token,0,0,0,0,0,1,0,1
apache_knox,org.apache.knox.gateway.topology,3,1,0,0,1,5,0,10
apache_knox,org.apache.hadoop.http,0,0,0,0,1,0,0,1
apache_knox,org.apache.knox.gateway.audit.api,0,0,0,0,1,0,0,1
apache_knox,org.apache.knox.gateway.audit.log4j.appender,0,0,0,0,0,0,0,0
apache_knox,org.apache.knox.gateway.audit.log4j.audit,0,0,0,0,0,0,0,0
apache_knox,org.apache.knox.gateway.audit.log4j.correlation,0,0,0,0,0,0,0,0
apache_knox,org.apache.knox.gateway.audit.log4j.layout,0,0,0,0,0,0,0,0
apache_knox,org.apache.knox.gateway.servlet,0,0,0,0,0,0,0,0
apache_knox,org.apache.knox.gateway.audit,0,0,0,0,1,0,0,1
apache_knox,org.apache.knox.gateway.config.spi,0,0,0,0,0,0,0,0
apache_knox,org.apache.knox.gateway.launcher,0,0,0,0,1,0,0,1
apache_knox,org.apache.knox.gateway.util.urltemplate,0,0,0,1,0,8,0,9
apache_knox,org.apache.knox.examples,0,0,0,0,0,0,0,0
apache_metamodel,org.apache.metamodel.arff,0,0,0,0,0,0,1,1
apache_metamodel,org.apache.metamodel.cassandra,0,0,0,0,1,0,1,2
apache_metamodel,org.apache.metamodel,35,1,0,1,0,45,1,83
apache_metamodel,org.apache.metamodel.annotations,0,0,0,0,0,0,1,1
apache_metamodel,org.apache.metamodel.convert,5,1,0,0,1,1,1,9
apache_metamodel,org.apache.metamodel.create,0,0,0,0,1,10,1,12
apache_metamodel,org.apache.metamodel.data,4,1,0,1,0,33,1,40
apache_metamodel,org.apache.metamodel.delete,3,0,0,0,0,1,1,5
apache_metamodel,org.apache.metamodel.drop,0,0,0,0,0,4,1,5
apache_metamodel,org.apache.metamodel.factory,1,0,0,0,0,1,1,3
apache_metamodel,org.apache.metamodel.insert,4,0,0,0,1,9,1,15
apache_metamodel,org.apache.metamodel.intercept,4,0,0,0,0,1,1,6
apache_metamodel,org.apache.metamodel.query,17,1,0,1,0,37,1,57
apache_metamodel,org.apache.metamodel.query.builder,7,0,0,1,0,23,1,32
apache_metamodel,org.apache.metamodel.query.parser,3,0,0,0,0,1,1,5
apache_metamodel,org.apache.metamodel.schema,23,1,0,1,1,42,1,69
apache_metamodel,org.apache.metamodel.schema.builder,0,0,0,0,1,1,1,3
apache_metamodel,org.apache.metamodel.schema.naming,2,0,0,0,1,0,1,4
apache_metamodel,org.apache.metamodel.update,2,1,0,0,0,0,1,4
apache_metamodel,org.apache.metamodel.util,18,1,0,1,1,6,1,28
apache_metamodel,org.apache.metamodel.couchdb,0,0,0,0,1,0,1,2
apache_metamodel,org.apache.metamodel.csv,8,0,0,0,1,11,1,21
apache_metamodel,org.apache.metamodel.dynamodb,0,0,0,0,1,0,1,2
apache_metamodel,org.apache.metamodel.elasticsearch,0,0,0,0,0,1,1,2
apache_metamodel,org.apache.metamodel.elasticsearch.common,0,0,0,0,0,0,1,1
apache_metamodel,org.apache.metamodel.elasticsearch.nativeclient,0,0,0,0,1,0,1,2
apache_metamodel,org.apache.metamodel.elasticsearch.rest,0,0,0,0,1,0,1,2
apache_metamodel,org.apache.metamodel.excel,6,0,0,0,1,5,1,13
apache_metamodel,org.apache.metamodel.fixedwidth,3,0,0,0,0,3,1,7
apache_metamodel,org.apache.metamodel.hadoop,0,0,0,0,0,0,1,1
apache_metamodel,org.apache.metamodel.hbase,0,0,0,0,0,2,1,3
apache_metamodel,org.apache.metamodel.jdbc.dialects,1,1,0,0,0,6,1,9
apache_metamodel,org.apache.metamodel.jdbc,1,0,0,1,1,18,1,22
apache_metamodel,org.apache.metamodel.dbmains,0,0,0,0,0,0,1,1
apache_metamodel,org.apache.metamodel.dialects,0,0,0,0,1,3,1,5
apache_metamodel,org.apache.metamodel.json,0,0,0,0,0,1,1,2
apache_metamodel,org.apache.metamodel.kafka,0,0,0,0,1,0,1,2
apache_metamodel,org.apache.metamodel.mongodb.common,0,0,0,0,0,0,1,1
apache_metamodel,org.apache.metamodel.mongodb.mongo2,0,0,0,0,1,0,1,2
apache_metamodel,org.apache.metamodel.mongodb.mongo3,0,0,0,0,1,0,1,2
apache_metamodel,org.apache.metamodel.neo4j,0,0,0,0,1,0,1,2
apache_metamodel,org.apache.metamodel.openoffice,0,0,0,0,0,1,1,2
apache_metamodel,org.apache.metamodel.pojo,0,0,0,0,0,1,1,2
apache_metamodel,org.apache.metamodel.salesforce,0,0,0,0,1,0,1,2
apache_metamodel,org.apache.metamodel.spring,0,0,0,0,1,1,1,3
apache_metamodel,org.apache.metamodel.sugarcrm,0,0,0,0,1,1,1,3
apache_metamodel,com.sugarcrm.ws.soap,0,0,0,1,0,0,1,2
apache_metamodel,org.apache.metamodel.xml,0,0,0,0,1,3,1,5
apache_olingo-odata2,org.apache.olingo.odata2.annotation.processor.api,0,0,0,0,0,0,1,1
apache_olingo-odata2,org.apache.olingo.odata2.annotation.processor.core.datasource,0,1,0,0,0,7,1,9
apache_olingo-odata2,org.apache.olingo.odata2.annotation.processor.core,1,0,0,0,0,11,1,13
apache_olingo-odata2,org.apache.olingo.odata2.annotation.processor.core.edm,0,0,0,0,0,2,1,3
apache_olingo-odata2,org.apache.olingo.odata2.annotation.processor.core.rt,1,1,0,0,0,0,1,3
apache_olingo-odata2,org.apache.olingo.odata2.annotation.processor.core.util,0,0,0,0,0,2,1,3
apache_olingo-odata2,org.apache.olingo.odata2.annotation.processor.core.model,0,0,0,0,0,0,1,1
apache_olingo-odata2,org.apache.olingo.odata2.annotation.processor.ref,0,0,0,0,0,1,1,2
apache_olingo-odata2,org.apache.olingo.odata2.annotation.processor.ref.model,0,0,0,0,0,0,1,1
apache_olingo-odata2,org.apache.olingo.odata2.jpa.processor.api.access,0,0,0,0,1,8,1,10
apache_olingo-odata2,org.apache.olingo.odata2.jpa.processor.api.exception,0,0,0,0,0,17,1,18
apache_olingo-odata2,org.apache.olingo.odata2.jpa.processor.api.factory,0,0,0,0,0,2,1,3
apache_olingo-odata2,org.apache.olingo.odata2.jpa.processor.api.jpql,0,0,0,0,1,9,1,11
apache_olingo-odata2,org.apache.olingo.odata2.jpa.processor.api.model,0,0,0,0,0,4,1,5
apache_olingo-odata2,org.apache.olingo.odata2.jpa.processor.api.model.mapping,0,0,0,0,1,0,1,2
apache_olingo-odata2,org.apache.olingo.odata2.jpa.processor.api,0,0,0,0,1,4,1,6
apache_olingo-odata2,org.apache.olingo.odata2.jpa.processor.core.access.data,3,0,0,0,1,15,1,20
apache_olingo-odata2,org.apache.olingo.odata2.jpa.processor.core.access.model,2,1,0,0,1,0,1,5
apache_olingo-odata2,org.apache.olingo.odata2.jpa.processor.core.callback,2,1,0,0,0,3,1,7
apache_olingo-odata2,org.apache.olingo.odata2.jpa.processor.core.edm,0,0,0,0,0,1,1,2
apache_olingo-odata2,org.apache.olingo.odata2.jpa.processor.core.exception,0,1,0,0,0,0,1,2
apache_olingo-odata2,org.apache.olingo.odata2.jpa.processor.core.factory,0,0,0,0,0,0,1,1
apache_olingo-odata2,org.apache.olingo.odata2.jpa.processor.core.jpql,0,0,0,0,1,11,1,13
apache_olingo-odata2,org.apache.olingo.odata2.jpa.processor.core.model,4,0,0,1,1,8,1,15
apache_olingo-odata2,org.apache.olingo.odata2.jpa.processor.core,2,1,0,0,1,13,1,18
apache_olingo-odata2,org.apache.olingo.odata2.jpa.processor.core.common,0,0,0,0,0,0,1,1
apache_olingo-odata2,org.apache.olingo.odata2.jpa.processor.core.mock.data,3,0,0,0,1,1,1,6
apache_olingo-odata2,org.apache.olingo.odata2.jpa.processor.core.mock,2,1,0,0,1,0,1,5
apache_olingo-odata2,org.apache.olingo.odata2.jpa.processor.core.mock.model,1,1,0,0,1,1,1,5
apache_olingo-odata2,org.apache.olingo.odata2.jpa.processor.ref.converter,0,0,0,0,0,0,1,1
apache_olingo-odata2,org.apache.olingo.odata2.jpa.processor.ref.factory,0,0,0,0,0,0,1,1
apache_olingo-odata2,org.apache.olingo.odata2.jpa.processor.ref.listeners,0,0,0,0,0,0,1,1
apache_olingo-odata2,org.apache.olingo.odata2.jpa.processor.ref.model,0,0,0,0,1,0,1,2
apache_olingo-odata2,org.apache.olingo.odata2.jpa.processor.ref.util,0,0,0,0,0,0,1,1
apache_olingo-odata2,org.apache.olingo.odata2.jpa.processor.ref.extension,0,0,0,0,0,0,1,1
apache_olingo-odata2,org.apache.olingo.odata2.jpa.processor.ref.web,0,0,0,0,0,0,1,1
apache_olingo-odata2,org.apache.olingo.odata2.api.batch,0,0,0,0,1,9,1,11
apache_olingo-odata2,org.apache.olingo.odata2.api.client.batch,0,0,0,0,1,7,1,9
apache_olingo-odata2,org.apache.olingo.odata2.api.commons,0,0,0,0,0,0,1,1
apache_olingo-odata2,org.apache.olingo.odata2.api.edm,0,0,0,1,1,150,1,153
apache_olingo-odata2,org.apache.olingo.odata2.api.edm.provider,0,0,0,1,1,24,1,27
apache_olingo-odata2,org.apache.olingo.odata2.api.ep.callback,0,0,0,0,1,13,1,15
apache_olingo-odata2,org.apache.olingo.odata2.api.ep,0,0,0,0,1,68,1,70
apache_olingo-odata2,org.apache.olingo.odata2.api.ep.entry,0,0,0,0,0,17,1,18
apache_olingo-odata2,org.apache.olingo.odata2.api.ep.feed,0,0,0,0,0,14,1,15
apache_olingo-odata2,org.apache.olingo.odata2.api.exception,0,0,0,0,0,37,1,38
apache_olingo-odata2,org.apache.olingo.odata2.api,0,0,0,0,1,0,1,2
apache_olingo-odata2,org.apache.olingo.odata2.api.processor.feature,0,0,0,0,0,0,1,1
apache_olingo-odata2,org.apache.olingo.odata2.api.processor,0,0,0,0,1,75,1,77
apache_olingo-odata2,org.apache.olingo.odata2.api.processor.part,0,0,0,0,1,2,1,4
apache_olingo-odata2,org.apache.olingo.odata2.api.rt,0,0,0,0,0,1,1,2
apache_olingo-odata2,org.apache.olingo.odata2.api.servicedocument,0,0,0,0,1,2,1,4
apache_olingo-odata2,org.apache.olingo.odata2.api.uri,0,0,0,0,1,46,1,48
apache_olingo-odata2,org.apache.olingo.odata2.api.uri.expression,0,0,0,0,1,3,1,5
apache_olingo-odata2,org.apache.olingo.odata2.api.uri.info,0,0,0,0,1,33,1,35
apache_olingo-odata2,org.apache.olingo.odata2.client.api.edm,0,0,0,0,0,1,1,2
apache_olingo-odata2,org.apache.olingo.odata2.client.api.ep.callback,0,0,0,0,0,0,1,1
apache_olingo-odata2,org.apache.olingo.odata2.client.api.ep,0,0,0,0,1,22,1,24
apache_olingo-odata2,org.apache.olingo.odata2.client.api,0,0,0,0,0,2,1,3
apache_olingo-odata2,org.apache.olingo.odata2.client.api.uri,0,0,0,0,0,1,1,2
apache_olingo-odata2,org.apache.olingo.odata2.client.core.edm,0,0,0,0,0,0,1,1
apache_olingo-odata2,org.apache.olingo.odata2.client.core.edm.Impl,0,0,0,1,1,1,1,4
apache_olingo-odata2,org.apache.olingo.odata2.client.core.ep,3,1,0,0,1,13,1,19
apache_olingo-odata2,org.apache.olingo.odata2.client.core.ep.deserializer,3,0,0,0,1,15,1,20
apache_olingo-odata2,org.apache.olingo.odata2.client.core.ep.serializer,2,0,0,0,1,17,1,21
apache_olingo-odata2,org.apache.olingo.odata2.client.core,3,1,0,0,0,0,1,5
apache_olingo-odata2,org.apache.olingo.odata2.client.core.uri,0,0,0,0,1,4,1,6
apache_olingo-odata2,org.apache.olingo.odata2.client.core.uri.util,0,0,0,0,0,0,1,1
apache_olingo-odata2,org.apache.olingo.odata2.client.core.edm.impl,0,0,0,0,1,0,1,2
apache_olingo-odata2,org.apache.olingo.odata2.core.batch,4,1,0,0,1,14,1,21
apache_olingo-odata2,org.apache.olingo.odata2.core.batch.v2,3,1,0,0,0,7,1,12
apache_olingo-odata2,org.apache.olingo.odata2.core.commons,0,1,0,0,1,15,1,18
apache_olingo-odata2,org.apache.olingo.odata2.core,9,1,0,0,1,8,1,20
apache_olingo-odata2,org.apache.olingo.odata2.core.debug,3,0,0,0,0,0,1,4
apache_olingo-odata2,org.apache.olingo.odata2.core.edm,0,0,0,0,0,4,1,5
apache_olingo-odata2,org.apache.olingo.odata2.core.edm.provider,7,1,0,1,0,6,1,16
apache_olingo-odata2,org.apache.olingo.odata2.core.ep.aggregator,0,1,0,0,1,29,1,32
apache_olingo-odata2,org.apache.olingo.odata2.core.ep,9,1,0,0,1,29,1,41
apache_olingo-odata2,org.apache.olingo.odata2.core.ep.consumer,5,0,0,1,1,27,1,35
apache_olingo-odata2,org.apache.olingo.odata2.core.ep.entry,0,0,0,0,0,0,1,1
apache_olingo-odata2,org.apache.olingo.odata2.core.ep.feed,0,0,0,0,0,0,1,1
apache_olingo-odata2,org.apache.olingo.odata2.core.ep.producer,10,0,0,1,1,42,1,55
apache_olingo-odata2,org.apache.olingo.odata2.core.ep.util,0,0,0,0,1,10,1,12
apache_olingo-odata2,org.apache.olingo.odata2.core.exception,0,0,0,0,1,1,1,3
apache_olingo-odata2,org.apache.olingo.odata2.core.processor,0,0,0,0,0,1,1,2
apache_olingo-odata2,org.apache.olingo.odata2.core.rest.app,0,0,0,0,0,0,1,1
apache_olingo-odata2,org.apache.olingo.odata2.core.rest,3,0,0,0,1,1,1,6
apache_olingo-odata2,org.apache.olingo.odata2.core.rt,0,0,0,0,0,0,1,1
apache_olingo-odata2,org.apache.olingo.odata2.core.servicedocument,3,1,0,0,1,0,1,6
apache_olingo-odata2,org.apache.olingo.odata2.core.servlet,0,0,0,0,0,0,1,1
apache_olingo-odata2,org.apache.olingo.odata2.core.uri,4,1,0,0,1,10,1,17
apache_olingo-odata2,org.apache.olingo.odata2.core.uri.expression,0,0,0,1,0,5,1,7
apache_olingo-odata2,org.apache.olingo.odata2.fit.basic,0,0,0,0,1,7,1,9
apache_olingo-odata2,org.apache.olingo.odata2.fit.client,0,0,0,0,0,1,1,2
apache_olingo-odata2,org.apache.olingo.odata2.fit.client.util,0,0,0,0,0,1,1,2
apache_olingo-odata2,org.apache.olingo.odata2.fit.mapping,0,0,0,0,0,1,1,2
apache_olingo-odata2,org.apache.olingo.odata2.fit.misc,0,0,0,0,1,1,1,3
apache_olingo-odata2,org.apache.olingo.odata2.fit.ref,0,0,0,1,0,5,1,7
apache_olingo-odata2,org.apache.olingo.odata2.fit.ref.contentnegotiation,0,0,0,0,1,0,1,2
apache_olingo-odata2,org.apache.olingo.odata2.ref.edm,0,0,0,0,0,1,1,2
apache_olingo-odata2,org.apache.olingo.odata2.ref.model,0,0,0,0,0,1,1,2
apache_olingo-odata2,org.apache.olingo.odata2.ref.processor,0,1,0,0,0,11,1,13
apache_olingo-odata2,org.apache.olingo.odata2.ref.read,0,0,0,0,0,3,1,4
apache_olingo-odata2,$,0,0,0,1,1,4,1,7
apache_olingo-odata2,it.pkg.model,0,0,0,0,0,0,1,1
apache_olingo-odata2,it.pkg.processor,0,0,0,0,0,1,1,2
apache_olingo-odata2,it.pkg.util,0,0,0,0,0,0,1,1
apache_olingo-odata2,it.pkg,0,0,0,0,0,2,1,3
apache_olingo-odata2,org.apache.olingo.odata2.spring,0,0,0,0,0,0,1,1
apache_olingo-odata4,org.apache.olingo.client.core.android.http,0,0,0,0,0,0,1,1
apache_olingo-odata4,org.apache.olingo.ext.proxy,0,0,0,0,0,3,1,4
apache_olingo-odata4,org.apache.olingo.ext.proxy.api,0,0,0,1,1,1,1,4
apache_olingo-odata4,org.apache.olingo.ext.proxy.commons,1,0,0,0,1,4,1,7
apache_olingo-odata4,org.apache.olingo.ext.proxy.context,0,0,0,0,0,1,1,2
apache_olingo-odata4,org.apache.olingo.ext.proxy.utils,1,1,0,0,0,0,1,3
apache_olingo-odata4,org.apache.olingo.ext.pojogen,0,0,0,0,1,1,1,3
apache_olingo-odata4,org.apache.olingo.fit.proxy.v4.staticservice.microsoft.exchange.services.odata.model,0,0,0,0,0,0,1,1
apache_olingo-odata4,org.apache.olingo.fit.proxy.v4.staticservice.microsoft.exchange.services.odata.model.types,0,0,0,1,1,0,1,3
apache_olingo-odata4,org.apache.olingo.fit.proxy.v4.staticservice,0,0,0,0,0,0,1,1
apache_olingo-odata4,microsoft.exchange.services.odata.model,0,0,0,0,0,0,1,1
apache_olingo-odata4,microsoft.exchange.services.odata.model.types,0,0,0,1,1,0,1,3
apache_olingo-odata4,(default package),0,0,0,0,0,0,1,1
apache_olingo-odata4,org.apache.olingo.fit,0,0,0,0,1,0,1,2
apache_olingo-odata4,org.apache.olingo.fit.metadata,0,0,0,0,0,0,1,1
apache_olingo-odata4,org.apache.olingo.fit.rest,0,0,0,0,1,0,1,2
apache_olingo-odata4,org.apache.olingo.fit.rproxy,0,0,0,0,0,0,1,1
apache_olingo-odata4,org.apache.olingo.fit.serializer,0,0,0,0,0,0,1,1
apache_olingo-odata4,org.apache.olingo.fit.server,0,0,0,0,0,0,1,1
apache_olingo-odata4,org.apache.olingo.fit.utils,0,1,0,0,1,0,1,3
apache_olingo-odata4,org.apache.olingo.fit.base,0,0,0,0,0,7,1,8
apache_olingo-odata4,org.apache.olingo.fit.proxy,0,0,0,0,0,1,1,2
apache_olingo-odata4,org.apache.olingo.fit.proxy.demo.odatademo,0,0,0,0,1,0,1,2
apache_olingo-odata4,org.apache.olingo.fit.proxy.demo.odatademo.types,0,0,0,1,1,0,1,3
apache_olingo-odata4,org.apache.olingo.fit.proxy.demo,0,0,0,0,0,0,1,1
apache_olingo-odata4,org.apache.olingo.fit.proxy.opentype.opentypesservice,0,0,0,0,1,0,1,2
apache_olingo-odata4,org.apache.olingo.fit.proxy.opentype.opentypesservice.types,0,0,0,1,1,0,1,3
apache_olingo-odata4,org.apache.olingo.fit.proxy.opentype,0,0,0,0,0,0,1,1
apache_olingo-odata4,org.apache.olingo.fit.proxy.staticservice.odatawcfservice,0,0,0,0,1,0,1,2
apache_olingo-odata4,org.apache.olingo.fit.proxy.staticservice.odatawcfservice.types,0,0,0,1,1,0,1,3
apache_olingo-odata4,org.apache.olingo.fit.proxy.staticservice,0,0,0,0,0,0,1,1
apache_olingo-odata4,org.apache.olingo.fit.tecsvc.client,0,0,0,0,1,5,1,7
apache_olingo-odata4,org.apache.olingo.fit.tecsvc.http,0,0,0,0,1,2,1,4
apache_olingo-odata4,org.apache.olingo.fit.tecsvc,0,0,0,0,0,0,1,1
apache_olingo-odata4,org.apache.olingo.fit.util,0,0,0,0,0,0,1,1
apache_olingo-odata4,org.apache.olingo.client.api.communication.header,0,0,0,0,0,0,1,1
apache_olingo-odata4,org.apache.olingo.client.api.communication,0,0,0,0,0,0,1,1
apache_olingo-odata4,org.apache.olingo.client.api.communication.request,0,0,0,0,1,15,1,17
apache_olingo-odata4,org.apache.olingo.client.api.communication.request.batch,0,0,0,0,1,0,1,2
apache_olingo-odata4,org.apache.olingo.client.api.communication.request.cud,0,0,0,0,1,1,1,3
apache_olingo-odata4,org.apache.olingo.client.api.communication.request.invoke,0,0,0,0,0,0,1,1
apache_olingo-odata4,org.apache.olingo.client.api.communication.request.retrieve,0,0,0,0,1,4,1,6
apache_olingo-odata4,org.apache.olingo.client.api.communication.request.streamed,0,0,0,0,1,0,1,2
apache_olingo-odata4,org.apache.olingo.client.api.communication.response,0,0,0,0,0,13,1,14
apache_olingo-odata4,org.apache.olingo.client.api,0,0,0,0,1,20,1,22
apache_olingo-odata4,org.apache.olingo.client.api.data,0,0,0,0,0,2,1,3
apache_olingo-odata4,org.apache.olingo.client.api.domain,0,0,0,0,1,19,1,21
apache_olingo-odata4,org.apache.olingo.client.api.edm.xml,0,0,0,0,1,1,1,3
apache_olingo-odata4,org.apache.olingo.client.api.http,0,0,0,0,0,0,1,1
apache_olingo-odata4,org.apache.olingo.client.api.serialization,0,0,0,0,1,3,1,5
apache_olingo-odata4,org.apache.olingo.client.api.uri,0,0,0,0,1,14,1,16
apache_olingo-odata4,org.apache.olingo.client.core,5,1,0,0,1,11,1,19
apache_olingo-odata4,org.apache.olingo.client.core.communication.header,0,0,0,0,0,0,1,1
apache_olingo-odata4,org.apache.olingo.client.core.communication.request,0,0,0,0,1,1,1,3
apache_olingo-odata4,org.apache.olingo.client.core.communication.request.batch,0,0,0,0,1,1,1,3
apache_olingo-odata4,org.apache.olingo.client.core.communication.request.cud,0,0,0,0,1,5,1,7
apache_olingo-odata4,org.apache.olingo.client.core.communication.request.invoke,2,0,0,0,1,1,1,5
apache_olingo-odata4,org.apache.olingo.client.core.communication.request.retrieve,0,0,0,0,1,1,1,3
apache_olingo-odata4,org.apache.olingo.client.core.communication.request.streamed,0,0,0,0,1,0,1,2
apache_olingo-odata4,org.apache.olingo.client.core.communication.response,0,0,0,0,0,0,1,1
apache_olingo-odata4,org.apache.olingo.client.core.communication.response.batch,0,0,0,0,0,0,1,1
apache_olingo-odata4,org.apache.olingo.client.core.communication.util,0,0,0,0,0,0,1,1
apache_olingo-odata4,org.apache.olingo.client.core.data,0,0,0,0,0,0,1,1
apache_olingo-odata4,org.apache.olingo.client.core.domain,2,0,0,0,0,1,1,4
apache_olingo-odata4,org.apache.olingo.client.core.edm,0,0,0,0,0,1,1,2
apache_olingo-odata4,org.apache.olingo.client.core.edm.xml,1,1,0,1,0,0,1,4
apache_olingo-odata4,org.apache.olingo.client.core.edm.xml.annotation,1,0,0,0,0,0,1,2
apache_olingo-odata4,org.apache.olingo.client.core.http,0,0,0,0,1,0,1,2
apache_olingo-odata4,org.apache.olingo.client.core.metadatavalidator,0,0,0,0,0,1,1,2
apache_olingo-odata4,org.apache.olingo.client.core.serialization,1,0,0,0,1,7,1,10
apache_olingo-odata4,org.apache.olingo.client.core.uri,2,1,0,0,0,3,1,7
apache_olingo-odata4,org.apache.olingo.commons.api.constants,0,0,0,0,0,0,1,1
apache_olingo-odata4,org.apache.olingo.commons.api,0,0,0,0,0,1,1,2
apache_olingo-odata4,org.apache.olingo.commons.api.data,0,0,0,0,1,73,1,75
apache_olingo-odata4,org.apache.olingo.commons.api.edm.annotation,0,0,0,0,0,6,1,7
apache_olingo-odata4,org.apache.olingo.commons.api.edm,0,0,0,1,1,117,1,120
apache_olingo-odata4,org.apache.olingo.commons.api.edm.geo,0,0,0,0,0,4,1,5
apache_olingo-odata4,org.apache.olingo.commons.api.edm.provider.annotation,0,0,0,0,0,8,1,9
apache_olingo-odata4,org.apache.olingo.commons.api.edm.provider,0,0,0,1,0,21,1,23
apache_olingo-odata4,org.apache.olingo.commons.api.edmx,0,0,0,0,0,3,1,4
apache_olingo-odata4,org.apache.olingo.commons.api.ex,0,0,0,0,0,1,1,2
apache_olingo-odata4,org.apache.olingo.commons.api.format,0,0,0,0,0,19,1,20
apache_olingo-odata4,org.apache.olingo.commons.api.http,0,0,0,0,0,0,1,1
apache_olingo-odata4,org.apache.olingo.commons.core,0,0,0,0,0,3,1,4
apache_olingo-odata4,org.apache.olingo.commons.core.edm,1,0,0,1,0,11,1,14
apache_olingo-odata4,org.apache.olingo.commons.core.edm.annotation,1,1,0,0,0,6,1,9
apache_olingo-odata4,org.apache.olingo.commons.core.edm.primitivetype,0,0,0,1,0,6,1,8
apache_olingo-odata4,org.apache.olingo.commons.core.edm.annotations,0,0,0,0,0,5,1,6
apache_olingo-odata4,org.apache.olingo.server.core.edm.provider,0,0,0,1,1,6,1,9
apache_olingo-odata4,org.apache.olingo.netty.server.api,0,0,0,0,0,0,1,1
apache_olingo-odata4,org.apache.olingo.server.api.batch,0,0,0,0,0,3,1,4
apache_olingo-odata4,org.apache.olingo.server.api.debug,0,0,0,0,0,0,1,1
apache_olingo-odata4,org.apache.olingo.server.api.deserializer.batch,0,0,0,0,0,3,1,4
apache_olingo-odata4,org.apache.olingo.server.api.deserializer,0,0,0,0,0,12,1,13
apache_olingo-odata4,org.apache.olingo.server.api.etag,0,0,0,0,0,1,1,2
apache_olingo-odata4,org.apache.olingo.server.api,0,0,0,0,1,58,1,60
apache_olingo-odata4,org.apache.olingo.server.api.prefer,0,0,0,0,0,2,1,3
apache_olingo-odata4,org.apache.olingo.server.api.processor,0,0,0,0,0,7,1,8
apache_olingo-odata4,org.apache.olingo.server.api.serializer,0,1,0,0,1,39,1,42
apache_olingo-odata4,org.apache.olingo.server.api.uri,0,0,1,0,0,48,1,50
apache_olingo-odata4,org.apache.olingo.server.api.uri.queryoption,0,0,0,0,1,19,1,21
apache_olingo-odata4,org.apache.olingo.server.api.uri.queryoption.apply,0,0,0,0,1,3,1,5
apache_olingo-odata4,org.apache.olingo.server.api.uri.queryoption.expression,0,0,0,0,1,2,1,4
apache_olingo-odata4,org.apache.olingo.server.api.uri.queryoption.search,0,0,0,0,0,1,1,2
apache_olingo-odata4,org.apache.olingo.netty.server.core,0,0,0,0,1,0,1,2
apache_olingo-odata4,org.apache.olingo.server.core,21,1,0,1,0,30,1,54
apache_olingo-odata4,org.apache.olingo.server.core.batchhandler,1,0,0,0,0,2,1,4
apache_olingo-odata4,org.apache.olingo.server.core.batchhandler.referenceRewriting,0,0,0,0,0,0,1,1
apache_olingo-odata4,org.apache.olingo.server.core.debug,2,0,0,0,1,3,1,7
apache_olingo-odata4,org.apache.olingo.server.core.deserializer.batch,0,0,0,0,0,4,1,5
apache_olingo-odata4,org.apache.olingo.server.core.deserializer,2,1,0,0,0,2,1,6
apache_olingo-odata4,org.apache.olingo.server.core.deserializer.helper,3,0,0,0,0,0,1,4
apache_olingo-odata4,org.apache.olingo.server.core.deserializer.json,4,0,0,0,1,4,1,10
apache_olingo-odata4,org.apache.olingo.server.core.deserializer.xml,0,0,0,0,0,4,1,5
apache_olingo-odata4,org.apache.olingo.server.core.etag,0,0,0,0,1,1,1,3
apache_olingo-odata4,org.apache.olingo.server.core.prefer,0,0,0,0,0,0,1,1
apache_olingo-odata4,org.apache.olingo.server.core.serializer,0,0,0,0,1,9,1,11
apache_olingo-odata4,org.apache.olingo.server.core.serializer.json,3,0,0,0,1,21,1,26
apache_olingo-odata4,org.apache.olingo.server.core.serializer.utils,0,1,0,0,1,11,1,14
apache_olingo-odata4,org.apache.olingo.server.core.serializer.xml,3,0,0,0,1,17,1,22
apache_olingo-odata4,org.apache.olingo.server.core.uri.parser,12,0,0,1,0,12,1,26
apache_olingo-odata4,org.apache.olingo.server.core.uri.parser.search,3,1,0,0,0,0,1,5
apache_olingo-odata4,org.apache.olingo.server.core.uri.queryoption,12,1,0,0,0,4,1,18
apache_olingo-odata4,org.apache.olingo.server.core.uri.queryoption.apply,0,0,0,0,1,1,1,3
apache_olingo-odata4,org.apache.olingo.server.core.uri.queryoption.expression,11,1,0,0,0,1,1,14
apache_olingo-odata4,org.apache.olingo.server.core.uri,16,1,0,0,0,10,1,28
apache_olingo-odata4,org.apache.olingo.server.core.uri.validator,3,1,0,0,0,1,1,6
apache_olingo-odata4,org.apache.olingo.server.core.legacy,1,1,0,0,0,4,1,7
apache_olingo-odata4,org.apache.olingo.server.core.requests,1,0,0,0,1,23,1,26
apache_olingo-odata4,org.apache.olingo.server.core.responses,0,1,0,0,1,18,1,21
apache_olingo-odata4,org.apache.olingo.server.example,0,0,0,0,0,6,1,7
apache_olingo-odata4,org.apache.olingo.server.tecsvc.async,0,0,0,0,0,0,1,1
apache_olingo-odata4,org.apache.olingo.server.tecsvc.data,0,0,0,0,0,19,1,20
apache_olingo-odata4,org.apache.olingo.server.tecsvc,0,1,0,0,0,0,1,2
apache_olingo-odata4,org.apache.olingo.server.tecsvc.processor.queryoptions,0,0,0,0,0,1,1,2
apache_olingo-odata4,org.apache.olingo.server.tecsvc.processor.queryoptions.expression,0,1,0,0,0,0,1,2
apache_olingo-odata4,org.apache.olingo.server.tecsvc.processor.queryoptions.expression.operand,0,0,0,0,0,2,1,3
apache_olingo-odata4,org.apache.olingo.server.tecsvc.processor.queryoptions.expression.operation,0,0,0,0,0,1,1,2
apache_olingo-odata4,org.apache.olingo.server.tecsvc.processor.queryoptions.expression.primitive,0,0,0,0,0,1,1,2
apache_olingo-odata4,org.apache.olingo.server.tecsvc.processor.queryoptions.options,0,1,0,0,1,3,1,6
apache_olingo-odata4,org.apache.olingo.server.tecsvc.processor,0,0,0,0,0,8,1,9
apache_olingo-odata4,org.apache.olingo.server.tecsvc.provider,0,0,0,0,0,2,1,3
apache_olingo-odata4,myservice.mynamespace.data,1,1,0,0,1,5,1,9
apache_olingo-odata4,myservice.mynamespace.service,1,0,0,1,1,14,1,18
apache_olingo-odata4,myservice.mynamespace.util,0,0,0,0,0,1,1,2
apache_olingo-odata4,myservice.mynamespace.web,0,0,0,0,1,0,1,2
apache_servicemix,org.apache.servicemix.activemq.camel,0,0,0,0,0,0,0,0
apache_servicemix,org.apache.servicemix.activiti.config,0,0,0,0,0,0,0,0
apache_servicemix,org.apache.servicemix.examples.activemq,0,0,0,0,0,0,0,0
apache_servicemix,org.apache.servicemix.examples.activiti,0,0,0,0,0,0,0,0
apache_servicemix,org.apache.servicemix.examples.camel,0,0,0,0,1,0,0,1
apache_servicemix,org.apache.servicemix.examples.camel.rest.client,0,0,0,0,0,0,0,0
apache_servicemix,org.apache.servicemix.examples.camel.rest,0,0,0,0,0,0,0,0
apache_servicemix,org.apache.servicemix.examples.camel.rest.model,0,0,0,0,0,0,0,0
apache_servicemix,org.apache.servicemix.examples.camel.soap.client,0,0,0,0,0,0,0,0
apache_servicemix,org.apache.servicemix.examples.camel.soap,0,0,0,0,0,0,0,0
apache_servicemix,org.apache.servicemix.examples.camel.soap.model,0,0,0,0,0,0,0,0
apache_servicemix,org.apache.servicemix.examples.camel.sql,0,0,0,0,0,0,0,0
apache_servicemix,org.apache.servicemix.examples.cxf.jaxrs.client,0,0,0,0,0,0,0,0
apache_servicemix,org.apache.servicemix.examples.cxf.jaxrs,0,0,0,0,1,0,0,1
apache_servicemix,org.apache.servicemix.examples.cxf,0,0,0,0,1,0,0,1
apache_servicemix,org.apache.servicemix.examples.cxf.wsaddressing,0,0,0,0,0,0,0,0
apache_servicemix,org.apache.servicemix.examples.cxf.base,0,0,0,0,0,0,0,0
apache_servicemix,org.apache.servicemix.examples.cxf.client,0,0,0,0,0,0,0,0
apache_servicemix,org.apache.servicemix.examples.cxf.notifier,0,0,0,0,0,0,0,0
apache_servicemix,org.apache.servicemix.examples.cxf.receive,0,0,0,0,0,0,0,0
apache_servicemix,org.apache.servicemix.examples.drools.camel.blueprint.model,0,0,0,0,0,0,0,0
apache_servicemix,org.apache.servicemix.examples.drools.camel.blueprint.osgi,0,0,0,0,0,0,0,0
apache_servicemix,org.apache.servicemix.examples.drools.camel.cxf.server.model,0,0,0,0,0,0,0,0
apache_servicemix,org.apache.servicemix.examples.drools.camel.cxf.server.osgi,0,0,0,0,0,0,0,0
apache_servicemix,org.apache.servicemix.examples.drools.simple.model,0,0,0,0,0,0,0,0
apache_servicemix,org.apache.servicemix.examples.drools.simple.osgi,0,0,0,0,0,0,0,0
apache_servicemix,org.apache.servicemix.examples.drools.spring.model,0,0,0,0,0,0,0,0
apache_servicemix,org.apache.servicemix.examples.drools.spring.osgi,0,0,0,0,0,0,0,0
apache_servicemix,org.apache.servicemix.logging.jms,0,0,0,0,1,0,0,1
apache_servicemix,$,0,0,0,0,1,0,0,1
apache_storm,org.apache.storm.elasticsearch.bolt,0,0,0,0,1,0,1,2
apache_storm,org.apache.storm.elasticsearch.common,0,0,0,0,1,0,1,2
apache_storm,org.apache.storm.elasticsearch.trident,0,0,0,0,1,0,1,2
apache_storm,org.apache.storm.hbase.topology,0,0,0,0,0,1,1,2
apache_storm,org.apache.storm.hbase.trident,0,0,0,0,0,0,1,1
apache_storm,org.apache.storm.hdfs.bolt,0,0,0,0,1,1,1,3
apache_storm,org.apache.storm.hdfs.spout,0,0,0,1,1,0,1,3
apache_storm,org.apache.storm.hdfs.trident,0,0,0,0,1,0,1,2
apache_storm,org.apache.storm.hive.bolt,1,0,0,0,1,0,1,3
apache_storm,org.apache.storm.hive.trident,0,0,0,0,0,0,1,1
apache_storm,org.apache.storm.jdbc.spout,0,0,0,0,0,0,1,1
apache_storm,org.apache.storm.jdbc.topology,0,0,0,0,0,0,1,1
apache_storm,org.apache.storm.jms.example,0,0,0,0,0,0,1,1
apache_storm,org.apache.storm.kafka.bolt,0,0,0,0,0,0,1,1
apache_storm,org.apache.storm.kafka.spout,2,0,0,1,1,0,1,5
apache_storm,org.apache.storm.kafka.trident,0,0,0,0,1,0,1,2
apache_storm,org.apache.storm.loadgen,0,0,0,1,1,0,1,3
apache_storm,org.apache.storm.mongodb.topology,0,0,0,0,0,1,1,2
apache_storm,org.apache.storm.mongodb.trident,0,0,0,0,0,0,1,1
apache_storm,org.apache.storm.mqtt.examples,0,0,0,0,0,0,1,1
apache_storm,org.apache.storm.opentsdb,1,0,0,0,0,0,1,2
apache_storm,org.apache.storm.perf,1,0,0,0,1,0,1,3
apache_storm,org.apache.storm.perf.bolt,0,0,0,0,0,1,1,2
apache_storm,org.apache.storm.perf.spout,1,1,0,0,0,0,1,3
apache_storm,org.apache.storm.perf.utils,0,0,0,0,0,0,1,1
apache_storm,org.apache.storm.pmml,0,0,0,0,0,0,1,1
apache_storm,org.apache.storm.redis.tools,0,0,0,0,0,0,1,1
apache_storm,org.apache.storm.redis.topology,0,0,0,0,1,0,1,2
apache_storm,org.apache.storm.redis.trident,0,0,0,0,1,0,1,2
apache_storm,org.apache.storm.rocketmq.topology,0,0,0,0,0,0,1,1
apache_storm,org.apache.storm.rocketmq.trident,0,0,0,0,0,0,1,1
apache_storm,org.apache.storm.solr.spout,0,0,0,0,0,0,1,1
apache_storm,org.apache.storm.solr.topology,0,0,0,0,0,0,1,1
apache_storm,org.apache.storm.solr.trident,0,0,0,0,0,0,1,1
apache_storm,org.apache.storm.solr.util,0,0,0,0,0,0,1,1
apache_storm,org.apache.storm.starter,0,0,0,1,1,3,1,6
apache_storm,org.apache.storm.starter.bolt,0,0,0,0,1,1,1,3
apache_storm,org.apache.storm.starter.spout,0,0,0,0,0,0,1,1
apache_storm,org.apache.storm.starter.streams,0,0,0,0,1,1,1,3
apache_storm,org.apache.storm.starter.tools,0,0,0,0,1,0,1,2
apache_storm,org.apache.storm.starter.trident,0,0,0,0,1,0,1,2
apache_storm,org.apache.storm.common,0,0,0,0,0,0,1,1
apache_storm,org.apache.storm.hbase.security,0,1,0,0,0,0,1,2
apache_storm,org.apache.storm.hdfs.security,0,1,0,0,0,0,1,2
apache_storm,org.apache.storm.hive.security,0,0,0,0,0,0,1,1
apache_storm,org.apache.storm.blobstore,9,1,0,1,1,0,1,13
apache_storm,org.apache.storm.cassandra,0,0,0,0,1,1,1,3
apache_storm,org.apache.storm.cassandra.bolt,0,0,0,0,1,0,1,2
apache_storm,org.apache.storm.cassandra.client,0,0,0,0,0,0,1,1
apache_storm,org.apache.storm.cassandra.client.impl,0,0,0,0,0,0,1,1
apache_storm,org.apache.storm.cassandra.context,0,0,0,0,0,0,1,1
apache_storm,org.apache.storm.cassandra.executor,0,0,0,0,1,1,1,3
apache_storm,org.apache.storm.cassandra.executor.impl,0,0,0,0,0,0,1,1
apache_storm,org.apache.storm.cassandra.query,0,0,0,0,1,0,1,2
apache_storm,org.apache.storm.cassandra.query.builder,0,0,0,0,0,0,1,1
apache_storm,org.apache.storm.cassandra.query.impl,0,0,0,0,1,0,1,2
apache_storm,org.apache.storm.cassandra.query.selector,0,0,0,0,0,0,1,1
apache_storm,org.apache.storm.cassandra.trident.state,0,0,0,0,1,1,1,3
apache_storm,org.apache.storm.cassandra.trident,0,0,0,0,0,0,1,1
apache_storm,org.apache.storm.elasticsearch,0,0,0,0,0,0,1,1
apache_storm,org.apache.storm.elasticsearch.doc,0,0,0,0,1,0,1,2
apache_storm,org.apache.storm.elasticsearch.response,0,0,0,0,0,0,1,1
apache_storm,org.apache.storm.eventhubs.bolt,0,0,0,0,0,0,1,1
apache_storm,org.apache.storm.eventhubs.spout,0,1,0,1,1,0,1,4
apache_storm,org.apache.storm.eventhubs.trident,0,0,0,0,1,0,1,2
apache_storm,org.apache.storm.hbase.bolt,0,0,0,0,0,1,1,2
apache_storm,org.apache.storm.hbase.bolt.mapper,0,0,0,0,0,1,1,2
apache_storm,org.apache.storm.hbase.common,0,0,0,0,1,0,1,2
apache_storm,org.apache.storm.hbase.state,0,0,0,0,1,0,1,2
apache_storm,org.apache.storm.hbase.trident.mapper,0,0,0,0,0,0,1,1
apache_storm,org.apache.storm.hbase.trident.state,0,0,0,0,1,0,1,2
apache_storm,org.apache.storm.hbase.trident.windowing,0,0,0,0,0,0,1,1
apache_storm,org.apache.storm.hdfs.avro,0,0,0,0,1,0,1,2
apache_storm,org.apache.storm.hdfs.bolt.format,0,0,0,0,1,1,1,3
apache_storm,org.apache.storm.hdfs.bolt.rotation,0,0,0,0,0,0,1,1
apache_storm,org.apache.storm.hdfs.bolt.sync,0,0,0,0,0,0,1,1
apache_storm,org.apache.storm.hdfs.common,0,0,0,0,1,0,1,2
apache_storm,org.apache.storm.hdfs.common.rotation,0,0,0,0,0,0,1,1
apache_storm,org.apache.storm.hdfs.trident.format,0,0,0,0,1,0,1,2
apache_storm,org.apache.storm.hdfs.trident.rotation,0,0,0,0,0,0,1,1
apache_storm,org.apache.storm.hdfs.trident.sync,0,0,0,0,0,0,1,1
apache_storm,org.apache.storm.hdfs.blobstore,3,0,0,0,1,0,1,5
apache_storm,org.apache.storm.hive.bolt.mapper,0,0,0,0,0,0,1,1
apache_storm,org.apache.storm.hive.common,1,1,0,0,1,0,1,4
apache_storm,org.apache.storm.jdbc.bolt,0,0,0,0,0,0,1,1
apache_storm,org.apache.storm.jdbc.common,0,0,0,0,0,1,1,2
apache_storm,org.apache.storm.jdbc.mapper,0,0,0,0,0,1,1,2
apache_storm,org.apache.storm.jdbc.trident.state,0,0,0,0,0,0,1,1
apache_storm,org.apache.storm.jms.bolt,0,0,0,0,0,0,1,1
apache_storm,org.apache.storm.jms,0,0,0,0,0,0,1,1
apache_storm,org.apache.storm.jms.spout,0,0,0,0,1,0,1,2
apache_storm,org.apache.storm.jms.trident,0,0,0,0,1,0,1,2
apache_storm,org.apache.storm.kafka.bolt.mapper,0,0,0,0,0,0,1,1
apache_storm,org.apache.storm.kafka.bolt.selector,0,0,0,0,0,0,1,1
apache_storm,org.apache.storm.kafka.spout.internal,0,0,0,0,1,0,1,2
apache_storm,org.apache.storm.kafka.spout.metrics,0,0,0,0,0,0,1,1
apache_storm,org.apache.storm.kafka.spout.subscription,1,1,0,0,1,0,1,4
apache_storm,org.apache.storm.kafka.spout.trident.internal,0,0,0,0,0,0,1,1
apache_storm,org.apache.storm.kafka.spout.trident,1,0,0,0,1,0,1,3
apache_storm,org.apache.storm.kafka.trident.mapper,0,0,0,0,0,0,1,1
apache_storm,org.apache.storm.kafka.trident.selector,0,0,0,0,0,0,1,1
apache_storm,org.apache.storm.kafka,0,0,0,0,0,0,1,1
apache_storm,org.apache.storm.kafka.spout.config.builder,2,1,0,0,0,0,1,4
apache_storm,org.apache.storm.kafka.spout.trident.config.builder,1,1,0,0,0,0,1,3
apache_storm,org.apache.storm.kafka.migration,0,0,0,0,1,0,1,2
apache_storm,org.apache.storm.kafka.monitor,0,0,0,0,0,0,1,1
apache_storm,org.apache.storm.kinesis.spout,0,0,0,0,1,0,1,2
apache_storm,org.apache.storm.metrics.hdrhistogram,0,0,0,0,0,0,1,1
apache_storm,org.apache.storm.metrics.sigar,0,0,0,0,0,0,1,1
apache_storm,org.apache.storm.mongodb.bolt,0,0,0,0,0,0,1,1
apache_storm,org.apache.storm.mongodb.common.mapper,0,0,0,0,1,0,1,2
apache_storm,org.apache.storm.mongodb.common,0,0,0,0,0,1,1,2
apache_storm,org.apache.storm.mongodb.trident.state,0,0,0,0,1,0,1,2
apache_storm,org.apache.storm.mqtt.bolt,0,0,0,0,0,0,1,1
apache_storm,org.apache.storm.mqtt.common,0,0,0,0,0,0,1,1
apache_storm,org.apache.storm.mqtt.mappers,0,0,0,0,0,0,1,1
apache_storm,org.apache.storm.mqtt,0,0,0,0,1,0,1,2
apache_storm,org.apache.storm.mqtt.spout,0,0,0,0,0,0,1,1
apache_storm,org.apache.storm.mqtt.ssl,0,0,0,0,0,0,1,1
apache_storm,org.apache.storm.mqtt.trident,0,0,0,0,0,0,1,1
apache_storm,org.apache.storm.opentsdb.bolt,1,1,0,0,0,0,1,3
apache_storm,org.apache.storm.opentsdb.client,0,0,0,0,0,0,1,1
apache_storm,org.apache.storm.opentsdb.trident,0,0,0,0,0,0,1,1
apache_storm,org.apache.storm.pmml.model.jpmml,0,0,0,0,0,0,1,1
apache_storm,org.apache.storm.pmml.model,0,0,0,0,0,0,1,1
apache_storm,org.apache.storm.pmml.runner.jpmml,0,0,0,0,0,0,1,1
apache_storm,org.apache.storm.pmml.runner,0,0,0,0,0,0,1,1
apache_storm,org.apache.storm.redis.bolt,0,0,0,0,0,0,1,1
apache_storm,org.apache.storm.redis.common.adapter,0,0,0,0,0,0,1,1
apache_storm,org.apache.storm.redis.common.commands,0,0,0,0,0,2,1,3
apache_storm,org.apache.storm.redis.common.config,0,0,0,0,0,1,1,2
apache_storm,org.apache.storm.redis.common.container,0,0,0,0,1,2,1,4
apache_storm,org.apache.storm.redis.common.mapper,0,0,0,0,1,0,1,2
apache_storm,org.apache.storm.redis.state,0,0,0,0,1,2,1,4
apache_storm,org.apache.storm.redis.trident.state,0,0,0,0,1,1,1,3
apache_storm,org.apache.storm.rocketmq.bolt,0,0,0,0,0,0,1,1
apache_storm,org.apache.storm.rocketmq.common.mapper,0,0,0,0,0,0,1,1
apache_storm,org.apache.storm.rocketmq.common.selector,0,0,0,0,0,0,1,1
apache_storm,org.apache.storm.rocketmq,0,1,0,0,1,0,1,3
apache_storm,org.apache.storm.rocketmq.spout,0,0,0,0,0,0,1,1
apache_storm,org.apache.storm.rocketmq.spout.scheme,0,0,0,0,0,0,1,1
apache_storm,org.apache.storm.rocketmq.trident.state,0,0,0,0,0,0,1,1
apache_storm,org.apache.storm.solr.bolt,0,0,0,0,0,0,1,1
apache_storm,org.apache.storm.solr.config,0,0,0,0,0,0,1,1
apache_storm,org.apache.storm.solr.mapper,0,0,0,0,1,0,1,2
apache_storm,org.apache.storm.solr.schema.builder,0,0,0,0,0,0,1,1
apache_storm,org.apache.storm.solr.schema,0,0,0,0,1,0,1,2
apache_storm,org.apache.storm.flux.api,0,0,0,0,0,0,1,1
apache_storm,org.apache.storm.flux,0,0,0,0,0,0,1,1
apache_storm,org.apache.storm.flux.model,0,0,0,0,1,0,1,2
apache_storm,org.apache.storm.flux.parser,0,0,0,0,0,0,1,1
apache_storm,org.apache.storm.flux.multilang,0,0,0,0,0,0,1,1
apache_storm,org.apache.storm.flux.examples,0,0,0,0,1,0,1,2
apache_storm,org.apache.storm.flux.wrappers.bolts,0,0,0,0,0,0,1,1
apache_storm,org.apache.storm.flux.wrappers.spouts,0,0,0,0,0,0,1,1
apache_storm,org.apache.storm.debug,0,0,0,0,0,0,1,1
apache_storm,org.apache.storm,68,1,0,1,1,4,1,76
apache_storm,org.apache.storm.st.topology,0,0,0,0,0,0,1,1
apache_storm,org.apache.storm.st.topology.window.data,0,0,0,0,0,0,1,1
apache_storm,org.apache.storm.st.topology.window,0,0,0,0,1,0,1,2
apache_storm,org.apache.storm.st.utils,0,0,0,0,0,0,1,1
apache_storm,org.apache.storm.st,0,0,0,0,0,0,1,1
apache_storm,org.apache.storm.st.helper,0,0,0,0,0,0,1,1
apache_storm,org.apache.storm.st.meta,0,0,0,0,0,0,1,1
apache_storm,org.apache.storm.st.wrapper,0,0,0,0,0,0,1,1
apache_storm,org.apache.storm.sql,0,0,0,1,1,0,1,3
apache_storm,org.apache.storm.sql.calcite,0,0,0,0,0,0,1,1
apache_storm,org.apache.storm.sql.compiler,0,0,0,0,0,0,1,1
apache_storm,org.apache.storm.sql.javac,0,0,0,0,0,0,1,1
apache_storm,org.apache.storm.sql.parser,0,0,0,0,1,0,1,2
apache_storm,org.apache.storm.sql.planner.rel,0,0,0,0,0,0,1,1
apache_storm,org.apache.storm.sql.planner,2,1,0,0,0,0,1,4
apache_storm,org.apache.storm.sql.planner.streams,2,1,0,0,0,0,1,4
apache_storm,org.apache.storm.sql.planner.streams.rel,3,0,0,0,0,0,1,4
apache_storm,org.apache.storm.sql.planner.streams.rules,0,0,0,0,1,0,1,2
apache_storm,org.apache.storm.sql.compiler.backends.streams,0,0,0,0,0,0,1,1
apache_storm,org.apache.storm.sql.hdfs,0,0,0,0,0,1,1,2
apache_storm,org.apache.storm.sql.kafka,0,0,0,0,0,0,1,1
apache_storm,org.apache.storm.sql.mongodb,0,0,0,0,0,0,1,1
apache_storm,org.apache.storm.sql.redis,0,0,0,0,1,0,1,2
apache_storm,org.apache.calcite.interpreter,0,0,0,0,0,0,1,1
apache_storm,org.apache.storm.sql.runtime.calcite,0,0,0,0,0,0,1,1
apache_storm,org.apache.storm.sql.runtime.datasource.socket.bolt,0,0,0,0,0,0,1,1
apache_storm,org.apache.storm.sql.runtime.datasource.socket,0,0,0,0,0,0,1,1
apache_storm,org.apache.storm.sql.runtime.datasource.socket.spout,0,0,0,0,0,0,1,1
apache_storm,org.apache.storm.sql.runtime,0,0,0,0,0,0,1,1
apache_storm,org.apache.storm.sql.runtime.serde.avro,0,0,0,0,0,0,1,1
apache_storm,org.apache.storm.sql.runtime.serde.csv,0,0,0,0,0,0,1,1
apache_storm,org.apache.storm.sql.runtime.serde.json,0,0,0,0,0,0,1,1
apache_storm,org.apache.storm.sql.runtime.serde.tsv,0,0,0,0,0,0,1,1
apache_storm,org.apache.storm.sql.runtime.streams.functions,0,0,0,0,0,0,1,1
apache_storm,org.apache.storm.sql.runtime.utils,0,0,0,0,0,0,1,1
apache_storm,org.apache.storm.maven.shade.clojure,0,0,0,0,0,0,1,1
apache_storm,org.apache.storm.maven.plugin.util,0,0,0,0,0,0,1,1
apache_storm,org.apache.storm.maven.plugin.versioninfo,0,0,0,0,0,0,1,1
apache_storm,org.apache.storm.annotation,0,0,0,0,0,0,1,1
apache_storm,org.apache.storm.assignments,3,0,0,0,0,0,1,4
apache_storm,org.apache.storm.bolt,0,0,0,0,0,0,1,1
apache_storm,org.apache.storm.callback,0,0,0,0,0,0,1,1
apache_storm,org.apache.storm.cluster,16,1,0,0,1,0,1,19
apache_storm,org.apache.storm.container.cgroup,1,1,0,0,1,0,1,4
apache_storm,org.apache.storm.container.cgroup.core,1,0,0,0,1,0,1,3
apache_storm,org.apache.storm.coordination,0,0,0,0,1,1,1,3
apache_storm,org.apache.storm.daemon,13,0,0,0,1,0,1,15
apache_storm,org.apache.storm.daemon.metrics,2,0,0,0,1,0,1,4
apache_storm,org.apache.storm.daemon.supervisor,8,1,0,1,1,0,1,12
apache_storm,org.apache.storm.daemon.worker,1,0,0,0,1,0,1,3
apache_storm,org.apache.storm.dependency,0,0,0,0,1,0,1,2
apache_storm,org.apache.storm.drpc,0,0,0,0,1,1,1,3
apache_storm,org.apache.storm.executor.bolt,0,0,0,0,0,0,1,1
apache_storm,org.apache.storm.executor.error,0,0,0,0,0,0,1,1
apache_storm,org.apache.storm.executor,6,0,0,0,1,0,1,8
apache_storm,org.apache.storm.executor.spout,0,0,0,0,0,0,1,1
apache_storm,org.apache.storm.generated,0,0,0,2,1,3,1,7
apache_storm,org.apache.storm.grouping,5,1,0,0,1,0,1,8
apache_storm,org.apache.storm.hooks,0,0,0,0,0,1,1,2
apache_storm,org.apache.storm.hooks.info,0,0,0,0,1,1,1,3
apache_storm,org.apache.storm.lambda,0,0,0,0,1,0,1,2
apache_storm,org.apache.storm.messaging,2,1,0,0,1,0,1,5
apache_storm,org.apache.storm.messaging.local,0,0,0,0,0,0,1,1
apache_storm,org.apache.storm.messaging.netty,3,0,0,1,1,0,1,6
apache_storm,org.apache.storm.metric.api,0,0,0,0,1,0,1,2
apache_storm,org.apache.storm.metric.api.rpc,0,0,0,0,0,0,1,1
apache_storm,org.apache.storm.metric.cgroup,0,0,0,0,0,0,1,1
apache_storm,org.apache.storm.metric,5,1,0,0,1,0,1,8
apache_storm,org.apache.storm.metric.filter,0,0,0,0,0,0,1,1
apache_storm,org.apache.storm.metric.internal,1,0,0,0,1,0,1,3
apache_storm,org.apache.storm.metric.util,0,0,0,0,0,0,1,1
apache_storm,org.apache.storm.metrics2.filters,0,0,0,0,0,0,1,1
apache_storm,org.apache.storm.metrics2,2,0,0,0,0,0,1,3
apache_storm,org.apache.storm.metrics2.reporters,0,0,0,0,1,0,1,2
apache_storm,org.apache.storm.multilang,1,0,0,0,1,0,1,3
apache_storm,org.apache.storm.networktopography,0,0,0,0,0,0,1,1
apache_storm,org.apache.storm.nimbus,4,0,0,0,1,0,1,6
apache_storm,org.apache.storm.pacemaker.codec,3,1,0,0,0,0,1,5
apache_storm,org.apache.storm.pacemaker,4,0,0,0,1,0,1,6
apache_storm,org.apache.storm.policy,2,0,0,0,0,0,1,3
apache_storm,org.apache.storm.scheduler,2,0,0,0,1,1,1,5
apache_storm,org.apache.storm.security.auth.authorizer,3,0,0,0,1,0,1,5
apache_storm,org.apache.storm.security.auth,11,1,0,1,1,0,1,15
apache_storm,org.apache.storm.security.auth.digest,3,1,0,0,0,0,1,5
apache_storm,org.apache.storm.security.auth.kerberos,0,1,0,0,1,0,1,3
apache_storm,org.apache.storm.security.auth.plain,0,0,0,0,0,0,1,1
apache_storm,org.apache.storm.security.auth.sasl,1,0,0,0,1,0,1,3
apache_storm,org.apache.storm.security.auth.workertoken,2,0,0,0,0,0,1,3
apache_storm,org.apache.storm.security,0,0,0,0,0,0,1,1
apache_storm,org.apache.storm.security.serialization,0,0,0,0,0,0,1,1
apache_storm,org.apache.storm.serialization,4,1,0,0,1,0,1,7
apache_storm,org.apache.storm.serialization.types,0,0,0,0,0,0,1,1
apache_storm,org.apache.storm.spout,7,0,0,0,1,1,1,10
apache_storm,org.apache.storm.state,4,1,0,0,1,1,1,8
apache_storm,org.apache.storm.stats,5,1,0,0,1,0,1,8
apache_storm,org.apache.storm.streams,5,1,0,0,1,2,1,10
apache_storm,org.apache.storm.streams.operations.aggregators,0,0,0,0,0,0,1,1
apache_storm,org.apache.storm.streams.operations,0,0,0,0,0,1,1,2
apache_storm,org.apache.storm.streams.operations.mappers,0,0,0,0,0,0,1,1
apache_storm,org.apache.storm.streams.processors,1,0,0,0,0,1,1,3
apache_storm,org.apache.storm.streams.tuple,0,0,0,0,1,0,1,2
apache_storm,org.apache.storm.streams.windowing,0,0,0,0,0,0,1,1
apache_storm,org.apache.storm.task,2,0,0,0,1,6,1,10
apache_storm,org.apache.storm.topology.base,3,1,0,0,1,1,1,7
apache_storm,org.apache.storm.topology,10,1,0,1,1,8,1,22
apache_storm,org.apache.storm.transactional,0,0,0,0,0,0,1,1
apache_storm,org.apache.storm.trident.drpc,0,0,0,0,0,0,1,1
apache_storm,org.apache.storm.trident.fluent,0,0,0,0,1,0,1,2
apache_storm,org.apache.storm.trident.graph,0,0,0,0,0,0,1,1
apache_storm,org.apache.storm.trident,0,1,0,0,1,0,1,3
apache_storm,org.apache.storm.trident.operation,0,0,0,0,1,3,1,5
apache_storm,org.apache.storm.trident.operation.builtin,0,0,0,0,1,0,1,2
apache_storm,org.apache.storm.trident.operation.impl,0,0,0,0,1,1,1,3
apache_storm,org.apache.storm.trident.partition,0,0,0,0,0,0,1,1
apache_storm,org.apache.storm.trident.planner,0,0,0,0,1,1,1,3
apache_storm,org.apache.storm.trident.planner.processor,0,0,0,0,1,3,1,5
apache_storm,org.apache.storm.trident.spout,1,1,0,1,1,1,1,6
apache_storm,org.apache.storm.trident.state,0,0,0,0,1,1,1,3
apache_storm,org.apache.storm.trident.state.map,0,0,0,0,1,1,1,3
apache_storm,org.apache.storm.trident.state.snapshot,0,0,0,0,0,0,1,1
apache_storm,org.apache.storm.trident.topology,1,0,0,0,1,2,1,5
apache_storm,org.apache.storm.trident.topology.state,0,0,0,0,0,0,1,1
apache_storm,org.apache.storm.trident.tuple,0,0,0,0,1,3,1,5
apache_storm,org.apache.storm.trident.util,0,0,0,0,0,0,1,1
apache_storm,org.apache.storm.trident.windowing,0,1,0,0,1,0,1,3
apache_storm,org.apache.storm.trident.windowing.config,0,0,0,0,0,0,1,1
apache_storm,org.apache.storm.trident.windowing.strategy,0,0,0,0,0,0,1,1
apache_storm,org.apache.storm.tuple,2,1,0,0,1,6,1,11
apache_storm,org.apache.storm.utils,64,1,0,1,1,3,1,71
apache_storm,org.apache.storm.validation,16,0,0,1,1,0,1,19
apache_storm,org.apache.storm.windowing,2,1,0,0,1,0,1,5
apache_storm,org.apache.storm.windowing.persistence,0,0,0,0,0,0,1,1
apache_storm,org.apache.storm.zookeeper,4,1,0,0,1,0,1,7
apache_storm,org.apache.storm.grouping.partialKeyGrouping,0,0,0,0,0,0,1,1
apache_storm,org.apache.storm.clojure,0,0,0,0,1,1,1,3
apache_storm,org.apache.storm.command,0,0,0,1,1,0,1,3
apache_storm,org.apache.storm.planner,0,0,0,0,0,0,1,1
apache_storm,org.apache.storm.shade.org.apache.zookeeper,0,0,0,0,0,0,1,1
apache_storm,org.apache.storm.integration,0,0,0,0,1,0,1,2
apache_storm,org.apache.storm.utils.staticmocking,0,0,0,0,0,0,1,1
apache_storm,org.apache.storm.container,0,0,0,0,0,0,1,1
apache_storm,org.apache.storm.daemon.drpc,0,0,0,0,1,0,1,2
apache_storm,org.apache.storm.daemon.metrics.reporters,0,0,0,0,0,0,1,1
apache_storm,org.apache.storm.daemon.nimbus,10,0,0,0,1,1,1,13
apache_storm,org.apache.storm.daemon.supervisor.timer,0,0,0,0,0,0,1,1
apache_storm,org.apache.storm.event,0,0,0,0,0,0,1,1
apache_storm,org.apache.storm.healthcheck,0,0,0,0,0,0,1,1
apache_storm,org.apache.storm.localizer,3,0,0,0,1,0,1,5
apache_storm,org.apache.storm.logging.filters,0,0,0,0,0,0,1,1
apache_storm,org.apache.storm.logging,0,0,0,0,0,0,1,1
apache_storm,org.apache.storm.metric.timed,0,0,0,0,0,0,1,1
apache_storm,org.apache.storm.metricstore,2,0,0,0,1,0,1,4
apache_storm,org.apache.storm.metricstore.rocksdb,0,0,0,0,1,0,1,2
apache_storm,org.apache.storm.scheduler.blacklist,0,0,0,0,1,0,1,2
apache_storm,org.apache.storm.scheduler.blacklist.reporters,0,0,0,0,0,0,1,1
apache_storm,org.apache.storm.scheduler.blacklist.strategies,0,0,0,0,0,0,1,1
apache_storm,org.apache.storm.scheduler.multitenant,0,0,0,0,1,0,1,2
apache_storm,org.apache.storm.scheduler.resource.normalization,4,1,0,0,1,0,1,7
apache_storm,org.apache.storm.scheduler.resource,20,1,0,0,1,1,1,24
apache_storm,org.apache.storm.scheduler.resource.strategies.priority,4,0,0,0,1,0,1,6
apache_storm,org.apache.storm.scheduler.resource.strategies.scheduling,2,1,0,0,1,0,1,5
apache_storm,org.apache.storm.scheduler.utils,2,0,0,0,1,0,1,4
apache_storm,org.apache.storm.scheduler.resource.strategies.eviction,0,0,0,0,0,0,1,1
apache_storm,org.apache.storm.submit.command,0,0,0,0,0,0,1,1
apache_storm,org.apache.storm.submit.dependency,0,0,0,0,1,0,1,2
apache_storm,org.apache.storm.daemon.common,0,1,0,0,0,0,1,2
apache_storm,org.apache.storm.daemon.drpc.webapp,0,0,0,0,0,0,1,1
apache_storm,org.apache.storm.daemon.logviewer.handler,1,0,0,0,1,0,1,3
apache_storm,org.apache.storm.daemon.logviewer,1,1,0,0,0,0,1,3
apache_storm,org.apache.storm.daemon.logviewer.utils,0,1,0,0,0,1,1,3
apache_storm,org.apache.storm.daemon.logviewer.webapp,1,0,0,0,0,0,1,2
apache_storm,org.apache.storm.daemon.ui.exceptionmappers,2,1,0,0,0,0,1,4
apache_storm,org.apache.storm.daemon.ui,4,1,0,0,1,0,1,7
apache_storm,org.apache.storm.daemon.ui.filters,2,0,0,0,0,0,1,3
apache_storm,org.apache.storm.daemon.ui.resources,2,1,0,0,0,0,1,4
apache_storm,org.apache.storm.daemon.utils,0,0,0,0,0,0,1,1
apache_struts,(default package),0,0,0,0,0,0,1,1
apache_struts,org.demo.rest.example,0,0,0,0,1,1,1,3
apache_struts,it.org.apache.struts2.rest.example,0,0,0,0,0,0,1,1
apache_struts,org.apache.struts2.showcase.action,0,0,0,0,1,0,1,2
apache_struts,org.apache.struts2.showcase.actionchaining,0,0,0,0,1,0,1,2
apache_struts,org.apache.struts2.showcase.ajax,0,0,0,0,1,0,1,2
apache_struts,org.apache.struts2.showcase.ajax.tree,0,0,0,0,0,0,1,1
apache_struts,org.apache.struts2.showcase.application,0,0,0,0,1,0,1,2
apache_struts,org.apache.struts2.showcase.async,0,0,0,0,1,0,1,2
apache_struts,org.apache.struts2.showcase.chat,0,0,0,1,1,1,1,4
apache_struts,org.apache.struts2.showcase.conversion,0,0,0,0,1,0,1,2
apache_struts,org.apache.struts2.showcase.dao,0,0,0,0,1,0,1,2
apache_struts,org.apache.struts2.showcase,0,0,0,1,1,0,1,3
apache_struts,org.apache.struts2.showcase.exception,0,0,0,0,1,0,1,2
apache_struts,org.apache.struts2.showcase.filedownload,0,0,0,0,0,0,1,1
apache_struts,org.apache.struts2.showcase.fileupload,0,0,0,0,1,0,1,2
apache_struts,org.apache.struts2.showcase.freemarker,0,0,0,0,1,0,1,2
apache_struts,org.apache.struts2.showcase.hangman,0,0,0,1,1,0,1,3
apache_struts,org.apache.struts2.showcase.model,0,0,0,0,1,0,1,2
apache_struts,org.apache.struts2.showcase.modelDriven,0,0,0,0,1,0,1,2
apache_struts,org.apache.struts2.showcase.person,0,0,0,0,1,0,1,2
apache_struts,org.apache.struts2.showcase.source,0,0,0,0,0,0,1,1
apache_struts,org.apache.struts2.showcase.tag.nonui.actionPrefix,0,0,0,0,0,0,1,1
apache_struts,org.apache.struts2.showcase.tag.nonui.actiontag,0,0,0,0,0,0,1,1
apache_struts,org.apache.struts2.showcase.tag.nonui.debugtag,0,0,0,0,0,0,1,1
apache_struts,org.apache.struts2.showcase.tag.nonui.iteratortag,0,0,0,0,1,0,1,2
apache_struts,org.apache.struts2.showcase.tiles,0,0,0,0,0,0,1,1
apache_struts,org.apache.struts2.showcase.token,0,0,0,0,0,0,1,1
apache_struts,org.apache.struts2.showcase.validation,0,0,0,1,1,0,1,3
apache_struts,org.apache.struts2.showcase.wait,0,0,0,0,0,0,1,1
apache_struts,org.apache.struts2.showcase.xslt,0,0,0,0,1,0,1,2
apache_struts,it.org.apache.struts2.showcase,0,0,0,0,0,0,1,1
apache_struts,org.apache.struts2.osgi.admin.actions,0,0,0,0,0,0,1,1
apache_struts,actions.osgi,0,0,0,0,0,0,1,1
apache_struts,com.opensymphony.xwork2,51,1,0,1,0,49,1,103
apache_struts,com.opensymphony.xwork2.config,3,1,0,0,1,11,1,17
apache_struts,com.opensymphony.xwork2.config.entities,7,1,0,0,1,17,1,27
apache_struts,com.opensymphony.xwork2.config.impl,7,0,0,0,1,1,1,10
apache_struts,com.opensymphony.xwork2.config.providers,13,1,0,1,1,4,1,21
apache_struts,com.opensymphony.xwork2.conversion,0,0,0,0,1,0,1,2
apache_struts,com.opensymphony.xwork2.conversion.impl,7,0,0,1,1,3,1,13
apache_struts,com.opensymphony.xwork2.conversion.metadata,0,0,0,0,0,0,1,1
apache_struts,com.opensymphony.xwork2.factory,3,1,0,0,1,0,1,6
apache_struts,com.opensymphony.xwork2.inject,0,0,0,1,0,5,1,7
apache_struts,com.opensymphony.xwork2.inject.util,0,0,0,0,0,0,1,1
apache_struts,com.opensymphony.xwork2.interceptor,8,1,0,1,0,16,1,27
apache_struts,com.opensymphony.xwork2.interceptor.annotations,0,0,0,0,1,2,1,4
apache_struts,com.opensymphony.xwork2.mock,0,0,0,0,1,8,1,10
apache_struts,com.opensymphony.xwork2.ognl.accessor,4,1,0,0,1,2,1,9
apache_struts,com.opensymphony.xwork2.ognl,3,0,0,1,1,2,1,8
apache_struts,com.opensymphony.xwork2.result,0,0,0,0,0,0,1,1
apache_struts,com.opensymphony.xwork2.security,2,0,0,0,1,0,1,4
apache_struts,com.opensymphony.xwork2.spring.interceptor,0,0,0,0,0,0,1,1
apache_struts,com.opensymphony.xwork2.spring,0,0,0,0,1,0,1,2
apache_struts,com.opensymphony.xwork2.util,36,1,0,1,1,31,1,71
apache_struts,com.opensymphony.xwork2.util.classloader,0,0,0,0,1,0,1,2
apache_struts,com.opensymphony.xwork2.util.finder,0,0,0,0,1,0,1,2
apache_struts,com.opensymphony.xwork2.util.fs,3,0,0,0,0,1,1,5
apache_struts,com.opensymphony.xwork2.util.location,17,1,0,0,0,1,1,20
apache_struts,com.opensymphony.xwork2.util.reflection,7,1,0,0,1,1,1,11
apache_struts,com.opensymphony.xwork2.validator,7,0,0,1,1,9,1,19
apache_struts,com.opensymphony.xwork2.validator.validators,3,1,0,1,1,6,1,13
apache_struts,org.apache.struts2.action,0,0,0,0,1,0,1,2
apache_struts,org.apache.struts2.components,5,0,0,1,1,2,1,10
apache_struts,org.apache.struts2.components.template,1,1,0,0,1,3,1,7
apache_struts,org.apache.struts2.config,10,0,0,0,1,0,1,12
apache_struts,org.apache.struts2.config.entities,1,0,0,0,0,0,1,2
apache_struts,org.apache.struts2.conversion,2,0,0,0,0,0,1,3
apache_struts,org.apache.struts2.dispatcher,9,1,0,1,1,9,1,22
apache_struts,org.apache.struts2.dispatcher.filter,0,0,0,0,0,0,1,1
apache_struts,org.apache.struts2.dispatcher.listener,0,0,0,0,0,0,1,1
apache_struts,org.apache.struts2.dispatcher.mapper,4,0,0,0,1,0,1,6
apache_struts,org.apache.struts2.dispatcher.multipart,4,0,0,0,1,0,1,6
apache_struts,org.apache.struts2.dispatcher.servlet,0,0,0,0,0,0,1,1
apache_struts,org.apache.struts2.factory,0,0,0,0,1,0,1,2
apache_struts,org.apache.struts2.interceptor,10,0,0,1,1,5,1,18
apache_struts,org.apache.struts2.interceptor.debugging,0,0,0,0,0,0,1,1
apache_struts,org.apache.struts2.interceptor.servlet,0,0,0,0,0,0,1,1
apache_struts,org.apache.struts2.interceptor.validation,0,0,0,0,0,0,1,1
apache_struts,org.apache.struts2,53,1,0,1,1,0,1,57
apache_struts,org.apache.struts2.result,3,0,0,0,1,3,1,8
apache_struts,org.apache.struts2.util,5,1,0,1,1,5,1,14
apache_struts,org.apache.struts2.util.fs,0,0,0,0,0,0,1,1
apache_struts,org.apache.struts2.util.tomcat.buf,0,0,0,0,0,0,1,1
apache_struts,org.apache.struts2.views,1,1,0,0,0,0,1,3
apache_struts,org.apache.struts2.views.freemarker,2,0,0,0,1,0,1,4
apache_struts,org.apache.struts2.views.freemarker.tags,0,0,0,1,1,0,1,3
apache_struts,org.apache.struts2.views.jsp,5,1,0,1,1,2,1,11
apache_struts,org.apache.struts2.views.jsp.iterator,0,0,0,0,0,2,1,3
apache_struts,org.apache.struts2.views.jsp.ui,7,1,0,1,1,0,1,11
apache_struts,org.apache.struts2.views.util,3,1,0,0,1,1,1,7
apache_struts,org.apache.struts2.views.velocity.components,0,0,0,1,1,0,1,3
apache_struts,org.apache.struts2.views.velocity,2,0,0,0,0,0,1,3
apache_struts,org.apache.struts2.views.xslt,0,0,0,0,1,0,1,2
apache_struts,com.opensymphony.xwork2.util.annotation,0,0,0,0,0,0,1,1
apache_struts,com.opensymphony.xwork2.util.annotation.pkg1,0,0,0,0,0,0,1,1
apache_struts,com.opensymphony.xwork2.util.annotation.pkg2,0,0,0,0,0,0,1,1
apache_struts,org.apache.struts2.async,0,0,0,0,0,0,1,1
apache_struts,org.apache.struts.beanvalidation.constraints.impl,0,0,0,0,0,0,1,1
apache_struts,org.apache.struts.beanvalidation.validation.constant,0,0,0,0,0,0,1,1
apache_struts,org.apache.struts.beanvalidation.validation.interceptor,0,0,0,0,0,0,1,1
apache_struts,org.apache.struts.beanvalidation.actions,0,0,0,0,1,0,1,2
apache_struts,org.apache.struts.beanvalidation,0,0,0,0,0,1,1,2
apache_struts,org.apache.struts.beanvalidation.models,0,0,0,0,1,0,1,2
apache_struts,org.apache.struts2.cdi,0,0,0,0,0,0,1,1
apache_struts,org.apache.struts2.config_browser,0,0,0,0,1,0,1,2
apache_struts,org.apache.struts2.convention,0,0,0,1,1,0,1,3
apache_struts,org.apache.struts2.convention.config.entities,0,0,0,0,0,0,1,1
apache_struts,org.apache.struts2.convention.actions.action,0,0,0,0,1,0,1,2
apache_struts,org.apache.struts2.convention.actions.allowedmethods,0,0,0,0,0,0,1,1
apache_struts,org.apache.struts2.convention.actions.allowedmethods.sub,0,0,0,0,0,0,1,1
apache_struts,org.apache.struts2.convention.actions.chain,0,0,0,0,0,0,1,1
apache_struts,org.apache.struts2.convention.actions.defaultinterceptor,0,0,0,0,0,0,1,1
apache_struts,org.apache.struts2.convention.actions,0,0,0,0,0,0,1,1
apache_struts,org.apache.struts2.convention.actions.exception,0,0,0,0,0,0,1,1
apache_struts,org.apache.struts2.convention.actions.exclude,0,0,0,0,0,0,1,1
apache_struts,org.apache.struts2.convention.actions.idx.idx2,0,0,0,0,0,0,1,1
apache_struts,org.apache.struts2.convention.actions.idx,0,0,0,0,0,0,1,1
apache_struts,org.apache.struts2.convention.actions.interceptor,0,0,0,0,0,0,1,1
apache_struts,org.apache.struts2.convention.actions.namespace,0,0,0,0,0,0,1,1
apache_struts,org.apache.struts2.convention.actions.namespace2,0,0,0,0,0,0,1,1
apache_struts,org.apache.struts2.convention.actions.namespace3,0,0,0,0,0,0,1,1
apache_struts,org.apache.struts2.convention.actions.namespace4,0,0,0,0,0,0,1,1
apache_struts,org.apache.struts2.convention.actions.params,0,0,0,0,0,0,1,1
apache_struts,org.apache.struts2.convention.actions.parentpackage,0,0,0,0,0,0,1,1
apache_struts,org.apache.struts2.convention.actions.parentpackage.sub,0,0,0,0,0,0,1,1
apache_struts,org.apache.struts2.convention.actions.result,0,0,0,0,1,0,1,2
apache_struts,org.apache.struts2.convention.actions.resultpath,0,0,0,0,0,0,1,1
apache_struts,org.apache.struts2.convention.actions.skip,0,0,0,0,0,0,1,1
apache_struts,org.apache.struts2.convention.actions.transactions,0,0,0,0,0,0,1,1
apache_struts,org.apache.struts2.convention.dontfind,0,0,0,0,0,0,1,1
apache_struts,org.apache.struts2.validators,0,0,0,0,0,0,1,1
apache_struts,org.apache.struts2.compiler,0,0,0,0,0,0,1,1
apache_struts,org.apache.struts2.el,0,0,0,0,0,0,1,1
apache_struts,org.apache.struts2.el.lang,1,0,0,0,1,0,1,3
apache_struts,org.apache.struts2.el.parser,0,0,0,1,0,0,1,2
apache_struts,org.apache.struts2.el.util,1,1,0,0,0,0,1,3
apache_struts,org.apache.struts2.jasper.compiler,9,1,0,1,1,0,1,13
apache_struts,org.apache.struts2.jasper.compiler.tagplugin,0,0,0,0,0,0,1,1
apache_struts,org.apache.struts2.jasper,8,1,0,0,1,0,1,11
apache_struts,org.apache.struts2.jasper.el,0,0,0,0,1,0,1,2
apache_struts,org.apache.struts2.jasper.runtime,6,0,0,0,1,0,1,8
apache_struts,org.apache.struts2.jasper.security,2,0,0,0,0,0,1,3
apache_struts,org.apache.struts2.jasper.servlet,0,0,0,0,0,0,1,1
apache_struts,org.apache.struts2.jasper.tagplugins.jstl.core,0,0,0,0,1,0,1,2
apache_struts,org.apache.struts2.jasper.tagplugins.jstl,0,0,0,0,0,0,1,1
apache_struts,org.apache.struts2.jasper.util,0,0,0,0,0,0,1,1
apache_struts,org.apache.struts2.jasper.xmlparser,6,0,0,0,1,0,1,8
apache_struts,org.apache.struts2.views.gxp,0,0,0,0,1,0,1,2
apache_struts,org.apache.struts2.views.jasperreports,0,0,0,0,1,1,1,3
apache_struts,org.apache.struts2.views.java,0,0,0,0,1,2,1,4
apache_struts,org.apache.struts2.views.java.simple,0,0,0,1,1,3,1,6
apache_struts,org.apache.struts2.json.bridge,0,0,0,0,0,0,1,1
apache_struts,org.apache.struts2.json.config.entities,0,0,0,0,0,0,1,1
apache_struts,org.apache.struts2.json,0,0,0,1,1,0,1,3
apache_struts,org.apache.struts2.json.rpc,0,0,0,0,0,0,1,1
apache_struts,org.apache.struts2.json.smd,0,0,0,0,0,0,1,1
apache_struts,actions,0,0,0,0,0,0,1,1
apache_struts,org.apache.struts2.session,0,0,0,0,0,0,1,1
apache_struts,org.apache.struts2.osgi.action,0,0,0,0,0,0,1,1
apache_struts,org.apache.struts2.osgi,1,0,0,0,1,0,1,3
apache_struts,org.apache.struts2.osgi.host,0,0,0,0,0,0,1,1
apache_struts,org.apache.struts2.osgi.interceptor,0,0,0,0,0,0,1,1
apache_struts,org.apache.struts2.osgi.loaders,1,1,0,0,0,0,1,3
apache_struts,org.apache.struts2.oval.interceptor,0,0,0,0,1,0,1,2
apache_struts,org.apache.struts2.oval.interceptor.domain,0,0,0,0,0,0,1,1
apache_struts,org.apache.struts2.plexus,0,0,0,0,0,0,1,1
apache_struts,org.apache.struts2.portlet.action,0,0,0,0,0,0,1,1
apache_struts,org.apache.struts2.portlet.context,3,0,0,0,0,0,1,4
apache_struts,org.apache.struts2.portlet.dispatcher,0,0,0,0,1,0,1,2
apache_struts,org.apache.struts2.portlet.interceptor,0,0,0,0,1,1,1,3
apache_struts,org.apache.struts2.portlet,1,1,0,0,1,0,1,4
apache_struts,org.apache.struts2.portlet.result,0,0,0,0,1,0,1,2
apache_struts,org.apache.struts2.portlet.servlet,0,0,0,0,1,0,1,2
apache_struts,org.apache.struts2.portlet.util,1,0,0,0,0,0,1,2
apache_struts,org.apache.struts2.views.tiles,0,0,0,0,0,0,1,1
apache_struts,org.apache.struts2.rest.config.entities,0,0,0,0,0,0,1,1
apache_struts,org.apache.struts2.rest,0,0,0,0,1,1,1,3
apache_struts,org.apache.struts2.rest.handler,0,0,0,0,1,0,1,2
apache_struts,org.apache.struts2.sitemesh,0,0,0,0,1,0,1,2
apache_struts,org.apache.struts2.spring,0,0,0,0,1,0,1,2
apache_struts,org.apache.struts2.spring.config.entities,0,0,0,0,0,0,1,1
apache_struts,org.apache.struts2.tiles,0,0,0,0,1,0,1,2
apache_struts-examples,(default package),0,0,0,0,0,0,0,0
apache_struts-examples,org.apache.struts_examples,0,0,0,0,0,0,0,0
apache_struts-examples,example.actions,0,0,0,0,0,0,0,0
apache_struts-examples,example.model,0,0,0,0,0,0,0,0
apache_struts-examples,org.apache.struts.edit.action,0,0,0,0,1,0,0,1
apache_struts-examples,org.apache.struts.edit.model,0,0,0,0,1,0,0,1
apache_struts-examples,org.apache.struts.edit.service,0,0,0,0,1,0,0,1
apache_struts-examples,example,0,0,0,0,0,0,0,0
apache_struts-examples,org.apache.struts.helloworld.action,0,0,0,0,1,0,0,1
apache_struts-examples,org.apache.struts.helloworld.model,0,0,0,0,1,0,0,1
apache_struts-examples,org.apache.struts.crud.action,0,0,0,0,0,1,0,1
apache_struts-examples,org.apache.struts.crud.dao,0,0,0,0,0,0,0,0
apache_struts-examples,org.apache.struts.crud.model,0,0,0,0,0,1,0,1
apache_struts-examples,org.apache.struts.crud.service,0,0,0,0,0,1,0,1
apache_struts-examples,org.apache.struts.register.action,0,0,0,0,1,0,0,1
apache_struts-examples,org.apache.struts.register.exceptions,0,0,0,0,0,0,0,0
apache_struts-examples,org.apache.struts.register.model,0,0,0,0,1,0,0,1
apache_struts-examples,org.apache.struts.example,0,0,0,0,1,0,0,1
apache_struts-examples,org.demo,0,0,0,0,1,0,0,1
apache_struts-examples,org.apache.struts.examples.mailreader2,0,0,0,0,1,0,0,1
apache_struts-examples,org.apache.struts.examples.mailreader2.dao,0,0,0,0,0,0,0,0
apache_struts-examples,org.apache.struts.examples.mailreader2.dao.impl,0,0,0,0,0,0,0,0
apache_struts-examples,org.apache.struts.examples.mailreader2.dao.impl.memory,0,0,0,0,0,0,0,0
apache_struts-examples,org.apache.struts2.portlet.example.eventing,0,0,0,0,0,0,0,0
apache_struts-examples,org.apache.struts2.portlet.example,0,0,0,0,1,0,0,1
apache_struts-examples,org.apache.struts2.portlet.example.fileupload,0,0,0,0,0,0,0,0
apache_struts-examples,org.apache.struts2.portlet.example.model,0,0,0,0,0,0,0,0
apache_struts-examples,org.apache.struts2.portlet.example.spring,0,0,0,0,0,0,0,0
apache_struts-examples,org.apache.examples.struts.actions.data,0,0,0,0,0,0,0,0
apache_struts-examples,org.apache.examples.struts.actions,0,0,0,0,0,0,0,0
apache_struts-examples,org.apache.examples.struts.interceptors,0,0,0,0,0,0,0,0
apache_struts-examples,org.apache.examples.struts.models,0,0,0,0,0,0,0,0
apache_struts-examples,org.apache.examples.struts.services,0,0,0,0,0,0,0,0
apache_struts-examples,org.apache.struts2.shiro.example.action,0,0,0,0,0,0,0,0
apache_struts-examples,org.apache.struts2.shiro.example.interceptor,0,0,0,0,0,0,0,0
apache_struts-examples,org.apache.struts_example,0,0,0,0,1,0,0,1
apache_struts-examples,org.demo.example,0,0,0,0,0,0,0,0
apache_struts-examples,org.apache.struts.model,0,0,0,0,0,0,0,0
apache_struts-examples,org.apache.strutsexamples.actions.admin,0,0,0,0,0,0,0,0
apache_struts-examples,org.apache.strutsexamples.actions,0,0,0,0,0,0,0,0
apache_struts-examples,org.apache.strutsexamples.web,0,0,0,0,0,0,0,0
apache_struts-examples,org.apache.struts.using_tags.helloworld.action,0,0,0,0,0,0,0,0
apache_struts-examples,org.apache.struts.using_tags.helloworld.model,0,0,0,0,0,0,0,0
apache_struts-examples,org.apache.struts.validation_messages,0,0,0,0,0,0,0,0
apache_struts-examples,org.apache.struts.tutorials.wildcardmethod.action,0,0,0,0,0,0,0,0
apache_struts-examples,org.apache.struts.tutorials.wildcardmethod.model,0,0,0,0,0,0,0,0
apache_struts-examples,org.apache.struts.tutorials.wildcardmethod.service,0,0,0,0,0,0,0,0
apache_struts-examples,org.apache.struts.form,0,0,0,0,0,0,0,0
apache_struts-examples,org.apache.struts.store,0,0,0,0,0,0,0,0
apache_tajo,org.apache.tajo.algebra,2,1,0,1,1,0,1,6
apache_tajo,org.apache.tajo.catalog,28,1,0,2,1,0,1,33
apache_tajo,org.apache.tajo.catalog.json,6,1,0,0,0,0,1,8
apache_tajo,org.apache.tajo.catalog.partition,0,0,0,0,0,0,1,1
apache_tajo,org.apache.tajo.catalog.statistics,0,0,0,0,1,0,1,2
apache_tajo,org.apache.tajo,90,1,0,2,0,1,1,95
apache_tajo,org.apache.tajo.function,4,0,0,0,1,0,1,6
apache_tajo,org.apache.tajo.catalog.proto,0,1,0,2,0,0,1,4
apache_tajo,org.apache.tajo.catalog.store,8,0,0,0,1,0,1,10
apache_tajo,org.apache.tajo.catalog.dictionary,0,0,0,0,1,0,1,2
apache_tajo,org.apache.tajo.catalog.store.object,0,0,0,0,0,0,1,1
apache_tajo,org.apache.tajo.cli.tools,2,0,0,0,1,0,1,4
apache_tajo,org.apache.tajo.cli.tsql,12,1,0,0,1,0,1,15
apache_tajo,org.apache.tajo.cli.tsql.commands,4,1,0,0,1,0,1,7
apache_tajo,org.apache.tajo.client,7,0,0,0,1,0,1,9
apache_tajo,org.apache.tajo.client.v2,0,0,0,0,1,0,1,2
apache_tajo,org.apache.tajo.client.v2.exception,0,0,0,0,0,0,1,1
apache_tajo,org.apache.tajo.jdbc,0,0,0,0,1,0,1,2
apache_tajo,org.apache.tajo.storage,16,1,0,1,1,0,1,20
apache_tajo,org.apache.tajo.ipc,5,0,0,2,1,0,1,9
apache_tajo,org.apache.tajo.client.v1.example,0,0,0,0,0,0,1,1
apache_tajo,org.apache.tajo.client.v2.example,0,0,0,0,0,0,1,1
apache_tajo,org.apache.tajo.auth,2,0,0,0,0,0,1,3
apache_tajo,org.apache.tajo.common,0,0,0,0,0,0,1,1
apache_tajo,org.apache.tajo.common.type,2,0,0,0,0,0,1,3
apache_tajo,org.apache.tajo.conf,15,1,0,0,0,0,1,17
apache_tajo,org.apache.tajo.datum,17,1,0,1,0,1,1,21
apache_tajo,org.apache.tajo.datum.protobuf,0,0,0,0,1,0,1,2
apache_tajo,org.apache.tajo.exception,10,0,0,1,1,0,1,13
apache_tajo,org.apache.tajo.ha,0,0,0,0,0,0,1,1
apache_tajo,org.apache.tajo.json,5,0,0,0,1,0,1,7
apache_tajo,org.apache.tajo.rule.base,0,0,0,0,0,0,1,1
apache_tajo,org.apache.tajo.rule,1,0,0,0,0,0,1,2
apache_tajo,org.apache.tajo.schema,6,1,0,0,1,0,1,9
apache_tajo,org.apache.tajo.service,3,0,0,0,1,0,1,5
apache_tajo,org.apache.tajo.tuple,0,0,0,0,0,0,1,1
apache_tajo,org.apache.tajo.tuple.memory,0,0,0,0,1,0,1,2
apache_tajo,org.apache.tajo.type,13,0,0,1,1,0,1,16
apache_tajo,org.apache.tajo.unit,0,0,0,0,0,0,1,1
apache_tajo,org.apache.tajo.util,56,1,0,1,1,2,1,62
apache_tajo,org.apache.tajo.util.datetime,9,1,0,0,1,1,1,13
apache_tajo,org.apache.tajo.util.graph,0,0,0,0,1,0,1,2
apache_tajo,org.apache.tajo.validation,0,0,0,0,0,0,1,1
apache_tajo,org.apache.hadoop.security.proto,0,0,0,0,0,0,1,1
apache_tajo,org.apache.hadoop.yarn.proto,0,0,0,2,0,0,1,3
apache_tajo,org.apache.tajo.error,0,0,0,0,0,0,1,1
apache_tajo,org.apache.tajo.rpc.protocolrecords,0,0,0,1,1,0,1,3
apache_tajo,org.apache.tajo.benchmark,4,1,0,0,0,0,1,6
apache_tajo,org.apache.tajo.engine.codegen,1,0,0,0,1,0,1,3
apache_tajo,org.apache.tajo.engine.exception,0,0,0,0,0,0,1,1
apache_tajo,org.apache.tajo.engine.function.builtin,1,0,0,1,1,0,1,4
apache_tajo,org.apache.tajo.engine.function.datetime,0,0,0,1,1,0,1,3
apache_tajo,org.apache.tajo.engine.function,4,1,0,0,1,0,1,7
apache_tajo,org.apache.tajo.engine.function.geoip,0,0,0,0,1,0,1,2
apache_tajo,org.apache.tajo.engine.function.hiveudf,1,0,0,0,0,0,1,2
apache_tajo,org.apache.tajo.engine.function.json,0,0,0,0,0,0,1,1
apache_tajo,org.apache.tajo.engine.function.math,0,0,0,0,1,0,1,2
apache_tajo,org.apache.tajo.engine.function.string,0,0,0,1,1,0,1,3
apache_tajo,org.apache.tajo.engine.function.window,0,0,0,0,1,0,1,2
apache_tajo,org.apache.tajo.engine.json,0,1,0,0,0,0,1,2
apache_tajo,org.apache.tajo.engine.planner.enforce,2,0,0,0,0,0,1,3
apache_tajo,org.apache.tajo.engine.planner.global.builder,0,0,0,0,0,0,1,1
apache_tajo,org.apache.tajo.engine.planner.global,31,1,0,0,1,0,1,34
apache_tajo,org.apache.tajo.engine.planner.global.rewriter,0,0,0,0,0,0,1,1
apache_tajo,org.apache.tajo.engine.planner.global.rewriter.rules,2,0,0,0,1,0,1,4
apache_tajo,org.apache.tajo.engine.planner,1,1,0,0,1,0,1,4
apache_tajo,org.apache.tajo.engine.planner.physical,0,0,0,1,1,0,1,3
apache_tajo,org.apache.tajo.engine.query,0,0,0,1,1,1,1,4
apache_tajo,org.apache.tajo.engine.utils,0,0,0,0,0,0,1,1
apache_tajo,org.apache.tajo.io,0,0,0,0,0,0,1,1
apache_tajo,org.apache.tajo.master.cluster,0,0,0,0,0,0,1,1
apache_tajo,org.apache.tajo.master.event,2,0,0,0,1,0,1,4
apache_tajo,org.apache.tajo.master.exec,0,0,0,0,1,0,1,2
apache_tajo,org.apache.tajo.master.exec.prehook,0,0,0,0,0,1,1,2
apache_tajo,org.apache.tajo.master,3,1,0,0,1,0,1,6
apache_tajo,org.apache.tajo.master.rm,0,0,0,0,1,0,1,2
apache_tajo,org.apache.tajo.master.rule,0,0,0,0,0,0,1,1
apache_tajo,org.apache.tajo.master.scheduler,0,0,0,0,1,0,1,2
apache_tajo,org.apache.tajo.master.scheduler.event,0,0,0,0,0,0,1,1
apache_tajo,org.apache.tajo.metrics,3,1,0,0,0,0,1,5
apache_tajo,org.apache.tajo.parser.sql,2,0,0,2,0,0,1,5
apache_tajo,org.apache.tajo.querymaster,9,1,0,1,1,0,1,13
apache_tajo,org.apache.tajo.resource,2,0,0,0,0,0,1,3
apache_tajo,org.apache.tajo.session,0,0,0,0,1,1,1,3
apache_tajo,org.apache.tajo.util.history,0,0,0,0,1,0,1,2
apache_tajo,org.apache.tajo.util.metrics,0,0,0,0,1,0,1,2
apache_tajo,org.apache.tajo.util.metrics.reporter,0,0,0,0,1,0,1,2
apache_tajo,org.apache.tajo.webapp,2,0,0,0,0,0,1,3
apache_tajo,org.apache.tajo.worker,28,1,0,1,1,0,1,32
apache_tajo,org.apache.tajo.worker.event,2,0,0,0,1,0,1,4
apache_tajo,org.apache.tajo.worker.rule,0,0,0,0,0,0,1,1
apache_tajo,org.apache.tajo.ws.rs,1,1,0,0,1,0,1,4
apache_tajo,org.apache.tajo.ws.rs.requests,0,0,0,0,0,1,1,2
apache_tajo,org.apache.tajo.ws.rs.resources,1,0,0,1,1,1,1,5
apache_tajo,org.apache.tajo.ws.rs.resources.outputs,0,0,0,0,0,0,1,1
apache_tajo,org.apache.tajo.ws.rs.responses,0,0,0,0,1,1,1,3
apache_tajo,org.apache.tajo.cluster,0,0,0,0,0,0,1,1
apache_tajo,org.apache.tajo.engine.eval,0,0,0,0,1,0,1,2
apache_tajo,org.apache.tajo.engine.util,0,0,0,0,0,0,1,1
apache_tajo,org.apache.tajo.engine.util.generated,0,0,0,0,0,0,1,1
apache_tajo,org.openjdk.jmh.infra.generated,0,0,0,0,0,0,1,1
apache_tajo,org.apache.tajo.jdbc.util,0,0,0,0,0,0,1,1
apache_tajo,org.apache.tajo.maven.plugin.protoc,0,0,0,0,0,0,1,1
apache_tajo,org.apache.tajo.maven.plugin.util,0,0,0,0,0,0,1,1
apache_tajo,org.apache.tajo.maven.plugin.versioninfo,0,0,0,0,0,0,1,1
apache_tajo,org.apache.tajo.plan.algebra,0,0,0,0,0,0,1,1
apache_tajo,org.apache.tajo.plan.expr,9,1,0,1,1,0,1,13
apache_tajo,org.apache.tajo.plan,16,1,0,0,1,1,1,20
apache_tajo,org.apache.tajo.plan.exprrewrite,0,0,0,0,0,0,1,1
apache_tajo,org.apache.tajo.plan.exprrewrite.rules,0,0,0,0,0,0,1,1
apache_tajo,org.apache.tajo.plan.function,7,0,0,0,1,0,1,9
apache_tajo,org.apache.tajo.plan.function.python,2,0,0,0,0,0,1,3
apache_tajo,org.apache.tajo.plan.function.stream,0,0,0,0,1,0,1,2
apache_tajo,org.apache.tajo.plan.joinorder,0,0,0,0,1,0,1,2
apache_tajo,org.apache.tajo.plan.logical,5,0,0,1,1,1,1,9
apache_tajo,org.apache.tajo.plan.nameresolver,3,0,0,0,0,0,1,4
apache_tajo,org.apache.tajo.plan.rewrite,5,0,0,0,1,0,1,7
apache_tajo,org.apache.tajo.plan.rewrite.rules,3,0,0,0,1,0,1,5
apache_tajo,org.apache.tajo.plan.serder,11,1,0,2,0,0,1,15
apache_tajo,org.apache.tajo.plan.util,8,1,0,0,1,0,1,11
apache_tajo,org.apache.tajo.plan.verifier,6,0,0,0,1,0,1,8
apache_tajo,org.apache.tajo.plan.visitor,3,0,0,0,1,0,1,5
apache_tajo,org.apache.tajo.pullserver,3,1,0,0,1,0,1,6
apache_tajo,org.apache.tajo.pullserver.retriever,2,0,0,0,1,0,1,4
apache_tajo,org.apache.tajo.rpc,0,0,0,1,1,0,1,3
apache_tajo,org.apache.tajo.ws.rs.netty.gson,0,0,0,0,0,0,1,1
apache_tajo,org.apache.tajo.ws.rs.netty,0,0,0,0,1,0,1,2
apache_tajo,org.apache.tajo.storage.compress,0,0,0,0,0,0,1,1
apache_tajo,org.apache.tajo.storage.exception,0,0,0,0,0,0,1,1
apache_tajo,org.apache.tajo.storage.fragment,2,1,0,0,1,0,1,5
apache_tajo,org.apache.tajo.index,0,0,0,0,0,0,1,1
apache_tajo,org.apache.tajo.storage.hbase,0,0,0,0,1,0,1,2
apache_tajo,org.apache.tajo.storage.avro,0,0,0,0,0,0,1,1
apache_tajo,org.apache.tajo.storage.index.bst,1,0,0,0,0,0,1,2
apache_tajo,org.apache.tajo.storage.index,0,0,0,0,1,0,1,2
apache_tajo,org.apache.tajo.storage.json,0,0,0,0,0,0,1,1
apache_tajo,org.apache.tajo.storage.orc,1,0,0,0,0,0,1,2
apache_tajo,org.apache.tajo.storage.parquet,0,0,0,0,1,0,1,2
apache_tajo,org.apache.tajo.storage.rawfile,0,0,0,0,0,0,1,1
apache_tajo,org.apache.tajo.storage.rcfile,2,0,0,0,1,0,1,4
apache_tajo,org.apache.tajo.storage.regex,0,0,0,0,0,0,1,1
apache_tajo,org.apache.tajo.storage.sequencefile,0,0,0,0,0,0,1,1
apache_tajo,org.apache.tajo.storage.text,2,0,0,0,1,0,1,4
apache_tajo,org.apache.tajo.storage.thirdparty.orc,1,1,0,1,1,0,1,5
apache_tajo,org.apache.tajo.storage.thirdparty.orc.util,0,0,0,0,0,0,1,1
apache_tajo,org.apache.tajo.storage.thirdparty.parquet,0,0,0,0,0,0,1,1
apache_tajo,org.apache.tajo.storage.raw,0,0,0,0,0,0,1,1
apache_tajo,org.apache.tajo.storage.jdbc,0,0,0,0,1,0,1,2
apache_tajo,org.apache.tajo.storage.kafka,0,0,0,0,1,0,1,2
apache_tajo,org.apache.tajo.storage.kafka.server,0,0,0,0,0,0,1,1
apache_tajo,org.apache.tajo.storage.pgsql,0,0,0,0,1,0,1,2
apache_tajo,org.apache.tajo.storage.s3,0,0,0,0,1,0,1,2
apache_tajo,org.apache.tajo.storage.http,0,0,0,0,1,0,1,2
apache_tajo,org.apache.tajo.org.objectweb.asm,0,0,0,0,0,1,1,2
apache_tajo,org.apache.tajo.org.objectweb.asm.commons,0,0,0,0,1,0,1,2
apache_tajo,org.apache.tajo.org.objectweb.asm.optimizer,0,0,0,0,1,0,1,2
apache_tajo,org.apache.tajo.org.objectweb.asm.signature,0,0,0,0,0,0,1,1
apache_tajo,org.apache.tajo.org.objectweb.asm.tree,0,0,0,0,0,1,1,2
apache_tajo,org.apache.tajo.org.objectweb.asm.tree.analysis,0,0,0,0,0,1,1,2
apache_tajo,org.apache.tajo.org.objectweb.asm.util,0,0,0,0,1,0,1,2
apache_tajo,org.apache.tajo.org.objectweb.asm.xml,0,0,0,1,0,0,1,2
apache_tajo,org.apache.tajo.yarn,0,0,0,0,1,0,1,2
apache_uima-uimafit,org.apache.uima.fit.benchmark,0,0,0,0,1,0,0,1
apache_uima-uimafit,org.apache.uima.fit.type,0,0,0,0,1,0,0,1
apache_uima-uimafit,org.apache.uima.fit.component,8,1,0,1,1,0,0,11
apache_uima-uimafit,org.apache.uima.fit.component.initialize,7,1,0,0,1,0,0,9
apache_uima-uimafit,org.apache.uima.fit.descriptor,0,0,0,0,0,0,0,0
apache_uima-uimafit,org.apache.uima.fit.factory,12,0,0,1,1,0,0,14
apache_uima-uimafit,org.apache.uima.fit.factory.initializable,0,0,0,0,1,0,0,1
apache_uima-uimafit,org.apache.uima.fit.factory.locator,0,0,0,0,0,0,0,0
apache_uima-uimafit,org.apache.uima.fit.internal,0,0,0,0,1,0,0,1
apache_uima-uimafit,org.apache.uima.fit.internal.propertyeditors,2,0,0,0,0,0,0,2
apache_uima-uimafit,org.apache.uima.fit.pipeline,4,0,0,0,1,0,0,5
apache_uima-uimafit,org.apache.uima.fit.util,7,1,0,1,1,0,0,10
apache_uima-uimafit,(default package),0,0,0,0,1,0,0,1
apache_uima-uimafit,org.apache.uima.fit,0,0,0,0,0,0,0,0
apache_uima-uimafit,org.apache.uima.fit.data,0,0,0,0,0,0,0,0
apache_uima-uimafit,org.apache.uima.fit.cpe,0,0,0,0,1,0,0,1
apache_uima-uimafit,org.apache.uima.fit.examples.experiment.pos,0,0,0,0,0,0,0,0
apache_uima-uimafit,org.apache.uima.fit.examples.getstarted,0,0,0,0,0,0,0,0
apache_uima-uimafit,org.apache.uima.fit.examples.resource,0,0,0,0,1,0,0,1
apache_uima-uimafit,org.apache.uima.fit.examples.tutorial.ex1,0,0,0,0,0,0,0,0
apache_uima-uimafit,org.apache.uima.fit.examples.tutorial.ex2,0,0,0,0,0,0,0,0
apache_uima-uimafit,org.apache.uima.fit.examples.tutorial.ex6,0,0,0,0,0,0,0,0
apache_uima-uimafit,org.apache.uima.fit.examples.tutorial,0,0,0,0,0,0,0,0
apache_uima-uimafit,org.apache.uima.fit.examples.xmi,0,0,0,0,0,0,0,0
apache_uima-uimafit,org.apache.uima.fit.examples.tutorial.type,0,0,0,0,1,0,0,1
apache_uima-uimafit,org.apache.uima.fit.examples.type,0,0,0,0,0,0,0,0
apache_uima-uimafit,org.apache.uima.fit.legacy,0,0,0,0,0,0,0,0
apache_uima-uimafit,org.apache.uima.fit.legacy.converter,0,0,0,0,1,0,0,1
apache_uima-uimafit,org.apache.uima.fit.maven,0,0,0,0,0,0,0,0
apache_uima-uimafit,org.apache.uima.fit.maven.util,0,0,0,0,0,0,0,0
apache_uima-uimafit,org.apache.uima.fit.maven.javadoc,0,0,0,0,0,0,0,0
apache_uima-uimafit,org.apache.uima.fit.spring.factory,0,0,0,0,0,0,0,0
apache_uima-uimafit,org.apache.uima.fit.spring,0,0,0,0,0,0,0,0
apache_uima-uimafit,org.apache.uima.fit.spring.util,0,0,0,0,0,0,0,0
Appendium_flatpack,net.sf.flatpack,4,1,0,0,0,4,0,9
Appendium_flatpack,net.sf.flatpack.brparse,2,0,0,0,1,2,0,5
Appendium_flatpack,net.sf.flatpack.converter,1,0,0,0,0,0,0,1
Appendium_flatpack,net.sf.flatpack.ordering,0,0,0,0,0,0,0,0
Appendium_flatpack,net.sf.flatpack.structure,0,0,0,0,0,3,0,3
Appendium_flatpack,net.sf.flatpack.util,4,1,0,0,1,1,0,7
Appendium_flatpack,net.sf.flatpack.writer,0,0,0,0,0,0,0,0
Appendium_flatpack,net.sf.flatpack.xml,4,0,0,0,0,1,0,5
Appendium_flatpack,net.sf.flatpack.columninfile,0,0,0,0,0,0,0,0
Appendium_flatpack,net.sf.flatpack.delim.tab,0,0,0,0,0,0,0,0
Appendium_flatpack,net.sf.flatpack.parserutils,0,0,0,0,0,0,0,0
Appendium_flatpack,net.sf.flatpack.pzparser,0,0,0,0,0,1,0,1
Appendium_flatpack,net.sf.flatpack.rfc4180,0,0,0,0,0,0,0,0
Appendium_flatpack,net.sf.flatpack.utilities,0,0,0,0,0,0,0,0
Appendium_flatpack,net.sf.flatpack.excel,0,0,0,0,0,0,0,0
Appendium_flatpack,net.sf.flatpack.examples.csvheaderandtrailer,0,0,0,0,0,0,0,0
Appendium_flatpack,net.sf.flatpack.examples.delimitedcolumnnamesinfile,0,0,0,0,0,0,0,0
Appendium_flatpack,net.sf.flatpack.examples.delimiteddynamiccolumns,0,0,0,0,0,0,0,0
Appendium_flatpack,net.sf.flatpack.examples.delimiteddynamiccolumnswitherrors,0,0,0,0,0,0,0,0
Appendium_flatpack,net.sf.flatpack.examples,0,0,0,0,0,0,0,0
Appendium_flatpack,net.sf.flatpack.examples.exporttoexcel,0,0,0,0,0,0,0,0
Appendium_flatpack,net.sf.flatpack.examples.fixedlengthdynamiccolumns,0,0,0,0,0,0,0,0
Appendium_flatpack,net.sf.flatpack.examples.fixedlengthheaderandtrailer,0,0,0,0,0,0,0,0
Appendium_flatpack,net.sf.flatpack.examples.largedataset.delimiteddynamiccolumns,0,1,0,0,0,0,0,1
Appendium_flatpack,net.sf.flatpack.examples.largedataset.fixedlengthdynamiccolumns,0,1,0,0,0,0,0,1
Appendium_flatpack,net.sf.flatpack.examples.lowlevelparse,0,0,0,0,0,0,0,0
Appendium_flatpack,net.sf.flatpack.examples.multilinedelimitedrecord,0,0,0,0,0,0,0,0
Appendium_flatpack,net.sf.flatpack.examples.numericsanddates,0,0,0,0,0,0,0,0
Appendium_objectlabkit,net.objectlab.kit.datecalc.common,1,1,0,1,0,0,0,3
Appendium_objectlabkit,net.objectlab.kit.datecalc.common.ccy,1,0,0,0,0,0,0,1
Appendium_objectlabkit,net.objectlab.kit.datecalc.jdk,0,0,0,1,0,0,0,1
Appendium_objectlabkit,net.objectlab.kit.datecalc.jdk.perf,0,0,0,0,0,0,0,0
Appendium_objectlabkit,net.objectlab.kit.datecalc.jdk8,0,0,0,0,0,0,0,0
Appendium_objectlabkit,net.objectlab.kit.datecalc.jdk8.perf,0,0,0,0,0,0,0,0
Appendium_objectlabkit,net.objectlab.kit.datecalc.joda,0,0,0,0,1,0,0,1
Appendium_objectlabkit,net.objectlab.kit.datecalc.gist,0,0,0,0,0,0,0,0
Appendium_objectlabkit,net.objectlab.kit.datecalc.joda.perf,0,0,0,0,0,0,0,0
Appendium_objectlabkit,net.objectlab.kit.fxcalc,0,0,0,0,0,0,0,0
Appendium_objectlabkit,net.objectlab.kit.fxcalc.gist,0,0,0,0,0,0,0,0
Appendium_objectlabkit,net.objectlab.kit.pf,0,0,0,0,1,0,0,1
Appendium_objectlabkit,net.objectlab.kit.pf.ucits,0,0,0,0,1,0,0,1
Appendium_objectlabkit,net.objectlab.kit.pf.validator,0,0,0,0,0,0,0,0
Appendium_objectlabkit,net.objectlab.kit.pf.cuke,0,0,0,0,0,0,0,0
Appendium_objectlabkit,net.objectlab.kit.report,0,0,0,0,0,0,0,0
Appendium_objectlabkit,net.objectlab.kit.report.gist,0,0,0,0,0,0,0,0
Appendium_objectlabkit,net.objectlab.kit.collections,0,0,0,0,0,0,0,0
Appendium_objectlabkit,net.objectlab.kit.console,0,0,0,0,0,0,0,0
Appendium_objectlabkit,net.objectlab.kit.util,0,0,0,1,1,0,0,2
Appendium_objectlabkit,net.objectlab.kit.util.predicate,0,0,0,0,0,0,0,0
Appendium_objectlabkit,net.objectlab.kit.util.example,0,0,0,0,0,0,0,0
Appendium_objectlabkit,net.objectlab.kit.util.excel,0,0,0,0,1,0,0,1
Appendium_objectlabkit,net.objectlab.kit.util.excel.gist,0,0,0,0,0,0,0,0
appium_java-client,io.appium.java_client.android,3,0,0,1,0,0,0,4
appium_java-client,io.appium.java_client.android.appmanagement,0,0,0,0,0,0,0,0
appium_java-client,io.appium.java_client.android.connection,1,0,0,0,0,0,0,1
appium_java-client,io.appium.java_client.android.nativekey,0,0,0,0,0,0,0,0
appium_java-client,io.appium.java_client,4,1,0,1,0,0,0,6
appium_java-client,io.appium.java_client.appmanagement,0,0,1,0,0,0,0,1
appium_java-client,io.appium.java_client.battery,0,0,0,0,0,0,0,0
appium_java-client,io.appium.java_client.clipboard,0,0,0,0,0,0,0,0
appium_java-client,io.appium.java_client.driverscripts,0,0,0,0,0,0,0,0
appium_java-client,io.appium.java_client.events.api.general,0,0,0,0,1,0,0,1
appium_java-client,io.appium.java_client.events.api,0,0,0,0,0,0,0,0
appium_java-client,io.appium.java_client.events.api.mobile,0,0,0,0,0,0,0,0
appium_java-client,io.appium.java_client.events,0,0,0,0,0,0,0,0
appium_java-client,io.appium.java_client.functions,0,0,0,0,0,0,0,0
appium_java-client,io.appium.java_client.imagecomparison,0,0,0,0,1,0,0,1
appium_java-client,io.appium.java_client.internal,0,0,0,0,0,0,0,0
appium_java-client,io.appium.java_client.ios,2,0,0,1,0,0,0,3
appium_java-client,io.appium.java_client.ios.touch,0,0,0,0,0,0,0,0
appium_java-client,io.appium.java_client.pagefactory,0,0,0,0,1,0,0,1
appium_java-client,io.appium.java_client.pagefactory.bys.builder,0,0,0,0,0,0,0,0
appium_java-client,io.appium.java_client.pagefactory.bys,0,0,0,0,0,0,0,0
appium_java-client,io.appium.java_client.pagefactory.interceptors,0,0,0,0,0,0,0,0
appium_java-client,io.appium.java_client.pagefactory.locator,0,0,0,0,0,0,0,0
appium_java-client,io.appium.java_client.pagefactory.utils,0,0,0,0,0,0,0,0
appium_java-client,io.appium.java_client.remote,0,0,0,0,1,0,0,1
appium_java-client,io.appium.java_client.screenrecording,1,0,0,0,0,0,0,1
appium_java-client,io.appium.java_client.serverevents,0,0,0,0,0,0,0,0
appium_java-client,io.appium.java_client.service.local,5,1,0,0,0,0,0,6
appium_java-client,io.appium.java_client.service.local.flags,0,0,0,0,0,0,0,0
appium_java-client,io.appium.java_client.touch,0,0,0,0,1,0,0,1
appium_java-client,io.appium.java_client.touch.offset,0,0,0,0,0,0,0,0
appium_java-client,io.appium.java_client.windows,0,0,0,0,0,0,0,0
appium_java-client,io.appium.java_client.ws,0,0,0,0,0,0,0,0
appium_java-client,org.openqa.selenium.internal,0,0,0,0,1,0,0,1
appium_java-client,org.openqa.selenium,0,0,0,0,1,0,0,1
appium_java-client,io.appium.java_client.appium,0,0,0,0,0,0,0,0
appium_java-client,io.appium.java_client.appium.element.generation.android,0,0,0,0,0,0,0,0
appium_java-client,io.appium.java_client.appium.element.generation,0,0,0,0,0,0,0,0
appium_java-client,io.appium.java_client.appium.element.generation.ios,0,0,0,0,0,0,0,0
appium_java-client,io.appium.java_client.events.listeners,0,0,0,0,0,0,0,0
arangodb_arangodb-java-driver,com.arangodb,17,1,0,1,1,8,1,29
arangodb_arangodb-java-driver,com.arangodb.async,0,0,0,0,1,3,1,5
arangodb_arangodb-java-driver,com.arangodb.async.internal,0,0,0,0,1,1,1,3
arangodb_arangodb-java-driver,com.arangodb.async.internal.velocystream,0,0,0,0,0,0,1,1
arangodb_arangodb-java-driver,com.arangodb.entity,4,1,0,1,0,9,1,16
arangodb_arangodb-java-driver,com.arangodb.entity.arangosearch,0,0,0,0,1,4,1,6
arangodb_arangodb-java-driver,com.arangodb.internal,18,1,0,1,1,1,1,23
arangodb_arangodb-java-driver,com.arangodb.internal.cursor,0,0,0,0,1,0,1,2
arangodb_arangodb-java-driver,com.arangodb.internal.http,4,0,0,0,1,0,1,6
arangodb_arangodb-java-driver,com.arangodb.internal.net,2,1,0,0,1,0,1,5
arangodb_arangodb-java-driver,com.arangodb.internal.util,13,1,0,0,1,0,1,16
arangodb_arangodb-java-driver,com.arangodb.internal.velocypack,4,0,0,0,0,0,1,5
arangodb_arangodb-java-driver,com.arangodb.internal.velocystream.internal,6,1,0,0,1,0,1,9
arangodb_arangodb-java-driver,com.arangodb.internal.velocystream,8,1,0,0,1,0,1,11
arangodb_arangodb-java-driver,com.arangodb.model,2,0,0,1,1,5,1,10
arangodb_arangodb-java-driver,com.arangodb.model.arangosearch,0,0,0,0,0,3,1,4
arangodb_arangodb-java-driver,com.arangodb.util,8,1,0,0,1,1,1,12
arangodb_arangodb-java-driver,com.arangodb.velocystream,0,0,0,0,0,0,1,1
arangodb_arangodb-java-driver,com.arangodb.async.debug,0,0,0,0,0,0,1,1
arangodb_arangodb-java-driver,com.arangodb.async.example.document,0,0,0,0,0,0,1,1
arangodb_arangodb-java-driver,com.arangodb.async.example,0,0,0,0,0,0,1,1
arangodb_arangodb-java-driver,com.arangodb.async.example.graph,0,0,0,0,1,0,1,2
arangodb_arangodb-java-driver,com.arangodb.async.example.ssl,0,0,0,0,0,0,1,1
arangodb_arangodb-java-driver,com.arangodb.async.example.velocypack,0,0,0,0,0,0,1,1
arangodb_arangodb-java-driver,com.arangodb.async.serde,0,0,0,0,0,1,1,2
arangodb_arangodb-java-driver,com.arangodb.example.document,0,0,0,0,0,0,1,1
arangodb_arangodb-java-driver,com.arangodb.example,0,0,0,0,0,0,1,1
arangodb_arangodb-java-driver,com.arangodb.example.graph,0,0,0,0,1,0,1,2
arangodb_arangodb-java-driver,com.arangodb.example.ssl,0,0,0,0,0,0,1,1
arangodb_arangodb-java-driver,com.arangodb.example.velocypack,0,0,0,0,0,0,1,1
arangodb_arangodb-java-driver,com.arangodb.serde,0,0,0,0,0,2,1,3
arangodb_arangodb-java-driver,perf,0,0,0,0,0,0,1,1
ArcBees_gwtquery-draggable-plugin,gwtquery.plugins.draggable.client,0,0,0,1,1,0,0,2
ArcBees_gwtquery-draggable-plugin,gwtquery.plugins.draggable.client.events,1,1,0,1,1,0,0,4
ArcBees_gwtquery-draggable-plugin,gwtquery.plugins.draggable.client.gwt,1,0,0,0,0,0,0,1
ArcBees_gwtquery-draggable-plugin,gwtquery.plugins.draggable.client.impl,0,0,0,0,1,0,0,1
ArcBees_gwtquery-draggable-plugin,gwtquery.plugins.draggable.client.plugins,0,0,0,0,1,0,0,1
ArcBees_gwtquery-draggable-plugin,com.google.gwt.i18n.client.constants,0,0,0,0,0,0,0,0
ArcBees_gwtquery-draggable-plugin,com.google.gwt.i18n.client.impl,0,0,0,0,0,0,0,0
ArcBees_gwtquery-draggable-plugin,com.google.gwt.lang,0,0,0,0,1,0,0,1
ArcBees_gwtquery-draggable-plugin,com.google.gwt.query.client,0,0,0,0,0,0,0,0
ArcBees_gwtquery-draggable-plugin,com.google.gwt.user.client,0,0,0,0,0,0,0,0
ArcBees_gwtquery-draggable-plugin,com.google.gwt.user.client.impl,0,0,0,0,0,0,0,0
ArcBees_gwtquery-draggable-plugin,com.google.gwt.user.client.ui.impl,0,0,0,0,0,0,0,0
ArcBees_gwtquery-draggable-plugin,com.google.gwt.user.client.ui,0,0,0,0,1,0,0,1
ArcBees_gwtquery-draggable-plugin,com.google.gwt.useragent.client,0,0,0,0,0,0,0,0
ArcBees_gwtquery-tooltip-plugin,com.arcbees.gquery.tooltip.client.event,0,0,0,0,1,0,0,1
ArcBees_gwtquery-tooltip-plugin,com.arcbees.gquery.tooltip.client,1,0,0,1,1,0,0,3
ArcBees_gwtquery-tooltip-plugin,com.arcbees.gquery.tooltip.client.contactcell,1,1,0,0,1,0,0,3
ArcBees_gwtquery-tooltip-plugin,com.arcbees.gquery.tooltip.client.resource,0,0,0,0,0,0,0,0
ArcBees_gwtquery-tooltip-plugin,com.arcbees.gquery.tooltip.client.widget,0,0,0,0,0,0,0,0
ArcBees_gwtquery-tooltip-plugin,com.google.gwt.i18n.client.constants,0,0,0,0,0,0,0,0
ArcBees_gwtquery-tooltip-plugin,com.google.gwt.i18n.client.impl,0,0,0,0,0,0,0,0
ArcBees_gwtquery-tooltip-plugin,com.google.gwt.query.client,0,0,0,0,0,0,0,0
ArcBees_gwtquery-tooltip-plugin,com.google.gwt.user.cellview.client,0,0,0,0,1,0,0,1
ArcBees_gwtquery-tooltip-plugin,com.google.gwt.user.client,0,0,0,0,0,0,0,0
ArcBees_gwtquery-tooltip-plugin,com.google.gwt.user.client.impl,0,0,0,0,0,0,0,0
ArcBees_gwtquery-tooltip-plugin,com.google.gwt.user.client.ui.impl,0,0,0,0,0,0,0,0
ArcBees_gwtquery-tooltip-plugin,com.google.gwt.useragent.client,0,0,0,0,0,0,0,0
Archarithms_bigio,io.bigio.agent,0,0,0,0,0,0,0,0
Archarithms_bigio,io.bigio.benchmark,0,0,0,0,0,0,0,0
Archarithms_bigio,io.bigio.benchmark.latency,0,0,0,0,0,0,0,0
Archarithms_bigio,io.bigio.benchmark.pingpong,0,0,0,0,0,0,0,0
Archarithms_bigio,io.bigio.benchmark.throughput,0,0,0,0,1,0,0,1
Archarithms_bigio,io.bigio,0,1,0,1,1,0,0,3
Archarithms_bigio,io.bigio.cli,0,0,0,0,1,1,0,2
Archarithms_bigio,io.bigio.core,2,0,0,0,1,1,0,4
Archarithms_bigio,io.bigio.core.codec,2,1,0,0,0,0,0,3
Archarithms_bigio,io.bigio.core.member,1,0,0,0,1,1,0,3
Archarithms_bigio,io.bigio.util,0,0,0,0,0,0,0,0
Archarithms_bigio,io.bigio.container,0,0,0,0,0,0,0,0
Archarithms_bigio,io.bigio.examples.cli,0,0,0,0,0,0,0,0
Archarithms_bigio,io.bigio.examples.helloworld,0,0,0,0,0,0,0,0
arnohaase_a-base,com.ajjpj.afoundation.collection,1,0,0,0,0,0,0,1
arnohaase_a-base,com.ajjpj.afoundation.collection.graph,0,0,0,0,0,0,0,0
arnohaase_a-base,com.ajjpj.afoundation.collection.immutable,2,1,0,1,0,0,0,4
arnohaase_a-base,com.ajjpj.afoundation.collection.tuples,0,0,0,0,0,0,0,0
arnohaase_a-base,com.ajjpj.afoundation.concurrent,1,0,0,1,0,0,0,2
arnohaase_a-base,com.ajjpj.afoundation.function,0,0,0,0,1,0,0,1
arnohaase_a-base,com.ajjpj.afoundation.io,0,0,0,0,0,0,0,0
arnohaase_a-base,com.ajjpj.afoundation.proc,0,0,0,0,0,0,0,0
arnohaase_a-base,com.ajjpj.afoundation.util,0,0,0,0,1,0,0,1
arnohaase_a-base,com.ajjpj.afoundation.concurrent.jdk.j8old,0,0,0,0,0,0,0,0
arnohaase_a-base,com.ajjpj.afoundation.concurrent.jdk.j9new,0,1,0,0,0,0,0,1
arnohaase_a-base,com.ajjpj.afoundation.concurrent.jdk.j9old,0,0,0,0,0,0,0,0
arnohaase_a-base,com.ajjpj.afoundation.concurrent.jdk,0,0,0,0,0,0,0,0
arquillian_arquillian-cube,org.arquillian.cube,0,0,0,0,1,0,0,1
arquillian_arquillian-cube,org.arquillian.cube.containerobject,0,0,0,0,1,0,0,1
arquillian_arquillian-cube,org.arquillian.cube.impl.containerless,0,0,0,0,1,0,0,1
arquillian_arquillian-cube,org.arquillian.cube.impl.client,0,0,0,0,1,1,0,2
arquillian_arquillian-cube,org.arquillian.cube.impl.client.container,0,0,0,0,1,0,0,1
arquillian_arquillian-cube,org.arquillian.cube.impl.client.container.remote.command,0,0,0,0,0,0,0,0
arquillian_arquillian-cube,org.arquillian.cube.impl.client.container.remote,0,0,0,0,0,0,0,0
arquillian_arquillian-cube,org.arquillian.cube.impl.client.enricher,0,0,0,0,1,0,0,1
arquillian_arquillian-cube,org.arquillian.cube.impl,0,0,0,0,0,0,0,0
arquillian_arquillian-cube,org.arquillian.cube.impl.model,0,0,0,0,1,0,0,1
arquillian_arquillian-cube,org.arquillian.cube.impl.reporter,0,0,0,0,0,0,0,0
arquillian_arquillian-cube,org.arquillian.cube.impl.shrinkwrap.asset,0,0,0,0,0,0,0,0
arquillian_arquillian-cube,org.arquillian.cube.impl.util,0,0,0,0,1,2,0,3
arquillian_arquillian-cube,com.github.dockerjava.assertions,0,0,0,0,1,0,0,1
arquillian_arquillian-cube,com.github.dockerjava,0,0,0,0,0,0,0,0
arquillian_arquillian-cube,org.arquillian.cube.docker.impl.afterStart,2,0,0,0,0,0,0,2
arquillian_arquillian-cube,org.arquillian.cube.docker.impl.await,9,0,0,0,1,0,0,10
arquillian_arquillian-cube,org.arquillian.cube.docker.impl.beforeStop,2,0,0,0,0,0,0,2
arquillian_arquillian-cube,org.arquillian.cube.docker.impl.client,22,1,0,1,1,3,0,28
arquillian_arquillian-cube,org.arquillian.cube.docker.impl.client.config,4,1,0,0,1,2,0,8
arquillian_arquillian-cube,org.arquillian.cube.docker.impl.client.container,2,0,0,0,0,0,0,2
arquillian_arquillian-cube,org.arquillian.cube.docker.impl.client.containerobject,3,0,0,1,1,0,0,5
arquillian_arquillian-cube,org.arquillian.cube.docker.impl.client.containerobject.dsl,3,0,0,0,1,0,0,4
arquillian_arquillian-cube,org.arquillian.cube.docker.impl.client.enricher,0,0,0,0,0,0,0,0
arquillian_arquillian-cube,org.arquillian.cube.docker.impl.client.metadata,0,0,0,0,1,0,0,1
arquillian_arquillian-cube,org.arquillian.cube.docker.impl.docker.compose,3,0,0,0,0,1,0,4
arquillian_arquillian-cube,org.arquillian.cube.docker.impl.docker.cube,1,0,0,0,0,1,0,2
arquillian_arquillian-cube,org.arquillian.cube.docker.impl.docker,15,1,0,0,0,0,0,16
arquillian_arquillian-cube,org.arquillian.cube.docker.impl.model,7,1,0,0,1,0,0,9
arquillian_arquillian-cube,org.arquillian.cube.docker.impl.reporter,0,0,0,0,0,0,0,0
arquillian_arquillian-cube,org.arquillian.cube.docker.impl.requirement,0,0,0,0,0,0,0,0
arquillian_arquillian-cube,org.arquillian.cube.docker.impl.util,20,1,0,1,1,1,0,24
arquillian_arquillian-cube,org.arquillian.cube.docker.drone,0,0,0,0,0,0,0,0
arquillian_arquillian-cube,org.arquillian.cube.docker.drone.event,0,0,0,0,0,0,0,0
arquillian_arquillian-cube,org.arquillian.cube.docker.drone.util,0,0,0,0,0,0,0,0
arquillian_arquillian-cube,org.arquillian.cube.docker.graphene.location,0,0,0,0,0,0,0,0
arquillian_arquillian-cube,org.jboss.arquillian.drone.webdriver.factory,0,0,0,0,0,0,0,0
arquillian_arquillian-cube,org.arquillian.cube.persistence,0,0,0,0,1,0,0,1
arquillian_arquillian-cube,org.arquillian.cube.servlet,0,0,0,0,1,0,0,1
arquillian_arquillian-cube,org.arquillian.cube.git,0,0,0,0,0,0,0,0
arquillian_arquillian-cube,org.arquillian.cube.containerobject.dsl,0,0,0,0,0,0,0,0
arquillian_arquillian-cube,org.arquillian.cube.docker.junit.rule,0,0,0,0,0,0,0,0
arquillian_arquillian-cube,org.arquillian.cube.docker.junit5,0,0,0,0,1,0,0,1
arquillian_arquillian-cube,org.arquillian.cube.drone,0,0,0,0,1,0,0,1
arquillian_arquillian-cube,org.arquillian.cube.restassured,0,0,0,0,0,0,0,0
arquillian_arquillian-cube,org.arquillian.cube.docker.systemproperties,0,0,0,0,0,0,0,0
arquillian_arquillian-cube,org.arquillian.cube.docker.junit,0,1,0,0,0,0,0,1
arquillian_arquillian-cube,org.arquillian.cube.docker.impl.client.reporter,0,0,0,0,1,0,0,1
arquillian_arquillian-cube,org.arquillian.cube.docker.impl.client.utils,0,0,0,0,0,0,0,0
arquillian_arquillian-cube,org.arquillian.cube.docker.restassured,0,0,0,0,0,0,0,0
arquillian_arquillian-cube,org.fabric8.maven.plugin.build,0,0,0,0,0,0,0,0
arquillian_arquillian-cube,io.openshift.booster,0,0,0,0,0,0,0,0
arquillian_arquillian-cube,io.openshift.booster.service,0,0,0,0,1,0,0,1
arquillian_arquillian-cube,org.arquillian.cube.kubernetes.fabric8.impl.annotation,0,0,0,0,0,1,0,1
arquillian_arquillian-cube,org.arquillian.cube.kubernetes.fabric8.impl,0,0,0,0,0,0,0,0
arquillian_arquillian-cube,org.arquillian.cube.kubernetes.fabric8.impl.label,0,0,0,0,0,0,0,0
arquillian_arquillian-cube,org.arquillian.cube.kubernetes.fabric8.impl.utils,0,0,0,0,0,0,0,0
arquillian_arquillian-cube,org.arquillian.cube.kubernetes.fabric8.impl.visitor,0,0,0,0,0,0,0,0
arquillian_arquillian-cube,(default package),0,0,0,0,0,0,0,0
arquillian_arquillian-cube,org.arquillian.cube.kubernetes.assistant,0,0,0,0,0,0,0,0
arquillian_arquillian-cube,org.arquillian.cube.kubernetes,0,0,0,0,0,0,0,0
arquillian_arquillian-cube,org.arquillian.cube.istio.impl.enricher,0,0,0,0,0,0,0,0
arquillian_arquillian-cube,org.arquillian.cube.istio.impl,0,0,0,0,1,0,0,1
arquillian_arquillian-cube,org.arquillian.cube.istio,0,0,0,0,0,0,0,0
arquillian_arquillian-cube,io.undertow.protocols.spdy,0,0,0,0,0,0,0,0
arquillian_arquillian-cube,org.arquillian.cube.kubernetes.api,0,0,0,0,1,2,0,3
arquillian_arquillian-cube,org.arquillian.cube.kubernetes.impl.annotation,0,0,0,0,0,0,0,0
arquillian_arquillian-cube,org.arquillian.cube.kubernetes.impl,0,0,0,0,1,2,0,3
arquillian_arquillian-cube,org.arquillian.cube.kubernetes.impl.enricher,0,0,0,0,0,0,0,0
arquillian_arquillian-cube,org.arquillian.cube.kubernetes.impl.enricher.external,0,0,0,0,1,0,0,1
arquillian_arquillian-cube,org.arquillian.cube.kubernetes.impl.enricher.internal,0,0,0,0,1,0,0,1
arquillian_arquillian-cube,org.arquillian.cube.kubernetes.impl.event,0,0,0,0,0,0,0,0
arquillian_arquillian-cube,org.arquillian.cube.kubernetes.impl.feedback,0,0,0,0,0,0,0,0
arquillian_arquillian-cube,org.arquillian.cube.kubernetes.impl.install,0,0,0,0,0,0,0,0
arquillian_arquillian-cube,org.arquillian.cube.kubernetes.impl.label,0,0,0,0,0,0,0,0
arquillian_arquillian-cube,org.arquillian.cube.kubernetes.impl.locator,0,0,0,0,0,0,0,0
arquillian_arquillian-cube,org.arquillian.cube.kubernetes.impl.log,0,0,0,0,0,0,0,0
arquillian_arquillian-cube,org.arquillian.cube.kubernetes.impl.namespace,0,0,0,0,0,0,0,0
arquillian_arquillian-cube,org.arquillian.cube.kubernetes.impl.portforward,0,0,0,0,1,0,0,1
arquillian_arquillian-cube,org.arquillian.cube.kubernetes.impl.requirement,0,0,0,0,0,0,0,0
arquillian_arquillian-cube,org.arquillian.cube.kubernetes.impl.resolve,0,0,0,0,0,0,0,0
arquillian_arquillian-cube,org.arquillian.cube.kubernetes.impl.resolver,0,0,0,0,0,0,0,0
arquillian_arquillian-cube,org.arquillian.cube.kubernetes.impl.resources,0,0,0,0,0,0,0,0
arquillian_arquillian-cube,org.arquillian.cube.kubernetes.impl.utils,0,0,0,0,1,0,0,1
arquillian_arquillian-cube,org.arquillian.cube.kubernetes.impl.visitor,0,0,0,0,1,0,0,1
arquillian_arquillian-cube,org.arquillian.cube.kubernetes.reporter,0,0,0,0,0,0,0,0
arquillian_arquillian-cube,org.arquillian.cube.openshift.api,0,0,0,0,0,0,0,0
arquillian_arquillian-cube,org.arquillian.cube.openshift.api.model,0,0,0,0,0,0,0,0
arquillian_arquillian-cube,org.arquillian.cube.openshift.standalone,0,0,0,0,1,0,0,1
arquillian_arquillian-cube,org.arquillian.cube.openshift.operational.methods,0,0,0,0,0,0,0,0
arquillian_arquillian-cube,org.arquillian.openshift.restassured,0,0,0,0,0,0,0,0
arquillian_arquillian-cube,org.arquillian.cube.openshift.routeurl,0,0,0,0,0,0,0,0
arquillian_arquillian-cube,org.arquillian.cube.openshift.impl.adapter,0,0,0,0,0,1,0,1
arquillian_arquillian-cube,org.arquillian.cube.openshift.impl,1,0,0,0,0,0,0,1
arquillian_arquillian-cube,org.arquillian.cube.openshift.impl.client,0,0,0,0,1,1,0,2
arquillian_arquillian-cube,org.arquillian.cube.openshift.impl.client.metadata,0,0,0,0,0,0,0,0
arquillian_arquillian-cube,org.arquillian.cube.openshift.impl.dns,0,0,0,0,0,0,0,0
arquillian_arquillian-cube,org.arquillian.cube.openshift.impl.enricher,0,0,0,0,0,0,0,0
arquillian_arquillian-cube,org.arquillian.cube.openshift.impl.enricher.external,0,0,0,0,0,0,0,0
arquillian_arquillian-cube,org.arquillian.cube.openshift.impl.enricher.internal,0,0,0,0,0,0,0,0
arquillian_arquillian-cube,org.arquillian.cube.openshift.impl.ext,1,1,0,0,1,0,0,3
arquillian_arquillian-cube,org.arquillian.cube.openshift.impl.fabric8,0,0,0,0,0,0,0,0
arquillian_arquillian-cube,org.arquillian.cube.openshift.impl.fabric8.model,0,0,0,0,0,0,0,0
arquillian_arquillian-cube,org.arquillian.cube.openshift.impl.feedback,0,0,0,0,0,0,0,0
arquillian_arquillian-cube,org.arquillian.cube.openshift.impl.graphene.location,0,0,0,0,0,0,0,0
arquillian_arquillian-cube,org.arquillian.cube.openshift.impl.install,0,0,0,0,0,0,0,0
arquillian_arquillian-cube,org.arquillian.cube.openshift.impl.locator,0,1,0,0,0,0,0,1
arquillian_arquillian-cube,org.arquillian.cube.openshift.impl.model,0,0,0,0,1,0,0,1
arquillian_arquillian-cube,org.arquillian.cube.openshift.impl.namespace,0,0,0,0,0,0,0,0
arquillian_arquillian-cube,org.arquillian.cube.openshift.impl.oauth,0,0,0,0,0,0,0,0
arquillian_arquillian-cube,org.arquillian.cube.openshift.impl.proxy,0,0,0,0,0,1,0,1
arquillian_arquillian-cube,org.arquillian.cube.openshift.impl.requirement,0,0,0,0,0,0,0,0
arquillian_arquillian-cube,org.arquillian.cube.openshift.impl.resources,0,0,0,0,1,1,0,2
arquillian_arquillian-cube,org.arquillian.cube.openshift.impl.utils,0,0,0,0,1,1,0,2
arquillian_arquillian-cube,org.arquillian.cube.openshift.restassured,0,0,0,0,0,0,0,0
arquillian_arquillian-cube,org.arquillian.cube.openshift.shrinkwrap,0,0,0,0,0,0,0,0
arquillian_arquillian-cube,org.arquillian.cube.requirement,0,0,0,0,1,0,0,1
arquillian_arquillian-cube,org.arquillian.cube.spi.requirement,0,0,0,0,0,0,0,0
arquillian_arquillian-cube,org.arquillian.cube.spi.afterStart,0,0,0,0,0,0,0,0
arquillian_arquillian-cube,org.arquillian.cube.spi,0,0,0,0,1,2,0,3
arquillian_arquillian-cube,org.arquillian.cube.spi.await,0,0,0,0,0,0,0,0
arquillian_arquillian-cube,org.arquillian.cube.spi.beforeStop,0,0,0,0,0,0,0,0
arquillian_arquillian-cube,org.arquillian.cube.spi.event,0,0,0,0,0,1,0,1
arquillian_arquillian-cube,org.arquillian.cube.spi.event.lifecycle,0,0,0,0,1,0,0,1
arquillian_arquillian-cube,org.arquillian.cube.spi.metadata,0,0,0,0,1,0,0,1
ArtificerRepo_artificer,org.jboss.errai.databinding.client,0,0,0,0,1,0,0,1
ArtificerRepo_artificer,org.jboss.errai.ioc.client,0,0,0,1,1,0,0,2
ArtificerRepo_artificer,org.jboss.errai.ui.nav.client.local.spi,0,0,0,0,0,0,0,0
ArtificerRepo_artificer,org.jboss.errai.enterprise.client.jaxrs,0,0,0,0,1,0,0,1
ArtificerRepo_artificer,org.jboss.errai.ui.client.local.spi,0,0,0,0,1,0,0,1
ArtificerRepo_artificer,org.jboss.errai.marshalling.client.api,0,0,0,1,1,0,0,2
ArtificerRepo_artificer,org.jboss.errai.bus.client.framework,0,0,0,0,0,0,0,0
ArtificerRepo_artificer,org.jboss.downloads.artificer._2013.auditing,0,0,0,0,0,1,0,1
ArtificerRepo_artificer,org.oasis_open.docs.s_ramp.ns.s_ramp_v1,0,0,0,1,0,15,0,16
ArtificerRepo_artificer,org.w3._1999.xlink,0,0,0,0,0,0,0,0
ArtificerRepo_artificer,org.w3._1999._02._22_rdf_syntax_ns,0,0,0,0,0,0,0,0
ArtificerRepo_artificer,org.w3._1999._02._22_rdf_syntax_ns_,0,0,0,0,0,1,0,1
ArtificerRepo_artificer,org.w3._2000._01.rdf_schema,0,0,0,0,0,0,0,0
ArtificerRepo_artificer,org.w3._2000._01.rdf_schema_,0,0,0,0,0,1,0,1
ArtificerRepo_artificer,org.w3._2002._07.owl,0,0,0,0,0,0,0,0
ArtificerRepo_artificer,org.w3._2002._07.owl_,0,0,0,0,0,1,0,1
ArtificerRepo_artificer,org.artificer.atom.archive,0,0,0,0,0,0,0,0
ArtificerRepo_artificer,org.artificer.atom,0,0,0,0,0,0,0,0
ArtificerRepo_artificer,org.artificer.atom.beans,0,0,0,0,0,0,0,0
ArtificerRepo_artificer,org.artificer.atom.err,0,0,0,0,0,0,0,0
ArtificerRepo_artificer,org.artificer.atom.i18n,0,0,0,0,0,0,0,0
ArtificerRepo_artificer,org.artificer.atom.mappers,0,0,0,0,0,1,0,1
ArtificerRepo_artificer,org.artificer.atom.providers,0,0,0,0,1,0,0,1
ArtificerRepo_artificer,org.artificer.atom.visitors,0,0,0,0,0,0,0,0
ArtificerRepo_artificer,org.artificer.client,0,0,0,0,0,5,0,5
ArtificerRepo_artificer,org.artificer.client.audit,0,0,0,0,0,0,0,0
ArtificerRepo_artificer,org.artificer.client.auth,0,0,0,0,0,0,0,0
ArtificerRepo_artificer,org.artificer.client.i18n,0,0,0,0,0,0,0,0
ArtificerRepo_artificer,org.artificer.client.ontology,0,0,0,0,0,0,0,0
ArtificerRepo_artificer,org.artificer.client.query,0,0,0,0,0,1,0,1
ArtificerRepo_artificer,org.artificer.common,0,1,0,0,1,8,0,10
ArtificerRepo_artificer,org.artificer.common.audit,0,0,0,0,0,0,0,0
ArtificerRepo_artificer,org.artificer.common.error,0,0,0,0,0,1,0,1
ArtificerRepo_artificer,org.artificer.common.i18n,0,0,0,0,0,0,0,0
ArtificerRepo_artificer,org.artificer.common.maven,0,0,0,0,0,3,0,3
ArtificerRepo_artificer,org.artificer.common.ontology,0,0,0,0,0,4,0,4
ArtificerRepo_artificer,org.artificer.common.query,0,0,0,0,0,1,0,1
ArtificerRepo_artificer,org.artificer.common.query.xpath.ast,0,0,0,0,0,0,0,0
ArtificerRepo_artificer,org.artificer.common.query.xpath,0,0,0,0,0,0,0,0
ArtificerRepo_artificer,org.artificer.common.query.xpath.visitors,0,0,0,0,0,0,0,0
ArtificerRepo_artificer,org.artificer.common.visitors,0,0,0,0,0,0,0,0
ArtificerRepo_artificer,org.artificer.demos.archivepkg,0,0,0,0,0,0,0,0
ArtificerRepo_artificer,org.artificer.demos.classifications,0,0,0,0,0,0,0,0
ArtificerRepo_artificer,org.artificer.demos.artifactbuilder,0,0,0,0,0,2,0,2
ArtificerRepo_artificer,org.artificer.demos.derived,0,0,0,0,0,0,0,0
ArtificerRepo_artificer,org.artificer.demos.endtoend.gettingthingsdone,0,0,0,0,0,1,0,1
ArtificerRepo_artificer,org.artificer.demos.endtoend.impactanalysis,0,0,0,0,0,0,0,0
ArtificerRepo_artificer,org.artificer.demos.mvnintegration.app,0,0,0,0,0,0,0,0
ArtificerRepo_artificer,org.artificer.demos.mvnintegration,0,0,0,0,0,0,0,0
ArtificerRepo_artificer,org.artificer.demos.ontologies,0,0,0,0,0,0,0,0
ArtificerRepo_artificer,org.artificer.demos.properties,0,0,0,0,0,0,0,0
ArtificerRepo_artificer,org.artificer.demos.query,0,0,0,0,0,0,0,0
ArtificerRepo_artificer,org.artificer.demos.relationships,0,0,0,0,0,0,0,0
ArtificerRepo_artificer,org.artificer.demos.simpleclient,0,0,0,0,0,0,0,0
ArtificerRepo_artificer,org.artificer.demos.webapp.multimodule.artifacts,0,0,0,0,0,0,0,0
ArtificerRepo_artificer,org.artificer.demos.webapp.multimodule.web,0,0,0,0,0,0,0,0
ArtificerRepo_artificer,org.artificer.devsvr,0,0,0,0,1,0,0,1
ArtificerRepo_artificer,org.artificer.events.jms.i18n,0,0,0,0,0,0,0,0
ArtificerRepo_artificer,org.artificer.events.jms,0,0,0,0,0,0,0,0
ArtificerRepo_artificer,org.artificer.events,0,0,0,0,0,2,0,2
ArtificerRepo_artificer,org.artificer.integration.java.artifactbuilder,0,0,0,0,0,1,0,1
ArtificerRepo_artificer,org.artificer.integration.java.artifacttypedetector,0,0,0,0,0,0,0,0
ArtificerRepo_artificer,org.artificer.integration.java.model,0,0,0,0,0,0,0,0
ArtificerRepo_artificer,org.artificer.integration.kie.artifacttypedetector,0,0,0,0,0,1,0,1
ArtificerRepo_artificer,org.artificer.integration.kie.model,0,0,0,0,0,0,0,0
ArtificerRepo_artificer,org.artificer.integration.rtgov.artifacttypedetector,0,0,0,0,0,0,0,0
ArtificerRepo_artificer,org.artificer.integration.rtgov.model,0,0,0,0,0,0,0,0
ArtificerRepo_artificer,org.artificer.integration,0,1,0,0,0,2,0,3
ArtificerRepo_artificer,org.artificer.integration.artifactbuilder,0,0,0,0,0,5,0,5
ArtificerRepo_artificer,org.artificer.integration.artifacttypedetector,0,0,0,0,0,0,0,0
ArtificerRepo_artificer,org.artificer.integration.switchyard.artifactbuilder,0,0,0,0,0,3,0,3
ArtificerRepo_artificer,org.artificer.integration.switchyard.artifacttypedetector,0,0,0,0,0,1,0,1
ArtificerRepo_artificer,org.artificer.integration.switchyard.i18n,0,0,0,0,0,0,0,0
ArtificerRepo_artificer,org.artificer.integration.switchyard.model,0,0,0,0,0,1,0,1
ArtificerRepo_artificer,org.artificer.integration.teiid.artifactbuilder,0,0,0,0,0,2,0,2
ArtificerRepo_artificer,org.artificer.integration.teiid.artifacttypedetector,0,0,0,0,0,0,0,0
ArtificerRepo_artificer,org.artificer.integration.teiid,0,0,0,0,0,1,0,1
ArtificerRepo_artificer,org.artificer.integration.teiid.model,0,1,0,1,1,2,0,5
ArtificerRepo_artificer,org.artificer.repository.hibernate.audit,1,1,0,0,0,2,0,4
ArtificerRepo_artificer,org.artificer.repository.hibernate.data,1,0,0,0,0,3,0,4
ArtificerRepo_artificer,org.artificer.repository.hibernate.entity,0,0,0,0,1,7,0,8
ArtificerRepo_artificer,org.artificer.repository.hibernate.file,0,0,0,0,0,0,0,0
ArtificerRepo_artificer,org.artificer.repository.hibernate,2,1,0,0,1,5,0,9
ArtificerRepo_artificer,org.artificer.repository.hibernate.i18n,0,0,0,0,0,0,0,0
ArtificerRepo_artificer,org.artificer.repository.hibernate.query,0,0,0,0,0,0,0,0
ArtificerRepo_artificer,org.artificer.repository.hibernate.tool,0,0,0,0,0,0,0,0
ArtificerRepo_artificer,org.artificer.repository,0,0,0,0,1,4,0,5
ArtificerRepo_artificer,org.artificer.repository.audit,0,0,0,0,0,0,0,0
ArtificerRepo_artificer,org.artificer.repository.error,0,0,0,0,0,0,0,0
ArtificerRepo_artificer,org.artificer.repository.filter,0,0,0,0,0,1,0,1
ArtificerRepo_artificer,org.artificer.repository.i18n,0,0,0,0,0,0,0,0
ArtificerRepo_artificer,org.artificer.repository.query,0,0,0,0,1,2,0,3
ArtificerRepo_artificer,org.artificer.server.core.api,0,0,0,0,1,0,0,1
ArtificerRepo_artificer,org.artificer.server,0,0,0,0,1,5,0,6
ArtificerRepo_artificer,org.artificer.server.atom.services,0,0,0,0,0,0,0,0
ArtificerRepo_artificer,org.artificer.server.atom.workspaces,0,0,0,0,1,0,0,1
ArtificerRepo_artificer,org.artificer.server.filters,0,0,0,0,0,0,0,0
ArtificerRepo_artificer,org.artificer.server.i18n,0,0,0,0,0,0,0,0
ArtificerRepo_artificer,org.artificer.server.mime,0,0,0,0,0,0,0,0
ArtificerRepo_artificer,org.artificer.server.mvn.services,0,0,0,0,0,3,0,3
ArtificerRepo_artificer,org.artificer.shell.archive,0,0,0,0,1,0,0,1
ArtificerRepo_artificer,org.artificer.shell,0,0,0,0,1,0,0,1
ArtificerRepo_artificer,org.artificer.shell.audit,0,0,0,0,0,0,0,0
ArtificerRepo_artificer,org.artificer.shell.common,0,0,0,0,0,0,0,0
ArtificerRepo_artificer,org.artificer.shell.core,0,0,0,0,1,0,0,1
ArtificerRepo_artificer,org.artificer.shell.i18n,0,0,0,0,0,0,0,0
ArtificerRepo_artificer,org.artificer.shell.maven,0,0,0,0,0,0,0,0
ArtificerRepo_artificer,org.artificer.shell.ontology,0,0,0,0,1,0,0,1
ArtificerRepo_artificer,org.artificer.shell.storedquery,0,0,0,0,1,0,0,1
ArtificerRepo_artificer,org.artificer.shell.util,0,0,0,0,0,0,0,0
ArtificerRepo_artificer,org.artificer.ui.client.local.animations,0,0,0,0,1,0,0,1
ArtificerRepo_artificer,org.artificer.ui.client.local,0,0,0,0,1,0,0,1
ArtificerRepo_artificer,org.artificer.ui.client.local.events,0,0,0,0,0,0,0,0
ArtificerRepo_artificer,org.artificer.ui.client.local.pages,0,0,0,0,1,0,0,1
ArtificerRepo_artificer,org.artificer.ui.client.local.pages.artifacts,0,0,0,1,1,0,0,2
ArtificerRepo_artificer,org.artificer.ui.client.local.pages.details,0,0,0,1,1,0,0,2
ArtificerRepo_artificer,org.artificer.ui.client.local.pages.ontologies,0,0,0,1,1,1,0,3
ArtificerRepo_artificer,org.artificer.ui.client.local.services,0,0,0,0,1,1,0,2
ArtificerRepo_artificer,org.artificer.ui.client.local.services.callback,0,0,0,0,1,0,0,1
ArtificerRepo_artificer,org.artificer.ui.client.local.services.notification,0,0,0,0,1,0,0,1
ArtificerRepo_artificer,org.artificer.ui.client.local.util,0,0,0,0,1,0,0,1
ArtificerRepo_artificer,org.artificer.ui.client.local.widgets.common,0,0,0,0,1,0,0,1
ArtificerRepo_artificer,org.artificer.ui.client.local.widgets.ontologies,0,0,0,0,1,0,0,1
ArtificerRepo_artificer,org.artificer.ui.client.shared.beans,0,0,0,1,1,3,0,5
ArtificerRepo_artificer,org.artificer.ui.client.shared.exceptions,0,0,0,0,0,0,0,0
ArtificerRepo_artificer,org.artificer.ui.client.shared.services,0,0,0,0,1,0,0,1
ArtificerRepo_artificer,org.artificer.ui.server.api,0,1,0,0,0,3,0,4
ArtificerRepo_artificer,org.artificer.ui.server,0,0,0,0,0,0,0,0
ArtificerRepo_artificer,org.artificer.ui.server.filters,0,0,0,0,0,0,0,0
ArtificerRepo_artificer,org.artificer.ui.server.i18n,0,0,0,0,0,0,0,0
ArtificerRepo_artificer,org.artificer.ui.server.services,0,0,0,0,0,4,0,4
ArtificerRepo_artificer,org.artificer.ui.server.services.util,0,0,0,0,0,0,0,0
ArtificerRepo_artificer,org.artificer.ui.server.servlets,0,0,0,0,1,0,0,1
ArtificerRepo_artificer,org.artificer.ui.server.util,0,0,0,0,0,0,0,0
ArtificerRepo_artificer,com.google.gwt.i18n.client.constants,0,0,0,0,0,0,0,0
ArtificerRepo_artificer,com.google.gwt.i18n.client,0,0,0,0,0,0,0,0
ArtificerRepo_artificer,com.google.gwt.i18n.client.impl,0,0,0,0,0,0,0,0
ArtificerRepo_artificer,com.google.gwt.lang,0,0,0,0,0,0,0,0
ArtificerRepo_artificer,com.google.gwt.user.client,0,0,0,0,0,0,0,0
ArtificerRepo_artificer,com.google.gwt.user.client.impl,0,0,0,0,0,0,0,0
ArtificerRepo_artificer,com.google.gwt.user.client.ui,0,0,0,0,0,0,0,0
ArtificerRepo_artificer,com.google.gwt.user.client.ui.impl,0,0,0,0,0,0,0,0
ArtificerRepo_artificer,com.google.gwt.useragent.client,0,0,0,0,0,0,0,0
ArtificerRepo_artificer,org.jboss.errai.ioc.client.container,0,0,0,0,0,0,0,0
ArtificerRepo_artificer,org.jboss.errai.databinding.client,0,0,0,0,1,0,0,1
ArtificerRepo_artificer,org.jboss.errai.ioc.client,0,0,0,1,1,0,0,2
ArtificerRepo_artificer,org.jboss.errai.ui.nav.client.local.spi,0,0,0,0,0,0,0,0
ArtificerRepo_artificer,org.jboss.errai.enterprise.client.jaxrs,0,0,0,0,1,0,0,1
ArtificerRepo_artificer,org.jboss.errai.ui.client.local.spi,0,0,0,0,1,0,0,1
ArtificerRepo_artificer,org.jboss.errai.marshalling.client.api,0,0,0,1,1,0,0,2
ArtificerRepo_artificer,org.jboss.errai.bus.client.framework,0,0,0,0,0,0,0,0
ArtificerRepo_artificer,org.jboss.downloads.artificer._2013.auditing,0,0,0,0,0,1,0,1
ArtificerRepo_artificer,org.oasis_open.docs.s_ramp.ns.s_ramp_v1,0,0,0,1,0,15,0,16
ArtificerRepo_artificer,org.w3._1999.xlink,0,0,0,0,0,0,0,0
ArtificerRepo_artificer,org.w3._1999._02._22_rdf_syntax_ns,0,0,0,0,0,0,0,0
ArtificerRepo_artificer,org.w3._1999._02._22_rdf_syntax_ns_,0,0,0,0,0,1,0,1
ArtificerRepo_artificer,org.w3._2000._01.rdf_schema,0,0,0,0,0,0,0,0
ArtificerRepo_artificer,org.w3._2000._01.rdf_schema_,0,0,0,0,0,1,0,1
ArtificerRepo_artificer,org.w3._2002._07.owl,0,0,0,0,0,0,0,0
ArtificerRepo_artificer,org.w3._2002._07.owl_,0,0,0,0,0,1,0,1
ArtificerRepo_artificer,org.artificer.atom.archive,0,0,0,0,0,0,0,0
ArtificerRepo_artificer,org.artificer.atom,0,0,0,0,0,0,0,0
ArtificerRepo_artificer,org.artificer.atom.beans,0,0,0,0,0,0,0,0
ArtificerRepo_artificer,org.artificer.atom.err,0,0,0,0,0,0,0,0
ArtificerRepo_artificer,org.artificer.atom.i18n,0,0,0,0,0,0,0,0
ArtificerRepo_artificer,org.artificer.atom.mappers,0,0,0,0,0,1,0,1
ArtificerRepo_artificer,org.artificer.atom.providers,0,0,0,0,1,0,0,1
ArtificerRepo_artificer,org.artificer.atom.visitors,0,0,0,0,0,0,0,0
ArtificerRepo_artificer,org.artificer.client,0,0,0,0,0,5,0,5
ArtificerRepo_artificer,org.artificer.client.audit,0,0,0,0,0,0,0,0
ArtificerRepo_artificer,org.artificer.client.auth,0,0,0,0,0,0,0,0
ArtificerRepo_artificer,org.artificer.client.i18n,0,0,0,0,0,0,0,0
ArtificerRepo_artificer,org.artificer.client.ontology,0,0,0,0,0,0,0,0
ArtificerRepo_artificer,org.artificer.client.query,0,0,0,0,0,1,0,1
ArtificerRepo_artificer,org.artificer.common,0,1,0,0,1,8,0,10
ArtificerRepo_artificer,org.artificer.common.audit,0,0,0,0,0,0,0,0
ArtificerRepo_artificer,org.artificer.common.error,0,0,0,0,0,1,0,1
ArtificerRepo_artificer,org.artificer.common.i18n,0,0,0,0,0,0,0,0
ArtificerRepo_artificer,org.artificer.common.maven,0,0,0,0,0,3,0,3
ArtificerRepo_artificer,org.artificer.common.ontology,0,0,0,0,0,4,0,4
ArtificerRepo_artificer,org.artificer.common.query,0,0,0,0,0,1,0,1
ArtificerRepo_artificer,org.artificer.common.query.xpath.ast,0,0,0,0,0,0,0,0
ArtificerRepo_artificer,org.artificer.common.query.xpath,0,0,0,0,0,0,0,0
ArtificerRepo_artificer,org.artificer.common.query.xpath.visitors,0,0,0,0,0,0,0,0
ArtificerRepo_artificer,org.artificer.common.visitors,0,0,0,0,0,0,0,0
ArtificerRepo_artificer,org.artificer.demos.archivepkg,0,0,0,0,0,0,0,0
ArtificerRepo_artificer,org.artificer.demos.classifications,0,0,0,0,0,0,0,0
ArtificerRepo_artificer,org.artificer.demos.artifactbuilder,0,0,0,0,0,2,0,2
ArtificerRepo_artificer,org.artificer.demos.derived,0,0,0,0,0,0,0,0
ArtificerRepo_artificer,org.artificer.demos.endtoend.gettingthingsdone,0,0,0,0,0,1,0,1
ArtificerRepo_artificer,org.artificer.demos.endtoend.impactanalysis,0,0,0,0,0,0,0,0
ArtificerRepo_artificer,org.artificer.demos.mvnintegration.app,0,0,0,0,0,0,0,0
ArtificerRepo_artificer,org.artificer.demos.mvnintegration,0,0,0,0,0,0,0,0
ArtificerRepo_artificer,org.artificer.demos.ontologies,0,0,0,0,0,0,0,0
ArtificerRepo_artificer,org.artificer.demos.properties,0,0,0,0,0,0,0,0
ArtificerRepo_artificer,org.artificer.demos.query,0,0,0,0,0,0,0,0
ArtificerRepo_artificer,org.artificer.demos.relationships,0,0,0,0,0,0,0,0
ArtificerRepo_artificer,org.artificer.demos.simpleclient,0,0,0,0,0,0,0,0
ArtificerRepo_artificer,org.artificer.demos.webapp.multimodule.artifacts,0,0,0,0,0,0,0,0
ArtificerRepo_artificer,org.artificer.demos.webapp.multimodule.web,0,0,0,0,0,0,0,0
ArtificerRepo_artificer,org.artificer.devsvr,0,0,0,0,1,0,0,1
ArtificerRepo_artificer,org.artificer.events.jms.i18n,0,0,0,0,0,0,0,0
ArtificerRepo_artificer,org.artificer.events.jms,0,0,0,0,0,0,0,0
ArtificerRepo_artificer,org.artificer.events,0,0,0,0,0,2,0,2
ArtificerRepo_artificer,org.artificer.integration.java.artifactbuilder,0,0,0,0,0,1,0,1
ArtificerRepo_artificer,org.artificer.integration.java.artifacttypedetector,0,0,0,0,0,0,0,0
ArtificerRepo_artificer,org.artificer.integration.java.model,0,0,0,0,0,0,0,0
ArtificerRepo_artificer,org.artificer.integration.kie.artifacttypedetector,0,0,0,0,0,1,0,1
ArtificerRepo_artificer,org.artificer.integration.kie.model,0,0,0,0,0,0,0,0
ArtificerRepo_artificer,org.artificer.integration.rtgov.artifacttypedetector,0,0,0,0,0,0,0,0
ArtificerRepo_artificer,org.artificer.integration.rtgov.model,0,0,0,0,0,0,0,0
ArtificerRepo_artificer,org.artificer.integration,0,1,0,0,0,2,0,3
ArtificerRepo_artificer,org.artificer.integration.artifactbuilder,0,0,0,0,0,5,0,5
ArtificerRepo_artificer,org.artificer.integration.artifacttypedetector,0,0,0,0,0,0,0,0
ArtificerRepo_artificer,org.artificer.integration.switchyard.artifactbuilder,0,0,0,0,0,3,0,3
ArtificerRepo_artificer,org.artificer.integration.switchyard.artifacttypedetector,0,0,0,0,0,1,0,1
ArtificerRepo_artificer,org.artificer.integration.switchyard.i18n,0,0,0,0,0,0,0,0
ArtificerRepo_artificer,org.artificer.integration.switchyard.model,0,0,0,0,0,1,0,1
ArtificerRepo_artificer,org.artificer.integration.teiid.artifactbuilder,0,0,0,0,0,2,0,2
ArtificerRepo_artificer,org.artificer.integration.teiid.artifacttypedetector,0,0,0,0,0,0,0,0
ArtificerRepo_artificer,org.artificer.integration.teiid,0,0,0,0,0,1,0,1
ArtificerRepo_artificer,org.artificer.integration.teiid.model,0,1,0,1,1,2,0,5
ArtificerRepo_artificer,org.artificer.repository.hibernate.audit,1,1,0,0,0,2,0,4
ArtificerRepo_artificer,org.artificer.repository.hibernate.data,1,0,0,0,0,3,0,4
ArtificerRepo_artificer,org.artificer.repository.hibernate.entity,0,0,0,0,1,7,0,8
ArtificerRepo_artificer,org.artificer.repository.hibernate.file,0,0,0,0,0,0,0,0
ArtificerRepo_artificer,org.artificer.repository.hibernate,2,1,0,0,1,5,0,9
ArtificerRepo_artificer,org.artificer.repository.hibernate.i18n,0,0,0,0,0,0,0,0
ArtificerRepo_artificer,org.artificer.repository.hibernate.query,0,0,0,0,0,0,0,0
ArtificerRepo_artificer,org.artificer.repository.hibernate.tool,0,0,0,0,0,0,0,0
ArtificerRepo_artificer,org.artificer.repository,0,0,0,0,1,4,0,5
ArtificerRepo_artificer,org.artificer.repository.audit,0,0,0,0,0,0,0,0
ArtificerRepo_artificer,org.artificer.repository.error,0,0,0,0,0,0,0,0
ArtificerRepo_artificer,org.artificer.repository.filter,0,0,0,0,0,1,0,1
ArtificerRepo_artificer,org.artificer.repository.i18n,0,0,0,0,0,0,0,0
ArtificerRepo_artificer,org.artificer.repository.query,0,0,0,0,1,2,0,3
ArtificerRepo_artificer,org.artificer.server.core.api,0,0,0,0,1,0,0,1
ArtificerRepo_artificer,org.artificer.server,0,0,0,0,1,5,0,6
ArtificerRepo_artificer,org.artificer.server.atom.services,0,0,0,0,0,0,0,0
ArtificerRepo_artificer,org.artificer.server.atom.workspaces,0,0,0,0,1,0,0,1
ArtificerRepo_artificer,org.artificer.server.filters,0,0,0,0,0,0,0,0
ArtificerRepo_artificer,org.artificer.server.i18n,0,0,0,0,0,0,0,0
ArtificerRepo_artificer,org.artificer.server.mime,0,0,0,0,0,0,0,0
ArtificerRepo_artificer,org.artificer.server.mvn.services,0,0,0,0,0,3,0,3
ArtificerRepo_artificer,org.artificer.shell.archive,0,0,0,0,1,0,0,1
ArtificerRepo_artificer,org.artificer.shell,0,0,0,0,1,0,0,1
ArtificerRepo_artificer,org.artificer.shell.audit,0,0,0,0,0,0,0,0
ArtificerRepo_artificer,org.artificer.shell.common,0,0,0,0,0,0,0,0
ArtificerRepo_artificer,org.artificer.shell.core,0,0,0,0,1,0,0,1
ArtificerRepo_artificer,org.artificer.shell.i18n,0,0,0,0,0,0,0,0
ArtificerRepo_artificer,org.artificer.shell.maven,0,0,0,0,0,0,0,0
ArtificerRepo_artificer,org.artificer.shell.ontology,0,0,0,0,1,0,0,1
ArtificerRepo_artificer,org.artificer.shell.storedquery,0,0,0,0,1,0,0,1
ArtificerRepo_artificer,org.artificer.shell.util,0,0,0,0,0,0,0,0
ArtificerRepo_artificer,org.artificer.ui.client.local.animations,0,0,0,0,1,0,0,1
ArtificerRepo_artificer,org.artificer.ui.client.local,0,0,0,0,1,0,0,1
ArtificerRepo_artificer,org.artificer.ui.client.local.events,0,0,0,0,0,0,0,0
ArtificerRepo_artificer,org.artificer.ui.client.local.pages,0,0,0,0,1,0,0,1
ArtificerRepo_artificer,org.artificer.ui.client.local.pages.artifacts,0,0,0,1,1,0,0,2
ArtificerRepo_artificer,org.artificer.ui.client.local.pages.details,0,0,0,1,1,0,0,2
ArtificerRepo_artificer,org.artificer.ui.client.local.pages.ontologies,0,0,0,1,1,1,0,3
ArtificerRepo_artificer,org.artificer.ui.client.local.services,0,0,0,0,1,1,0,2
ArtificerRepo_artificer,org.artificer.ui.client.local.services.callback,0,0,0,0,1,0,0,1
ArtificerRepo_artificer,org.artificer.ui.client.local.services.notification,0,0,0,0,1,0,0,1
ArtificerRepo_artificer,org.artificer.ui.client.local.util,0,0,0,0,1,0,0,1
ArtificerRepo_artificer,org.artificer.ui.client.local.widgets.common,0,0,0,0,1,0,0,1
ArtificerRepo_artificer,org.artificer.ui.client.local.widgets.ontologies,0,0,0,0,1,0,0,1
ArtificerRepo_artificer,org.artificer.ui.client.shared.beans,0,0,0,1,1,3,0,5
ArtificerRepo_artificer,org.artificer.ui.client.shared.exceptions,0,0,0,0,0,0,0,0
ArtificerRepo_artificer,org.artificer.ui.client.shared.services,0,0,0,0,1,0,0,1
ArtificerRepo_artificer,org.artificer.ui.server.api,0,1,0,0,0,3,0,4
ArtificerRepo_artificer,org.artificer.ui.server,0,0,0,0,0,0,0,0
ArtificerRepo_artificer,org.artificer.ui.server.filters,0,0,0,0,0,0,0,0
ArtificerRepo_artificer,org.artificer.ui.server.i18n,0,0,0,0,0,0,0,0
ArtificerRepo_artificer,org.artificer.ui.server.services,0,0,0,0,0,4,0,4
ArtificerRepo_artificer,org.artificer.ui.server.services.util,0,0,0,0,0,0,0,0
ArtificerRepo_artificer,org.artificer.ui.server.servlets,0,0,0,0,1,0,0,1
ArtificerRepo_artificer,org.artificer.ui.server.util,0,0,0,0,0,0,0,0
ArtificerRepo_artificer,com.google.gwt.i18n.client.constants,0,0,0,0,0,0,0,0
ArtificerRepo_artificer,com.google.gwt.i18n.client,0,0,0,0,0,0,0,0
ArtificerRepo_artificer,com.google.gwt.i18n.client.impl,0,0,0,0,0,0,0,0
ArtificerRepo_artificer,com.google.gwt.lang,0,0,0,0,0,0,0,0
ArtificerRepo_artificer,com.google.gwt.user.client,0,0,0,0,0,0,0,0
ArtificerRepo_artificer,com.google.gwt.user.client.impl,0,0,0,0,0,0,0,0
ArtificerRepo_artificer,com.google.gwt.user.client.ui,0,0,0,0,0,0,0,0
ArtificerRepo_artificer,com.google.gwt.user.client.ui.impl,0,0,0,0,0,0,0,0
ArtificerRepo_artificer,com.google.gwt.useragent.client,0,0,0,0,0,0,0,0
ArtificerRepo_artificer,org.jboss.errai.ioc.client.container,0,0,0,0,0,0,0,0
astefanutti_camel-cdi,org.apache.camel.cdi.ee,0,0,0,0,0,0,0,0
astefanutti_camel-cdi,org.apache.camel.cdi.ee.category,0,0,0,0,0,0,0,0
astefanutti_camel-cdi,org.apache.camel.cdi.osgi,0,0,0,0,0,0,0,0
astefanutti_camel-cdi,org.apache.camel.cdi.se.bean,0,0,0,1,1,0,0,2
astefanutti_camel-cdi,org.apache.camel.cdi.se.converter,0,0,0,0,0,0,0,0
astefanutti_camel-cdi,org.apache.camel.cdi.se.expression,0,0,0,0,0,0,0,0
astefanutti_camel-cdi,org.apache.camel.cdi.se.pojo,0,0,0,0,0,0,0,0
astefanutti_camel-cdi,org.apache.camel.cdi.se.qualifier,0,0,0,0,0,0,0,0
astefanutti_camel-cdi,org.apache.camel.cdi.se,0,0,0,1,1,0,0,2
astefanutti_camel-cdi,org.apache.camel.cdi,0,0,0,1,1,0,0,2
astefanutti_camel-cdi,org.apache.camel.cdi.xml,0,0,0,0,1,0,0,1
astefanutti_camel-cdi,org.apache.camel.maven,0,0,0,0,0,0,0,0
astefanutti_camel-cdi,org.codehaus.mojo.exec,0,0,0,0,1,0,0,1
ATLauncher_ATLauncher,com.atlauncher.adapter,0,0,0,0,0,0,1,1
ATLauncher_ATLauncher,com.atlauncher,39,1,0,0,0,0,1,41
ATLauncher_ATLauncher,com.atlauncher.builders,0,0,0,0,0,0,1,1
ATLauncher_ATLauncher,com.atlauncher.collection,0,0,0,0,0,0,1,1
ATLauncher_ATLauncher,com.atlauncher.data,44,1,0,0,1,0,1,47
ATLauncher_ATLauncher,com.atlauncher.data.curse,4,1,0,0,1,0,1,7
ATLauncher_ATLauncher,com.atlauncher.data.curse.pack,0,0,0,0,0,0,1,1
ATLauncher_ATLauncher,com.atlauncher.data.json,7,1,0,0,1,0,1,10
ATLauncher_ATLauncher,com.atlauncher.data.minecraft,7,1,0,1,1,0,1,11
ATLauncher_ATLauncher,com.atlauncher.data.minecraft.loaders.fabric,0,0,0,0,0,0,1,1
ATLauncher_ATLauncher,com.atlauncher.data.minecraft.loaders.forge,4,0,0,0,1,0,1,6
ATLauncher_ATLauncher,com.atlauncher.data.minecraft.loaders,4,1,0,0,0,0,1,6
ATLauncher_ATLauncher,com.atlauncher.data.mojang.api,3,0,0,0,1,0,1,5
ATLauncher_ATLauncher,com.atlauncher.data.openmods,2,0,0,0,0,0,1,3
ATLauncher_ATLauncher,com.atlauncher.evnt.listener,0,0,0,0,1,0,1,2
ATLauncher_ATLauncher,com.atlauncher.evnt,3,0,0,0,0,0,1,4
ATLauncher_ATLauncher,com.atlauncher.evnt.manager,0,0,0,0,1,0,1,2
ATLauncher_ATLauncher,com.atlauncher.exceptions,0,0,0,0,0,0,1,1
ATLauncher_ATLauncher,com.atlauncher.gui,16,0,0,0,1,0,1,18
ATLauncher_ATLauncher,com.atlauncher.gui.card,4,0,0,0,1,0,1,6
ATLauncher_ATLauncher,com.atlauncher.gui.components,5,1,0,0,1,0,1,8
ATLauncher_ATLauncher,com.atlauncher.gui.dialogs,24,1,0,0,1,0,1,27
ATLauncher_ATLauncher,com.atlauncher.gui.handlers,0,0,0,0,0,0,1,1
ATLauncher_ATLauncher,com.atlauncher.gui.layouts,0,0,0,0,0,0,1,1
ATLauncher_ATLauncher,com.atlauncher.gui.panels,0,0,0,0,0,0,1,1
ATLauncher_ATLauncher,com.atlauncher.gui.tabs,7,1,0,0,1,0,1,10
ATLauncher_ATLauncher,com.atlauncher.gui.tabs.settings,3,0,0,0,0,0,1,4
ATLauncher_ATLauncher,com.atlauncher.gui.theme,4,0,0,0,0,0,1,5
ATLauncher_ATLauncher,com.atlauncher.interfaces,0,0,0,0,0,0,1,1
ATLauncher_ATLauncher,com.atlauncher.listener,0,0,0,0,0,0,1,1
ATLauncher_ATLauncher,com.atlauncher.managers,3,1,0,0,0,0,1,5
ATLauncher_ATLauncher,com.atlauncher.mclauncher,2,0,0,0,0,0,1,3
ATLauncher_ATLauncher,com.atlauncher.network,6,1,0,0,1,0,1,9
ATLauncher_ATLauncher,com.atlauncher.thread,0,0,0,0,0,0,1,1
ATLauncher_ATLauncher,com.atlauncher.utils,19,1,0,0,1,0,1,22
ATLauncher_ATLauncher,com.atlauncher.utils.javafinder,4,0,0,0,0,0,1,5
ATLauncher_ATLauncher,com.atlauncher.utils.walker,0,0,0,0,0,0,1,1
ATLauncher_ATLauncher,com.atlauncher.workers,14,0,0,0,0,0,1,15
ATLauncher_ATLauncher,com.atlauncher.writer,0,0,0,0,0,0,1,1
ATLauncher_ATLauncher,io.github.asyncronous.toast,9,1,0,0,0,0,1,11
ATLauncher_ATLauncher,io.github.asyncronous.toast.thread,0,0,0,0,0,0,1,1
ATLauncher_ATLauncher,io.github.asyncronous.toast.ui,8,0,0,0,0,0,1,9
ATLauncher_ATLauncher,(default package),0,0,0,0,0,0,1,1
att_XACML,com.att.research.xacml.api,0,0,0,0,1,19,1,21
att_XACML,com.att.research.xacml.api.pap,0,1,0,0,1,1,1,4
att_XACML,com.att.research.xacml.api.pdp,3,1,0,0,1,1,1,7
att_XACML,com.att.research.xacml.api.pep,0,0,0,0,0,0,1,1
att_XACML,com.att.research.xacml.api.pip,0,1,0,0,1,5,1,8
att_XACML,com.att.research.xacml.api.trace,0,0,0,0,0,1,1,2
att_XACML,com.att.research.xacml.std.annotations,0,0,0,0,0,0,1,1
att_XACML,com.att.research.xacml.std.datatypes,3,0,0,1,0,8,1,13
att_XACML,com.att.research.xacml.std.dom,5,0,0,0,0,4,1,10
att_XACML,com.att.research.xacml.std,7,1,0,1,1,13,1,24
att_XACML,com.att.research.xacml.std.jaxp,0,0,0,0,0,1,1,2
att_XACML,com.att.research.xacml.std.json,0,0,0,0,0,6,1,7
att_XACML,com.att.research.xacml.std.pap,0,0,0,0,1,0,1,2
att_XACML,com.att.research.xacml.std.pep,0,0,0,0,0,0,1,1
att_XACML,com.att.research.xacml.std.pip.engines,1,0,0,0,1,1,1,4
att_XACML,com.att.research.xacml.std.pip.finders,2,0,0,0,0,0,1,3
att_XACML,com.att.research.xacml.std.pip,2,1,0,0,0,3,1,7
att_XACML,com.att.research.xacml.std.trace,0,0,0,0,0,0,1,1
att_XACML,com.att.research.xacml.util,7,1,0,0,1,3,1,13
att_XACML,oasis.names.tc.xacml._3_0.core.schema.wd_17,0,0,0,1,0,5,1,7
att_XACML,com.att.research.xacml.admin.components,1,1,0,0,1,0,1,4
att_XACML,com.att.research.xacml.admin.converters,0,0,0,0,0,1,1,2
att_XACML,com.att.research.xacml.admin.jpa,1,1,0,0,1,3,1,7
att_XACML,com.att.research.xacml.admin.model,0,0,0,0,1,1,1,3
att_XACML,com.att.research.xacml.admin,0,1,0,0,1,1,1,4
att_XACML,com.att.research.xacml.admin.util,1,1,0,0,1,2,1,6
att_XACML,com.att.research.xacml.admin.view.components,1,0,0,0,1,0,1,3
att_XACML,com.att.research.xacml.admin.view.events,0,0,0,0,1,0,1,2
att_XACML,com.att.research.xacml.admin.view.fields,0,0,0,0,1,0,1,2
att_XACML,com.att.research.xacml.admin.view.validators,0,0,0,0,0,0,1,1
att_XACML,com.att.research.xacml.admin.view.windows,0,0,0,1,1,2,1,5
att_XACML,com.att.research.xacml.rest,0,0,0,0,1,0,1,2
att_XACML,com.att.research.xacmlatt.pdp,0,0,0,0,0,1,1,2
att_XACML,com.att.research.xacmlatt.pdp.eval,0,0,0,0,1,4,1,6
att_XACML,com.att.research.xacmlatt.pdp.policy,0,0,0,1,1,8,1,11
att_XACML,com.att.research.xacmlatt.pdp.policy.dom,0,0,0,0,0,1,1,2
att_XACML,com.att.research.xacmlatt.pdp.policy.expressions,0,0,0,0,1,0,1,2
att_XACML,com.att.research.xacmlatt.pdp.std.combiners,0,0,0,0,0,1,1,2
att_XACML,com.att.research.xacmlatt.pdp.std.functions,1,0,0,1,1,3,1,7
att_XACML,com.att.research.xacmlatt.pdp.std,1,1,0,0,1,1,1,5
att_XACML,com.att.research.xacmlatt.pdp.util,0,0,0,0,0,0,1,1
att_XACML,com.att.research.xacmlatt.pdp.std.dom,0,0,0,0,0,2,1,3
att_XACML,com.att.research.xacmlatt.pdp.std.json,0,0,0,0,1,3,1,5
att_XACML,com.att.research.xacml.rest.impl,0,0,0,0,0,0,1,1
att_XACML,com.att.research.xacml.std.pip.engines.csv,0,0,0,0,1,1,1,3
att_XACML,com.att.research.xacml.std.pip.engines.jdbc,0,0,0,0,0,1,1,2
att_XACML,com.att.research.xacml.std.pip.engines.ldap,0,0,0,0,0,0,1,1
audit4j_audit4j-core,org.audit4j.core.annotation,2,0,0,0,1,0,0,3
audit4j_audit4j-core,org.audit4j.core,17,1,0,1,1,6,0,26
audit4j_audit4j-core,org.audit4j.core.command,2,0,0,0,0,0,0,2
audit4j_audit4j-core,org.audit4j.core.command.impl,0,0,0,0,0,0,0,0
audit4j_audit4j-core,org.audit4j.core.dto,4,1,0,0,0,3,0,8
audit4j_audit4j-core,org.audit4j.core.exception,3,1,0,0,1,0,0,5
audit4j_audit4j-core,org.audit4j.core.extra.scannotation,0,0,0,0,0,0,0,0
audit4j_audit4j-core,org.audit4j.core.filter,0,0,0,0,0,0,0,0
audit4j_audit4j-core,org.audit4j.core.filter.impl,0,0,0,0,0,0,0,0
audit4j_audit4j-core,org.audit4j.core.handler,0,0,0,0,0,1,0,1
audit4j_audit4j-core,org.audit4j.core.handler.file.archive,0,0,0,0,1,0,0,1
audit4j_audit4j-core,org.audit4j.core.handler.file,2,0,0,0,1,0,0,3
audit4j_audit4j-core,org.audit4j.core.io,2,0,0,0,0,0,0,2
audit4j_audit4j-core,org.audit4j.core.jmx,3,0,0,0,0,1,0,4
audit4j_audit4j-core,org.audit4j.core.layout,3,0,0,0,1,1,0,5
audit4j_audit4j-core,org.audit4j.core.schedule,0,0,0,1,0,0,0,1
audit4j_audit4j-core,org.audit4j.core.schedule.util,0,0,0,0,0,0,0,0
audit4j_audit4j-core,org.audit4j.core.util,13,1,0,0,1,5,0,20
audit4j_audit4j-core,org.audit4j.core.web,0,0,0,0,0,0,0,0
audit4j_audit4j-core,org.audit4j.core.Int.command,0,0,0,0,0,0,0,0
audit4j_audit4j-core,org.audit4j.core.Int.configuration,0,0,0,0,0,0,0,0
audit4j_audit4j-core,org.audit4j.core.Int.event.annotation,0,0,0,0,0,1,0,1
audit4j_audit4j-core,org.audit4j.core.Int.filter,0,0,0,0,0,1,0,1
audit4j_audit4j-core,org.audit4j.core.Int,0,0,0,0,0,0,0,0
audit4j_audit4j-core,org.audit4j.core.Int.option,0,0,0,0,0,0,0,0
audit4j_audit4j-core,org.audit4j.core.Mock,0,0,0,0,1,0,0,1
audit4j_audit4j-core,org.audit4j.core.smoke,0,0,0,0,0,0,0,0
augustt198_lumen,me.august.lumen.common,0,0,0,0,1,0,0,1
augustt198_lumen,me.august.lumen.compile.analyze,0,0,0,0,0,0,0,0
augustt198_lumen,me.august.lumen.compile.analyze.method,0,0,0,0,0,0,0,0
augustt198_lumen,me.august.lumen.compile.analyze.node,0,0,0,0,0,0,0,0
augustt198_lumen,me.august.lumen.compile.analyze.scope,0,0,0,0,0,0,0,0
augustt198_lumen,me.august.lumen.compile.analyze.var,0,0,0,0,0,0,0,0
augustt198_lumen,me.august.lumen.compile.codegen,0,0,0,0,0,0,0,0
augustt198_lumen,me.august.lumen.compile,0,0,0,0,0,0,0,0
augustt198_lumen,me.august.lumen.compile.parser.ast,0,0,0,0,1,2,0,3
augustt198_lumen,me.august.lumen.compile.parser.ast.expr,0,0,0,1,1,0,0,2
augustt198_lumen,me.august.lumen.compile.parser.ast.stmt,0,0,0,0,1,1,0,2
augustt198_lumen,me.august.lumen.compile.parser.components,0,0,0,0,1,2,0,3
augustt198_lumen,me.august.lumen.compile.parser,0,1,0,0,0,3,0,4
augustt198_lumen,me.august.lumen.compile.resolve.convert,0,0,0,0,0,0,0,0
augustt198_lumen,me.august.lumen.compile.resolve.convert.types,0,0,0,0,0,0,0,0
augustt198_lumen,me.august.lumen.compile.resolve.data,0,0,0,0,0,0,0,0
augustt198_lumen,me.august.lumen.compile.resolve.data.exception,0,0,0,0,0,0,0,0
augustt198_lumen,me.august.lumen.compile.resolve.impl,0,0,0,0,0,0,0,0
augustt198_lumen,me.august.lumen.compile.resolve.lookup,0,0,0,0,0,0,0,0
augustt198_lumen,me.august.lumen.compile.resolve,0,0,0,0,0,0,0,0
augustt198_lumen,me.august.lumen.compile.resolve.type,0,0,0,0,0,0,0,0
augustt198_lumen,me.august.lumen.compile.scanner,0,0,0,0,0,3,0,3
augustt198_lumen,me.august.lumen.compile.scanner.pos,0,0,0,0,0,0,0,0
augustt198_lumen,me.august.lumen.compile.scanner.tokens,0,0,0,0,0,0,0,0
augustt198_lumen,me.august.lumen.compile.types,0,0,0,0,0,0,0,0
augustt198_lumen,me.august.lumen,0,1,0,0,1,1,0,3
augustt198_lumen,me.august.lumen.analyze,0,0,0,0,0,0,0,0
augustt198_lumen,me.august.lumen.codegen,0,0,0,0,0,0,0,0
augustt198_lumen,me.august.lumen.data,0,0,0,0,0,0,0,0
augustt198_lumen,me.august.lumen.resolve,0,0,0,0,0,0,0,0
avandeursen_jpacman-framework-v5,org.jpacman.framework.controller,0,0,0,0,0,0,0,0
avandeursen_jpacman-framework-v5,org.jpacman.framework.factory,1,0,0,0,0,0,0,1
avandeursen_jpacman-framework-v5,org.jpacman.framework.model,1,1,0,0,1,0,0,3
avandeursen_jpacman-framework-v5,org.jpacman.framework.ui,0,0,0,0,0,0,0,0
avandeursen_jpacman-framework-v5,org.jpacman.framework.view,0,1,0,0,0,0,0,1
awslabs_aws-ant-tasks,com.amazonaws.ant,0,0,0,0,0,0,0,0
awslabs_aws-ant-tasks,com.amazonaws.ant.cloudformation,0,0,0,0,1,0,0,1
awslabs_aws-ant-tasks,com.amazonaws.ant.elasticbeanstalk,0,0,0,0,1,0,0,1
awslabs_aws-ant-tasks,com.amazonaws.ant.opsworks,0,0,0,1,1,0,0,2
awslabs_aws-ant-tasks,com.amazonaws.ant.s3,0,0,0,0,1,0,0,1
awslabs_aws-dynamodb-encryption-java,com.amazonaws.examples,0,0,0,0,1,0,0,1
awslabs_aws-dynamodb-encryption-java,com.amazonaws.services.dynamodbv2.datamodeling,0,0,0,0,0,0,0,0
awslabs_aws-dynamodb-encryption-java,com.amazonaws.services.dynamodbv2.datamodeling.encryption,0,0,0,0,1,1,0,2
awslabs_aws-dynamodb-encryption-java,com.amazonaws.services.dynamodbv2.datamodeling.encryption.materials,0,0,0,0,0,1,0,1
awslabs_aws-dynamodb-encryption-java,com.amazonaws.services.dynamodbv2.datamodeling.encryption.providers,0,0,0,0,1,1,0,2
awslabs_aws-dynamodb-encryption-java,com.amazonaws.services.dynamodbv2.datamodeling.encryption.providers.store,0,0,0,0,1,0,0,1
awslabs_aws-dynamodb-encryption-java,com.amazonaws.services.dynamodbv2.datamodeling.encryption.utils,0,0,0,0,0,0,0,0
awslabs_aws-dynamodb-encryption-java,com.amazonaws.services.dynamodbv2.datamodeling.internal,0,0,0,0,1,0,0,1
awslabs_aws-dynamodb-encryption-java,com.amazonaws.services.dynamodbv2.mapper.encryption,0,0,0,0,1,0,0,1
awslabs_aws-dynamodb-encryption-java,com.amazonaws.services.dynamodbv2.mapper.integration,0,0,0,1,0,0,0,1
awslabs_aws-dynamodb-encryption-java,software.amazon.cryptools.dynamodbencryptionclientsdk2,5,1,0,0,0,0,0,6
awslabs_aws-dynamodb-encryption-java,software.amazon.cryptools.dynamodbencryptionclientsdk2.encryption,7,1,0,0,1,1,0,10
awslabs_aws-dynamodb-encryption-java,software.amazon.cryptools.dynamodbencryptionclientsdk2.encryption.exceptions,0,0,0,0,0,0,0,0
awslabs_aws-dynamodb-encryption-java,software.amazon.cryptools.dynamodbencryptionclientsdk2.encryption.materials,0,0,0,0,0,1,0,1
awslabs_aws-dynamodb-encryption-java,software.amazon.cryptools.dynamodbencryptionclientsdk2.encryption.providers,4,0,0,0,1,1,0,6
awslabs_aws-dynamodb-encryption-java,software.amazon.cryptools.dynamodbencryptionclientsdk2.encryption.providers.store,2,0,0,0,1,0,0,3
awslabs_aws-dynamodb-encryption-java,software.amazon.cryptools.dynamodbencryptionclientsdk2.internal,2,1,0,0,1,0,0,4
awslabs_aws-sdk-java-resources,com.amazonaws.resources,0,1,0,0,1,0,0,2
awslabs_aws-sdk-java-resources,com.amazonaws.resources.internal,0,0,0,0,1,0,0,1
awslabs_aws-sdk-java-resources,com.amazonaws.resources.internal.model,0,0,0,0,1,0,0,1
awslabs_aws-sdk-java-resources,com.amazonaws.resources.internal.model.builders,0,0,0,0,0,0,0,0
awslabs_aws-sdk-java-resources,com.amazonaws.resources.foo,0,0,0,0,0,0,0,0
awslabs_aws-sdk-java-resources,com.amazonaws.resources.ec2,0,0,0,1,1,0,0,2
awslabs_aws-sdk-java-resources,com.amazonaws.resources.ec2.internal,0,0,0,1,1,0,0,2
awslabs_aws-sdk-java-resources,com.amazonaws.resources.glacier,0,0,0,0,1,0,0,1
awslabs_aws-sdk-java-resources,com.amazonaws.resources.glacier.internal,0,0,0,0,1,0,0,1
awslabs_aws-sdk-java-resources,com.amazonaws.resources.identitymanagement,0,0,0,1,1,0,0,2
awslabs_aws-sdk-java-resources,com.amazonaws.resources.identitymanagement.internal,0,0,0,1,1,0,0,2
awslabs_aws-sdk-java-resources,com.amazonaws.resources.sns.internal,0,0,0,0,1,0,0,1
awslabs_aws-sdk-java-resources,com.amazonaws.resources.sns,0,0,0,0,1,0,0,1
awslabs_aws-sdk-java-resources,com.amazonaws.resources.sqs.internal,0,0,0,0,1,0,0,1
awslabs_aws-sdk-java-resources,com.amazonaws.resources.sqs,0,0,0,0,0,0,0,0
AzureAD_azure-activedirectory-library-for-java,com.microsoft.aad.adal4j,0,0,0,1,0,0,0,1
AzureAD_azure-activedirectory-library-for-java,(default package),0,0,0,0,0,0,0,0
Azure_azure-documentdb-java,com.microsoft.azure.documentdb.benchmark,0,0,0,0,0,0,0,0
Azure_azure-documentdb-java,com.microsoft.azure.documentdb.bulkimport,0,0,0,1,1,0,0,2
Azure_azure-documentdb-java,com.microsoft.azure.documentdb.examples,0,0,0,0,0,0,0,0
Baqend_Orestes-Bloomfilter,orestes.bloomfilter,1,1,0,0,1,0,1,4
Baqend_Orestes-Bloomfilter,orestes.bloomfilter.cachesketch,0,1,0,0,0,0,1,2
Baqend_Orestes-Bloomfilter,orestes.bloomfilter.json,0,0,0,0,0,0,1,1
Baqend_Orestes-Bloomfilter,orestes.bloomfilter.memory,0,0,0,0,0,0,1,1
Baqend_Orestes-Bloomfilter,orestes.bloomfilter.redis,0,0,0,0,0,0,1,1
Baqend_Orestes-Bloomfilter,orestes.bloomfilter.redis.helper,1,0,0,0,0,0,1,2
Baqend_Orestes-Bloomfilter,performance,0,0,0,0,1,0,1,2
basis-technology-corp_tcl-regex-java,com.basistech.tclre,0,0,0,1,0,0,0,1
bedrin_jdbc-sniffer,io.sniffy,3,1,0,1,0,1,0,6
bedrin_jdbc-sniffer,io.sniffy.configuration,0,0,0,0,0,0,0,0
bedrin_jdbc-sniffer,io.sniffy.registry,0,0,0,0,0,0,0,0
bedrin_jdbc-sniffer,io.sniffy.socket,2,1,0,0,0,1,0,4
bedrin_jdbc-sniffer,io.sniffy.sql,2,0,0,1,0,1,0,4
bedrin_jdbc-sniffer,io.sniffy.util,0,0,0,0,1,0,0,1
bedrin_jdbc-sniffer,io.sniffy.junit,0,0,0,0,0,0,0,0
bedrin_jdbc-sniffer,io.sniffy.spring,0,0,0,0,0,0,0,0
bedrin_jdbc-sniffer,io.sniffy.boot,0,0,0,0,0,0,0,0
bedrin_jdbc-sniffer,io.sniffy.servlet,0,0,0,0,1,0,0,1
bedrin_jsonde,com.jsonde.agent,0,0,0,0,0,0,0,0
bedrin_jsonde,com.jsonde.api.configuration,0,0,0,0,0,0,0,0
bedrin_jsonde,com.jsonde.api.function.echo,0,0,0,0,0,0,0,0
bedrin_jsonde,com.jsonde.api.function,0,0,0,0,0,0,0,0
bedrin_jsonde,com.jsonde.api.function.heap,0,0,0,0,0,0,0,0
bedrin_jsonde,com.jsonde.api,0,0,0,0,0,0,0,0
bedrin_jsonde,com.jsonde.api.methodCall,0,0,0,0,1,1,0,2
bedrin_jsonde,com.jsonde.api.serialization,0,0,0,0,0,0,0,0
bedrin_jsonde,com.jsonde.api.telemetry,0,0,0,0,0,0,0,0
bedrin_jsonde,com.jsonde.client,0,0,0,0,0,2,0,2
bedrin_jsonde,com.jsonde.client.dao,0,0,0,0,0,5,0,5
bedrin_jsonde,com.jsonde.client.domain,0,0,0,0,0,5,0,5
bedrin_jsonde,com.jsonde.client.network,0,0,0,0,0,1,0,1
bedrin_jsonde,com.jsonde.client.sun,0,0,0,0,0,0,0,0
bedrin_jsonde,com.jsonde,0,0,0,0,0,0,0,0
bedrin_jsonde,com.jsonde.gui.action,3,0,0,0,1,1,0,5
bedrin_jsonde,com.jsonde.gui.action.composite,0,0,0,0,0,0,0,0
bedrin_jsonde,com.jsonde.gui.action.reports,1,0,0,0,0,0,0,1
bedrin_jsonde,com.jsonde.gui,8,1,0,0,0,5,0,14
bedrin_jsonde,com.jsonde.gui.components.accordion,0,0,0,0,0,0,0,0
bedrin_jsonde,com.jsonde.gui.components.composite,0,0,0,0,0,0,0,0
bedrin_jsonde,com.jsonde.gui.components,0,0,0,0,0,0,0,0
bedrin_jsonde,com.jsonde.gui.components.listpane,0,0,0,0,1,0,0,1
bedrin_jsonde,com.jsonde.gui.components.timeChart,0,0,0,0,0,0,0,0
bedrin_jsonde,com.jsonde.gui.configuration,0,0,0,0,0,0,0,0
bedrin_jsonde,com.jsonde.gui.dialog.about,0,0,0,0,0,0,0,0
bedrin_jsonde,com.jsonde.gui.dialog.error,0,0,0,0,0,0,0,0
bedrin_jsonde,com.jsonde.gui.dialog,0,0,0,0,0,0,0,0
bedrin_jsonde,com.jsonde.gui.dialog.license,1,1,0,0,0,0,0,2
bedrin_jsonde,com.jsonde.gui.dialog.project,0,0,0,0,0,0,0,0
bedrin_jsonde,com.jsonde.gui.dialog.project.sun,1,0,0,0,0,0,0,1
bedrin_jsonde,com.jsonde.gui.license.codec.binary,0,0,0,0,0,0,0,0
bedrin_jsonde,com.jsonde.gui.license.codec,0,0,0,0,1,0,0,1
bedrin_jsonde,com.jsonde.gui.license,2,1,0,0,0,1,0,4
bedrin_jsonde,com.jsonde.gui.profiler,1,0,0,0,0,1,0,2
bedrin_jsonde,com.jsonde.gui.reports,2,0,0,0,1,0,0,3
bedrin_jsonde,com.jsonde.gui.reports.custom,0,0,0,0,0,1,0,1
bedrin_jsonde,com.jsonde.gui.sdedit,6,0,0,0,0,2,0,8
bedrin_jsonde,com.jsonde.gui.tree,0,0,0,0,0,0,0,0
bedrin_jsonde,com.jsonde.instrumentation,1,0,0,0,1,0,0,2
bedrin_jsonde,com.jsonde.instrumentation.classloader,1,1,0,0,0,0,0,2
bedrin_jsonde,com.jsonde.instrumentation.profiler,0,0,0,0,0,0,0,0
bedrin_jsonde,com.jsonde.profiler,1,0,0,0,1,1,0,3
bedrin_jsonde,com.jsonde.profiler.heap,1,1,0,0,0,0,0,2
bedrin_jsonde,com.jsonde.profiler.network,0,0,0,0,0,1,0,1
bedrin_jsonde,com.jsonde.profiler.telemetry,0,0,0,0,0,0,0,0
bedrin_jsonde,org.objectweb.asm,0,0,0,0,0,0,0,0
bedrin_jsonde,com.jsonde.util,0,0,0,0,1,0,0,1
bedrin_jsonde,com.jsonde.util.db,0,0,0,0,0,0,0,0
bedrin_jsonde,com.jsonde.util.file,0,0,0,0,0,0,0,0
bedrin_jsonde,com.jsonde.util.io,0,0,0,0,0,2,0,2
bedrin_jsonde,com.jsonde.util.log,0,0,0,0,0,1,0,1
bedrin_jsonde,com.jsonde.util.pool,0,0,0,0,0,0,0,0
benas_easy-batch,$,0,0,0,0,0,0,1,1
benas_easy-batch,org.easybatch.bench,0,0,0,0,0,0,1,1
benas_easy-batch,org.easybatch.core.converter,0,0,0,1,0,0,1,2
benas_easy-batch,org.easybatch.core.field,0,0,0,0,0,0,1,1
benas_easy-batch,org.easybatch.core.filter,0,0,0,0,0,0,1,1
benas_easy-batch,org.easybatch.core.jmx,0,0,0,0,0,0,1,1
benas_easy-batch,org.easybatch.core.job,9,1,0,0,0,3,1,14
benas_easy-batch,org.easybatch.core.listener,4,0,0,0,1,1,1,7
benas_easy-batch,org.easybatch.core.mapper,0,0,0,0,1,1,1,3
benas_easy-batch,org.easybatch.core.marshaller,0,0,0,0,0,0,1,1
benas_easy-batch,org.easybatch.core.processor,1,0,0,0,0,2,1,4
benas_easy-batch,org.easybatch.core.reader,3,0,0,0,0,1,1,5
benas_easy-batch,org.easybatch.core.record,4,1,0,0,1,4,1,11
benas_easy-batch,org.easybatch.core.retry,0,0,0,0,0,0,1,1
benas_easy-batch,org.easybatch.core.util,8,1,0,0,0,0,1,10
benas_easy-batch,org.easybatch.core.validator,0,0,0,0,0,0,1,1
benas_easy-batch,org.easybatch.core.writer,4,0,0,1,0,0,1,6
benas_easy-batch,org.easybatch.core.beans,0,0,0,0,0,0,1,1
benas_easy-batch,org.easybatch.extensions.apache.common.csv,0,0,0,0,0,0,1,1
benas_easy-batch,org.easybatch.extensions.gson,0,0,0,0,0,1,1,2
benas_easy-batch,org.easybatch.extensions.hibernate,0,0,0,0,0,0,1,1
benas_easy-batch,org.easybatch.extensions.jackson,0,0,0,0,0,1,1,2
benas_easy-batch,org.easybatch.extensions.mongodb,0,0,0,0,1,0,1,2
benas_easy-batch,org.easybatch.extensions.msexcel,0,0,0,0,1,0,1,2
benas_easy-batch,org.easybatch.extensions.opencsv,0,0,0,0,0,0,1,1
benas_easy-batch,org.easybatch.extensions.quartz,0,0,0,0,0,0,1,1
benas_easy-batch,org.easybatch.extensions.spring,0,0,0,0,0,0,1,1
benas_easy-batch,org.easybatch.extensions.stream,0,0,0,0,0,0,1,1
benas_easy-batch,org.easybatch.extensions.univocity,0,0,0,0,1,0,1,2
benas_easy-batch,org.easybatch.extensions.xstream,0,0,0,0,0,0,1,1
benas_easy-batch,org.easybatch.extensions.yaml,0,0,0,0,0,0,1,1
benas_easy-batch,org.easybatch.flatfile,0,1,0,0,0,1,1,3
benas_easy-batch,org.easybatch.jdbc,0,1,0,0,1,0,1,3
benas_easy-batch,org.easybatch.jms,0,0,0,0,1,0,1,2
benas_easy-batch,org.easybatch.jpa,0,0,0,0,0,0,1,1
benas_easy-batch,org.easybatch.json,0,0,0,0,0,2,1,3
benas_easy-batch,org.easybatch.tools.monitoring,0,0,0,0,0,0,1,1
benas_easy-batch,org.easybatch.tools.reporting,0,0,0,0,0,0,1,1
benas_easy-batch,org.easybatch.tutorials.advanced.cbrd,0,0,0,0,0,0,1,1
benas_easy-batch,org.easybatch.tutorials.advanced.jms,0,0,0,0,0,0,1,1
benas_easy-batch,org.easybatch.tutorials.advanced.jmx,0,0,0,0,0,0,1,1
benas_easy-batch,org.easybatch.tutorials.advanced.metric,0,0,0,0,0,0,1,1
benas_easy-batch,org.easybatch.tutorials.advanced.parallel,0,0,0,0,0,0,1,1
benas_easy-batch,org.easybatch.tutorials.advanced.quartz,0,0,0,0,0,0,1,1
benas_easy-batch,org.easybatch.tutorials.advanced.recipes,0,0,0,0,0,0,1,1
benas_easy-batch,org.easybatch.tutorials.advanced.restart,0,0,0,0,0,0,1,1
benas_easy-batch,org.easybatch.tutorials.advanced.spring,0,0,0,0,0,0,1,1
benas_easy-batch,org.easybatch.tutorials.basic.helloworld,0,0,0,0,0,0,1,1
benas_easy-batch,org.easybatch.tutorials.basic.wordcount,0,0,0,0,0,0,1,1
benas_easy-batch,org.easybatch.tutorials.common,0,0,0,0,0,0,1,1
benas_easy-batch,org.easybatch.tutorials.intermediate.csv2xml,0,0,0,0,0,0,1,1
benas_easy-batch,org.easybatch.tutorials.intermediate.elasticsearch,0,0,0,0,0,0,1,1
benas_easy-batch,org.easybatch.tutorials.intermediate.extract,0,0,0,0,0,0,1,1
benas_easy-batch,org.easybatch.tutorials.intermediate.load,0,0,0,0,0,0,1,1
benas_easy-batch,org.easybatch.validation,0,0,0,0,0,0,1,1
benas_easy-batch,org.easybatch.xml,0,0,0,0,0,0,1,1
benjiman_expressions,uk.co.benjiweber.expressions,0,0,0,1,1,0,0,2
benjiman_expressions,uk.co.benjiweber.expressions.caseclass,0,0,0,1,0,0,0,1
benjiman_expressions,uk.co.benjiweber.expressions.caseclass.constructor,0,0,0,0,0,0,0,0
benjiman_expressions,uk.co.benjiweber.expressions.caseclass.constructor.references,0,0,0,0,0,0,0,0
benjiman_expressions,uk.co.benjiweber.expressions.collections,0,0,0,0,1,0,0,1
benjiman_expressions,uk.co.benjiweber.expressions.exceptions,0,0,0,0,1,0,0,1
benjiman_expressions,uk.co.benjiweber.expressions.functions,0,0,0,0,1,0,0,1
benjiman_expressions,uk.co.benjiweber.expressions.properties,0,0,0,0,1,0,0,1
benjiman_expressions,uk.co.benjiweber.expressions.tuples,0,0,0,0,0,0,0,0
beothorn_webGrude,webGrude,0,0,0,0,0,0,0,0
beothorn_webGrude,webGrude.elements,0,0,0,0,0,0,0,0
beothorn_webGrude,webGrude.http,0,0,0,0,0,0,0,0
beothorn_webGrude,webGrude.mappables,0,0,0,0,1,0,0,1
biboudis_streamalg,benchmarks,0,0,0,0,0,0,0,0
biboudis_streamalg,gadt,0,0,0,0,0,0,0,0
biboudis_streamalg,gadt.collection,0,0,0,0,0,0,0,0
biboudis_streamalg,gadt.evaluator,0,0,0,0,1,0,0,1
biboudis_streamalg,streams.algebras,0,0,0,0,0,0,0,0
biboudis_streamalg,streams.factories,0,0,0,0,1,0,0,1
biboudis_streamalg,streams.fold,0,0,0,0,0,0,0,0
biboudis_streamalg,streams.higher,0,0,0,0,1,0,0,1
biboudis_streamalg,algebras,0,0,0,0,1,0,0,1
biboudis_streamalg,base,0,0,0,0,0,0,0,0
biboudis_streamalg,fold,0,0,0,0,0,0,0,0
biboudis_streamalg,benchmarks.generated,0,0,0,1,0,0,0,1
biboudis_streamalg,org.openjdk.jmh.infra.generated,0,0,0,0,0,0,0,0
bitcoin-solutions_multibit-website,org.multibit.site.core.atom,1,1,0,0,1,0,0,3
bitcoin-solutions_multibit-website,org.multibit.site.core.cleaner,0,0,0,0,0,0,0,0
bitcoin-solutions_multibit-website,org.multibit.site.core.languages,0,0,0,0,0,0,0,0
bitcoin-solutions_multibit-website,org.multibit.site.core.resizer,0,0,0,0,0,0,0,0
bitcoin-solutions_multibit-website,org.multibit.site.core.sitemap,1,1,0,0,0,0,0,2
bitcoin-solutions_multibit-website,org.multibit.site.health,0,0,0,0,0,0,0,0
bitcoin-solutions_multibit-website,org.multibit.site.model,2,0,0,0,0,0,0,2
bitcoin-solutions_multibit-website,org.multibit.site.resources,2,1,0,0,1,0,0,4
bitcoin-solutions_multibit-website,org.multibit.site.servlets,0,0,0,0,0,0,0,0
bitcoin-solutions_multibit-website,org.multibit.site,0,0,0,0,0,0,0,0
bitcoin-solutions_multibit-website,org.multibit.site.utils,2,0,0,0,0,0,0,2
bitcoin-solutions_multibit-website,org.multibit.site.views,0,0,0,0,0,0,0,0
bitcoin-solutions_multibit-website,(default package),0,0,0,0,0,0,0,0
bitcoin-solutions_multibit-website,org.multibit.site.core.resources,0,0,0,0,0,0,0,0
bitcoinj_bitcoinj,org.bitcoin.crawler,0,0,0,0,0,0,1,1
bitcoinj_bitcoinj,org.bitcoin,0,0,0,0,0,0,1,1
bitcoinj_bitcoinj,org.bitcoin.protocols.payments,0,0,0,0,0,0,1,1
bitcoinj_bitcoinj,org.bitcoinj.core,18,1,0,1,0,0,1,21
bitcoinj_bitcoinj,org.bitcoinj.core.listeners,2,0,0,0,1,0,1,4
bitcoinj_bitcoinj,org.bitcoinj.crypto,6,1,0,1,0,0,1,9
bitcoinj_bitcoinj,org.bitcoinj.jni,0,0,0,0,1,0,1,2
bitcoinj_bitcoinj,org.bitcoinj.kits,0,0,0,0,0,0,1,1
bitcoinj_bitcoinj,org.bitcoinj.net,1,0,0,0,0,0,1,2
bitcoinj_bitcoinj,org.bitcoinj.net.discovery,0,0,0,0,0,0,1,1
bitcoinj_bitcoinj,org.bitcoinj.params,2,1,0,0,1,0,1,5
bitcoinj_bitcoinj,org.bitcoinj.protocols.payments,0,0,0,0,0,0,1,1
bitcoinj_bitcoinj,org.bitcoinj.script,6,1,0,0,0,0,1,8
bitcoinj_bitcoinj,org.bitcoinj.signers,2,0,0,0,0,0,1,3
bitcoinj_bitcoinj,org.bitcoinj.store,3,1,0,0,0,0,1,5
bitcoinj_bitcoinj,org.bitcoinj.uri,0,0,0,0,0,0,1,1
bitcoinj_bitcoinj,org.bitcoinj.utils,3,1,0,1,1,0,1,7
bitcoinj_bitcoinj,org.bitcoinj.wallet,12,1,0,2,0,0,1,16
bitcoinj_bitcoinj,org.bitcoinj.wallet.listeners,3,1,1,0,1,0,1,7
bitcoinj_bitcoinj,org.bitcoinj.examples,0,0,0,0,1,0,1,2
bitcoinj_bitcoinj,org.bitcoinj.tools,0,0,0,0,1,0,1,2
bitcoinj_bitcoinj,wallettemplate.controls,1,1,0,0,0,0,1,3
bitcoinj_bitcoinj,wallettemplate,1,0,0,0,0,0,1,2
bitcoinj_bitcoinj,wallettemplate.utils,0,1,0,0,1,0,1,3
bitcoinj_bitcoinj,wallettemplate.utils.easing,0,0,0,0,0,0,1,1
BjoernKW_ZenQuery,com.zenquery.api,0,0,0,0,0,0,0,0
BjoernKW_ZenQuery,com.zenquery.exception,0,0,0,0,0,0,0,0
BjoernKW_ZenQuery,com.zenquery.filter,0,0,0,0,0,0,0,0
BjoernKW_ZenQuery,com.zenquery.model.dao,0,0,0,0,0,1,0,1
BjoernKW_ZenQuery,com.zenquery.model.dao.impl,0,0,0,0,1,1,0,2
BjoernKW_ZenQuery,com.zenquery.model,0,0,0,0,1,1,0,2
BjoernKW_ZenQuery,com.zenquery,0,0,0,0,0,0,0,0
BjoernKW_ZenQuery,com.zenquery.util,0,0,0,0,0,0,0,0
bjornharrtell_jdbc-http-server,model,0,0,0,0,1,0,0,1
bjornharrtell_jdbc-http-server,org.wololo.jdbc,0,0,0,0,0,0,0,0
bjornharrtell_jdbc-http-server,org.wololo.jdbc.resources,0,0,0,0,1,0,0,1
blockchain_api-v1-client-java,info.blockchain.api,0,0,0,0,1,0,0,1
blockchain_api-v1-client-java,info.blockchain.api.blockexplorer,0,0,0,0,0,0,0,0
blockchain_api-v1-client-java,info.blockchain.api.blockexplorer.entity,0,0,0,0,1,0,0,1
blockchain_api-v1-client-java,info.blockchain.api.etc,0,0,0,0,0,0,0,0
blockchain_api-v1-client-java,info.blockchain.api.exchangerates,0,0,0,0,0,0,0,0
blockchain_api-v1-client-java,info.blockchain.api.pushtx,0,0,0,0,0,0,0,0
blockchain_api-v1-client-java,info.blockchain.api.receive,0,0,0,0,0,0,0,0
blockchain_api-v1-client-java,info.blockchain.api.statistics,0,0,0,0,0,0,0,0
blockchain_api-v1-client-java,info.blockchain.api.wallet.entity,0,0,0,0,0,0,0,0
blockchain_api-v1-client-java,info.blockchain.api.wallet,0,0,0,0,0,0,0,0
bonigarcia_dualsub,io.github.bonigarcia.dualsub.gui,1,0,0,1,0,0,0,2
bonigarcia_dualsub,io.github.bonigarcia.dualsub.srt,1,1,0,0,0,0,0,2
bonigarcia_dualsub,io.github.bonigarcia.dualsub.translate,0,0,0,0,1,0,0,1
bonigarcia_dualsub,io.github.bonigarcia.dualsub.util,0,0,0,0,0,0,0,0
brettwooldridge_HikariJSON,com.zaxxer.hikari.json,0,0,0,0,1,0,0,1
brettwooldridge_HikariJSON,com.zaxxer.hikari.json.serializer,0,0,0,0,0,0,0,0
brettwooldridge_HikariJSON,com.zaxxer.hikari.json.util,0,0,0,0,1,0,0,1
bruno-medeiros_DDT,melnorme.utilbox.collections,4,1,0,0,0,3,1,9
bruno-medeiros_DDT,melnorme.utilbox.collections.iter,0,0,0,0,0,0,1,1
bruno-medeiros_DDT,melnorme.utilbox.concurrency,1,0,0,1,0,8,1,11
bruno-medeiros_DDT,melnorme.utilbox.core,4,1,0,0,1,27,1,34
bruno-medeiros_DDT,melnorme.utilbox.core.fntypes,1,1,0,0,1,4,1,8
bruno-medeiros_DDT,melnorme.utilbox.fields,0,0,0,0,1,1,1,3
bruno-medeiros_DDT,melnorme.utilbox.fields.validation,0,0,0,0,1,0,1,2
bruno-medeiros_DDT,melnorme.utilbox.misc,5,1,0,0,1,8,1,16
bruno-medeiros_DDT,melnorme.utilbox.ownership,0,0,0,0,0,0,1,1
bruno-medeiros_DDT,melnorme.utilbox.process,0,0,0,0,0,4,1,5
bruno-medeiros_DDT,melnorme.utilbox.status,0,0,0,0,0,0,1,1
bruno-medeiros_DDT,melnorme.utilbox.tree,0,0,0,0,1,0,1,2
bruno-medeiros_DDT,melnorme.lang.ide.core,17,1,0,0,1,1,1,21
bruno-medeiros_DDT,melnorme.lang.ide.core.project_model.view,0,0,0,0,1,0,1,2
bruno-medeiros_DDT,mmrnmhrm.core.build,5,0,0,0,1,0,1,7
bruno-medeiros_DDT,mmrnmhrm.core,3,1,0,0,0,0,1,5
bruno-medeiros_DDT,mmrnmhrm.core.dub_model,3,0,0,0,1,0,1,5
bruno-medeiros_DDT,mmrnmhrm.core.engine,7,1,0,0,1,4,1,14
bruno-medeiros_DDT,mmrnmhrm.core.launch,1,0,0,0,0,0,1,2
bruno-medeiros_DDT,mmrnmhrm.core.text,0,0,0,0,0,0,1,1
bruno-medeiros_DDT,mmrnmhrm.core.workspace.viewmodel,0,1,0,0,0,0,1,2
bruno-medeiros_DDT,org.dsource.ddt.ide.core,0,0,0,0,0,0,1,1
bruno-medeiros_DDT,melnorme.lang.ide.core.engine,2,0,0,0,1,1,1,5
bruno-medeiros_DDT,melnorme.lang.ide.core.launch,2,0,0,0,1,0,1,4
bruno-medeiros_DDT,melnorme.lang.ide.core.operations,4,0,0,0,1,0,1,6
bruno-medeiros_DDT,melnorme.lang.ide.core.operations.build,2,1,0,0,1,0,1,5
bruno-medeiros_DDT,melnorme.lang.ide.core.project_model,0,0,0,0,1,0,1,2
bruno-medeiros_DDT,melnorme.lang.ide.core.text,0,1,0,0,1,1,1,4
bruno-medeiros_DDT,melnorme.lang.ide.core.text.format,0,0,0,0,0,0,1,1
bruno-medeiros_DDT,melnorme.lang.ide.core.utils,5,1,0,0,1,0,1,8
bruno-medeiros_DDT,melnorme.lang.ide.core.utils.operation,3,0,0,0,1,1,1,6
bruno-medeiros_DDT,melnorme.lang.ide.core.utils.prefs,0,0,0,0,1,1,1,3
bruno-medeiros_DDT,melnorme.lang.ide.core.utils.process,0,0,0,0,0,0,1,1
bruno-medeiros_DDT,melnorme.lang.ide.launching,1,0,0,0,0,0,1,2
bruno-medeiros_DDT,melnorme.lang.ide.debug.core,0,0,0,0,1,0,1,2
bruno-medeiros_DDT,melnorme.lang.ide.debug.ui,0,0,0,0,1,0,1,2
bruno-medeiros_DDT,org.dsource.ddt.debug.core,0,0,0,0,0,0,1,1
bruno-medeiros_DDT,org.dsource.ddt.debug.ui,0,0,0,0,0,0,1,1
bruno-medeiros_DDT,melnorme.lang.ide.debug.core.services,0,0,0,0,0,0,1,1
bruno-medeiros_DDT,melnorme.lang.ide.debug.ui.viewmodel,0,0,0,0,1,0,1,2
bruno-medeiros_DDT,mmrnmhrm.core.launch.debug,0,0,0,0,0,0,1,1
bruno-medeiros_DDT,melnorme.lang.ide.ui,18,1,0,0,1,0,1,21
bruno-medeiros_DDT,melnorme.lang.ide.ui.navigator,0,0,0,1,1,0,1,3
bruno-medeiros_DDT,melnorme.lang.ide.ui.text,0,0,0,0,1,0,1,2
bruno-medeiros_DDT,mmrnmhrm.ui.actions,0,0,0,0,0,0,1,1
bruno-medeiros_DDT,mmrnmhrm.ui,9,1,0,0,1,0,1,12
bruno-medeiros_DDT,mmrnmhrm.ui.editor,0,0,0,0,1,0,1,2
bruno-medeiros_DDT,mmrnmhrm.ui.editor.codeassist,0,0,0,0,0,0,1,1
bruno-medeiros_DDT,mmrnmhrm.ui.editor.folding,0,0,0,0,0,0,1,1
bruno-medeiros_DDT,mmrnmhrm.ui.editor.hover,5,1,0,0,0,0,1,7
bruno-medeiros_DDT,mmrnmhrm.ui.editor.templates,0,0,0,0,0,0,1,1
bruno-medeiros_DDT,mmrnmhrm.ui.editor.text,0,0,0,0,0,0,1,1
bruno-medeiros_DDT,mmrnmhrm.ui.launch,0,0,0,0,0,0,1,1
bruno-medeiros_DDT,mmrnmhrm.ui.navigator,0,0,0,0,1,0,1,2
bruno-medeiros_DDT,mmrnmhrm.ui.preferences,0,0,0,0,0,0,1,1
bruno-medeiros_DDT,mmrnmhrm.ui.preferences.pages,0,1,0,0,1,0,1,3
bruno-medeiros_DDT,mmrnmhrm.ui.text,0,1,0,0,0,0,1,2
bruno-medeiros_DDT,mmrnmhrm.ui.views,0,0,0,0,0,0,1,1
bruno-medeiros_DDT,mmrnmhrm.ui.wizards,0,0,0,0,0,0,1,1
bruno-medeiros_DDT,org.dsource.ddt.ide.core_text,0,0,0,0,0,0,1,1
bruno-medeiros_DDT,org.dsource.ddt.ui.tabgroup,0,0,0,0,0,0,1,1
bruno-medeiros_DDT,_org.eclipse.dltk.internal.ui.actions,0,0,0,0,0,0,1,1
bruno-medeiros_DDT,_org.eclipse.dltk.internal.ui.dialogs,0,0,0,0,0,0,1,1
bruno-medeiros_DDT,_org.eclipse.dltk.internal.ui.editor,0,0,0,0,1,0,1,2
bruno-medeiros_DDT,_org.eclipse.dltk.ui.dialogs,0,0,0,0,0,0,1,1
bruno-medeiros_DDT,_org.eclipse.dltk.ui,0,0,0,0,0,0,1,1
bruno-medeiros_DDT,_org.eclipse.dltk.ui.preferences,0,0,0,0,1,0,1,2
bruno-medeiros_DDT,_org.eclipse.dltk.ui.text.completion,0,0,0,0,0,0,1,1
bruno-medeiros_DDT,_org.eclipse.dltk.ui.text.folding,0,0,0,0,1,0,1,2
bruno-medeiros_DDT,_org.eclipse.dltk.ui.util,0,0,0,0,0,0,1,1
bruno-medeiros_DDT,_org.eclipse.jdt.internal.ui.text,0,0,0,0,0,0,1,1
bruno-medeiros_DDT,melnorme.lang.ide.core_text,2,0,0,0,1,0,1,4
bruno-medeiros_DDT,melnorme.lang.ide.ui.actions,0,0,0,0,0,0,1,1
bruno-medeiros_DDT,melnorme.lang.ide.ui.build,0,0,0,0,1,0,1,2
bruno-medeiros_DDT,melnorme.lang.ide.ui.dialogs,6,0,0,0,1,0,1,8
bruno-medeiros_DDT,melnorme.lang.ide.ui.editor,2,0,0,0,1,0,1,4
bruno-medeiros_DDT,melnorme.lang.ide.ui.editor.actions,0,0,0,0,1,0,1,2
bruno-medeiros_DDT,melnorme.lang.ide.ui.editor.hover,0,1,0,0,1,0,1,3
bruno-medeiros_DDT,melnorme.lang.ide.ui.editor.structure,0,0,0,0,1,0,1,2
bruno-medeiros_DDT,melnorme.lang.ide.ui.editor.text,0,0,0,0,0,0,1,1
bruno-medeiros_DDT,melnorme.lang.ide.ui.fields,0,0,0,0,0,0,1,1
bruno-medeiros_DDT,melnorme.lang.ide.ui.launch,0,0,0,0,1,0,1,2
bruno-medeiros_DDT,melnorme.lang.ide.ui.operations,0,0,0,0,1,0,1,2
bruno-medeiros_DDT,melnorme.lang.ide.ui.preferences,3,0,0,0,1,0,1,5
bruno-medeiros_DDT,melnorme.lang.ide.ui.preferences.common,0,0,0,0,1,1,1,3
bruno-medeiros_DDT,melnorme.lang.ide.ui.preferences.pages,0,0,0,0,1,0,1,2
bruno-medeiros_DDT,melnorme.lang.ide.ui.templates,0,0,0,0,1,0,1,2
bruno-medeiros_DDT,melnorme.lang.ide.ui.text.coloring,7,1,0,0,1,0,1,10
bruno-medeiros_DDT,melnorme.lang.ide.ui.text.completion,0,0,0,0,1,0,1,2
bruno-medeiros_DDT,melnorme.lang.ide.ui.tools.console,0,0,0,0,1,0,1,2
bruno-medeiros_DDT,melnorme.lang.ide.ui.utils,6,0,0,0,1,0,1,8
bruno-medeiros_DDT,melnorme.lang.ide.ui.utils.operations,3,0,0,0,1,0,1,5
bruno-medeiros_DDT,melnorme.lang.ide.ui.utils.prefs,0,0,0,0,0,0,1,1
bruno-medeiros_DDT,melnorme.lang.ide.ui.views,0,0,0,0,1,0,1,2
bruno-medeiros_DDT,melnorme.util.swt.components,0,0,0,0,1,0,1,2
bruno-medeiros_DDT,melnorme.util.swt.components.fields,1,0,0,0,1,0,1,3
bruno-medeiros_DDT,melnorme.util.swt.components.misc,0,0,0,0,0,0,1,1
bruno-medeiros_DDT,melnorme.util.swt,0,0,0,0,1,0,1,2
bruno-medeiros_DDT,melnorme.util.swt.jface,0,0,0,0,1,0,1,2
bruno-medeiros_DDT,melnorme.util.swt.jface.preference,0,0,0,0,0,0,1,1
bruno-medeiros_DDT,melnorme.util.swt.jface.resources,0,0,0,0,0,0,1,1
bruno-medeiros_DDT,melnorme.util.swt.jface.text,0,0,0,0,0,0,1,1
bruno-medeiros_DDT,_org.eclipse.debug.internal.ui,0,0,0,0,0,0,1,1
bruno-medeiros_DDT,_org.eclipse.jdt.internal.corext.template.java,0,1,0,0,1,1,1,4
bruno-medeiros_DDT,_org.eclipse.jdt.internal.ui.javaeditor,0,0,0,0,0,0,1,1
bruno-medeiros_DDT,_org.eclipse.jdt.internal.ui.text.java.hover,0,0,0,0,1,0,1,2
bruno-medeiros_DDT,_org.eclipse.jdt.internal.ui.text.template.contentassist,0,0,0,0,0,0,1,1
bruno-medeiros_DDT,_org.eclipse.jdt.internal.ui.util,0,0,0,0,0,0,1,1
bruno-medeiros_DDT,_org.eclipse.jdt.internal.ui.viewsupport,0,0,0,0,0,0,1,1
bruno-medeiros_DDT,_org.eclipse.jdt.ui,0,0,0,0,0,0,1,1
bruno-medeiros_DDT,mmrnmhrm.core_text,0,0,0,0,0,0,1,1
bruno-medeiros_DDT,mmrnmhrm.ui.editor.ref,0,0,0,0,0,0,1,1
bruno-medeiros_DDT,mmrnmhrm.ui.tools,0,0,0,0,0,0,1,1
bruno-medeiros_DDT,descent.core.ddoc,3,1,0,0,0,0,1,5
bruno-medeiros_DDT,dtool.ast.declarations,2,0,0,1,0,2,1,6
bruno-medeiros_DDT,dtool.ast.definitions,9,1,0,1,0,9,1,21
bruno-medeiros_DDT,dtool.ast.expressions,4,1,0,1,0,4,1,11
bruno-medeiros_DDT,dtool.ast.references,10,1,0,0,0,11,1,23
bruno-medeiros_DDT,dtool.ast.statements,3,0,0,1,0,1,1,6
bruno-medeiros_DDT,dtool.ddoc,2,1,0,0,1,0,1,5
bruno-medeiros_DDT,dtool,0,0,0,0,0,0,1,1
bruno-medeiros_DDT,dtool.dub,3,1,0,0,0,4,1,9
bruno-medeiros_DDT,dtool.engine,7,1,0,1,0,9,1,19
bruno-medeiros_DDT,dtool.engine.analysis,44,1,0,1,1,9,1,57
bruno-medeiros_DDT,dtool.engine.analysis.templates,4,0,0,0,1,1,1,7
bruno-medeiros_DDT,dtool.engine.compiler_installs,1,1,0,0,0,1,1,4
bruno-medeiros_DDT,dtool.engine.modules,8,1,0,0,0,1,1,11
bruno-medeiros_DDT,dtool.engine.operations,6,1,0,0,0,1,1,9
bruno-medeiros_DDT,dtool.engine.util,0,0,0,0,0,0,1,1
bruno-medeiros_DDT,dtool.genie,1,0,0,0,1,0,1,3
bruno-medeiros_DDT,dtool.genie.cmdline,1,1,0,0,0,0,1,3
bruno-medeiros_DDT,dtool.parser.common,2,1,0,0,0,8,1,12
bruno-medeiros_DDT,dtool.parser,18,0,0,1,0,14,1,34
bruno-medeiros_DDT,dtool.parser.structure,1,1,0,0,0,2,1,5
bruno-medeiros_DDT,dtool.util,0,0,0,0,1,0,1,2
bruno-medeiros_DDT,melnorme.lang.tooling.ast,12,1,0,0,0,17,1,31
bruno-medeiros_DDT,melnorme.lang.tooling.ast_actual,15,1,0,0,0,3,1,20
bruno-medeiros_DDT,melnorme.lang.tooling.bundle,4,1,0,0,1,1,1,8
bruno-medeiros_DDT,melnorme.lang.tooling,3,1,0,0,1,1,1,7
bruno-medeiros_DDT,melnorme.lang.tooling.structure,0,0,0,0,1,0,1,2
bruno-medeiros_DDT,dtool.com.google.gson.stream,0,0,0,0,0,0,1,1
bruno-medeiros_DDT,melnorme.lang.tooling.commands,0,0,0,0,0,0,1,1
bruno-medeiros_DDT,melnorme.lang.tooling.common,2,1,0,0,1,0,1,5
bruno-medeiros_DDT,melnorme.lang.tooling.common.ops,0,0,0,0,1,0,1,2
bruno-medeiros_DDT,melnorme.lang.tooling.completion,0,0,0,0,0,0,1,1
bruno-medeiros_DDT,melnorme.lang.tooling.engine,22,1,0,0,1,2,1,27
bruno-medeiros_DDT,melnorme.lang.tooling.parser.lexer,1,0,0,0,0,1,1,3
bruno-medeiros_DDT,melnorme.lang.tooling.parser,0,0,0,0,1,1,1,3
bruno-medeiros_DDT,melnorme.lang.tooling.toolchain.ops,2,0,0,0,1,1,1,5
bruno-medeiros_DDT,melnorme.lang.tooling.utils,0,0,0,0,0,0,1,1
bruno-medeiros_DDT,melnorme.lang.utils.concurrency,0,0,0,0,1,1,1,3
bruno-medeiros_DDT,melnorme.lang.utils,1,1,0,0,1,3,1,7
bruno-medeiros_DDT,melnorme.lang.utils.gson,0,0,0,0,0,0,1,1
bruno-medeiros_DDT,melnorme.lang.utils.parse,1,1,0,0,0,3,1,6
bruno-medeiros_DDT,melnorme.lang.utils.validators,0,0,0,0,0,0,1,1
bruno-medeiros_DDT,melnorme.lang.tooling.ast.util,0,0,0,0,1,2,1,4
bruno-medeiros_DDT,melnorme.lang.tooling.context,12,1,0,0,1,3,1,18
bruno-medeiros_DDT,melnorme.lang.tooling.engine.completion,0,0,0,0,0,0,1,1
bruno-medeiros_DDT,melnorme.lang.tooling.engine.intrinsics,3,0,0,0,1,2,1,7
bruno-medeiros_DDT,melnorme.lang.tooling.engine.resolver,8,1,0,0,0,7,1,17
bruno-medeiros_DDT,melnorme.lang.tooling.engine.scoping,5,1,0,0,1,9,1,17
bruno-medeiros_DDT,melnorme.lang.tooling.symbols,3,0,0,0,1,4,1,9
bruno-medeiros_DDT,dtool.json,0,0,0,0,0,0,1,1
bruno-medeiros_DDT,dtool.parser.ddoc,0,0,0,0,0,0,1,1
bruno-medeiros_DDT,dtool.sourcegen,1,0,0,0,0,1,1,3
bruno-medeiros_DDT,lang_project_id.jvmcheck,0,0,0,0,0,0,1,1
buschmais_extended-objects,com.buschmais.xo.api.bootstrap.osgi,0,0,0,0,0,0,0,0
buschmais_extended-objects,com.buschmais.xo.api.bootstrap,0,0,0,0,0,0,0,0
buschmais_extended-objects,com.buschmais.xo.api,0,0,0,0,1,1,0,2
buschmais_extended-objects,com.buschmais.xo.api.proxy,0,0,0,0,0,0,0,0
buschmais_extended-objects,com.buschmais.xo.impl,0,1,0,0,1,7,0,9
buschmais_extended-objects,com.buschmais.xo.impl.bootstrap.osgi,0,0,0,0,0,0,0,0
buschmais_extended-objects,com.buschmais.xo.impl.bootstrap,0,1,0,0,0,0,0,1
buschmais_extended-objects,com.buschmais.xo.impl.cache,0,0,0,0,1,0,0,1
buschmais_extended-objects,com.buschmais.xo.impl.instancelistener,0,0,0,0,0,0,0,0
buschmais_extended-objects,com.buschmais.xo.impl.interceptor,0,0,0,0,0,0,0,0
buschmais_extended-objects,com.buschmais.xo.impl.metadata,0,0,0,0,0,3,0,3
buschmais_extended-objects,com.buschmais.xo.impl.plugin,0,0,0,0,0,0,0,0
buschmais_extended-objects,com.buschmais.xo.impl.proxy,0,0,0,0,0,0,0,0
buschmais_extended-objects,com.buschmais.xo.impl.proxy.collection,0,0,0,0,0,0,0,0
buschmais_extended-objects,com.buschmais.xo.impl.proxy.common.composite,0,0,0,0,0,0,0,0
buschmais_extended-objects,com.buschmais.xo.impl.proxy.common,0,0,0,0,0,0,0,0
buschmais_extended-objects,com.buschmais.xo.impl.proxy.common.object,0,0,0,0,0,0,0,0
buschmais_extended-objects,com.buschmais.xo.impl.proxy.common.property,0,0,0,0,0,2,0,2
buschmais_extended-objects,com.buschmais.xo.impl.proxy.common.resultof,0,0,0,0,0,0,0,0
buschmais_extended-objects,com.buschmais.xo.impl.proxy.entity.composite,0,0,0,0,0,0,0,0
buschmais_extended-objects,com.buschmais.xo.impl.proxy.entity,0,0,0,0,0,0,0,0
buschmais_extended-objects,com.buschmais.xo.impl.proxy.entity.object,0,0,0,0,0,1,0,1
buschmais_extended-objects,com.buschmais.xo.impl.proxy.entity.property,0,0,0,0,1,1,0,2
buschmais_extended-objects,com.buschmais.xo.impl.proxy.entity.resultof,0,0,0,0,0,0,0,0
buschmais_extended-objects,com.buschmais.xo.impl.proxy.example.composite,0,0,0,0,0,0,0,0
buschmais_extended-objects,com.buschmais.xo.impl.proxy.example,0,0,0,0,0,0,0,0
buschmais_extended-objects,com.buschmais.xo.impl.proxy.example.property,0,0,0,0,0,0,0,0
buschmais_extended-objects,com.buschmais.xo.impl.proxy.query.composite,0,0,0,0,0,0,0,0
buschmais_extended-objects,com.buschmais.xo.impl.proxy.query.object,0,0,0,0,0,0,0,0
buschmais_extended-objects,com.buschmais.xo.impl.proxy.query.property,0,0,0,0,0,0,0,0
buschmais_extended-objects,com.buschmais.xo.impl.proxy.query.row,0,0,0,0,0,0,0,0
buschmais_extended-objects,com.buschmais.xo.impl.proxy.query,0,0,0,0,0,0,0,0
buschmais_extended-objects,com.buschmais.xo.impl.proxy.relation.composite,0,0,0,0,0,0,0,0
buschmais_extended-objects,com.buschmais.xo.impl.proxy.relation.object,0,0,0,0,0,1,0,1
buschmais_extended-objects,com.buschmais.xo.impl.proxy.relation.property,0,0,0,0,0,0,0,0
buschmais_extended-objects,com.buschmais.xo.impl.proxy.relation,0,0,0,0,0,0,0,0
buschmais_extended-objects,com.buschmais.xo.impl.proxy.relation.resultof,0,0,0,0,0,0,0,0
buschmais_extended-objects,com.buschmais.xo.impl.proxy.repository.composite,0,0,0,0,0,0,0,0
buschmais_extended-objects,com.buschmais.xo.impl.proxy.repository.object,0,0,0,0,0,0,0,0
buschmais_extended-objects,com.buschmais.xo.impl.proxy.repository,0,0,0,0,0,0,0,0
buschmais_extended-objects,com.buschmais.xo.impl.query,0,1,0,0,0,0,0,1
buschmais_extended-objects,com.buschmais.xo.impl.transaction,0,0,0,0,0,1,0,1
buschmais_extended-objects,com.buschmais.xo.impl.validation,0,0,0,0,0,0,0,0
buschmais_extended-objects,com.buschmais.xo.impl.schema.v1,0,0,0,0,0,0,0,0
buschmais_extended-objects,com.buschmais.xo.inject,0,0,0,0,0,0,0,0
buschmais_extended-objects,com.buschmais.xo.neo4j.api.model,0,0,0,0,1,0,0,1
buschmais_extended-objects,com.buschmais.xo.neo4j.api,0,0,0,0,0,0,0,0
buschmais_extended-objects,com.buschmais.xo.neo4j.doc,0,0,0,0,0,0,0,0
buschmais_extended-objects,com.buschmais.xo.neo4j.doc.bootstrap,0,0,0,0,0,0,0,0
buschmais_extended-objects,com.buschmais.xo.neo4j.doc.dynamic,0,0,0,0,0,0,0,0
buschmais_extended-objects,com.buschmais.xo.neo4j.doc.implementedby,0,0,0,0,0,0,0,0
buschmais_extended-objects,com.buschmais.xo.neo4j.doc.label,0,0,0,0,0,0,0,0
buschmais_extended-objects,com.buschmais.xo.neo4j.doc.label.explicit,0,0,0,0,0,0,0,0
buschmais_extended-objects,com.buschmais.xo.neo4j.doc.relation,0,0,0,0,0,0,0,0
buschmais_extended-objects,com.buschmais.xo.neo4j.doc.relation.qualified,0,0,0,0,0,0,0,0
buschmais_extended-objects,com.buschmais.xo.neo4j.doc.relation.self,0,0,0,0,0,0,0,0
buschmais_extended-objects,com.buschmais.xo.neo4j.doc.relation.typed,0,0,0,0,0,0,0,0
buschmais_extended-objects,com.buschmais.xo.neo4j.doc.relation.unidirectional,0,0,0,0,0,0,0,0
buschmais_extended-objects,com.buschmais.xo.neo4j.doc.relation.unidirectional.explicit,0,0,0,0,0,0,0,0
buschmais_extended-objects,com.buschmais.xo.neo4j.doc.repository,0,0,0,0,0,0,0,0
buschmais_extended-objects,com.buschmais.xo.neo4j.doc.template,0,0,0,0,0,0,0,0
buschmais_extended-objects,com.buschmais.xo.neo4j.doc.transientproperty,0,0,0,0,0,0,0,0
buschmais_extended-objects,com.buschmais.xo.neo4j.embedded.api,0,1,0,0,1,0,0,2
buschmais_extended-objects,com.buschmais.xo.neo4j.embedded.impl.converter,0,0,0,0,0,0,0,0
buschmais_extended-objects,com.buschmais.xo.neo4j.embedded.impl.datastore,0,0,0,0,1,1,0,2
buschmais_extended-objects,com.buschmais.xo.neo4j.embedded.impl.model,0,0,0,0,1,1,0,2
buschmais_extended-objects,com.buschmais.xo.neo4j.remote.api,1,1,0,0,0,0,0,2
buschmais_extended-objects,com.buschmais.xo.neo4j.remote.impl.converter,0,0,0,0,0,0,0,0
buschmais_extended-objects,com.buschmais.xo.neo4j.remote.impl.datastore,1,0,0,0,1,1,0,3
buschmais_extended-objects,com.buschmais.xo.neo4j.remote.impl.model,0,0,0,0,0,1,0,1
buschmais_extended-objects,com.buschmais.xo.neo4j.remote.impl.model.state,0,0,0,0,0,1,0,1
buschmais_extended-objects,com.buschmais.xo.neo4j.spi,0,0,0,0,0,0,0,0
buschmais_extended-objects,com.buschmais.xo.neo4j.spi.helper,0,0,0,0,0,0,0,0
buschmais_extended-objects,com.buschmais.xo.neo4j.spi.metadata,0,0,0,0,0,1,0,1
buschmais_extended-objects,com.buschmais.xo.spi.bootstrap,0,0,0,0,0,0,0,0
buschmais_extended-objects,com.buschmais.xo.spi.datastore,0,0,0,0,1,5,0,6
buschmais_extended-objects,com.buschmais.xo.spi.interceptor,0,0,0,0,0,0,0,0
buschmais_extended-objects,com.buschmais.xo.spi.metadata,0,0,0,0,0,0,0,0
buschmais_extended-objects,com.buschmais.xo.spi.metadata.method,0,0,0,0,0,5,0,5
buschmais_extended-objects,com.buschmais.xo.spi.metadata.type,0,0,0,0,0,2,0,2
buschmais_extended-objects,com.buschmais.xo.spi.plugin,0,0,0,0,0,0,0,0
buschmais_extended-objects,com.buschmais.xo.spi.reflection,0,0,0,0,1,5,0,6
buschmais_extended-objects,com.buschmais.xo.spi.session,0,0,0,0,0,0,0,0
buschmais_extended-objects,com.buschmais.xo.trace.api,0,0,0,0,0,0,0,0
buschmais_extended-objects,com.buschmais.xo.trace.impl,0,0,0,0,1,0,0,1
buschmais_extended-objects,com.buschmais.xo.trace,0,0,0,0,0,0,0,0
buschmais_extended-objects,com.buschmais.xo.trace.composite,0,0,0,0,0,0,0,0
bytedeco_javacpp,org.bytedeco.javacpp,1,0,0,1,0,0,0,2
bytedeco_javacpp,org.bytedeco.javacpp.indexer,0,0,0,1,0,0,0,1
bytedeco_javacpp,org.bytedeco.javacpp.tools,1,1,0,0,0,0,0,2
bywan_trello-java-wrapper,com.julienvey.trello.domain,1,1,0,0,0,0,0,2
bywan_trello-java-wrapper,com.julienvey.trello.exception,0,0,0,0,0,0,0,0
bywan_trello-java-wrapper,com.julienvey.trello.impl.domaininternal,0,0,0,0,0,0,0,0
bywan_trello-java-wrapper,com.julienvey.trello.impl.http,0,0,0,0,1,0,0,1
bywan_trello-java-wrapper,com.julienvey.trello.impl,0,0,0,0,0,0,0,0
bywan_trello-java-wrapper,com.julienvey.trello,1,0,0,0,1,0,0,2
bywan_trello-java-wrapper,com.julienvey.trello.utils,0,0,0,0,0,0,0,0
bywan_trello-java-wrapper,com.julienvey.trello.integration,0,0,0,0,0,0,0,0
bywan_trello-java-wrapper,com.julienvey.trello.unit,0,0,0,0,1,0,0,1
c4fcm_CLIFF,org.mediameter.cliff,2,1,0,0,0,0,0,3
c4fcm_CLIFF,org.mediameter.cliff.extractor,1,0,0,0,1,0,0,2
c4fcm_CLIFF,org.mediameter.cliff.orgs.disambiguation,1,0,0,0,0,0,0,1
c4fcm_CLIFF,org.mediameter.cliff.orgs,1,0,0,0,0,0,0,1
c4fcm_CLIFF,org.mediameter.cliff.people.disambiguation,1,1,0,0,0,0,0,2
c4fcm_CLIFF,org.mediameter.cliff.people,1,0,0,0,0,0,0,1
c4fcm_CLIFF,org.mediameter.cliff.places,2,1,0,0,0,0,0,3
c4fcm_CLIFF,org.mediameter.cliff.places.disambiguation,0,0,0,0,1,0,0,1
c4fcm_CLIFF,org.mediameter.cliff.places.focus,0,0,0,0,0,0,0,0
c4fcm_CLIFF,org.mediameter.cliff.places.substitutions,0,0,0,0,0,0,0,0
c4fcm_CLIFF,org.mediameter.cliff.util,0,0,0,0,0,0,0,0
c4fcm_CLIFF,org.mediameter.cliff.stanford,0,0,0,0,0,0,0,0
c4fcm_CLIFF,com.nytlabs.corpus,0,0,0,0,0,0,0,0
c4fcm_CLIFF,(default package),0,0,0,0,0,0,0,0
c4fcm_CLIFF,org.mediameter.cliff.servlet,0,0,0,0,0,0,0,0
caelum_mamute,org.mamute.integration.pages,1,1,0,0,0,0,0,2
caelum_mamute,org.mamute.integration.scene,2,0,0,0,0,0,0,2
caelum_mamute,org.mamute.integration.scene.vraptor,0,0,0,0,0,0,0,0
caelum_mamute,org.mamute.integration.util,2,1,0,0,0,0,0,3
caelum_mamute,org.mamute.util,0,0,0,0,1,0,0,1
caelum_mamute,br.com.caelum.vraptor,0,0,0,0,0,0,0,0
caelum_mamute,br.com.caelum.vraptor.serialization,0,0,0,0,0,0,0,0
caelum_mamute,br.com.caelum.vraptor.server,0,0,0,0,0,0,0,0
caelum_mamute,org.mamute.ads,0,0,0,0,0,0,0,0
caelum_mamute,org.mamute.auth,3,1,0,0,1,1,0,6
caelum_mamute,org.mamute.auth.rules,0,0,0,0,1,1,0,2
caelum_mamute,org.mamute.brutauth.auth.handlers,0,0,0,0,0,0,0,0
caelum_mamute,org.mamute.brutauth.auth.rules,0,0,0,0,1,1,0,2
caelum_mamute,org.mamute.components,0,0,0,0,0,0,0,0
caelum_mamute,org.mamute.controllers,6,1,0,1,1,4,0,13
caelum_mamute,org.mamute.converters,0,0,0,0,0,0,0,0
caelum_mamute,org.mamute.cron,0,0,0,0,0,0,0,0
caelum_mamute,org.mamute.dao,4,0,0,1,1,5,0,11
caelum_mamute,org.mamute.dao.util,0,0,0,0,0,0,0,0
caelum_mamute,org.mamute.dto,0,0,0,0,1,0,0,1
caelum_mamute,org.mamute.environment,0,0,0,0,0,0,0,0
caelum_mamute,org.mamute.event,0,0,0,0,0,0,0,0
caelum_mamute,org.mamute.factory,0,0,0,0,0,0,0,0
caelum_mamute,org.mamute.filesystem,0,0,0,0,0,0,0,0
caelum_mamute,org.mamute.i18n,0,0,0,0,0,0,0,0
caelum_mamute,org.mamute.infra,3,0,0,0,1,1,0,5
caelum_mamute,org.mamute.infra.locale,0,0,0,0,0,0,0,0
caelum_mamute,org.mamute.infra.rss.converter,0,0,0,0,0,0,0,0
caelum_mamute,org.mamute.infra.rss.job,0,0,0,0,0,0,0,0
caelum_mamute,org.mamute.infra.rss.read,0,0,0,0,0,0,0,0
caelum_mamute,org.mamute.infra.rss,0,0,0,0,0,0,0,0
caelum_mamute,org.mamute.infra.rss.write,0,0,0,0,1,0,0,1
caelum_mamute,org.mamute.input,0,0,0,0,0,0,0,0
caelum_mamute,org.mamute.interceptors,2,0,0,0,1,0,0,3
caelum_mamute,org.mamute.mail.action,0,0,0,0,0,0,0,0
caelum_mamute,org.mamute.mail,0,0,0,0,0,0,0,0
caelum_mamute,org.mamute.managers,0,0,0,0,0,0,0,0
caelum_mamute,org.mamute.meta,0,0,0,0,0,0,0,0
caelum_mamute,org.mamute.model,14,1,0,1,1,7,0,24
caelum_mamute,org.mamute.model.ban,2,0,0,0,0,0,0,2
caelum_mamute,org.mamute.model.flag,0,0,0,0,1,0,0,1
caelum_mamute,org.mamute.model.interfaces,0,0,0,0,1,2,0,3
caelum_mamute,org.mamute.model.post,0,0,0,0,0,0,0,0
caelum_mamute,org.mamute.model.vote,1,0,0,0,0,2,0,3
caelum_mamute,org.mamute.model.watch,2,0,0,0,0,0,0,2
caelum_mamute,org.mamute.newsletter,0,0,0,0,0,0,0,0
caelum_mamute,org.mamute.notification,0,0,0,0,0,0,0,0
caelum_mamute,org.mamute.observer,0,0,0,0,0,0,0,0
caelum_mamute,org.mamute.preload,0,0,0,0,0,0,0,0
caelum_mamute,org.mamute.providers,10,1,0,0,1,0,0,12
caelum_mamute,org.mamute.reputation.rules,5,0,0,0,1,0,0,6
caelum_mamute,org.mamute.sanitizer,0,0,0,0,1,0,0,1
caelum_mamute,org.mamute.search,0,0,0,0,1,0,0,1
caelum_mamute,org.mamute.security,0,0,0,0,0,0,0,0
caelum_mamute,org.mamute.template,0,0,0,0,0,0,0,0
caelum_mamute,org.mamute.validators,0,0,0,0,1,1,0,2
caelum_mamute,org.mamute.vraptor,0,0,0,0,0,0,0,0
caelum_mamute,org.mamute.vraptor.environment,0,0,0,0,0,0,0,0
caelum_mamute,org.mamute.migration.all,0,0,0,0,1,0,0,1
caelum_mamute,org.mamute.migration,0,0,0,0,1,0,0,1
caelum_mamute,org.mamute.migration.util,0,0,0,0,0,0,0,0
caelum_mamute,org.mamute.builder,1,0,0,0,0,0,0,1
caelum_mamute,org.mamute.feed,0,0,0,0,0,0,0,0
caelum_vraptor-panettone,br.com.caelum.vraptor.panettone,0,0,0,0,0,1,0,1
caelum_vraptor-panettone,br.com.caelum.vraptor.panettone.mini,0,0,0,0,0,0,0,0
caelum_vraptor-panettone,br.com.caelum.vraptor.panettone.parser.ast,0,0,0,0,1,1,0,2
caelum_vraptor-panettone,br.com.caelum.vraptor.panettone.parser,1,1,0,0,1,1,0,4
caelum_vraptor-panettone,br.com.caelum.vraptor.panettone.parser.rule,1,0,0,0,0,0,0,1
caelum_vraptor-panettone,br.com.caelum.vraptor.panettone.defaulted,0,0,0,0,0,0,0,0
caelum_vraptor-panettone,templates,0,0,0,0,0,0,0,0
CalebFenton_simplify,org.cf.demoapp,0,0,0,0,0,0,1,1
CalebFenton_simplify,org.cf.demosmali,0,0,0,0,0,0,1,1
CalebFenton_simplify,org.cf.obfuscated,0,0,0,0,1,0,1,2
CalebFenton_simplify,org.cf.crypto,0,0,0,0,1,0,1,2
CalebFenton_simplify,org.cf.simplify,1,1,0,0,0,0,1,3
CalebFenton_simplify,org.cf.simplify.strategy,1,0,0,0,1,0,1,3
CalebFenton_simplify,org.cf.smalivm.configuration,2,0,0,0,0,0,1,3
CalebFenton_simplify,org.cf.smalivm.context,5,1,0,0,0,0,1,7
CalebFenton_simplify,org.cf.smalivm.dex,10,1,0,0,1,0,1,13
CalebFenton_simplify,org.cf.smalivm.emulate,3,0,0,0,0,0,1,4
CalebFenton_simplify,org.cf.smalivm,14,1,0,1,1,0,1,18
CalebFenton_simplify,org.cf.smalivm.opcode,11,1,0,1,1,0,1,15
CalebFenton_simplify,org.cf.smalivm.type,10,1,0,0,0,0,1,12
CalebFenton_simplify,org.cf.util,12,1,0,0,0,0,1,14
calrissian_flowmix,org.calrissian.flowmix.api.aggregator,0,0,0,0,1,0,0,1
calrissian_flowmix,org.calrissian.flowmix.api,0,0,0,0,0,1,0,1
calrissian_flowmix,org.calrissian.flowmix.api.builder,0,0,0,0,1,0,0,1
calrissian_flowmix,org.calrissian.flowmix.api.filter,0,0,0,0,0,0,0,0
calrissian_flowmix,org.calrissian.flowmix.api.kryo,0,0,0,0,0,0,0,0
calrissian_flowmix,org.calrissian.flowmix.api.storm.bolt,0,0,0,0,0,0,0,0
calrissian_flowmix,org.calrissian.flowmix.api.storm.spout,0,0,0,0,0,0,0,0
calrissian_flowmix,org.calrissian.flowmix.core,0,0,0,0,0,0,0,0
calrissian_flowmix,org.calrissian.flowmix.core.model.event,0,0,0,0,0,0,0,0
calrissian_flowmix,org.calrissian.flowmix.core.model,0,0,0,0,0,1,0,1
calrissian_flowmix,org.calrissian.flowmix.core.model.op,0,0,0,0,0,0,0,0
calrissian_flowmix,org.calrissian.flowmix.core.storm.bolt,0,0,0,0,1,0,0,1
calrissian_flowmix,org.calrissian.flowmix.core.storm.spout,0,0,0,0,0,0,0,0
calrissian_flowmix,org.calrissian.flowmix.core.support.deque,0,0,0,0,0,0,0,0
calrissian_flowmix,org.calrissian.flowmix.core.support,0,0,0,0,0,1,0,1
calrissian_flowmix,org.calrissian.flowmix.core.support.window,0,0,0,0,0,0,0,0
calrissian_flowmix,org.calrissian.flowmix.example,0,0,0,0,1,0,0,1
calrissian_flowmix,org.calrissian.flowmix.example.support,0,0,0,0,0,0,0,0
calrissian_flowmix,org.calrissian.flowmix.exceptions,0,0,0,0,0,0,0,0
camelinaction_camelinaction,camelinaction,0,0,0,1,1,0,0,2
camelinaction_camelinaction,camelinaction.component,0,0,0,0,0,0,0,0
camelinaction_camelinaction,camelinaction.inventory,0,0,0,1,1,0,0,2
camelinaction_camelinaction,camelinaction.bindy,0,0,0,0,0,0,0,0
camelinaction_camelinaction,camelinaction.order,0,0,0,0,1,0,0,1
caoxinyu_RedisClient,com.cxy.redisclient.domain,1,0,0,0,1,3,0,5
caoxinyu_RedisClient,com.cxy.redisclient.dto,0,0,0,0,1,0,0,1
caoxinyu_RedisClient,com.cxy.redisclient.integration,8,1,0,0,0,7,0,16
caoxinyu_RedisClient,com.cxy.redisclient.integration.hash,2,0,0,0,0,0,0,2
caoxinyu_RedisClient,com.cxy.redisclient.integration.key,1,0,0,0,1,3,0,5
caoxinyu_RedisClient,com.cxy.redisclient.integration.list,2,0,0,0,1,0,0,3
caoxinyu_RedisClient,com.cxy.redisclient.integration.protocol,0,0,0,0,0,0,0,0
caoxinyu_RedisClient,com.cxy.redisclient.integration.pubsub,0,0,0,0,0,0,0,0
caoxinyu_RedisClient,com.cxy.redisclient.integration.server,0,0,0,0,0,1,0,1
caoxinyu_RedisClient,com.cxy.redisclient.integration.set,2,0,0,0,1,2,0,5
caoxinyu_RedisClient,com.cxy.redisclient.integration.string,0,0,0,0,0,0,0,0
caoxinyu_RedisClient,com.cxy.redisclient.integration.zset,0,0,0,0,1,0,0,1
caoxinyu_RedisClient,com.cxy.redisclient.presentation,13,1,0,0,1,0,0,15
caoxinyu_RedisClient,com.cxy.redisclient.presentation.component,12,1,0,0,1,0,0,14
caoxinyu_RedisClient,com.cxy.redisclient.presentation.console,0,0,0,0,1,0,0,1
caoxinyu_RedisClient,com.cxy.redisclient.presentation.favorite,0,0,0,0,0,0,0,0
caoxinyu_RedisClient,com.cxy.redisclient.presentation.hash,0,0,0,0,0,0,0,0
caoxinyu_RedisClient,com.cxy.redisclient.presentation.key,0,0,0,0,0,0,0,0
caoxinyu_RedisClient,com.cxy.redisclient.presentation.list,0,0,0,0,0,0,0,0
caoxinyu_RedisClient,com.cxy.redisclient.presentation.pubsub,0,0,0,0,0,0,0,0
caoxinyu_RedisClient,com.cxy.redisclient.presentation.server,0,0,0,0,0,0,0,0
caoxinyu_RedisClient,com.cxy.redisclient.presentation.set,0,0,0,0,0,0,0,0
caoxinyu_RedisClient,com.cxy.redisclient.presentation.string,0,0,0,0,0,0,0,0
caoxinyu_RedisClient,com.cxy.redisclient.presentation.zset,0,0,0,0,0,0,0,0
caoxinyu_RedisClient,com.cxy.redisclient.service,10,0,0,0,1,8,0,19
caoxinyu_RedisClient,org.eclipse.wb.swt,0,0,0,0,0,0,0,0
caoxinyu_RedisClient,com.cxy.redisclient,0,0,0,0,1,3,0,4
CaptainBern_Reflection,com.captainbern.jbel,16,1,0,0,1,0,0,18
CaptainBern_Reflection,com.captainbern.jbel.commons.attribute.annotation,6,1,0,0,0,0,0,7
CaptainBern_Reflection,com.captainbern.jbel.commons.attribute.annotation.elementvalue,5,0,0,0,0,0,0,5
CaptainBern_Reflection,com.captainbern.jbel.commons.attribute,10,0,0,1,0,0,0,11
CaptainBern_Reflection,com.captainbern.jbel.commons.attribute.stackmap,2,0,0,0,0,0,0,2
CaptainBern_Reflection,com.captainbern.jbel.commons.constant,0,0,0,0,0,0,0,0
CaptainBern_Reflection,com.captainbern.jbel.commons.exception,0,0,0,0,0,0,0,0
CaptainBern_Reflection,com.captainbern.jbel.commons.member.field,1,0,0,0,0,0,0,1
CaptainBern_Reflection,com.captainbern.jbel.commons.member,2,0,0,0,0,0,0,2
CaptainBern_Reflection,com.captainbern.jbel.commons.member.method,1,0,0,0,0,0,0,1
CaptainBern_Reflection,com.captainbern.jbel.generator,1,0,0,0,0,0,0,1
CaptainBern_Reflection,com.captainbern.jbel.util.code,0,0,0,0,0,0,0,0
CaptainBern_Reflection,com.captainbern.jbel.util,0,0,0,0,0,0,0,0
CaptainBern_Reflection,com.captainbern.jbel.util.instruction,0,0,0,0,0,0,0,0
CaptainBern_Reflection,com.captainbern.jbel.visitor,7,0,0,0,0,0,0,7
CaptainBern_Reflection,com.captainbern.minecraft.collection,0,0,0,0,0,0,0,0
CaptainBern_Reflection,com.captainbern.minecraft.conversion,7,1,0,0,0,0,0,8
CaptainBern_Reflection,com.captainbern.minecraft.error,0,0,0,0,1,0,0,1
CaptainBern_Reflection,com.captainbern.minecraft.protocol,1,0,0,0,1,0,0,2
CaptainBern_Reflection,com.captainbern.minecraft.reflection,5,1,0,0,1,1,0,8
CaptainBern_Reflection,com.captainbern.minecraft.reflection.providers.remapper,0,0,0,0,0,1,0,1
CaptainBern_Reflection,com.captainbern.minecraft.reflection.providers,0,0,0,0,0,1,0,1
CaptainBern_Reflection,com.captainbern.minecraft.reflection.utils,0,0,0,0,0,0,0,0
CaptainBern_Reflection,com.captainbern.minecraft.wrapper,3,0,0,0,1,0,0,4
CaptainBern_Reflection,com.captainbern.minecraft.wrapper.nbt.io,2,1,0,0,0,0,0,3
CaptainBern_Reflection,com.captainbern.minecraft.wrapper.nbt,4,0,0,0,1,0,0,5
CaptainBern_Reflection,com.captainbern.reflection,1,1,0,0,1,0,0,3
CaptainBern_Reflection,com.captainbern.reflection.accessor,0,0,0,0,0,0,0,0
CaptainBern_Reflection,com.captainbern.reflection.asm.accessor,0,0,0,0,1,0,0,1
CaptainBern_Reflection,com.captainbern.reflection.asm,0,0,0,0,0,0,0,0
CaptainBern_Reflection,com.captainbern.reflection.conversion,0,0,0,0,0,0,0,0
CaptainBern_Reflection,com.captainbern.reflection.impl,0,0,0,0,0,0,0,0
CaptainBern_Reflection,com.captainbern.reflection.matcher,0,0,0,0,0,0,0,0
CaptainBern_Reflection,com.captainbern.reflection.matcher.type,0,0,0,0,1,0,0,1
CaptainBern_Reflection,com.captainbern.reflection.provider.impl,0,0,0,0,0,0,0,0
CaptainBern_Reflection,com.captainbern.reflection.provider,1,0,0,0,0,0,0,1
CaptainBern_Reflection,com.captainbern.reflection.provider.type,0,0,0,0,0,0,0,0
CaptainBern_Reflection,com.captainbern.reflection.provider.type.impl,0,0,0,0,0,0,0,0
CaptainBern_Reflection,com.captainbern.reflection.utils,0,0,0,0,0,0,0,0
caskdata_cdap,io.cdap.cdap.api,0,0,0,0,1,25,1,27
caskdata_cdap,io.cdap.cdap.api.app,0,0,0,0,0,6,1,7
caskdata_cdap,io.cdap.cdap.api.artifact,0,0,0,0,1,4,1,6
caskdata_cdap,io.cdap.cdap.api.builder,0,0,0,0,0,0,1,1
caskdata_cdap,io.cdap.cdap.api.common,0,0,0,0,1,13,1,15
caskdata_cdap,io.cdap.cdap.api.customaction,0,0,0,0,0,5,1,6
caskdata_cdap,io.cdap.cdap.api.data.batch,0,1,0,0,1,15,1,18
caskdata_cdap,io.cdap.cdap.api.data,0,0,0,0,0,3,1,4
caskdata_cdap,io.cdap.cdap.api.dataset,0,0,0,0,1,11,1,13
caskdata_cdap,io.cdap.cdap.api.dataset.lib,12,1,0,1,1,20,1,36
caskdata_cdap,io.cdap.cdap.api.dataset.lib.app.partitioned,0,0,0,0,0,0,1,1
caskdata_cdap,io.cdap.cdap.api.dataset.lib.cube,0,0,0,1,0,1,1,3
caskdata_cdap,io.cdap.cdap.api.dataset.lib.partitioned,1,0,0,0,1,0,1,3
caskdata_cdap,io.cdap.cdap.api.dataset.metrics,0,0,0,0,0,0,1,1
caskdata_cdap,io.cdap.cdap.api.dataset.module,0,0,0,0,0,0,1,1
caskdata_cdap,io.cdap.cdap.api.dataset.table,0,0,0,0,1,12,1,14
caskdata_cdap,io.cdap.cdap.api.lineage.field,0,0,0,0,1,2,1,4
caskdata_cdap,io.cdap.cdap.api.macro,0,0,0,0,1,0,1,2
caskdata_cdap,io.cdap.cdap.api.mapreduce,0,0,0,0,1,17,1,19
caskdata_cdap,io.cdap.cdap.api.messaging,0,0,0,0,1,2,1,4
caskdata_cdap,io.cdap.cdap.api.metadata,0,0,0,0,1,3,1,5
caskdata_cdap,io.cdap.cdap.api.metrics,0,0,0,0,1,5,1,7
caskdata_cdap,io.cdap.cdap.api.plugin,0,0,0,0,1,1,1,3
caskdata_cdap,io.cdap.cdap.api.preview,0,0,0,0,0,1,1,2
caskdata_cdap,io.cdap.cdap.api.retry,0,0,0,0,0,0,1,1
caskdata_cdap,io.cdap.cdap.api.schedule,0,0,0,0,1,2,1,4
caskdata_cdap,io.cdap.cdap.api.security.store,0,0,0,0,0,0,1,1
caskdata_cdap,io.cdap.cdap.api.service,0,0,0,0,1,0,1,2
caskdata_cdap,io.cdap.cdap.api.service.http,0,0,0,0,1,7,1,9
caskdata_cdap,io.cdap.cdap.api.spark,0,0,0,0,1,5,1,7
caskdata_cdap,io.cdap.cdap.api.worker,0,0,0,0,0,0,1,1
caskdata_cdap,io.cdap.cdap.api.workflow,0,0,0,0,1,6,1,8
caskdata_cdap,io.cdap.cdap.internal.api,0,0,0,0,0,1,1,2
caskdata_cdap,io.cdap.cdap.internal.app.runtime.schedule,17,1,0,0,1,4,1,24
caskdata_cdap,io.cdap.cdap.internal.customaction,0,0,0,0,0,0,1,1
caskdata_cdap,io.cdap.cdap.internal.dataset,0,0,0,0,0,0,1,1
caskdata_cdap,io.cdap.cdap.internal.guava.reflect,0,0,0,1,1,0,1,3
caskdata_cdap,io.cdap.cdap.internal.io,0,0,0,0,1,1,1,3
caskdata_cdap,io.cdap.cdap.internal.lang,0,0,0,0,1,0,1,2
caskdata_cdap,io.cdap.cdap.internal,19,1,0,0,1,0,1,22
caskdata_cdap,io.cdap.cdap.internal.schedule.constraint,0,0,0,0,0,0,1,1
caskdata_cdap,io.cdap.cdap.internal.schedule,0,0,0,0,0,1,1,2
caskdata_cdap,io.cdap.cdap.internal.specification,0,0,0,0,0,0,1,1
caskdata_cdap,io.cdap.cdap.internal.workflow.condition,0,0,0,0,0,0,1,1
caskdata_cdap,io.cdap.cdap.api.data.format,0,0,0,0,1,9,1,11
caskdata_cdap,io.cdap.cdap.api.data.schema,0,0,0,0,1,12,1,14
caskdata_cdap,io.cdap.cdap.api.spark.service,0,0,0,0,1,0,1,2
caskdata_cdap,io.cdap.cdap.api.spark.dynamic,0,0,0,0,1,0,1,2
caskdata_cdap,io.cdap.cdap.api.spark.sql,0,0,0,0,1,0,1,2
caskdata_cdap,io.cdap.cdap.app,1,0,0,0,0,0,1,2
caskdata_cdap,io.cdap.cdap.app.deploy,0,0,0,0,0,0,1,1
caskdata_cdap,io.cdap.cdap.app.guice,27,1,0,0,1,0,1,30
caskdata_cdap,io.cdap.cdap.app.mapreduce,0,0,0,0,0,1,1,2
caskdata_cdap,io.cdap.cdap.app.metrics,0,0,0,0,0,0,1,1
caskdata_cdap,io.cdap.cdap.app.preview,13,1,0,0,1,0,1,16
caskdata_cdap,io.cdap.cdap.app.program,6,1,0,0,1,0,1,9
caskdata_cdap,io.cdap.cdap.app.runtime,12,1,0,0,1,0,1,15
caskdata_cdap,io.cdap.cdap.app.runtime.scheduler,0,0,0,0,0,0,1,1
caskdata_cdap,io.cdap.cdap.app.services,0,0,0,0,0,0,1,1
caskdata_cdap,io.cdap.cdap.app.store.preview,0,0,0,0,0,0,1,1
caskdata_cdap,io.cdap.cdap.app.store,3,1,0,0,0,0,1,5
caskdata_cdap,io.cdap.cdap.app.verification,0,0,0,0,0,0,1,1
caskdata_cdap,io.cdap.cdap.common.twill,3,1,0,0,1,0,1,6
caskdata_cdap,io.cdap.cdap.config,3,1,0,0,0,2,1,7
caskdata_cdap,io.cdap.cdap.config.guice,0,0,0,0,0,0,1,1
caskdata_cdap,io.cdap.cdap.error,0,0,0,0,0,0,1,1
caskdata_cdap,io.cdap.cdap.gateway.handlers,9,1,0,1,1,2,1,15
caskdata_cdap,io.cdap.cdap.gateway.handlers.meta,0,0,0,0,0,0,1,1
caskdata_cdap,io.cdap.cdap.gateway.handlers.preview,0,0,0,0,0,0,1,1
caskdata_cdap,io.cdap.cdap.gateway.handlers.util,3,0,0,0,0,0,1,4
caskdata_cdap,io.cdap.cdap.hive,0,1,0,0,0,0,1,2
caskdata_cdap,io.cdap.cdap.internal.app,4,1,0,0,1,0,1,7
caskdata_cdap,io.cdap.cdap.internal.app.customaction,0,0,0,0,0,0,1,1
caskdata_cdap,io.cdap.cdap.internal.app.deploy,9,1,0,0,1,0,1,12
caskdata_cdap,io.cdap.cdap.internal.app.deploy.pipeline,4,0,0,0,1,0,1,6
caskdata_cdap,io.cdap.cdap.internal.app.mapreduce,0,0,0,0,0,0,1,1
caskdata_cdap,io.cdap.cdap.internal.app.namespace,3,0,0,0,1,0,1,5
caskdata_cdap,io.cdap.cdap.internal.app.preview,26,1,0,0,1,0,1,29
caskdata_cdap,io.cdap.cdap.internal.app.program,6,0,0,0,1,0,1,8
caskdata_cdap,io.cdap.cdap.internal.app.runtime,47,1,0,0,1,1,1,51
caskdata_cdap,io.cdap.cdap.internal.app.runtime.artifact,23,1,0,1,1,2,1,29
caskdata_cdap,io.cdap.cdap.internal.app.runtime.batch,7,0,0,1,1,10,1,20
caskdata_cdap,io.cdap.cdap.internal.app.runtime.batch.dataset,1,1,0,0,1,0,1,4
caskdata_cdap,io.cdap.cdap.internal.app.runtime.batch.dataset.input,0,1,0,0,1,1,1,4
caskdata_cdap,io.cdap.cdap.internal.app.runtime.batch.dataset.output,2,1,0,0,1,2,1,7
caskdata_cdap,io.cdap.cdap.internal.app.runtime.batch.dataset.partitioned,0,0,0,0,1,0,1,2
caskdata_cdap,io.cdap.cdap.internal.app.runtime.batch.distributed,3,1,0,0,0,0,1,5
caskdata_cdap,io.cdap.cdap.internal.app.runtime.codec,0,0,0,0,0,0,1,1
caskdata_cdap,io.cdap.cdap.internal.app.runtime.customaction,0,0,0,0,0,0,1,1
caskdata_cdap,io.cdap.cdap.internal.app.runtime.distributed,13,0,0,1,1,0,1,16
caskdata_cdap,io.cdap.cdap.internal.app.runtime.distributed.remote,3,0,0,0,1,0,1,5
caskdata_cdap,io.cdap.cdap.internal.app.runtime.k8s,0,0,0,0,0,0,1,1
caskdata_cdap,io.cdap.cdap.internal.app.runtime.monitor,4,1,0,0,1,0,1,7
caskdata_cdap,io.cdap.cdap.internal.app.runtime.monitor.proxy,0,0,0,0,1,0,1,2
caskdata_cdap,io.cdap.cdap.internal.app.runtime.plugin,3,0,0,0,1,0,1,5
caskdata_cdap,io.cdap.cdap.internal.app.runtime.schedule.constraint,8,1,0,0,0,0,1,10
caskdata_cdap,io.cdap.cdap.internal.app.runtime.schedule.queue,2,0,0,0,1,0,1,4
caskdata_cdap,io.cdap.cdap.internal.app.runtime.schedule.store,8,1,0,0,1,1,1,12
caskdata_cdap,io.cdap.cdap.internal.app.runtime.schedule.trigger,7,1,0,0,1,1,1,11
caskdata_cdap,io.cdap.cdap.internal.app.runtime.service.http,2,0,0,0,1,0,1,4
caskdata_cdap,io.cdap.cdap.internal.app.runtime.service,2,1,0,0,0,0,1,4
caskdata_cdap,io.cdap.cdap.internal.app.runtime.worker,2,0,0,0,1,0,1,4
caskdata_cdap,io.cdap.cdap.internal.app.runtime.workflow,3,1,0,0,1,1,1,7
caskdata_cdap,io.cdap.cdap.internal.app.services,13,1,0,1,1,0,1,17
caskdata_cdap,io.cdap.cdap.internal.app.spark,0,0,0,0,0,0,1,1
caskdata_cdap,io.cdap.cdap.internal.app.store,25,1,0,0,1,1,1,29
caskdata_cdap,io.cdap.cdap.internal.app.store.preview,1,0,0,0,0,0,1,2
caskdata_cdap,io.cdap.cdap.internal.app.store.profile,0,0,0,0,0,0,1,1
caskdata_cdap,io.cdap.cdap.internal.app.verification,0,0,0,0,0,1,1,2
caskdata_cdap,io.cdap.cdap.internal.app.worker,0,0,0,0,0,0,1,1
caskdata_cdap,io.cdap.cdap.internal.app.workflow.condition,0,0,0,0,0,0,1,1
caskdata_cdap,io.cdap.cdap.internal.app.workflow,0,0,0,0,0,0,1,1
caskdata_cdap,io.cdap.cdap.internal.bootstrap,1,1,0,0,1,1,1,5
caskdata_cdap,io.cdap.cdap.internal.bootstrap.executor,1,0,0,0,1,0,1,3
caskdata_cdap,io.cdap.cdap.internal.bootstrap.guice,2,0,0,0,0,0,1,3
caskdata_cdap,io.cdap.cdap.internal.pipeline,0,0,0,0,0,0,1,1
caskdata_cdap,io.cdap.cdap.internal.profile,6,1,0,0,1,0,1,9
caskdata_cdap,io.cdap.cdap.internal.provision,3,1,0,0,1,0,1,6
caskdata_cdap,io.cdap.cdap.internal.provision.task,0,0,0,0,0,0,1,1
caskdata_cdap,io.cdap.cdap.master.environment,0,0,0,0,1,1,1,3
caskdata_cdap,io.cdap.cdap.master.environment.k8s,0,0,0,1,1,0,1,3
caskdata_cdap,io.cdap.cdap.metadata,21,1,0,1,1,1,1,26
caskdata_cdap,io.cdap.cdap.metadata.profile,0,0,0,0,0,0,1,1
caskdata_cdap,io.cdap.cdap.operations,0,0,0,0,1,0,1,2
caskdata_cdap,io.cdap.cdap.operations.guice,0,0,0,0,0,0,1,1
caskdata_cdap,io.cdap.cdap.pipeline,0,0,0,0,1,0,1,2
caskdata_cdap,io.cdap.cdap.reporting,0,0,0,0,0,0,1,1
caskdata_cdap,io.cdap.cdap.scheduler,4,1,0,0,1,2,1,9
caskdata_cdap,io.cdap.cdap.security,3,1,0,0,1,0,1,6
caskdata_cdap,io.cdap.cdap.security.hive,0,0,0,0,0,0,1,1
caskdata_cdap,io.cdap.cdap.security.impersonation,36,1,0,0,1,0,1,39
caskdata_cdap,org.apache.hadoop.fs.ftp,0,0,0,0,0,0,1,1
caskdata_cdap,org.apache.hadoop.fs.sftp,0,0,0,0,0,0,1,1
caskdata_cdap,io.cdap.cdap,17,1,0,1,1,13,1,34
caskdata_cdap,io.cdap.cdap.app.runtime.monitor,0,0,0,0,0,0,1,1
caskdata_cdap,io.cdap.cdap.extension,0,0,0,0,1,0,1,2
caskdata_cdap,io.cdap.cdap.internal.app.runtime.artifact.app.inspection,0,0,0,0,0,0,1,1
caskdata_cdap,io.cdap.cdap.internal.app.runtime.artifact.app,0,0,0,0,0,0,1,1
caskdata_cdap,io.cdap.cdap.internal.app.runtime.artifact.app.plugin,0,0,0,0,0,0,1,1
caskdata_cdap,io.cdap.cdap.internal.app.runtime.artifact.plugin,0,0,1,0,0,0,1,2
caskdata_cdap,io.cdap.cdap.internal.app.runtime.entity,0,0,0,0,0,0,1,1
caskdata_cdap,io.cdap.cdap.internal.app.scheduler,0,0,0,0,0,0,1,1
caskdata_cdap,io.cdap.cdap.internal.app.services.http,3,0,0,0,0,0,1,4
caskdata_cdap,io.cdap.cdap.internal.app.services.http.handlers,0,0,0,0,1,4,1,6
caskdata_cdap,io.cdap.cdap.internal.app.store.remote,0,0,0,0,0,0,1,1
caskdata_cdap,io.cdap.cdap.internal.audit,0,0,0,0,0,0,1,1
caskdata_cdap,io.cdap.cdap.internal.guice,0,0,0,0,0,0,1,1
caskdata_cdap,io.cdap.cdap.runtime,0,0,0,0,0,0,1,1
caskdata_cdap,org.apache.hadoop.util,0,0,0,0,1,0,1,2
caskdata_cdap,org.apache.tephra.hbase.txprune,0,0,0,0,0,0,1,1
caskdata_cdap,io.cdap.cdap.app.runtime.spark.distributed,2,1,0,1,1,0,1,6
caskdata_cdap,io.cdap.cdap.datapipeline,0,0,0,0,0,0,1,1
caskdata_cdap,io.cdap.cdap.datapipeline.service,0,1,0,0,1,1,1,4
caskdata_cdap,io.cdap.cdap.datapipeline.mock,0,0,0,0,0,0,1,1
caskdata_cdap,io.cdap.cdap.datapipeline.plugin,0,0,0,0,0,0,1,1
caskdata_cdap,io.cdap.cdap.datapipeline.preview,0,0,0,0,0,0,1,1
caskdata_cdap,io.cdap.cdap.datapipeline.spark,0,0,0,0,0,0,1,1
caskdata_cdap,io.cdap.cdap.datastreams,0,0,0,0,0,0,1,1
caskdata_cdap,io.cdap.cdap.datastreams.preview,0,0,0,0,0,0,1,1
caskdata_cdap,io.cdap.cdap.etl.api.action,0,0,0,0,0,0,1,1
caskdata_cdap,io.cdap.cdap.etl.api,0,0,0,1,1,0,1,3
caskdata_cdap,io.cdap.cdap.etl.api.batch,0,1,0,0,0,0,1,2
caskdata_cdap,io.cdap.cdap.etl.api.condition,0,0,0,0,0,0,1,1
caskdata_cdap,io.cdap.cdap.etl.api.lineage.field,0,0,0,0,0,0,1,1
caskdata_cdap,io.cdap.cdap.etl.api.lookup,0,0,0,0,0,0,1,1
caskdata_cdap,io.cdap.cdap.etl.api.validation,0,0,0,0,1,0,1,2
caskdata_cdap,io.cdap.cdap.etl.api.streaming,0,0,0,0,0,0,1,1
caskdata_cdap,$package,0,0,0,0,1,0,1,2
caskdata_cdap,io.cdap.cdap.etl.batch.condition,0,0,0,0,0,0,1,1
caskdata_cdap,io.cdap.cdap.etl.batch,0,0,0,0,0,1,1,2
caskdata_cdap,io.cdap.cdap.etl.batch.conversion,0,0,0,0,0,0,1,1
caskdata_cdap,io.cdap.cdap.etl.batch.customaction,0,0,0,0,0,0,1,1
caskdata_cdap,io.cdap.cdap.etl.batch.join,0,0,0,0,0,0,1,1
caskdata_cdap,io.cdap.cdap.etl.batch.mapreduce,0,0,0,0,1,3,1,5
caskdata_cdap,io.cdap.cdap.etl.batch.connector,0,0,0,0,1,2,1,4
caskdata_cdap,io.cdap.cdap.etl.batch.preview,0,0,0,0,0,0,1,1
caskdata_cdap,io.cdap.cdap.etl.common,1,1,0,1,1,2,1,7
caskdata_cdap,io.cdap.cdap.etl.common.guice,0,0,0,0,0,0,1,1
caskdata_cdap,io.cdap.cdap.etl.common.macro,0,0,0,0,0,0,1,1
caskdata_cdap,io.cdap.cdap.etl.common.plugin,1,0,0,0,0,0,1,2
caskdata_cdap,io.cdap.cdap.etl.common.preview,0,0,0,0,0,0,1,1
caskdata_cdap,io.cdap.cdap.etl.common.record,0,0,0,0,0,1,1,2
caskdata_cdap,io.cdap.cdap.etl.common.submit,0,0,0,0,1,0,1,2
caskdata_cdap,io.cdap.cdap.etl.log,0,1,0,0,0,0,1,2
caskdata_cdap,io.cdap.cdap.etl.planner,0,0,0,0,1,0,1,2
caskdata_cdap,io.cdap.cdap.etl.spec,0,0,0,0,1,0,1,2
caskdata_cdap,io.cdap.cdap.etl.validation,0,0,0,0,0,0,1,1
caskdata_cdap,io.cdap.cdap.etl.proto,0,0,0,0,0,0,1,1
caskdata_cdap,io.cdap.cdap.etl.proto.v0,0,0,0,0,0,0,1,1
caskdata_cdap,io.cdap.cdap.etl.proto.v1,1,0,0,0,0,0,1,2
caskdata_cdap,io.cdap.cdap.etl.proto.v2,1,1,0,0,1,0,1,4
caskdata_cdap,io.cdap.cdap.etl.proto.v2.spec,0,0,0,0,1,0,1,2
caskdata_cdap,io.cdap.cdap.etl.proto.v2.validation,0,0,0,0,0,0,1,1
caskdata_cdap,io.cdap.cdap.etl.tool.config,1,0,0,0,0,0,1,2
caskdata_cdap,io.cdap.cdap.etl.tool,1,1,0,0,0,0,1,3
caskdata_cdap,io.cdap.cdap.etl.spark,1,1,0,0,1,1,1,5
caskdata_cdap,io.cdap.cdap.etl.spark.batch,0,0,0,0,1,1,1,3
caskdata_cdap,io.cdap.cdap.etl.spark.function,1,0,0,0,1,0,1,3
caskdata_cdap,io.cdap.cdap.etl.spark.plugin,0,0,0,0,0,0,1,1
caskdata_cdap,io.cdap.cdap.etl.spark.streaming,0,1,0,0,0,0,1,2
caskdata_cdap,io.cdap.cdap.etl.spark.streaming.function,0,0,0,0,1,0,1,2
caskdata_cdap,io.cdap.cdap.etl.spark.streaming.function.preview,0,0,0,0,0,0,1,1
caskdata_cdap,io.cdap.cdap.etl.mock.action,0,0,0,0,1,0,1,2
caskdata_cdap,io.cdap.cdap.etl.mock.alert,0,0,0,0,0,0,1,1
caskdata_cdap,io.cdap.cdap.etl.mock.batch.aggregator,0,0,0,0,1,0,1,2
caskdata_cdap,io.cdap.cdap.etl.mock.batch,0,0,0,0,1,2,1,4
caskdata_cdap,io.cdap.cdap.etl.mock.batch.joiner,0,0,0,0,0,0,1,1
caskdata_cdap,io.cdap.cdap.etl.mock.common,0,0,0,0,1,0,1,2
caskdata_cdap,io.cdap.cdap.etl.mock.condition,0,0,0,0,0,0,1,1
caskdata_cdap,io.cdap.cdap.etl.mock.spark.compute,0,0,0,0,0,0,1,1
caskdata_cdap,io.cdap.cdap.etl.mock.spark.streaming,0,0,0,0,0,0,1,1
caskdata_cdap,io.cdap.cdap.etl.mock.spark,0,0,0,0,0,0,1,1
caskdata_cdap,io.cdap.cdap.etl.mock.transform,0,0,0,0,1,1,1,3
caskdata_cdap,io.cdap.cdap.etl.mock.validation,0,0,0,0,0,0,1,1
caskdata_cdap,io.cdap.cdap.report.main,1,1,0,0,0,0,1,3
caskdata_cdap,io.cdap.cdap.report.proto,0,0,0,0,1,0,1,2
caskdata_cdap,io.cdap.cdap.report.proto.summary,0,0,0,0,1,0,1,2
caskdata_cdap,io.cdap.cdap.report,1,0,0,0,0,0,1,2
caskdata_cdap,io.cdap.cdap.report.util,0,1,0,0,1,0,1,3
caskdata_cdap,io.cdap.cdap.cli,9,1,0,0,1,0,1,12
caskdata_cdap,io.cdap.cdap.cli.command,2,0,0,1,1,0,1,5
caskdata_cdap,io.cdap.cdap.cli.command.app,0,0,0,0,1,0,1,2
caskdata_cdap,io.cdap.cdap.cli.command.artifact,0,0,0,0,1,0,1,2
caskdata_cdap,io.cdap.cdap.cli.command.lineage,0,0,0,0,0,0,1,1
caskdata_cdap,io.cdap.cdap.cli.command.metadata,0,0,0,0,0,0,1,1
caskdata_cdap,io.cdap.cdap.cli.command.metrics,1,0,0,0,0,0,1,2
caskdata_cdap,io.cdap.cdap.cli.command.schedule,1,0,0,0,1,0,1,3
caskdata_cdap,io.cdap.cdap.cli.command.security,0,0,0,0,1,0,1,2
caskdata_cdap,io.cdap.cdap.cli.command.system,2,1,0,0,1,0,1,5
caskdata_cdap,io.cdap.cdap.cli.commandset,4,0,0,0,0,0,1,5
caskdata_cdap,io.cdap.cdap.cli.completer,0,0,0,0,0,0,1,1
caskdata_cdap,io.cdap.cdap.cli.completer.element,1,0,0,0,1,0,1,3
caskdata_cdap,io.cdap.cdap.cli.completer.supplier,0,0,0,0,0,0,1,1
caskdata_cdap,io.cdap.cdap.cli.english,0,0,0,0,1,0,1,2
caskdata_cdap,io.cdap.cdap.cli.exception,0,0,0,0,0,0,1,1
caskdata_cdap,io.cdap.cdap.cli.util,9,1,0,0,1,0,1,12
caskdata_cdap,io.cdap.cdap.cli.util.table,0,0,0,0,1,0,1,2
caskdata_cdap,io.cdap.cdap.client,4,0,0,1,1,1,1,8
caskdata_cdap,io.cdap.cdap.client.config,0,0,0,0,0,1,1,2
caskdata_cdap,io.cdap.cdap.client.exception,0,0,0,0,0,0,1,1
caskdata_cdap,io.cdap.cdap.client.util,0,0,0,0,0,0,1,1
caskdata_cdap,io.cdap.cdap.client.app,0,0,0,1,1,4,1,7
caskdata_cdap,io.cdap.cdap.client.artifact,0,0,0,0,0,0,1,1
caskdata_cdap,io.cdap.cdap.client.artifact.plugin,0,0,0,0,0,0,1,1
caskdata_cdap,io.cdap.cdap.client.common,0,0,0,0,0,0,1,1
caskdata_cdap,io.cdap.cdap.common,25,1,0,1,1,0,1,29
caskdata_cdap,io.cdap.cdap.common.app,0,1,0,0,0,0,1,2
caskdata_cdap,io.cdap.cdap.common.async,0,0,0,0,0,0,1,1
caskdata_cdap,io.cdap.cdap.common.builder,0,0,0,0,0,0,1,1
caskdata_cdap,io.cdap.cdap.common.collect,0,0,0,0,1,0,1,2
caskdata_cdap,io.cdap.cdap.common.conf,0,1,0,1,1,0,1,4
caskdata_cdap,io.cdap.cdap.common.dataset,0,0,0,0,0,0,1,1
caskdata_cdap,io.cdap.cdap.common.db,0,0,0,0,0,0,1,1
caskdata_cdap,io.cdap.cdap.common.discovery,0,0,0,0,1,0,1,2
caskdata_cdap,io.cdap.cdap.common.election,0,0,0,0,0,0,1,1
caskdata_cdap,io.cdap.cdap.common.entity,0,0,0,0,0,0,1,1
caskdata_cdap,io.cdap.cdap.common.guice,0,0,0,0,1,0,1,2
caskdata_cdap,io.cdap.cdap.common.guice.preview,0,0,0,0,0,0,1,1
caskdata_cdap,io.cdap.cdap.common.http,0,0,0,0,0,0,1,1
caskdata_cdap,io.cdap.cdap.common.id,0,0,0,0,0,3,1,4
caskdata_cdap,io.cdap.cdap.common.internal.guava,0,0,0,0,0,0,1,1
caskdata_cdap,io.cdap.cdap.common.internal.remote,0,0,0,0,0,0,1,1
caskdata_cdap,io.cdap.cdap.common.io,0,0,0,0,1,1,1,3
caskdata_cdap,io.cdap.cdap.common.lang,1,1,0,0,1,0,1,4
caskdata_cdap,io.cdap.cdap.common.lang.jar,0,0,0,0,1,0,1,2
caskdata_cdap,io.cdap.cdap.common.logging,0,0,0,0,1,0,1,2
caskdata_cdap,io.cdap.cdap.common.logging.common,0,0,0,0,0,0,1,1
caskdata_cdap,io.cdap.cdap.common.logging.perf,0,0,0,0,0,0,1,1
caskdata_cdap,io.cdap.cdap.common.metadata,0,1,0,0,1,0,1,3
caskdata_cdap,io.cdap.cdap.common.metrics,0,0,0,0,0,0,1,1
caskdata_cdap,io.cdap.cdap.common.namespace,2,1,0,0,1,1,1,6
caskdata_cdap,io.cdap.cdap.common.namespace.guice,0,0,0,0,0,0,1,1
caskdata_cdap,io.cdap.cdap.common.options,0,0,0,0,0,0,1,1
caskdata_cdap,io.cdap.cdap.common.resource,0,0,0,0,0,0,1,1
caskdata_cdap,io.cdap.cdap.common.runtime,0,0,0,0,0,0,1,1
caskdata_cdap,io.cdap.cdap.common.security,0,0,0,0,1,0,1,2
caskdata_cdap,io.cdap.cdap.common.service,0,0,0,0,1,1,1,3
caskdata_cdap,io.cdap.cdap.common.ssh,0,0,0,0,1,0,1,2
caskdata_cdap,io.cdap.cdap.common.startup,0,0,0,0,1,0,1,2
caskdata_cdap,io.cdap.cdap.common.transaction,0,0,0,0,0,0,1,1
caskdata_cdap,io.cdap.cdap.common.utils,0,0,0,0,1,2,1,4
caskdata_cdap,io.cdap.cdap.common.zookeeper.coordination,0,0,0,0,1,0,1,2
caskdata_cdap,io.cdap.cdap.common.zookeeper.election,0,0,0,0,0,0,1,1
caskdata_cdap,io.cdap.cdap.common.zookeeper,0,0,0,0,0,0,1,1
caskdata_cdap,io.cdap.cdap.common.zookeeper.store,0,0,0,0,0,0,1,1
caskdata_cdap,io.cdap.cdap.internal.asm,0,0,0,0,1,0,1,2
caskdata_cdap,io.cdap.cdap.common.startup.check.fail,0,0,0,0,0,0,1,1
caskdata_cdap,io.cdap.cdap.common.startup.check,0,0,0,0,0,0,1,1
caskdata_cdap,io.cdap.cdap.io,0,0,0,0,1,1,1,3
caskdata_cdap,io.cdap.cdap.data.dataset,0,0,0,0,0,0,1,1
caskdata_cdap,io.cdap.cdap.data,0,0,0,0,0,0,1,1
caskdata_cdap,io.cdap.cdap.data.runtime,21,1,0,0,1,0,1,24
caskdata_cdap,io.cdap.cdap.data.runtime.preview,0,0,0,0,0,0,1,1
caskdata_cdap,io.cdap.cdap.data.security,0,0,0,0,0,0,1,1
caskdata_cdap,io.cdap.cdap.data.startup,0,0,0,0,0,0,1,1
caskdata_cdap,io.cdap.cdap.data2.audit,0,0,0,0,1,0,1,2
caskdata_cdap,io.cdap.cdap.data2.audit.payload.builder,0,0,0,0,0,0,1,1
caskdata_cdap,io.cdap.cdap.data2.datafabric.dataset,19,1,0,0,1,1,1,23
caskdata_cdap,io.cdap.cdap.data2.datafabric.dataset.instance,0,0,0,0,0,0,1,1
caskdata_cdap,io.cdap.cdap.data2.datafabric.dataset.service,14,1,0,0,1,3,1,20
caskdata_cdap,io.cdap.cdap.data2.datafabric.dataset.service.executor,5,1,0,0,1,1,1,9
caskdata_cdap,io.cdap.cdap.data2.datafabric.dataset.service.mds,0,0,0,0,0,0,1,1
caskdata_cdap,io.cdap.cdap.data2.datafabric.dataset.type,0,0,0,0,1,0,1,2
caskdata_cdap,io.cdap.cdap.data2.datafabric,0,0,0,0,0,0,1,1
caskdata_cdap,io.cdap.cdap.data2.dataset2,16,1,0,1,1,0,1,20
caskdata_cdap,io.cdap.cdap.data2.dataset2.lib.cube,4,0,0,0,1,1,1,7
caskdata_cdap,io.cdap.cdap.data2.dataset2.lib.external,0,0,0,0,0,0,1,1
caskdata_cdap,io.cdap.cdap.data2.dataset2.lib.file,2,0,0,0,1,0,1,4
caskdata_cdap,io.cdap.cdap.data2.dataset2.lib.hbase,0,0,0,0,0,0,1,1
caskdata_cdap,io.cdap.cdap.data2.dataset2.lib.kv,0,0,0,0,1,0,1,2
caskdata_cdap,io.cdap.cdap.data2.dataset2.lib.partitioned,7,0,0,1,1,0,1,10
caskdata_cdap,io.cdap.cdap.data2.dataset2.lib.table,13,1,0,1,1,4,1,21
caskdata_cdap,io.cdap.cdap.data2.dataset2.lib.table.hbase,6,1,0,0,1,0,1,9
caskdata_cdap,io.cdap.cdap.data2.dataset2.lib.table.inmemory,9,1,0,0,1,0,1,12
caskdata_cdap,io.cdap.cdap.data2.dataset2.lib.table.leveldb,3,1,0,0,1,1,1,7
caskdata_cdap,io.cdap.cdap.data2.dataset2.lib.timeseries,2,1,0,0,1,1,1,6
caskdata_cdap,io.cdap.cdap.data2.dataset2.module.lib,2,1,0,0,0,0,1,4
caskdata_cdap,io.cdap.cdap.data2.dataset2.module.lib.hbase,0,0,0,0,0,0,1,1
caskdata_cdap,io.cdap.cdap.data2.dataset2.module.lib.inmemory,2,0,0,0,0,0,1,3
caskdata_cdap,io.cdap.cdap.data2.dataset2.module.lib.leveldb,0,0,0,0,0,0,1,1
caskdata_cdap,io.cdap.cdap.data2.dataset2.preview,0,0,0,0,0,0,1,1
caskdata_cdap,io.cdap.cdap.data2.metadata,2,1,0,0,0,0,1,4
caskdata_cdap,io.cdap.cdap.data2.metadata.dataset,0,1,0,0,1,3,1,6
caskdata_cdap,io.cdap.cdap.data2.metadata.indexer,0,0,0,0,1,0,1,2
caskdata_cdap,io.cdap.cdap.data2.metadata.lineage,1,1,0,0,1,0,1,4
caskdata_cdap,io.cdap.cdap.data2.metadata.lineage.field,1,0,0,0,0,0,1,2
caskdata_cdap,io.cdap.cdap.data2.metadata.system,0,0,0,0,1,0,1,2
caskdata_cdap,io.cdap.cdap.data2.metadata.writer,11,1,0,0,1,0,1,14
caskdata_cdap,io.cdap.cdap.data2.metrics,1,0,0,0,0,0,1,2
caskdata_cdap,io.cdap.cdap.data2.queue,0,0,0,0,0,0,1,1
caskdata_cdap,io.cdap.cdap.data2.registry,1,0,0,0,1,3,1,6
caskdata_cdap,io.cdap.cdap.data2.transaction,2,1,0,0,1,0,1,5
caskdata_cdap,io.cdap.cdap.data2.transaction.metrics,0,0,0,0,0,0,1,1
caskdata_cdap,io.cdap.cdap.spi.data.common,4,0,0,0,0,1,1,6
caskdata_cdap,io.cdap.cdap.spi.data.nosql.dataset,0,0,0,0,0,0,1,1
caskdata_cdap,io.cdap.cdap.spi.data.nosql,3,1,0,0,1,0,1,6
caskdata_cdap,io.cdap.cdap.spi.data.sql.jdbc,0,0,0,0,0,0,1,1
caskdata_cdap,io.cdap.cdap.spi.data.sql,2,1,0,0,1,0,1,5
caskdata_cdap,io.cdap.cdap.spi.metadata.dataset,0,0,0,0,1,0,1,2
caskdata_cdap,io.cdap.cdap.spi.metadata.noop,0,0,0,0,0,0,1,1
caskdata_cdap,io.cdap.cdap.store,12,1,0,1,0,0,1,15
caskdata_cdap,io.cdap.cdap.data.hbase,0,0,0,0,0,0,1,1
caskdata_cdap,io.cdap.cdap.data2.dataset2.cache,0,0,0,0,1,0,1,2
caskdata_cdap,io.cdap.cdap.data2.dataset2.customds,0,0,0,0,1,0,1,2
caskdata_cdap,io.cdap.cdap.data2.dataset2.lib,0,0,0,0,0,0,1,1
caskdata_cdap,io.cdap.cdap.data2.increment.hbase,2,1,0,0,1,0,1,5
caskdata_cdap,io.cdap.cdap.data2.transaction.queue.leveldb,0,0,0,0,0,1,1,2
caskdata_cdap,io.cdap.cdap.data2.util.hbase,0,0,0,1,1,1,1,4
caskdata_cdap,io.cdap.cdap.kafka,0,0,0,0,0,0,1,1
caskdata_cdap,io.cdap.cdap.data2.transaction.distributed,0,0,0,0,0,0,1,1
caskdata_cdap,org.apache.tephra.inmemory,0,0,0,0,0,0,1,1
caskdata_cdap,io.cdap.cdap.docgen.cli,0,0,0,0,0,0,1,1
caskdata_cdap,io.cdap.cdap.docgen.client,0,0,0,0,0,0,1,1
caskdata_cdap,io.cdap.cdap.metadata.elastic,0,0,0,0,1,1,1,3
caskdata_cdap,io.cdap.cdap.explore.executor,2,0,0,0,1,0,1,4
caskdata_cdap,io.cdap.cdap.explore.guice,0,0,0,0,1,0,1,2
caskdata_cdap,io.cdap.cdap.explore,0,1,0,0,0,0,1,2
caskdata_cdap,io.cdap.cdap.explore.service,18,1,0,1,1,0,1,22
caskdata_cdap,io.cdap.cdap.explore.service.hive,1,0,0,0,1,0,1,3
caskdata_cdap,io.cdap.cdap.explore.table,0,0,0,0,1,1,1,3
caskdata_cdap,io.cdap.cdap.hive.context,0,0,0,0,1,0,1,2
caskdata_cdap,io.cdap.cdap.hive.datasets,0,0,0,0,1,0,1,2
caskdata_cdap,io.cdap.cdap.hive.objectinspector,0,0,0,0,1,0,1,2
caskdata_cdap,io.cdap.cdap.hive.serde,0,0,0,0,1,0,1,2
caskdata_cdap,io.cdap.cdap.explore.service.datasets,0,0,0,1,1,2,1,5
caskdata_cdap,io.cdap.cdap.explore.client,5,1,0,0,1,0,1,8
caskdata_cdap,io.cdap.cdap.explore.utils,0,0,0,0,0,0,1,1
caskdata_cdap,io.cdap.cdap.explore.jdbc,1,0,0,0,1,0,1,3
caskdata_cdap,io.cdap.cdap.format,0,0,0,0,1,7,1,9
caskdata_cdap,io.cdap.cdap.format.io,0,0,0,0,1,1,1,3
caskdata_cdap,io.cdap.cdap.gateway.discovery,0,0,0,0,0,0,1,1
caskdata_cdap,io.cdap.cdap.gateway,4,1,0,0,0,0,1,6
caskdata_cdap,io.cdap.cdap.gateway.router,3,0,0,1,1,0,1,6
caskdata_cdap,io.cdap.cdap.gateway.router.handlers,0,0,0,0,1,0,1,2
caskdata_cdap,io.cdap.cdap.gateway.handlers.hooks,0,0,0,0,0,0,1,1
caskdata_cdap,io.cdap.cdap.gateway.handlers.log,1,0,0,0,1,0,1,3
caskdata_cdap,io.cdap.cdap.gateway.handlers.metrics,0,0,0,0,0,0,1,1
caskdata_cdap,(default package),0,0,0,0,0,0,1,1
caskdata_cdap,io.cdap.cdap.data2.increment.hbase10,2,0,0,0,1,0,1,4
caskdata_cdap,io.cdap.cdap.data2.replication,0,0,0,0,1,0,1,2
caskdata_cdap,io.cdap.cdap.data2.transaction.coprocessor.hbase10,0,0,0,0,0,0,1,1
caskdata_cdap,io.cdap.cdap.data2.transaction.messaging.coprocessor.hbase10,0,0,0,0,0,0,1,1
caskdata_cdap,io.cdap.cdap.data2.increment.hbase10cdh,0,0,0,0,1,0,1,2
caskdata_cdap,io.cdap.cdap.data2.transaction.coprocessor.hbase10cdh,0,0,0,0,0,0,1,1
caskdata_cdap,io.cdap.cdap.data2.transaction.messaging.coprocessor.hbase10cdh,0,0,0,0,0,0,1,1
caskdata_cdap,io.cdap.data2.txprune,0,0,0,0,0,0,1,1
caskdata_cdap,io.cdap.cdap.data2.increment.hbase10cdh550,0,0,0,0,1,0,1,2
caskdata_cdap,io.cdap.cdap.data2.transaction.coprocessor.hbase10cdh550,0,0,0,0,0,0,1,1
caskdata_cdap,io.cdap.cdap.data2.transaction.messaging.coprocessor.hbase10cdh550,0,0,0,0,0,0,1,1
caskdata_cdap,io.cdap.cdap.data2.increment.hbase11,0,0,0,0,1,0,1,2
caskdata_cdap,io.cdap.cdap.data2.transaction.coprocessor.hbase11,0,0,0,0,0,0,1,1
caskdata_cdap,io.cdap.cdap.data2.transaction.messaging.coprocessor.hbase11,0,0,0,0,0,0,1,1
caskdata_cdap,io.cdap.cdap.data2.increment.hbase12cdh570,0,0,0,0,1,0,1,2
caskdata_cdap,io.cdap.cdap.data2.transaction.coprocessor.hbase12cdh570,0,0,0,0,0,0,1,1
caskdata_cdap,io.cdap.cdap.data2.transaction.messaging.coprocessor.hbase12cdh570,0,0,0,0,0,0,1,1
caskdata_cdap,io.cdap.cdap.data2.transaction.coprocessor,0,0,0,0,0,0,1,1
caskdata_cdap,io.cdap.cdap.data2.util,0,0,0,0,0,2,1,3
caskdata_cdap,io.cdap.cdap.hbase.wd,0,0,0,0,0,0,1,1
caskdata_cdap,io.cdap.cdap.messaging,0,1,0,0,1,4,1,7
caskdata_cdap,io.cdap.cdap.replication,0,0,0,0,0,0,1,1
caskdata_cdap,io.cdap.cdap.spi.hbase,0,0,0,0,0,0,1,1
caskdata_cdap,io.cdap.cdap.kafka.run,0,0,0,0,0,0,1,1
caskdata_cdap,io.cdap.cdap.security.store,1,1,0,0,1,0,1,4
caskdata_cdap,io.cdap.cdap.k8s.common,0,0,0,0,0,0,1,1
caskdata_cdap,io.cdap.cdap.k8s.discovery,0,0,0,0,0,0,1,1
caskdata_cdap,io.cdap.cdap.k8s.runtime,0,0,0,0,1,0,1,2
caskdata_cdap,io.cdap.cdap.data.runtime.main,11,0,0,0,1,0,1,13
caskdata_cdap,io.cdap.cdap.data.runtime.main.transaction,0,0,0,0,0,0,1,1
caskdata_cdap,io.cdap.cdap.data.tools,1,0,0,0,1,0,1,3
caskdata_cdap,io.cdap.cdap.master.startup,25,1,0,0,1,0,1,28
caskdata_cdap,io.cdap.cdap.master.upgrade,0,0,0,0,0,2,1,3
caskdata_cdap,io.cdap.cdap.master.environment.app,0,0,0,0,0,1,1,2
caskdata_cdap,io.cdap.cdap.master.environment.plugin,0,1,0,0,0,0,1,2
caskdata_cdap,io.cdap.cdap.master.spi.discovery,0,0,0,0,0,0,1,1
caskdata_cdap,io.cdap.cdap.master.spi.environment,0,0,0,0,0,0,1,1
caskdata_cdap,io.cdap.cdap.spi.metadata,0,1,0,0,1,1,1,4
caskdata_cdap,io.cdap.cdap.operations.cdap,0,0,0,0,1,0,1,2
caskdata_cdap,io.cdap.cdap.proto,0,0,0,1,1,1,1,4
caskdata_cdap,io.cdap.cdap.proto.artifact,0,0,0,0,1,1,1,3
caskdata_cdap,io.cdap.cdap.proto.artifact.preview,0,0,0,0,0,0,1,1
caskdata_cdap,io.cdap.cdap.proto.audit,0,0,0,0,0,0,1,1
caskdata_cdap,io.cdap.cdap.proto.audit.payload.access,0,0,0,0,0,0,1,1
caskdata_cdap,io.cdap.cdap.proto.audit.payload.metadata,0,0,0,0,0,0,1,1
caskdata_cdap,io.cdap.cdap.proto.bootstrap,0,0,0,0,0,0,1,1
caskdata_cdap,io.cdap.cdap.proto.codec,0,0,0,0,1,0,1,2
caskdata_cdap,io.cdap.cdap.proto.id,0,0,0,0,0,18,1,19
caskdata_cdap,io.cdap.cdap.proto.metadata.lineage,0,0,0,0,1,0,1,2
caskdata_cdap,io.cdap.cdap.proto.metadata,0,0,0,0,0,0,1,1
caskdata_cdap,io.cdap.cdap.proto.ops,0,0,0,0,0,0,1,1
caskdata_cdap,io.cdap.cdap.proto.profile,0,0,0,0,0,1,1,2
caskdata_cdap,io.cdap.cdap.proto.provisioner,0,0,0,0,0,0,1,1
caskdata_cdap,io.cdap.cdap.proto.security,0,0,0,0,1,2,1,4
caskdata_cdap,io.cdap.cdap.runtime.spi.provisioner.dataproc,0,0,0,0,0,0,1,1
caskdata_cdap,io.cdap.cdap.runtime.spi.provisioner.emr,0,0,0,0,0,0,1,1
caskdata_cdap,io.cdap.cdap.runtime.spi.provisioner.remote,0,0,0,0,0,1,1,2
caskdata_cdap,io.cdap.cdap.runtime.spi.provisioner,0,0,0,0,1,1,1,3
caskdata_cdap,io.cdap.cdap.runtime.spi.ssh,0,0,0,0,1,1,1,3
caskdata_cdap,io.cdap.cdap.securestore.gcp.cloudkms,0,0,0,0,0,0,1,1
caskdata_cdap,io.cdap.cdap.securestore.spi,0,1,0,0,0,0,1,2
caskdata_cdap,io.cdap.cdap.securestore.spi.secret,0,0,0,0,0,0,1,1
caskdata_cdap,io.cdap.cdap.security.auth,4,1,0,1,1,0,1,8
caskdata_cdap,io.cdap.cdap.security.auth.context,0,0,0,0,0,0,1,1
caskdata_cdap,io.cdap.cdap.security.authorization,7,1,0,1,1,0,1,11
caskdata_cdap,io.cdap.cdap.security.guice,3,0,0,0,1,0,1,5
caskdata_cdap,io.cdap.cdap.security.guice.preview,0,0,0,0,0,0,1,1
caskdata_cdap,io.cdap.cdap.security.runtime,0,0,0,0,0,0,1,1
caskdata_cdap,io.cdap.cdap.security.server,2,0,0,0,1,0,1,4
caskdata_cdap,io.cdap.cdap.security.store.client,0,0,0,0,0,0,1,1
caskdata_cdap,io.cdap.cdap.security.store.secretmanager,0,0,0,0,1,0,1,2
caskdata_cdap,io.cdap.cdap.security.zookeeper,0,0,0,0,1,0,1,2
caskdata_cdap,io.cdap.cdap.security.spi.authentication,0,1,0,0,0,4,1,6
caskdata_cdap,io.cdap.cdap.security.spi.authorization,0,1,0,0,1,2,1,5
caskdata_cdap,io.cdap.cdap.app.runtime.spark.python,0,0,0,0,1,0,1,2
caskdata_cdap,io.cdap.cdap.app.runtime.spark,2,1,0,1,1,1,1,7
caskdata_cdap,org.apache.spark.executor,0,0,0,0,0,0,1,1
caskdata_cdap,io.cdap.cdap.app.runtime.spark.classloader,0,0,0,0,1,0,1,2
caskdata_cdap,io.cdap.cdap.app.runtime.spark.dynamic,0,0,0,0,1,0,1,2
caskdata_cdap,io.cdap.cdap.app.runtime.spark.preview,0,0,0,0,0,1,1,2
caskdata_cdap,io.cdap.cdap.app.runtime.spark.serializer,0,0,0,0,1,1,1,3
caskdata_cdap,io.cdap.cdap.app.runtime.spark.service,0,0,0,0,1,0,1,2
caskdata_cdap,io.cdap.cdap.app.runtime.spark.submit,0,0,0,0,1,0,1,2
caskdata_cdap,org.apache.spark.util,0,0,0,0,0,0,1,1
caskdata_cdap,io.cdap.cdap.spi.data,5,1,0,0,1,3,1,11
caskdata_cdap,io.cdap.cdap.spi.data.table.field,4,0,0,0,1,3,1,9
caskdata_cdap,io.cdap.cdap.spi.data.table,4,1,0,0,1,0,1,7
caskdata_cdap,io.cdap.cdap.spi.data.transaction,2,1,0,0,1,4,1,9
caskdata_cdap,io.cdap.cdap.messaging.cache,0,0,0,0,1,0,1,2
caskdata_cdap,io.cdap.cdap.messaging.client,0,0,0,0,1,1,1,3
caskdata_cdap,io.cdap.cdap.messaging.context,0,0,0,0,1,2,1,4
caskdata_cdap,io.cdap.cdap.messaging.data,0,0,0,0,0,0,1,1
caskdata_cdap,io.cdap.cdap.messaging.distributed,1,1,0,0,0,0,1,3
caskdata_cdap,io.cdap.cdap.messaging.guice,1,0,0,0,0,0,1,2
caskdata_cdap,io.cdap.cdap.messaging.server,0,0,0,0,1,1,1,3
caskdata_cdap,io.cdap.cdap.messaging.service,0,0,0,0,1,0,1,2
caskdata_cdap,io.cdap.cdap.messaging.store,0,0,0,0,1,2,1,4
caskdata_cdap,io.cdap.cdap.messaging.store.cache,0,0,0,0,1,0,1,2
caskdata_cdap,io.cdap.cdap.messaging.store.hbase,0,0,0,0,1,0,1,2
caskdata_cdap,io.cdap.cdap.messaging.store.leveldb,0,0,0,0,1,0,1,2
caskdata_cdap,io.cdap.cdap.messaging.subscriber,0,0,0,0,0,0,1,1
caskdata_cdap,io.cdap.cdap.ui,0,0,0,0,0,0,1,1
caskdata_cdap,io.cdap.cdap.admin,0,0,0,0,1,0,1,2
caskdata_cdap,io.cdap.cdap.mapreduce.service,0,0,0,0,0,1,1,2
caskdata_cdap,io.cdap.cdap.partitioned,0,0,0,0,1,1,1,3
caskdata_cdap,io.cdap.cdap.partitioned.concatenate,0,0,0,0,0,0,1,1
caskdata_cdap,io.cdap.cdap.service,1,1,0,0,1,1,1,5
caskdata_cdap,io.cdap.cdap.service.function,1,1,0,0,0,0,1,3
caskdata_cdap,io.cdap.cdap.spark.app,0,0,0,0,1,1,1,3
caskdata_cdap,io.cdap.cdap.spark.app.plugin,0,0,0,0,0,0,1,1
caskdata_cdap,io.cdap.cdap.spark,0,0,0,0,0,0,1,1
caskdata_cdap,io.cdap.cdap.spark.metrics,0,0,0,0,0,1,1,2
caskdata_cdap,io.cdap.cdap.spark.service,0,0,0,0,0,0,1,1
caskdata_cdap,io.cdap.cdap.spark.stream,0,0,0,0,0,0,1,1
caskdata_cdap,io.cdap.cdap.logging.appender,3,1,0,0,1,0,1,6
caskdata_cdap,io.cdap.cdap.logging.appender.kafka,0,0,0,0,0,0,1,1
caskdata_cdap,io.cdap.cdap.logging.appender.loader,0,0,0,0,0,0,1,1
caskdata_cdap,io.cdap.cdap.logging.appender.remote,0,0,0,0,0,0,1,1
caskdata_cdap,io.cdap.cdap.logging.appender.system,2,0,0,0,1,0,1,4
caskdata_cdap,io.cdap.cdap.logging.appender.tms,0,0,0,0,0,0,1,1
caskdata_cdap,io.cdap.cdap.logging.clean,0,0,0,0,1,0,1,2
caskdata_cdap,io.cdap.cdap.logging.context,0,0,0,0,0,0,1,1
caskdata_cdap,io.cdap.cdap.logging.filter,0,0,0,0,0,0,1,1
caskdata_cdap,io.cdap.cdap.logging.framework,0,0,0,0,1,0,1,2
caskdata_cdap,io.cdap.cdap.logging.framework.distributed,1,0,0,0,0,0,1,2
caskdata_cdap,io.cdap.cdap.logging.framework.local,0,0,0,0,0,0,1,1
caskdata_cdap,io.cdap.cdap.logging.gateway.handlers,0,0,0,0,1,0,1,2
caskdata_cdap,io.cdap.cdap.logging.gateway.handlers.store,0,0,0,0,0,0,1,1
caskdata_cdap,io.cdap.cdap.logging.guice,0,0,0,0,1,0,1,2
caskdata_cdap,io.cdap.cdap.logging.kafka,0,0,0,0,0,0,1,1
caskdata_cdap,io.cdap.cdap.logging.logbuffer.cleaner,0,0,0,0,0,0,1,1
caskdata_cdap,io.cdap.cdap.logging.logbuffer,0,0,0,0,1,0,1,2
caskdata_cdap,io.cdap.cdap.logging.logbuffer.handler,0,0,0,0,0,0,1,1
caskdata_cdap,io.cdap.cdap.logging.logbuffer.recover,0,0,0,0,0,0,1,1
caskdata_cdap,io.cdap.cdap.logging,4,0,0,0,0,0,1,5
caskdata_cdap,io.cdap.cdap.logging.meta,2,1,0,0,1,0,1,5
caskdata_cdap,io.cdap.cdap.logging.pipeline.kafka,0,0,0,0,1,0,1,2
caskdata_cdap,io.cdap.cdap.logging.pipeline.logbuffer,0,0,0,0,1,0,1,2
caskdata_cdap,io.cdap.cdap.logging.pipeline,0,1,0,0,1,0,1,3
caskdata_cdap,io.cdap.cdap.logging.pipeline.queue,0,0,0,0,1,0,1,2
caskdata_cdap,io.cdap.cdap.logging.plugins,0,0,0,0,1,0,1,2
caskdata_cdap,io.cdap.cdap.logging.read,5,1,0,0,1,0,1,8
caskdata_cdap,io.cdap.cdap.logging.run,0,0,0,0,0,0,1,1
caskdata_cdap,io.cdap.cdap.logging.serialize,0,0,0,0,1,0,1,2
caskdata_cdap,io.cdap.cdap.logging.service,0,0,0,0,0,0,1,1
caskdata_cdap,io.cdap.cdap.logging.write,4,1,0,0,0,0,1,6
caskdata_cdap,io.cdap.cdap.metrics.collect,0,0,0,0,1,0,1,2
caskdata_cdap,io.cdap.cdap.metrics.guice,0,0,0,0,0,0,1,1
caskdata_cdap,io.cdap.cdap.metrics,0,0,0,0,0,0,1,1
caskdata_cdap,io.cdap.cdap.metrics.process,2,0,0,0,1,0,1,4
caskdata_cdap,io.cdap.cdap.metrics.query,0,0,0,0,1,0,1,2
caskdata_cdap,io.cdap.cdap.metrics.runtime,0,0,0,0,0,0,1,1
caskdata_cdap,io.cdap.cdap.metrics.store,1,1,0,0,0,0,1,3
caskdata_cdap,io.cdap.cdap.metrics.store.upgrade,0,0,0,0,0,0,1,1
caskdata_cdap,io.cdap.cdap.common.logging.logback,0,0,0,0,0,0,1,1
caskdata_cdap,io.cdap.cdap.logging.appender.file,0,0,0,0,0,0,1,1
caskdata_cdap,io.cdap.cdap.api.logging,0,0,0,0,0,0,1,1
caskdata_coopr,co.cask.coopr.shell,2,1,0,0,0,0,1,4
caskdata_coopr,co.cask.coopr.shell.command,3,1,0,1,0,0,1,6
caskdata_coopr,co.cask.coopr.shell.command.set,2,0,0,0,0,0,1,3
caskdata_coopr,co.cask.coopr.shell.util,0,0,0,0,0,0,1,1
caskdata_coopr,co.cask.coopr.client,0,0,0,0,1,0,1,2
caskdata_coopr,co.cask.coopr.client.rest,1,0,0,0,0,0,1,2
caskdata_coopr,co.cask.coopr.client.rest.exception,0,0,0,0,0,0,1,1
caskdata_coopr,co.cask.coopr.client.rest.request,0,0,0,0,0,0,1,1
caskdata_coopr,co.cask.coopr.client.rest.handler,1,1,0,0,0,0,1,3
caskdata_coopr,co.cask.coopr.account,0,0,0,0,0,1,1,2
caskdata_coopr,co.cask.coopr.cluster,13,1,0,0,1,8,1,24
caskdata_coopr,co.cask.coopr.codec.json,0,0,0,0,0,0,1,1
caskdata_coopr,co.cask.coopr.codec.json.current,0,0,0,1,1,0,1,3
caskdata_coopr,co.cask.coopr.codec.json.guice,0,0,0,0,0,0,1,1
caskdata_coopr,co.cask.coopr.common.conf,0,0,0,0,1,1,1,3
caskdata_coopr,co.cask.coopr.common.conf.guice,0,0,0,0,0,0,1,1
caskdata_coopr,co.cask.coopr.common.daemon,0,0,0,0,0,0,1,1
caskdata_coopr,co.cask.coopr.common.queue,0,0,0,0,1,0,1,2
caskdata_coopr,co.cask.coopr.common.queue.guice,0,0,0,0,0,0,1,1
caskdata_coopr,co.cask.coopr.common.queue.internal,0,0,0,0,1,0,1,2
caskdata_coopr,co.cask.coopr.common.security,0,0,0,0,0,0,1,1
caskdata_coopr,co.cask.coopr.common.utils,0,0,0,0,0,0,1,1
caskdata_coopr,co.cask.coopr.common.zookeeper,0,0,0,0,1,0,1,2
caskdata_coopr,co.cask.coopr.common.zookeeper.guice,0,0,0,0,0,0,1,1
caskdata_coopr,co.cask.coopr.common.zookeeper.lib,0,0,0,0,1,0,1,2
caskdata_coopr,co.cask.coopr.http,1,1,0,0,1,1,1,5
caskdata_coopr,co.cask.coopr.http.guice,0,0,0,0,0,0,1,1
caskdata_coopr,co.cask.coopr.http.handler,1,0,0,0,1,0,1,3
caskdata_coopr,co.cask.coopr.http.handler.auth,0,0,0,0,0,0,1,1
caskdata_coopr,co.cask.coopr.http.request,3,1,0,0,1,0,1,6
caskdata_coopr,co.cask.coopr.layout.change,4,0,0,0,1,0,1,6
caskdata_coopr,co.cask.coopr.layout,5,1,0,0,1,1,1,9
caskdata_coopr,co.cask.coopr.macro.eval,1,1,0,0,0,1,1,4
caskdata_coopr,co.cask.coopr.macro,1,0,0,0,1,0,1,3
caskdata_coopr,co.cask.coopr.management,0,0,0,0,0,0,1,1
caskdata_coopr,co.cask.coopr.management.guice,0,0,0,0,0,0,1,1
caskdata_coopr,co.cask.coopr.metrics,0,0,0,0,0,0,1,1
caskdata_coopr,co.cask.coopr.provisioner,6,0,0,0,1,0,1,8
caskdata_coopr,co.cask.coopr.provisioner.guice,0,0,0,0,0,0,1,1
caskdata_coopr,co.cask.coopr.provisioner.mock,0,0,0,0,0,0,1,1
caskdata_coopr,co.cask.coopr.provisioner.plugin,0,0,0,0,0,1,1,2
caskdata_coopr,co.cask.coopr.runtime,0,0,0,0,0,0,1,1
caskdata_coopr,co.cask.coopr.scheduler,3,0,0,0,1,3,1,8
caskdata_coopr,co.cask.coopr.scheduler.callback,4,0,0,0,1,1,1,7
caskdata_coopr,co.cask.coopr.scheduler.dag,0,0,0,0,0,2,1,3
caskdata_coopr,co.cask.coopr.scheduler.guice,0,0,0,0,0,0,1,1
caskdata_coopr,co.cask.coopr.scheduler.task,14,1,0,0,1,3,1,20
caskdata_coopr,co.cask.coopr.spec,0,0,0,0,1,6,1,8
caskdata_coopr,co.cask.coopr.spec.plugin,0,0,0,0,0,0,1,1
caskdata_coopr,co.cask.coopr.spec.service,0,0,0,0,1,4,1,6
caskdata_coopr,co.cask.coopr.spec.template,4,1,0,0,1,0,1,7
caskdata_coopr,co.cask.coopr.store.cluster,4,0,0,0,1,2,1,8
caskdata_coopr,co.cask.coopr.store.credential,0,0,0,0,1,0,1,2
caskdata_coopr,co.cask.coopr.store,0,0,0,0,0,0,1,1
caskdata_coopr,co.cask.coopr.store.entity,1,0,0,0,1,0,1,3
caskdata_coopr,co.cask.coopr.store.guice,0,0,0,0,0,0,1,1
caskdata_coopr,co.cask.coopr.store.node,0,0,0,0,1,0,1,2
caskdata_coopr,co.cask.coopr.store.provisioner,3,0,0,0,1,0,1,5
caskdata_coopr,co.cask.coopr.store.tenant,1,0,0,0,0,0,1,2
caskdata_coopr,co.cask.coopr.store.user,1,0,0,0,0,0,1,2
caskdata_coopr,co.cask.coopr.upgrade,0,0,0,0,0,0,1,1
caskdata_coopr,co.cask.coopr,15,1,0,0,1,0,1,18
caskdata_coopr,co.cask.coopr.scheduler.action,0,0,0,0,0,0,1,1
caskdata_tephra,co.cask.tephra,8,1,0,1,0,0,1,11
caskdata_tephra,co.cask.tephra.coprocessor,0,0,0,0,0,0,1,1
caskdata_tephra,co.cask.tephra.distributed,3,1,0,1,0,0,1,6
caskdata_tephra,co.cask.tephra.distributed.thrift,0,0,0,1,0,0,1,2
caskdata_tephra,co.cask.tephra.inmemory,0,0,0,0,0,0,1,1
caskdata_tephra,co.cask.tephra.metrics,4,1,0,0,0,0,1,6
caskdata_tephra,co.cask.tephra.persist,8,1,0,1,0,0,1,11
caskdata_tephra,co.cask.tephra.rpc,0,0,0,0,0,0,1,1
caskdata_tephra,co.cask.tephra.runtime,0,0,0,0,1,0,1,2
caskdata_tephra,co.cask.tephra.snapshot,2,0,0,0,0,0,1,3
caskdata_tephra,co.cask.tephra.util,3,1,0,0,1,0,1,6
caskdata_tephra,co.cask.tephra.visibility,0,0,0,0,0,0,1,1
caskdata_tephra,co.cask.tephra.zookeeper,0,0,0,0,0,0,1,1
caskdata_tephra,org.apache.thrift.server,0,0,0,0,0,0,1,1
caskdata_tephra,co.cask.tephra.hbase,0,0,0,0,0,0,1,1
caskdata_tephra,co.cask.tephra.examples,0,0,0,0,0,0,1,1
caskdata_tephra,co.cask.tephra.hbase96.coprocessor,0,0,0,0,0,0,1,1
caskdata_tephra,co.cask.tephra.hbase96,0,0,0,0,1,0,1,2
caskdata_tephra,co.cask.tephra.hbase98.coprocessor,0,0,0,0,0,0,1,1
caskdata_tephra,co.cask.tephra.hbase98,0,0,0,0,1,0,1,2
caskdata_tephra,co.cask.tephra.hbase10.coprocessor,0,0,0,0,0,0,1,1
caskdata_tephra,co.cask.tephra.hbase10,0,0,0,0,1,0,1,2
caskdata_tephra,co.cask.tephra.hbase10cdh.coprocessor,0,0,0,0,0,0,1,1
caskdata_tephra,co.cask.tephra.hbase10cdh,0,0,0,0,1,0,1,2
caskdata_tephra,co.cask.tephra.hbase11.coprocessor,0,0,0,0,0,0,1,1
caskdata_tephra,co.cask.tephra.hbase11,0,0,0,0,1,0,1,2
castlabs_dashencrypt,com.castlabs.dash.dashfragmenter,0,0,0,0,0,0,0,0
castlabs_dashencrypt,com.castlabs.dash.dashfragmenter.cmdlines,0,0,0,0,1,0,0,1
castlabs_dashencrypt,com.castlabs.dash.dashfragmenter.cmdlines.trackoptions,0,0,0,0,1,0,0,1
castlabs_dashencrypt,com.castlabs.dash.dashfragmenter.encrypt2,0,0,0,0,0,0,0,0
castlabs_dashencrypt,com.castlabs.dash.dashfragmenter.representation,0,0,0,0,1,0,0,1
castlabs_dashencrypt,com.castlabs.dash.helpers,0,0,0,0,1,0,0,1
castlabs_dashencrypt,mpeg.cenc._2013,0,0,0,0,0,0,0,0
castlabs_dashencrypt,mpeg.dash.schema.mpd._2011,0,0,0,0,0,0,0,0
castlabs_dashencrypt,org.w3._1999.xlink,0,0,0,0,0,0,0,0
cecom_pomutils,de.oppermann.pomutils.commands,0,0,0,0,0,0,0,0
cecom_pomutils,de.oppermann.pomutils,0,0,0,0,1,0,0,1
cecom_pomutils,de.oppermann.pomutils.rules,0,0,0,0,1,0,0,1
cecom_pomutils,de.oppermann.pomutils.select,0,0,0,0,0,0,0,0
cecom_pomutils,de.oppermann.pomutils.util,0,0,0,0,0,0,0,0
ceph_cephfs-hadoop,org.apache.hadoop.fs.ceph,0,0,0,0,1,0,0,1
ceph_cephfs-hadoop,org.apache.hadoop.fs.contract.cephfs,0,0,0,0,0,0,0,0
ceskaexpedice_kramerius,cz.incad.kramerius.auth.basic,0,0,0,0,0,0,1,1
ceskaexpedice_kramerius,cz.incad.kramerius.auth.thirdparty,0,0,0,0,0,0,1,1
ceskaexpedice_kramerius,cz.incad.kramerius.auth.thirdparty.impl,0,0,0,0,0,0,1,1
ceskaexpedice_kramerius,cz.incad.kramerius.auth.thirdparty.shibb.external,1,0,0,0,0,0,1,2
ceskaexpedice_kramerius,cz.incad.kramerius.auth.thirdparty.shibb.impl,0,0,0,0,0,0,1,1
ceskaexpedice_kramerius,cz.incad.kramerius.auth.thirdparty.shibb.internal,0,0,0,0,0,0,1,1
ceskaexpedice_kramerius,cz.incad.kramerius.auth.thirdparty.shibb.rules.objects,0,1,0,0,0,0,1,2
ceskaexpedice_kramerius,cz.incad.kramerius.auth.thirdparty.shibb.rules,0,0,0,0,0,0,1,1
ceskaexpedice_kramerius,cz.incad.kramerius.auth.thirdparty.shibb,0,0,0,0,0,0,1,1
ceskaexpedice_kramerius,cz.incad.kramerius.auth.thirdparty.shibb.utils,0,1,0,0,0,0,1,2
ceskaexpedice_kramerius,cz.incad.kramerius.auth.thirdparty.social,0,0,0,0,0,0,1,1
ceskaexpedice_kramerius,cz.incad.kramerius.auth.thirdparty.social.utils,0,0,0,0,0,0,1,1
ceskaexpedice_kramerius,cz.incad.kramerius.auth.thirdparty.utils,1,1,0,0,0,0,1,3
ceskaexpedice_kramerius,cz.incad.kramerius.auth.shibb.rules,0,0,0,0,0,0,1,1
ceskaexpedice_kramerius,cz.incad.kramerius.auth.shibb.utils,0,0,0,0,0,0,1,1
ceskaexpedice_kramerius,cz.incad.kramerius.client,0,0,0,0,1,0,1,2
ceskaexpedice_kramerius,cz.incad.kramerius.client.forward,0,0,0,0,0,0,1,1
ceskaexpedice_kramerius,cz.incad.kramerius.client.handle,0,0,0,0,0,0,1,1
ceskaexpedice_kramerius,cz.incad.kramerius.client.i18n,0,0,0,0,1,0,1,2
ceskaexpedice_kramerius,cz.incad.kramerius.client.kapi.auth,0,1,0,0,0,0,1,2
ceskaexpedice_kramerius,cz.incad.kramerius.client.kapi.auth.impl,0,0,0,0,0,0,1,1
ceskaexpedice_kramerius,cz.incad.kramerius.client.resources.merge.css,0,0,0,0,0,0,1,1
ceskaexpedice_kramerius,cz.incad.kramerius.client.resources.merge,0,0,0,0,0,0,1,1
ceskaexpedice_kramerius,cz.incad.kramerius.client.resources.merge.validators,0,0,0,0,0,0,1,1
ceskaexpedice_kramerius,cz.incad.kramerius.client.resources,0,0,0,0,0,0,1,1
ceskaexpedice_kramerius,cz.incad.kramerius.client.shib,0,0,0,0,0,0,1,1
ceskaexpedice_kramerius,cz.incad.kramerius.client.socialauth,0,0,0,0,0,0,1,1
ceskaexpedice_kramerius,cz.incad.kramerius.client.tools,0,0,0,0,1,0,1,2
ceskaexpedice_kramerius,cz.incad.kramerius.client.tools.json,0,0,0,0,0,0,1,1
ceskaexpedice_kramerius,cz.incad.kramerius.client.tools.utils,0,0,0,0,0,0,1,1
ceskaexpedice_kramerius,cz.incad.kramerius.client.utils,0,0,0,0,0,0,1,1
ceskaexpedice_kramerius,cz.incad.utils,0,0,0,0,1,0,1,2
ceskaexpedice_kramerius,cz.incad.kramerius,25,1,0,0,1,0,1,28
ceskaexpedice_kramerius,cz.incad.kramerius.audio,3,1,0,0,1,0,1,6
ceskaexpedice_kramerius,cz.incad.kramerius.audio.jersey,1,0,0,0,0,0,1,2
ceskaexpedice_kramerius,cz.incad.kramerius.audio.servlets,1,1,0,0,0,0,1,3
ceskaexpedice_kramerius,cz.incad.kramerius.audio.urlMapping,1,0,0,0,0,0,1,2
ceskaexpedice_kramerius,cz.incad.kramerius.auth.utils,0,0,0,0,0,0,1,1
ceskaexpedice_kramerius,cz.incad.kramerius.database.cond,1,0,0,0,0,0,1,2
ceskaexpedice_kramerius,cz.incad.kramerius.database.guice,0,0,0,0,0,0,1,1
ceskaexpedice_kramerius,cz.incad.kramerius.database.impl,0,0,0,0,0,0,1,1
ceskaexpedice_kramerius,cz.incad.kramerius.database.utils,1,1,0,0,0,0,1,3
ceskaexpedice_kramerius,cz.incad.kramerius.database,1,0,0,0,0,0,1,2
ceskaexpedice_kramerius,cz.incad.kramerius.document,1,1,0,0,0,0,1,3
ceskaexpedice_kramerius,cz.incad.kramerius.document.guice,0,0,0,0,0,0,1,1
ceskaexpedice_kramerius,cz.incad.kramerius.document.impl,2,1,0,0,0,0,1,4
ceskaexpedice_kramerius,cz.incad.kramerius.document.model,3,0,0,0,0,0,1,4
ceskaexpedice_kramerius,cz.incad.kramerius.document.model.utils,0,0,0,0,0,0,1,1
ceskaexpedice_kramerius,cz.incad.kramerius.imaging,15,1,0,0,1,0,1,18
ceskaexpedice_kramerius,cz.incad.kramerius.imaging.guice,0,0,0,0,0,0,1,1
ceskaexpedice_kramerius,cz.incad.kramerius.imaging.impl,5,0,0,0,1,0,1,7
ceskaexpedice_kramerius,cz.incad.kramerius.imaging.lp,0,0,0,0,0,0,1,1
ceskaexpedice_kramerius,cz.incad.kramerius.imaging.lp.guice,0,0,0,0,0,0,1,1
ceskaexpedice_kramerius,cz.incad.kramerius.imaging.paths,0,0,0,0,0,0,1,1
ceskaexpedice_kramerius,cz.incad.kramerius.imaging.paths.impl,0,0,0,0,0,0,1,1
ceskaexpedice_kramerius,cz.incad.kramerius.imaging.utils,0,0,0,0,0,0,1,1
ceskaexpedice_kramerius,cz.incad.kramerius.impl,3,1,0,0,1,0,1,6
ceskaexpedice_kramerius,cz.incad.kramerius.impl.fedora,0,0,0,0,0,0,1,1
ceskaexpedice_kramerius,cz.incad.kramerius.intconfig,0,0,0,0,0,0,1,1
ceskaexpedice_kramerius,cz.incad.kramerius.pdf,1,1,0,0,1,0,1,4
ceskaexpedice_kramerius,cz.incad.kramerius.pdf.commands,0,0,0,0,0,0,1,1
ceskaexpedice_kramerius,cz.incad.kramerius.pdf.commands.lists,0,0,0,0,0,0,1,1
ceskaexpedice_kramerius,cz.incad.kramerius.pdf.commands.render,0,0,0,0,0,0,1,1
ceskaexpedice_kramerius,cz.incad.kramerius.pdf.guice,0,0,0,0,0,0,1,1
ceskaexpedice_kramerius,cz.incad.kramerius.pdf.impl,3,0,0,0,1,0,1,5
ceskaexpedice_kramerius,cz.incad.kramerius.pdf.utils,0,0,0,0,1,0,1,2
ceskaexpedice_kramerius,cz.incad.kramerius.pdf.utils.pdf,0,0,0,0,0,0,1,1
ceskaexpedice_kramerius,cz.incad.kramerius.printing.guice,0,0,0,0,0,0,1,1
ceskaexpedice_kramerius,cz.incad.kramerius.printing.impl,0,0,0,0,0,0,1,1
ceskaexpedice_kramerius,cz.incad.kramerius.printing,0,0,0,0,0,0,1,1
ceskaexpedice_kramerius,cz.incad.kramerius.printing.utils,0,0,0,0,0,0,1,1
ceskaexpedice_kramerius,cz.incad.kramerius.processes,9,1,0,0,1,0,1,12
ceskaexpedice_kramerius,cz.incad.kramerius.processes.database,7,1,0,0,1,0,1,10
ceskaexpedice_kramerius,cz.incad.kramerius.processes.def,0,0,0,0,0,0,1,1
ceskaexpedice_kramerius,cz.incad.kramerius.processes.guice,0,0,0,0,0,0,1,1
ceskaexpedice_kramerius,cz.incad.kramerius.processes.impl,20,1,0,0,1,0,1,23
ceskaexpedice_kramerius,cz.incad.kramerius.processes.impl.io,0,0,0,0,0,0,1,1
ceskaexpedice_kramerius,cz.incad.kramerius.processes.logging,0,0,0,0,0,0,1,1
ceskaexpedice_kramerius,cz.incad.kramerius.processes.manages,0,0,0,0,0,0,1,1
ceskaexpedice_kramerius,cz.incad.kramerius.processes.manages.input,0,0,0,0,0,0,1,1
ceskaexpedice_kramerius,cz.incad.kramerius.processes.mock.logs,0,0,0,0,0,0,1,1
ceskaexpedice_kramerius,cz.incad.kramerius.processes.mock,0,0,0,0,0,0,1,1
ceskaexpedice_kramerius,cz.incad.kramerius.processes.mock.wizard,0,0,0,0,0,0,1,1
ceskaexpedice_kramerius,cz.incad.kramerius.processes.os.impl.unix,2,0,0,0,0,0,1,3
ceskaexpedice_kramerius,cz.incad.kramerius.processes.os.impl.windows.csv,0,0,0,0,0,0,1,1
ceskaexpedice_kramerius,cz.incad.kramerius.processes.os.impl.windows,0,0,0,0,0,0,1,1
ceskaexpedice_kramerius,cz.incad.kramerius.processes.template.impl,0,0,0,0,0,0,1,1
ceskaexpedice_kramerius,cz.incad.kramerius.processes.template,0,0,0,0,0,0,1,1
ceskaexpedice_kramerius,cz.incad.kramerius.processes.utils,5,1,0,0,0,0,1,7
ceskaexpedice_kramerius,cz.incad.kramerius.relation.impl,1,0,0,0,0,0,1,2
ceskaexpedice_kramerius,cz.incad.kramerius.relation,1,1,0,0,1,0,1,4
ceskaexpedice_kramerius,cz.incad.kramerius.resourceindex,2,0,0,0,0,0,1,3
ceskaexpedice_kramerius,cz.incad.kramerius.security,26,1,0,0,0,0,1,28
ceskaexpedice_kramerius,cz.incad.kramerius.security.database,3,1,0,0,0,0,1,5
ceskaexpedice_kramerius,cz.incad.kramerius.security.guice,0,0,0,0,0,0,1,1
ceskaexpedice_kramerius,cz.incad.kramerius.security.impl,6,0,0,0,1,0,1,8
ceskaexpedice_kramerius,cz.incad.kramerius.security.impl.criteria,0,0,0,0,0,0,1,1
ceskaexpedice_kramerius,cz.incad.kramerius.security.impl.criteria.mw,0,0,0,0,0,0,1,1
ceskaexpedice_kramerius,cz.incad.kramerius.security.impl.http,0,0,0,0,1,0,1,2
ceskaexpedice_kramerius,cz.incad.kramerius.security.utils,13,1,0,0,0,0,1,15
ceskaexpedice_kramerius,cz.incad.kramerius.service,1,1,0,0,1,0,1,4
ceskaexpedice_kramerius,cz.incad.kramerius.service.guice,0,0,0,0,0,0,1,1
ceskaexpedice_kramerius,cz.incad.kramerius.service.impl,1,1,0,0,1,0,1,4
ceskaexpedice_kramerius,cz.incad.kramerius.service.replication,0,0,0,0,0,0,1,1
ceskaexpedice_kramerius,cz.incad.kramerius.statistics.database,0,0,0,0,0,0,1,1
ceskaexpedice_kramerius,cz.incad.kramerius.statistics.filters,0,0,0,0,0,0,1,1
ceskaexpedice_kramerius,cz.incad.kramerius.statistics.impl,0,0,0,0,0,0,1,1
ceskaexpedice_kramerius,cz.incad.kramerius.statistics,0,1,0,0,0,0,1,2
ceskaexpedice_kramerius,cz.incad.kramerius.users.database,1,0,0,0,0,0,1,2
ceskaexpedice_kramerius,cz.incad.kramerius.users.guice,0,0,0,0,0,0,1,1
ceskaexpedice_kramerius,cz.incad.kramerius.users.impl.http,0,0,0,0,0,0,1,1
ceskaexpedice_kramerius,cz.incad.kramerius.users.impl,1,0,0,0,0,0,1,2
ceskaexpedice_kramerius,cz.incad.kramerius.users,2,1,0,0,0,0,1,4
ceskaexpedice_kramerius,cz.incad.kramerius.users.utils,1,1,0,0,0,0,1,3
ceskaexpedice_kramerius,cz.incad.kramerius.utils,33,1,0,1,1,0,1,37
ceskaexpedice_kramerius,cz.incad.kramerius.utils.conf,0,0,0,0,0,0,1,1
ceskaexpedice_kramerius,cz.incad.kramerius.utils.database,3,1,0,0,1,0,1,6
ceskaexpedice_kramerius,cz.incad.kramerius.utils.handle,0,0,0,0,0,0,1,1
ceskaexpedice_kramerius,cz.incad.kramerius.utils.imgs,1,0,0,0,0,0,1,2
ceskaexpedice_kramerius,cz.incad.kramerius.utils.jersey,0,0,0,0,0,0,1,1
ceskaexpedice_kramerius,cz.incad.kramerius.utils.json,0,0,0,0,0,0,1,1
ceskaexpedice_kramerius,cz.incad.kramerius.utils.mods,0,0,0,0,0,0,1,1
ceskaexpedice_kramerius,cz.incad.kramerius.utils.params,0,0,0,0,0,0,1,1
ceskaexpedice_kramerius,cz.incad.kramerius.utils.pid,0,0,0,0,0,0,1,1
ceskaexpedice_kramerius,cz.incad.kramerius.utils.properties,1,0,0,0,0,0,1,2
ceskaexpedice_kramerius,cz.incad.kramerius.utils.solr,1,0,0,0,0,0,1,2
ceskaexpedice_kramerius,cz.incad.kramerius.utils.stemplates,0,0,0,0,0,0,1,1
ceskaexpedice_kramerius,cz.incad.kramerius.utils.templates,0,0,0,0,0,0,1,1
ceskaexpedice_kramerius,cz.incad.kramerius.virtualcollections,18,1,0,0,1,0,1,21
ceskaexpedice_kramerius,cz.incad.kramerius.virtualcollections.impl,0,0,0,0,0,0,1,1
ceskaexpedice_kramerius,cz.incad.kramerius.virtualcollections.impl.fedora,3,0,0,0,0,0,1,4
ceskaexpedice_kramerius,cz.incad.kramerius.virtualcollections.impl.solr,0,0,0,0,0,0,1,1
ceskaexpedice_kramerius,cz.knav.pdf,0,0,0,0,0,0,1,1
ceskaexpedice_kramerius,cz.incad.kramerius.pdf.pdfpages,0,0,0,0,0,0,1,1
ceskaexpedice_kramerius,cz.incad.kramerius.fedora.impl,1,0,0,0,1,0,1,3
ceskaexpedice_kramerius,cz.incad.kramerius.security.database.impl,0,0,0,0,0,0,1,1
ceskaexpedice_kramerius,(default package),0,0,0,0,0,0,1,1
ceskaexpedice_kramerius,org.kramerius.consistency,0,0,0,0,1,0,1,2
ceskaexpedice_kramerius,org.kramerius.convert.input,0,0,0,0,0,0,1,1
ceskaexpedice_kramerius,org.kramerius.convert,0,0,0,0,0,0,1,1
ceskaexpedice_kramerius,org.kramerius,0,0,0,0,0,0,1,1
ceskaexpedice_kramerius,org.kramerius.imports.input,0,0,0,0,0,0,1,1
ceskaexpedice_kramerius,org.kramerius.imports,0,0,0,0,0,0,1,1
ceskaexpedice_kramerius,org.kramerius.k3replications.input,0,0,0,0,0,0,1,1
ceskaexpedice_kramerius,org.kramerius.k3replications,0,0,0,0,0,0,1,1
ceskaexpedice_kramerius,org.kramerius.processes.filetree,1,1,0,0,0,0,1,3
ceskaexpedice_kramerius,org.kramerius.processes.utils,1,0,0,0,0,0,1,2
ceskaexpedice_kramerius,org.kramerius.replications,0,0,0,0,0,0,1,1
ceskaexpedice_kramerius,org.kramerius.replications.inputs,0,0,0,0,0,0,1,1
ceskaexpedice_kramerius,org.kramerius.replications.outputs,0,0,0,0,0,0,1,1
ceskaexpedice_kramerius,org.kramerius.replications.pidlist,0,0,0,0,0,0,1,1
ceskaexpedice_kramerius,org.kramerius.fedora.impl,0,0,0,0,0,0,1,1
ceskaexpedice_kramerius,com.qbizm.kramerius.imptool.poc.convertor,1,0,0,0,0,0,1,2
ceskaexpedice_kramerius,com.qbizm.kramerius.imptool.poc,2,1,0,0,0,0,1,4
ceskaexpedice_kramerius,com.qbizm.kramerius.imptool.poc.utils,0,0,0,0,0,0,1,1
ceskaexpedice_kramerius,com.qbizm.kramerius.imptool.poc.valueobj,1,0,0,0,1,0,1,3
ceskaexpedice_kramerius,com.sun.xml.bind.marshaller,0,0,0,0,0,0,1,1
ceskaexpedice_kramerius,org.kramerius.importmets.convertor,2,0,0,0,0,0,1,3
ceskaexpedice_kramerius,org.kramerius.importmets,3,1,0,0,0,0,1,5
ceskaexpedice_kramerius,org.kramerius.importmets.parametrized.input,0,0,0,0,0,0,1,1
ceskaexpedice_kramerius,org.kramerius.importmets.parametrized,0,0,0,0,0,0,1,1
ceskaexpedice_kramerius,org.kramerius.importmets.utils,0,0,0,0,0,0,1,1
ceskaexpedice_kramerius,org.kramerius.importmets.valueobj,2,1,0,0,1,0,1,5
ceskaexpedice_kramerius,cz.incad.kramerius.indexer.coordinates,0,0,0,0,0,0,1,1
ceskaexpedice_kramerius,cz.incad.kramerius.indexer,0,0,0,0,1,0,1,2
ceskaexpedice_kramerius,dk.defxws.fedoragsearch.server,0,0,0,0,0,0,1,1
ceskaexpedice_kramerius,cz.incad.kramerius.k5indexer,0,0,0,0,1,0,1,2
ceskaexpedice_kramerius,cz.cas.lib.knav,0,1,0,0,1,0,1,3
ceskaexpedice_kramerius,cz.cas.lib.knav.indexer,0,1,0,0,0,0,1,2
ceskaexpedice_kramerius,cz.cas.lib.knav.templates,0,0,0,0,0,0,1,1
ceskaexpedice_kramerius,cz.incad.kramerius.rest.api.client.v46,0,0,0,0,0,0,1,1
ceskaexpedice_kramerius,cz.incad.kramerius.rest.api.client.v50.admin,0,0,0,0,0,0,1,1
ceskaexpedice_kramerius,cz.incad.kramerius.rest.api.client.v50.client,0,0,0,0,1,0,1,2
ceskaexpedice_kramerius,cz.incad.kramerius.rest.api.exceptions,0,0,0,0,1,0,1,2
ceskaexpedice_kramerius,cz.incad.kramerius.rest.api.guice,17,1,0,0,0,0,1,19
ceskaexpedice_kramerius,cz.incad.kramerius.rest.api.iiif,2,0,0,0,0,0,1,3
ceskaexpedice_kramerius,cz.incad.kramerius.rest.api.k5.admin.rights,0,0,0,0,0,0,1,1
ceskaexpedice_kramerius,cz.incad.kramerius.rest.api.k5.admin.statistics,0,0,0,0,0,0,1,1
ceskaexpedice_kramerius,cz.incad.kramerius.rest.api.k5.admin.users,0,0,0,0,0,0,1,1
ceskaexpedice_kramerius,cz.incad.kramerius.rest.api.k5.admin.vc,0,0,0,0,0,0,1,1
ceskaexpedice_kramerius,cz.incad.kramerius.rest.api.k5.client,21,1,0,0,1,0,1,24
ceskaexpedice_kramerius,cz.incad.kramerius.rest.api.k5.client.authentication,0,0,0,0,0,0,1,1
ceskaexpedice_kramerius,cz.incad.kramerius.rest.api.k5.client.feedback,0,0,0,0,0,0,1,1
ceskaexpedice_kramerius,cz.incad.kramerius.rest.api.k5.client.feeder.decorators,2,0,0,0,0,0,1,3
ceskaexpedice_kramerius,cz.incad.kramerius.rest.api.k5.client.feeder,2,0,0,0,0,0,1,3
ceskaexpedice_kramerius,cz.incad.kramerius.rest.api.k5.client.impl,1,0,0,0,0,0,1,2
ceskaexpedice_kramerius,cz.incad.kramerius.rest.api.k5.client.info,0,0,0,0,0,0,1,1
ceskaexpedice_kramerius,cz.incad.kramerius.rest.api.k5.client.item.decorators,3,0,0,0,0,0,1,4
ceskaexpedice_kramerius,cz.incad.kramerius.rest.api.k5.client.item.decorators.details,0,0,0,0,0,0,1,1
ceskaexpedice_kramerius,cz.incad.kramerius.rest.api.k5.client.item.decorators.display,2,0,0,0,0,0,1,3
ceskaexpedice_kramerius,cz.incad.kramerius.rest.api.k5.client.item.exceptions,0,0,0,0,0,0,1,1
ceskaexpedice_kramerius,cz.incad.kramerius.rest.api.k5.client.item,7,0,0,0,0,0,1,8
ceskaexpedice_kramerius,cz.incad.kramerius.rest.api.k5.client.item.utils,5,1,0,0,0,0,1,7
ceskaexpedice_kramerius,cz.incad.kramerius.rest.api.k5.client.pdf,1,0,0,0,1,0,1,3
ceskaexpedice_kramerius,cz.incad.kramerius.rest.api.k5.client.pdf.utils,0,0,0,0,0,0,1,1
ceskaexpedice_kramerius,cz.incad.kramerius.rest.api.k5.client.rights,0,0,0,0,0,0,1,1
ceskaexpedice_kramerius,cz.incad.kramerius.rest.api.k5.client.search.decorators,0,0,0,0,0,0,1,1
ceskaexpedice_kramerius,cz.incad.kramerius.rest.api.k5.client.search,2,0,0,0,0,0,1,3
ceskaexpedice_kramerius,cz.incad.kramerius.rest.api.k5.client.user,1,0,0,0,0,0,1,2
ceskaexpedice_kramerius,cz.incad.kramerius.rest.api.k5.client.utils,9,1,0,0,1,0,1,12
ceskaexpedice_kramerius,cz.incad.kramerius.rest.api.k5.client.virtualcollection,0,0,0,0,0,0,1,1
ceskaexpedice_kramerius,cz.incad.kramerius.rest.api.processes.exceptions,0,0,0,0,1,0,1,2
ceskaexpedice_kramerius,cz.incad.kramerius.rest.api.processes.filter,0,0,0,0,0,0,1,1
ceskaexpedice_kramerius,cz.incad.kramerius.rest.api.processes,1,0,0,0,0,0,1,2
ceskaexpedice_kramerius,cz.incad.kramerius.rest.api.replication,0,0,0,0,0,0,1,1
ceskaexpedice_kramerius,cz.incad.kramerius.rest.api.replication.exceptions,0,0,0,0,0,0,1,1
ceskaexpedice_kramerius,cz.incad.kramerius.rest.api.serialization,0,0,0,0,0,0,1,1
ceskaexpedice_kramerius,cz.incad.kramerius.rest.api.utils.dbfilter,1,1,0,0,0,0,1,3
ceskaexpedice_kramerius,cz.incad.kramerius.rest.api.utils,0,0,0,0,0,0,1,1
ceskaexpedice_kramerius,cz.incad.kramerius.solr.impl,0,0,0,0,0,0,1,1
ceskaexpedice_kramerius,cz.incad.Kramerius,0,0,0,0,1,0,1,2
ceskaexpedice_kramerius,cz.incad.Kramerius.admins,0,1,0,0,0,0,1,2
ceskaexpedice_kramerius,cz.incad.Kramerius.admins.commands,0,0,0,0,0,0,1,1
ceskaexpedice_kramerius,cz.incad.Kramerius.apache.modproxy,0,0,0,0,0,0,1,1
ceskaexpedice_kramerius,cz.incad.Kramerius.audio.servlet,0,0,0,0,0,0,1,1
ceskaexpedice_kramerius,cz.incad.Kramerius.backend.guice,0,0,0,0,1,0,1,2
ceskaexpedice_kramerius,cz.incad.Kramerius.exts.menu.context,0,0,0,0,0,0,1,1
ceskaexpedice_kramerius,cz.incad.Kramerius.exts.menu.context.guice,0,0,0,0,0,0,1,1
ceskaexpedice_kramerius,cz.incad.Kramerius.exts.menu.context.impl,0,0,0,0,0,0,1,1
ceskaexpedice_kramerius,cz.incad.Kramerius.exts.menu.context.impl.adm,0,0,0,0,0,0,1,1
ceskaexpedice_kramerius,cz.incad.Kramerius.exts.menu.context.impl.adm.items,0,0,0,0,1,0,1,2
ceskaexpedice_kramerius,cz.incad.Kramerius.exts.menu.context.impl.pub.items,0,0,0,0,1,0,1,2
ceskaexpedice_kramerius,cz.incad.Kramerius.exts.menu.context.impl.pub,0,0,0,0,0,0,1,1
ceskaexpedice_kramerius,cz.incad.Kramerius.exts.menu.context.impl.utils,0,0,0,0,0,0,1,1
ceskaexpedice_kramerius,cz.incad.Kramerius.exts.menu.impl,0,0,0,0,0,0,1,1
ceskaexpedice_kramerius,cz.incad.Kramerius.exts.menu.main.guice,0,0,0,0,0,0,1,1
ceskaexpedice_kramerius,cz.incad.Kramerius.exts.menu.main.impl,0,0,0,0,0,0,1,1
ceskaexpedice_kramerius,cz.incad.Kramerius.exts.menu.main.impl.adm,0,0,0,0,0,0,1,1
ceskaexpedice_kramerius,cz.incad.Kramerius.exts.menu.main.impl.adm.items,0,0,0,0,1,0,1,2
ceskaexpedice_kramerius,cz.incad.Kramerius.exts.menu.main.impl.pub.items,0,0,0,0,0,0,1,1
ceskaexpedice_kramerius,cz.incad.Kramerius.exts.menu.main.impl.pub,0,0,0,0,0,0,1,1
ceskaexpedice_kramerius,cz.incad.Kramerius.exts.menu.main,0,0,0,0,0,0,1,1
ceskaexpedice_kramerius,cz.incad.Kramerius.exts.menu,0,0,0,0,0,0,1,1
ceskaexpedice_kramerius,cz.incad.Kramerius.exts.menu.utils,0,0,0,0,0,0,1,1
ceskaexpedice_kramerius,cz.incad.Kramerius.imaging,3,0,0,0,1,0,1,5
ceskaexpedice_kramerius,cz.incad.Kramerius.imaging.utils,2,0,0,0,0,0,1,3
ceskaexpedice_kramerius,cz.incad.Kramerius.oai,0,0,0,0,1,0,1,2
ceskaexpedice_kramerius,cz.incad.Kramerius.processes.imported.views,0,0,0,0,0,0,1,1
ceskaexpedice_kramerius,cz.incad.Kramerius.security.rightscommands.post,0,0,0,0,0,0,1,1
ceskaexpedice_kramerius,cz.incad.Kramerius.security.rightscommands,0,0,0,0,0,0,1,1
ceskaexpedice_kramerius,cz.incad.Kramerius.security,0,0,0,0,0,0,1,1
ceskaexpedice_kramerius,cz.incad.Kramerius.security.strenderers,0,0,0,0,1,0,1,2
ceskaexpedice_kramerius,cz.incad.Kramerius.security.userscommands.get,0,0,0,0,1,0,1,2
ceskaexpedice_kramerius,cz.incad.Kramerius.security.userscommands.post,0,0,0,0,1,0,1,2
ceskaexpedice_kramerius,cz.incad.Kramerius.security.userscommands,0,0,0,0,0,0,1,1
ceskaexpedice_kramerius,cz.incad.Kramerius.security.utils,0,0,0,0,0,0,1,1
ceskaexpedice_kramerius,cz.incad.Kramerius.statistics.formatters.guice,0,0,0,0,0,0,1,1
ceskaexpedice_kramerius,cz.incad.Kramerius.statistics.formatters.main.impl,0,0,0,0,0,0,1,1
ceskaexpedice_kramerius,cz.incad.Kramerius.statistics.formatters.main,0,0,0,0,0,0,1,1
ceskaexpedice_kramerius,cz.incad.Kramerius.statistics.formatters.report.annual,0,1,0,0,0,0,1,2
ceskaexpedice_kramerius,cz.incad.Kramerius.statistics.formatters.report.author,0,0,0,0,0,0,1,1
ceskaexpedice_kramerius,cz.incad.Kramerius.statistics.formatters.report.lang,0,0,0,0,0,0,1,1
ceskaexpedice_kramerius,cz.incad.Kramerius.statistics.formatters.report.model,0,0,0,0,0,0,1,1
ceskaexpedice_kramerius,cz.incad.Kramerius.statistics.formatters.report,0,0,0,0,0,0,1,1
ceskaexpedice_kramerius,cz.incad.Kramerius.statistics.formatters,0,0,0,0,0,0,1,1
ceskaexpedice_kramerius,cz.incad.Kramerius.statistics.formatters.utils,0,0,0,0,0,0,1,1
ceskaexpedice_kramerius,cz.incad.Kramerius.statistics,0,0,0,0,0,0,1,1
ceskaexpedice_kramerius,cz.incad.Kramerius.tags,0,0,0,0,1,0,1,2
ceskaexpedice_kramerius,cz.incad.Kramerius.users,0,0,0,0,0,0,1,1
ceskaexpedice_kramerius,cz.incad.Kramerius.utils,0,0,0,0,0,0,1,1
ceskaexpedice_kramerius,cz.incad.Kramerius.views,0,0,0,0,1,0,1,2
ceskaexpedice_kramerius,cz.incad.Kramerius.views.adminmenu,0,0,0,0,0,0,1,1
ceskaexpedice_kramerius,cz.incad.Kramerius.views.help,0,0,0,0,0,0,1,1
ceskaexpedice_kramerius,cz.incad.Kramerius.views.inc,0,0,0,0,1,0,1,2
ceskaexpedice_kramerius,cz.incad.Kramerius.views.inc.details.tabs,0,0,0,0,0,0,1,1
ceskaexpedice_kramerius,cz.incad.Kramerius.views.inc.home,0,0,0,0,0,0,1,1
ceskaexpedice_kramerius,cz.incad.Kramerius.views.inc.results,0,0,0,0,0,0,1,1
ceskaexpedice_kramerius,cz.incad.Kramerius.views.localprint,0,0,0,0,0,0,1,1
ceskaexpedice_kramerius,cz.incad.Kramerius.views.rights,0,0,0,0,1,0,1,2
ceskaexpedice_kramerius,cz.incad.Kramerius.views.social,0,0,0,0,0,0,1,1
ceskaexpedice_kramerius,cz.incad.Kramerius.views.statistics,0,0,0,0,0,0,1,1
ceskaexpedice_kramerius,cz.incad.Kramerius.views.statistics.details,0,0,0,0,0,0,1,1
ceskaexpedice_kramerius,cz.incad.Kramerius.views.themes,0,0,0,0,0,0,1,1
ceskaexpedice_kramerius,cz.incad.Kramerius.views.virtualcollection,0,0,0,0,0,0,1,1
ceskaexpedice_kramerius,cz.incad.Solr,0,0,0,0,0,0,1,1
ceskaexpedice_kramerius,cz.incad.kramerius.exts.menu.main,0,0,0,0,0,0,1,1
ceskaexpedice_kramerius,cz.incad.kramerius.processes.imported,0,0,0,0,0,0,1,1
ceskaexpedice_kramerius,cz.incad.kramerius.views,0,0,0,0,0,0,1,1
ceskaexpedice_kramerius,biz.sourcecode.base64Coder,0,0,0,0,0,0,1,1
ceskaexpedice_kramerius,cz.incad.kramerius.security.jaas,3,0,0,0,0,0,1,4
ceskaexpedice_kramerius,cz.incad.kramerius.services,0,0,0,0,0,0,1,1
ceskaexpedice_kramerius,cz.incad.kramerius.lp,0,0,0,0,1,0,1,2
ceskaexpedice_kramerius,cz.incad.kramerius.lp.guice,0,0,0,0,0,0,1,1
ceskaexpedice_kramerius,cz.incad.kramerius.lp.utils,0,0,0,0,1,0,1,2
cglib_cglib,net.sf.cglib.beans,0,0,0,1,1,0,0,2
cglib_cglib,net.sf.cglib.core,0,0,0,1,1,0,0,2
cglib_cglib,net.sf.cglib.core.internal,0,0,0,0,0,0,0,0
cglib_cglib,net.sf.cglib.proxy,1,0,0,1,1,0,0,3
cglib_cglib,net.sf.cglib.reflect,0,0,0,1,1,0,0,2
cglib_cglib,net.sf.cglib.transform,0,0,0,0,1,0,0,1
cglib_cglib,net.sf.cglib.transform.impl,0,0,0,1,1,0,0,2
cglib_cglib,net.sf.cglib.util,0,0,0,0,1,0,0,1
cglib_cglib,net.sf.cglib,0,0,0,0,0,0,0,0
cglib_cglib,net.sf.cglib.reflect.sub,0,0,0,0,0,0,0,0
cglib_cglib,net.sf.cglib.jmh,0,0,0,0,0,0,0,0
cglib_cglib,net.sf.cglib.jmh.generated,0,0,0,0,0,0,0,0
chanedi_QuickProject,chanedi.action,0,0,0,0,0,0,0,0
chanedi_QuickProject,chanedi.action.view,0,0,0,0,0,0,0,0
chanedi_QuickProject,chanedi.bean.editor,0,0,0,0,0,0,0,0
chanedi_QuickProject,chanedi.dao.complexQuery,0,0,0,0,0,0,0,0
chanedi_QuickProject,chanedi.dao.dialect,0,0,0,0,0,0,0,0
chanedi_QuickProject,chanedi.dao,0,0,0,0,0,1,0,1
chanedi_QuickProject,chanedi.dao.impl.mybatis,2,1,0,0,0,0,0,3
chanedi_QuickProject,chanedi.dao.impl.mybatis.interceptor,1,1,0,0,0,0,0,2
chanedi_QuickProject,chanedi.dao.impl.mybatis.modelParser,2,0,0,0,0,0,0,2
chanedi_QuickProject,chanedi.dao.impl.mybatis.session,0,0,0,0,0,0,0,0
chanedi_QuickProject,chanedi.dao.impl.mybatis.typeHandler,0,0,0,0,0,0,0,0
chanedi_QuickProject,chanedi.exception,0,0,0,0,0,0,0,0
chanedi_QuickProject,chanedi.model,0,0,0,0,0,1,0,1
chanedi_QuickProject,chanedi.service,0,0,0,0,0,1,0,1
chanedi_QuickProject,chanedi.bas.dao,0,0,0,0,0,0,0,0
chanedi_QuickProject,chanedi.bas.model,0,0,0,0,0,0,0,0
chanedi_QuickProject,chanedi.bas.service,0,0,0,0,0,0,0,0
chanedi_QuickProject,chanedi.bas.service.impl,0,0,0,0,0,0,0,0
chanedi_QuickProject,chanedi.generator,0,0,0,0,0,0,0,0
chanedi_QuickProject,chanedi.generator.file.exception,0,0,0,0,0,0,0,0
chanedi_QuickProject,chanedi.generator.file,1,0,0,0,0,0,0,1
chanedi_QuickProject,chanedi.generator.file.sqlparser,0,0,0,0,0,0,0,0
chanedi_QuickProject,chanedi.generator.file.sqlparser.gen,0,0,0,0,0,0,0,0
chanedi_QuickProject,chanedi.generator.log,0,0,0,0,0,0,0,0
chanedi_QuickProject,chanedi.generator.model,1,1,0,0,1,0,0,3
chanedi_QuickProject,chanedi.context,0,0,0,0,0,0,0,0
chanedi_QuickProject,chanedi.util,0,0,0,0,0,0,0,0
chanjarster_tomcat-mongo-access-log,me.chanjar.tomcat.valves,0,0,0,1,1,0,0,2
chanjarster_tomcat-mongo-access-log,me.chanjar.tomcat.util,0,0,0,0,0,0,0,0
chanjarster_tomcat-mongo-access-log,org.apache.catalina.startup,0,0,0,0,1,0,0,1
chanjarster_weixin-java-tools,me.chanjar.weixin.common.api,0,0,0,0,0,0,1,1
chanjarster_weixin-java-tools,me.chanjar.weixin.common.bean.result,1,0,0,0,0,0,1,2
chanjarster_weixin-java-tools,me.chanjar.weixin.common.bean,2,0,0,0,1,0,1,4
chanjarster_weixin-java-tools,me.chanjar.weixin.common.exception,0,0,0,0,0,0,1,1
chanjarster_weixin-java-tools,me.chanjar.weixin.common.session,0,0,0,0,0,3,1,4
chanjarster_weixin-java-tools,me.chanjar.weixin.common.util.crypto,0,0,0,0,0,0,1,1
chanjarster_weixin-java-tools,me.chanjar.weixin.common.util.fs,0,0,0,0,0,0,1,1
chanjarster_weixin-java-tools,me.chanjar.weixin.common.util.http,0,0,0,0,1,0,1,2
chanjarster_weixin-java-tools,me.chanjar.weixin.common.util.json,2,1,0,0,1,0,1,5
chanjarster_weixin-java-tools,me.chanjar.weixin.common.util,0,0,0,0,0,0,1,1
chanjarster_weixin-java-tools,me.chanjar.weixin.common.util.res,0,0,0,0,0,0,1,1
chanjarster_weixin-java-tools,me.chanjar.weixin.common.util.xml,0,0,0,0,0,0,1,1
chanjarster_weixin-java-tools,me.chanjar.weixin.cp.api,0,0,0,0,1,2,1,4
chanjarster_weixin-java-tools,me.chanjar.weixin.cp.bean.messagebuilder,0,0,0,0,0,0,1,1
chanjarster_weixin-java-tools,me.chanjar.weixin.cp.bean.outxmlbuilder,1,0,0,0,0,1,1,3
chanjarster_weixin-java-tools,me.chanjar.weixin.cp.bean,2,1,0,0,1,2,1,7
chanjarster_weixin-java-tools,me.chanjar.weixin.cp.util.crypto,0,0,0,0,0,0,1,1
chanjarster_weixin-java-tools,me.chanjar.weixin.cp.util.json,1,0,0,0,0,0,1,2
chanjarster_weixin-java-tools,me.chanjar.weixin.cp.util.xml,0,0,0,0,0,0,1,1
chanjarster_weixin-java-tools,me.chanjar.weixin.cp.demo,0,0,0,0,0,1,1,2
chanjarster_weixin-java-tools,me.chanjar.weixin.mp.api,0,0,0,0,1,3,1,5
chanjarster_weixin-java-tools,me.chanjar.weixin.mp.bean.custombuilder,0,0,0,0,0,1,1,2
chanjarster_weixin-java-tools,me.chanjar.weixin.mp.bean.outxmlbuilder,1,0,0,0,0,0,1,2
chanjarster_weixin-java-tools,me.chanjar.weixin.mp.bean.result,2,1,0,0,1,1,1,6
chanjarster_weixin-java-tools,me.chanjar.weixin.mp.bean,3,1,0,1,1,3,1,10
chanjarster_weixin-java-tools,me.chanjar.weixin.mp.util.crypto,0,0,0,0,0,0,1,1
chanjarster_weixin-java-tools,me.chanjar.weixin.mp.util.http,0,0,0,0,1,0,1,2
chanjarster_weixin-java-tools,me.chanjar.weixin.mp.util.json,3,1,0,0,1,0,1,6
chanjarster_weixin-java-tools,me.chanjar.weixin.mp.util.xml,0,0,0,0,0,0,1,1
chanjarster_weixin-java-tools,me.chanjar.weixin.mp.demo,0,0,0,0,0,1,1,2
chaupal_jxse,net.jxta.impl.cm.bdb,0,0,0,0,0,0,1,1
chaupal_jxse,net.jxta.impl.cm.srdi.bdb,0,0,0,0,0,1,1,2
chaupal_jxse,net.jxta.document,45,1,0,1,0,68,1,116
chaupal_jxse,net.jxta.impl.membership.pse.examples,0,0,0,0,0,1,1,2
chaupal_jxse,net.jxta.socket.examples,0,0,0,0,0,4,1,5
chaupal_jxse,net.jxse.configuration,0,0,0,0,0,2,1,3
chaupal_jxse,net.jxse.impl.OSGi.Activators,0,0,0,0,0,0,1,1
chaupal_jxse,net.jxse.impl.OSGi,0,0,0,0,0,0,1,1
chaupal_jxse,net.jxse.impl.OSGi.Services,0,0,0,0,0,0,1,1
chaupal_jxse,net.jxse,0,0,0,0,0,0,1,1
chaupal_jxse,net.jxse.module,0,0,0,0,0,0,1,1
chaupal_jxse,net.jxse.OSGi,0,0,0,0,0,0,1,1
chaupal_jxse,net.jxse.OSGi.Services,0,0,0,0,0,0,1,1
chaupal_jxse,net.jxse.service,0,0,0,0,0,0,1,1
chaupal_jxse,net.jxta.access,0,0,0,0,0,1,1,2
chaupal_jxse,net.jxta.codat,0,0,0,0,0,0,1,1
chaupal_jxse,net.jxta.configuration,0,0,0,0,1,1,1,3
chaupal_jxse,net.jxta.content,2,0,0,0,1,6,1,10
chaupal_jxse,net.jxta.credential,2,0,0,0,0,4,1,7
chaupal_jxse,net.jxta.discovery,0,0,0,0,0,9,1,10
chaupal_jxse,net.jxta.endpoint,27,1,0,1,0,53,1,83
chaupal_jxse,net.jxta.endpoint.router,0,0,0,0,0,0,1,1
chaupal_jxse,net.jxta.exception,0,0,0,0,1,0,1,2
chaupal_jxse,net.jxta.id,17,1,0,0,0,65,1,84
chaupal_jxse,net.jxta.id.jxta,8,0,0,0,0,0,1,9
chaupal_jxse,net.jxta.impl.access,0,0,0,0,0,2,1,3
chaupal_jxse,net.jxta.impl.access.always,0,0,0,0,0,2,1,3
chaupal_jxse,net.jxta.impl.access.pse,3,0,0,0,0,3,1,7
chaupal_jxse,net.jxta.impl.access.simpleACL,0,0,0,0,0,3,1,4
chaupal_jxse,net.jxta.impl.cm,5,1,0,1,0,18,1,26
chaupal_jxse,net.jxta.impl.cm.sql,0,0,0,0,0,0,1,1
chaupal_jxse,net.jxta.impl.cm.srdi.inmemory,2,0,0,0,1,1,1,5
chaupal_jxse,net.jxta.impl.content,3,0,0,0,1,6,1,11
chaupal_jxse,net.jxta.impl.content.defprovider,0,0,0,0,0,3,1,4
chaupal_jxse,net.jxta.impl.content.srdisocket,0,0,0,0,0,2,1,3
chaupal_jxse,net.jxta.impl.discovery,0,0,0,0,0,2,1,3
chaupal_jxse,net.jxta.impl.document,1,0,0,0,1,0,1,3
chaupal_jxse,net.jxta.impl.endpoint,25,1,0,0,1,16,1,44
chaupal_jxse,net.jxta.impl.endpoint.cbjx,3,0,0,0,0,0,1,4
chaupal_jxse,net.jxta.impl.endpoint.endpointMeter,2,0,0,0,1,2,1,6
chaupal_jxse,net.jxta.impl.endpoint.mcast,3,0,0,0,0,0,1,4
chaupal_jxse,net.jxta.impl.endpoint.msgframing,3,0,0,0,0,0,1,4
chaupal_jxse,net.jxta.impl.endpoint.netty,0,0,0,1,1,0,1,3
chaupal_jxse,net.jxta.impl.endpoint.netty.http,0,0,0,0,0,0,1,1
chaupal_jxse,net.jxta.impl.endpoint.relay,1,0,0,0,0,11,1,13
chaupal_jxse,net.jxta.impl.endpoint.router,8,0,0,0,0,10,1,19
chaupal_jxse,net.jxta.impl.endpoint.servlethttp,0,0,0,0,1,7,1,9
chaupal_jxse,net.jxta.impl.endpoint.tcp,0,0,0,0,0,1,1,2
chaupal_jxse,net.jxta.impl.endpoint.tls,2,0,0,0,0,3,1,6
chaupal_jxse,net.jxta.impl.endpoint.transportMeter,0,1,0,0,1,3,1,6
chaupal_jxse,net.jxta.impl.id.binaryID,0,0,0,0,0,1,1,2
chaupal_jxse,net.jxta.impl.id.CBID,0,0,0,0,0,0,1,1
chaupal_jxse,net.jxta.impl.id.unknown,0,0,0,0,0,0,1,1
chaupal_jxse,net.jxta.impl.id.UUID,2,1,0,0,0,2,1,6
chaupal_jxse,net.jxta.impl.loader,6,1,0,0,0,1,1,9
chaupal_jxse,net.jxta.impl.membership.none,2,0,0,0,0,1,1,4
chaupal_jxse,net.jxta.impl.membership.passwd,0,0,0,0,0,1,1,2
chaupal_jxse,net.jxta.impl.membership.pse,25,1,0,1,0,8,1,36
chaupal_jxse,net.jxta.impl.meter,3,0,0,0,1,1,1,6
chaupal_jxse,net.jxta.impl.peer,0,0,0,0,1,5,1,7
chaupal_jxse,net.jxta.impl.peergroup,19,1,0,0,1,3,1,25
chaupal_jxse,net.jxta.impl.pipe,0,0,0,0,0,4,1,5
chaupal_jxse,net.jxta.impl.protocol,3,1,0,1,1,12,1,19
chaupal_jxse,net.jxta.impl.rendezvous.adhoc,2,0,0,0,0,1,1,4
chaupal_jxse,net.jxta.impl.rendezvous.edge,4,0,0,0,0,3,1,8
chaupal_jxse,net.jxta.impl.rendezvous.limited,1,0,0,0,0,0,1,2
chaupal_jxse,net.jxta.impl.rendezvous,18,1,0,0,1,8,1,29
chaupal_jxse,net.jxta.impl.rendezvous.rdv,5,1,0,0,0,3,1,10
chaupal_jxse,net.jxta.impl.rendezvous.rendezvousMeter,1,1,0,0,1,6,1,10
chaupal_jxse,net.jxta.impl.rendezvous.rpv,1,0,0,0,0,4,1,6
chaupal_jxse,net.jxta.impl.resolver,0,0,0,0,1,3,1,5
chaupal_jxse,net.jxta.impl.resolver.resolverMeter,0,0,0,0,1,4,1,6
chaupal_jxse,net.jxta.impl.util,11,1,0,1,1,3,1,18
chaupal_jxse,net.jxta.impl.util.backport.java.util,0,0,0,1,0,0,1,2
chaupal_jxse,net.jxta.impl.util.cm,0,0,0,0,0,2,1,3
chaupal_jxse,net.jxta.impl.util.pipe.reliable,5,0,0,0,0,4,1,10
chaupal_jxse,net.jxta.impl.util.ternary,0,0,0,0,0,0,1,1
chaupal_jxse,net.jxta.impl.util.ternary.wild,0,0,0,0,0,0,1,1
chaupal_jxse,net.jxta.impl.util.threads,0,0,0,0,0,7,1,8
chaupal_jxse,net.jxta.impl,0,0,0,0,0,0,1,1
chaupal_jxse,net.jxta.impl.xindice.core.data,0,0,0,0,0,5,1,6
chaupal_jxse,net.jxta.impl.xindice.core,0,0,0,0,0,4,1,5
chaupal_jxse,net.jxta.impl.xindice.core.filer,1,0,0,0,0,7,1,9
chaupal_jxse,net.jxta.impl.xindice.core.indexer,1,1,0,0,0,1,1,4
chaupal_jxse,net.jxta.impl.xindice,0,0,0,0,0,2,1,3
chaupal_jxse,net.jxta.impl.xindice.util,0,0,0,0,0,0,1,1
chaupal_jxse,net.jxta.logging,0,0,0,0,0,15,1,16
chaupal_jxse,net.jxta.membership,0,0,0,0,0,4,1,5
chaupal_jxse,net.jxta.meter,4,0,0,0,1,4,1,10
chaupal_jxse,net.jxta.peer,2,0,0,0,0,3,1,6
chaupal_jxse,net.jxta.peergroup,25,1,0,0,0,61,1,88
chaupal_jxse,net.jxta.pipe,4,1,0,0,1,16,1,23
chaupal_jxse,net.jxta.platform,25,1,0,0,1,18,1,46
chaupal_jxse,net.jxta.protocol,19,1,0,1,1,45,1,68
chaupal_jxse,net.jxta.rendezvous,7,1,0,0,0,3,1,12
chaupal_jxse,net.jxta.resolver,0,0,0,0,0,5,1,6
chaupal_jxse,net.jxta.service,0,0,0,0,0,0,1,1
chaupal_jxse,net.jxta.socket,4,1,0,0,0,5,1,11
chaupal_jxse,net.jxta.util,10,1,0,1,1,6,1,20
chaupal_jxse,net.jxta.util.documentSerializable,3,0,0,0,0,3,1,7
chaupal_jxse,net.jxta,0,0,0,0,0,0,1,1
chaupal_jxse,tutorial.advertisement,0,0,0,0,0,1,1,2
chaupal_jxse,tutorial.bidi,0,0,0,0,0,2,1,3
chaupal_jxse,tutorial.connectivitymonitoring,0,0,0,0,0,1,1,2
chaupal_jxse,tutorial.content,0,0,0,0,0,0,1,1
chaupal_jxse,tutorial.customgroupservice,0,0,0,0,0,1,1,2
chaupal_jxse,tutorial.directmessenger,0,0,0,0,0,1,1,2
chaupal_jxse,tutorial.discovery,0,0,0,0,0,2,1,3
chaupal_jxse,tutorial.helloworld,0,0,0,0,0,0,1,1
chaupal_jxse,tutorial.id,0,0,0,0,0,0,1,1
chaupal_jxse,tutorial.message,0,0,0,0,0,0,1,1
chaupal_jxse,tutorial.multicast,0,0,0,0,0,1,1,2
chaupal_jxse,tutorial.multinetgroup,0,0,0,0,0,0,1,1
chaupal_jxse,tutorial.pipe,0,0,0,0,0,3,1,4
chaupal_jxse,tutorial.propagated,0,0,0,0,0,0,1,1
chaupal_jxse,tutorial.service,0,0,0,0,0,1,1,2
chaupal_jxse,tutorial.socket,0,0,0,0,0,0,1,1
chaupal_jxse,tutorial.WorkingWithLocalConfiguration,0,0,0,0,0,0,1,1
chenlb_mmseg4j-core,com.chenlb.mmseg4j,1,0,0,0,0,0,0,1
chenlb_mmseg4j-core,com.chenlb.mmseg4j.example,1,1,0,0,0,0,0,2
chenlb_mmseg4j-core,com.chenlb.mmseg4j.rule,0,0,0,0,0,0,0,0
chenlb_mmseg4j-solr,com.chenlb.mmseg4j.analysis,0,0,0,0,1,0,0,1
chenlb_mmseg4j-solr,com.chenlb.mmseg4j.solr,0,0,0,0,0,0,0,0
cinovo_cloudconductor-server,de.cinovo.cloudconductor.server.dao.hibernate,0,0,0,0,1,0,0,1
cinovo_cloudconductor-server,de.cinovo.cloudconductor.server.dao,0,0,0,0,1,0,0,1
cinovo_cloudconductor-server,de.cinovo.cloudconductor.server.handler,0,0,0,0,1,0,0,1
cinovo_cloudconductor-server,de.cinovo.cloudconductor.server.model,0,0,0,0,1,0,0,1
cinovo_cloudconductor-server,de.cinovo.cloudconductor.server.repo,0,0,0,0,0,0,0,0
cinovo_cloudconductor-server,de.cinovo.cloudconductor.server.repo.importer,0,0,0,0,0,0,0,0
cinovo_cloudconductor-server,de.cinovo.cloudconductor.server.repo.indexer,0,0,0,0,0,0,0,0
cinovo_cloudconductor-server,de.cinovo.cloudconductor.server.repo.provider,0,0,0,0,0,0,0,0
cinovo_cloudconductor-server,de.cinovo.cloudconductor.server.rest.agent,0,0,0,0,0,0,0,0
cinovo_cloudconductor-server,de.cinovo.cloudconductor.server.rest.shared,0,0,0,0,0,0,0,0
cinovo_cloudconductor-server,de.cinovo.cloudconductor.server.rest.ui,0,0,0,0,1,0,0,1
cinovo_cloudconductor-server,de.cinovo.cloudconductor.server.rest.utils,0,0,0,0,0,0,0,0
cinovo_cloudconductor-server,de.cinovo.cloudconductor.server.security,0,0,0,0,0,0,0,0
cinovo_cloudconductor-server,de.cinovo.cloudconductor.server.security.exception,0,0,0,0,0,0,0,0
cinovo_cloudconductor-server,de.cinovo.cloudconductor.server,0,0,0,0,0,0,0,0
cinovo_cloudconductor-server,de.cinovo.cloudconductor.server.tasks,0,0,0,0,1,0,0,1
cinovo_cloudconductor-server,de.cinovo.cloudconductor.server.util,0,1,0,0,1,0,0,2
cinovo_cloudconductor-server,de.cinovo.cloudconductor.server.util.comparators,0,0,0,0,0,0,0,0
cinovo_cloudconductor-server,de.cinovo.cloudconductor.server.websockets.model,0,0,0,0,0,0,0,0
cinovo_cloudconductor-server,de.cinovo.cloudconductor.server.ws,0,0,0,0,0,0,0,0
cinovo_cloudconductor-server,de.cinovo.cloudconductor.server.ws.host,0,0,0,0,0,0,0,0
cinovo_cloudconductor-server,de.cinovo.cloudconductor.server.ws.template,0,0,0,0,0,0,0,0
cinovo_cloudconductor-server,de.cinovo.cloudconductor.api.lib.helper,0,0,0,0,0,0,0,0
cinovo_cloudconductor-server,de.cinovo.cloudconductor.api.lib.manager,0,0,0,0,1,0,0,1
citerus_bookstore-cqrs-example,se.citerus.cqrs.bookstore.command,0,0,0,0,0,0,0,0
citerus_bookstore-cqrs-example,se.citerus.cqrs.bookstore.domain,0,0,0,0,0,1,0,1
citerus_bookstore-cqrs-example,se.citerus.cqrs.bookstore.event,0,0,0,0,0,0,0,0
citerus_bookstore-cqrs-example,se.citerus.cqrs.bookstore,0,0,0,0,0,0,0,0
citerus_bookstore-cqrs-example,se.citerus.cqrs.bookstore.saga,0,0,0,0,0,0,0,0
citerus_bookstore-cqrs-example,se.citerus.cqrs.bookstore.ordercontext.order,0,0,0,0,0,1,0,1
citerus_bookstore-cqrs-example,se.citerus.cqrs.bookstore.ordercontext.order.event,0,0,0,0,0,0,0,0
citerus_bookstore-cqrs-example,se.citerus.cqrs.bookstore.ordercontext.publishercontract.event,0,0,0,0,0,0,0,0
citerus_bookstore-cqrs-example,se.citerus.cqrs.bookstore.ordercontext.publishercontract,0,0,0,0,0,0,0,0
citerus_bookstore-cqrs-example,se.citerus.cqrs.bookstore.ordercontext.application.infrastructure,0,0,0,0,0,0,0,0
citerus_bookstore-cqrs-example,se.citerus.cqrs.bookstore.ordercontext.application,0,0,0,0,0,0,0,0
citerus_bookstore-cqrs-example,se.citerus.cqrs.bookstore.ordercontext.application.task,0,0,0,0,0,0,0,0
citerus_bookstore-cqrs-example,se.citerus.cqrs.bookstore.ordercontext.infrastructure,1,1,0,0,1,0,0,3
citerus_bookstore-cqrs-example,se.citerus.cqrs.bookstore.ordercontext.api,0,0,0,0,0,0,0,0
citerus_bookstore-cqrs-example,se.citerus.cqrs.bookstore.ordercontext.order.command,0,0,0,0,0,0,0,0
citerus_bookstore-cqrs-example,se.citerus.cqrs.bookstore.ordercontext.order.domain,0,0,0,0,0,1,0,1
citerus_bookstore-cqrs-example,se.citerus.cqrs.bookstore.ordercontext.resource,0,0,0,0,0,0,0,0
citerus_bookstore-cqrs-example,se.citerus.cqrs.bookstore.ordercontext.client.productcatalog,0,0,0,0,0,0,0,0
citerus_bookstore-cqrs-example,se.citerus.cqrs.bookstore.ordercontext.query.orderlist,1,0,0,0,0,0,0,1
citerus_bookstore-cqrs-example,se.citerus.cqrs.bookstore.ordercontext.query,0,0,0,0,0,0,0,0
citerus_bookstore-cqrs-example,se.citerus.cqrs.bookstore.ordercontext.query.sales,0,0,0,0,0,0,0,0
citerus_bookstore-cqrs-example,se.citerus.cqrs.bookstore.ordercontext.publishercontract.command,0,1,0,0,0,0,0,1
citerus_bookstore-cqrs-example,se.citerus.cqrs.bookstore.ordercontext.publishercontract.domain,0,0,0,0,0,0,0,0
citerus_bookstore-cqrs-example,se.citerus.cqrs.bookstore.ordercontext.saga,0,0,0,0,0,0,0,0
citerus_bookstore-cqrs-example,se.citerus.cqrs.bookstore.productcatalog.api,0,0,0,0,0,1,0,1
citerus_bookstore-cqrs-example,se.citerus.cqrs.bookstore.productcatalog.application,0,0,0,0,0,0,0,0
citerus_bookstore-cqrs-example,se.citerus.cqrs.bookstore.productcatalog.domain,0,0,0,0,0,1,0,1
citerus_bookstore-cqrs-example,se.citerus.cqrs.bookstore.productcatalog.infrastructure,0,0,0,0,0,0,0,0
citerus_bookstore-cqrs-example,se.citerus.cqrs.bookstore.productcatalog.resource,0,0,0,0,0,1,0,1
citerus_bookstore-cqrs-example,se.citerus.cqrs.bookstore.shopping.api,0,0,1,0,0,0,0,1
citerus_bookstore-cqrs-example,se.citerus.cqrs.bookstore.shopping.application,0,0,0,0,0,0,0,0
citerus_bookstore-cqrs-example,se.citerus.cqrs.bookstore.shopping.client.productcatalog,0,0,0,0,0,0,0,0
citerus_bookstore-cqrs-example,se.citerus.cqrs.bookstore.shopping.domain,0,0,0,0,1,0,0,1
citerus_bookstore-cqrs-example,se.citerus.cqrs.bookstore.shopping.infrastructure,0,0,0,0,0,0,0,0
citerus_bookstore-cqrs-example,se.citerus.cqrs.bookstore.shopping.resource,0,0,0,0,0,0,0,0
clinejj_foursquare-api-java,fi.foyt.foursquare.api.entities,0,0,0,1,1,0,0,2
clinejj_foursquare-api-java,fi.foyt.foursquare.api.entities.notifications,0,0,0,0,1,0,0,1
clinejj_foursquare-api-java,fi.foyt.foursquare.api.entities.venue,0,0,0,0,0,0,0,0
clinejj_foursquare-api-java,fi.foyt.foursquare.api,0,0,0,0,1,0,0,1
clinejj_foursquare-api-java,fi.foyt.foursquare.api.io,0,0,0,0,0,0,0,0
clinejj_foursquare-api-java,fi.foyt.foursquare.example,0,0,0,0,0,0,0,0
cloudera_cm_ext,com.cloudera.common,0,0,0,0,0,1,0,1
cloudera_cm_ext,com.cloudera.config,0,0,0,0,0,0,0,0
cloudera_cm_ext,com.cloudera.csd.components,0,0,0,0,1,0,0,1
cloudera_cm_ext,com.cloudera.csd.descriptors,0,0,0,1,1,2,0,4
cloudera_cm_ext,com.cloudera.csd.descriptors.cgroups,0,0,0,0,0,0,0,0
cloudera_cm_ext,com.cloudera.csd.descriptors.dependencyExtension,0,0,0,0,0,0,0,0
cloudera_cm_ext,com.cloudera.csd.descriptors.generators,0,0,0,0,1,0,0,1
cloudera_cm_ext,com.cloudera.csd.descriptors.parameters,0,0,1,0,1,0,0,2
cloudera_cm_ext,com.cloudera.csd,0,0,0,0,0,0,0,0
cloudera_cm_ext,com.cloudera.csd.tools,0,0,0,0,1,2,0,3
cloudera_cm_ext,com.cloudera.csd.tools.codahale,0,0,0,0,1,1,0,2
cloudera_cm_ext,com.cloudera.csd.tools.impala,0,0,0,0,1,1,0,2
cloudera_cm_ext,com.cloudera.csd.validation.components,0,0,0,0,0,0,0,0
cloudera_cm_ext,com.cloudera.csd.validation.constraints,0,0,0,0,1,0,0,1
cloudera_cm_ext,com.cloudera.csd.validation.constraints.components,0,0,0,0,1,0,0,1
cloudera_cm_ext,com.cloudera.csd.validation.monitoring,1,1,0,0,0,0,0,2
cloudera_cm_ext,com.cloudera.csd.validation.monitoring.components,0,0,0,0,0,0,0,0
cloudera_cm_ext,com.cloudera.csd.validation.monitoring.constraints,1,0,0,0,1,0,0,2
cloudera_cm_ext,com.cloudera.csd.validation.references.components,0,0,0,0,1,0,0,1
cloudera_cm_ext,com.cloudera.csd.validation.references.constraints,0,0,0,0,0,0,0,0
cloudera_cm_ext,com.cloudera.csd.validation.references,0,0,0,0,1,0,0,1
cloudera_cm_ext,com.cloudera.parcel.components,0,0,0,0,1,0,0,1
cloudera_cm_ext,com.cloudera.parcel.descriptors,0,0,0,0,1,1,0,2
cloudera_cm_ext,com.cloudera.parcel.validation.components,0,0,0,0,1,0,0,1
cloudera_cm_ext,com.cloudera.validation,0,0,0,0,1,1,0,2
cloudera_cm_ext,com.cloudera.csd.validation,0,0,0,0,0,0,0,0
cloudera_cm_ext,com.cloudera.parcel.validation,0,0,0,0,0,0,0,0
cloudera_cm_ext,com.cloudera.cli.validator,0,0,0,0,0,0,0,0
cloudera_cm_ext,com.cloudera.cli.validator.components,0,0,0,0,0,1,0,1
cloudfoundry_java-buildpack-auto-reconfiguration,(default package),0,0,0,0,0,0,0,0
cloudfoundry_java-buildpack-auto-reconfiguration,org.cloudfoundry.reconfiguration,0,0,0,0,1,0,0,1
Cloudslab_cloudsim,org.cloudbus.cloudsim,4,1,0,1,0,21,1,28
Cloudslab_cloudsim,org.cloudbus.cloudsim.container.containerPlacementPolicies,0,0,0,0,0,1,1,2
Cloudslab_cloudsim,org.cloudbus.cloudsim.container.containerProvisioners,0,0,0,0,1,2,1,4
Cloudslab_cloudsim,org.cloudbus.cloudsim.container.containerSelectionPolicies,0,0,0,0,0,0,1,1
Cloudslab_cloudsim,org.cloudbus.cloudsim.container.containerVmProvisioners,0,0,0,0,1,2,1,4
Cloudslab_cloudsim,org.cloudbus.cloudsim.container.core,0,0,0,0,1,20,1,22
Cloudslab_cloudsim,org.cloudbus.cloudsim.container.hostSelectionPolicies,0,0,0,0,0,1,1,2
Cloudslab_cloudsim,org.cloudbus.cloudsim.container.lists,0,0,0,0,1,1,1,3
Cloudslab_cloudsim,org.cloudbus.cloudsim.container.resourceAllocatorMigrationEnabled,0,0,0,0,0,9,1,10
Cloudslab_cloudsim,org.cloudbus.cloudsim.container.resourceAllocators,0,0,0,0,1,8,1,10
Cloudslab_cloudsim,org.cloudbus.cloudsim.container.schedulers,0,0,0,0,1,9,1,11
Cloudslab_cloudsim,org.cloudbus.cloudsim.container.utils,0,0,0,0,1,1,1,3
Cloudslab_cloudsim,org.cloudbus.cloudsim.container.vmSelectionPolicies,0,0,0,0,0,0,1,1
Cloudslab_cloudsim,org.cloudbus.cloudsim.core,1,1,0,0,0,17,1,20
Cloudslab_cloudsim,org.cloudbus.cloudsim.core.predicates,0,0,0,0,0,0,1,1
Cloudslab_cloudsim,org.cloudbus.cloudsim.distributions,0,0,0,0,0,0,1,1
Cloudslab_cloudsim,org.cloudbus.cloudsim.lists,2,0,0,0,1,1,1,5
Cloudslab_cloudsim,org.cloudbus.cloudsim.network.datacenter,0,0,0,0,0,1,1,2
Cloudslab_cloudsim,org.cloudbus.cloudsim.network,0,0,0,0,1,0,1,2
Cloudslab_cloudsim,org.cloudbus.cloudsim.power.lists,0,0,0,0,0,1,1,2
Cloudslab_cloudsim,org.cloudbus.cloudsim.power.models,0,0,0,0,0,1,1,2
Cloudslab_cloudsim,org.cloudbus.cloudsim.power,0,0,0,0,1,2,1,4
Cloudslab_cloudsim,org.cloudbus.cloudsim.provisioners,2,1,0,0,1,2,1,7
Cloudslab_cloudsim,org.cloudbus.cloudsim.util,0,1,0,0,1,1,1,4
Cloudslab_cloudsim,org.cloudbus.cloudsim.examples,0,0,0,0,1,1,1,3
Cloudslab_cloudsim,org.cloudbus.cloudsim.examples.container,0,0,0,0,0,4,1,5
Cloudslab_cloudsim,org.cloudbus.cloudsim.examples.network.datacenter,0,0,0,0,0,1,1,2
Cloudslab_cloudsim,org.cloudbus.cloudsim.examples.network,0,0,0,0,0,1,1,2
Cloudslab_cloudsim,org.cloudbus.cloudsim.examples.power,0,0,0,0,0,1,1,2
Cloudslab_cloudsim,org.cloudbus.cloudsim.examples.power.planetlab,0,0,0,0,0,0,1,1
Cloudslab_cloudsim,org.cloudbus.cloudsim.examples.power.random,0,0,0,0,0,0,1,1
CloudSlang_cloud-slang,io.cloudslang.lang.api.configuration,0,0,0,0,0,0,1,1
CloudSlang_cloud-slang,io.cloudslang.lang.api,0,0,0,0,0,2,1,3
CloudSlang_cloud-slang,io.cloudslang.lang.commons.configuration,0,0,0,0,0,0,1,1
CloudSlang_cloud-slang,io.cloudslang.lang.commons.services.api,0,0,0,0,0,1,1,2
CloudSlang_cloud-slang,io.cloudslang.lang.commons.services.impl,0,0,0,0,1,0,1,2
CloudSlang_cloud-slang,io.cloudslang.lang.cli.converters,0,0,0,0,0,0,1,1
CloudSlang_cloud-slang,io.cloudslang.lang.cli.services,0,0,0,0,1,0,1,2
CloudSlang_cloud-slang,io.cloudslang.lang.cli,0,0,0,0,1,0,1,2
CloudSlang_cloud-slang,io.cloudslang.lang.cli.utils,0,0,0,0,1,2,1,4
CloudSlang_cloud-slang,io.cloudslang.lang.cli.configuration,0,0,0,0,0,0,1,1
CloudSlang_cloud-slang,io.cloudslang.lang.logging,0,0,0,0,0,0,1,1
CloudSlang_cloud-slang,io.cloudslang.utils,0,0,0,0,0,0,1,1
CloudSlang_cloud-slang,io.cloudslang.lang.compiler.caching,1,0,0,0,0,0,1,2
CloudSlang_cloud-slang,io.cloudslang.lang.compiler,12,1,0,1,1,6,1,22
CloudSlang_cloud-slang,io.cloudslang.lang.compiler.configuration,0,0,0,0,0,0,1,1
CloudSlang_cloud-slang,io.cloudslang.lang.compiler.modeller,7,0,0,0,1,2,1,11
CloudSlang_cloud-slang,io.cloudslang.lang.compiler.modeller.model,4,1,0,0,1,7,1,14
CloudSlang_cloud-slang,io.cloudslang.lang.compiler.modeller.result,0,0,0,0,0,4,1,5
CloudSlang_cloud-slang,io.cloudslang.lang.compiler.modeller.transformers,3,0,0,1,1,1,1,7
CloudSlang_cloud-slang,io.cloudslang.lang.compiler.parser,0,0,0,0,0,1,1,2
CloudSlang_cloud-slang,io.cloudslang.lang.compiler.parser.model,0,0,0,0,0,0,1,1
CloudSlang_cloud-slang,io.cloudslang.lang.compiler.parser.utils,0,0,0,0,0,0,1,1
CloudSlang_cloud-slang,io.cloudslang.lang.compiler.scorecompiler,2,0,0,0,1,0,1,4
CloudSlang_cloud-slang,io.cloudslang.lang.compiler.utils,0,0,0,0,0,0,1,1
CloudSlang_cloud-slang,io.cloudslang.lang.compiler.validator,4,0,0,0,0,3,1,8
CloudSlang_cloud-slang,io.cloudslang.lang.compiler.validator.matcher,0,0,0,0,1,0,1,2
CloudSlang_cloud-slang,io.cloudslang.lang.compiler.dependencies,0,0,0,0,0,1,1,2
CloudSlang_cloud-slang,io.cloudslang.maven.compiler,0,0,0,0,0,0,1,1
CloudSlang_cloud-slang,io.cloudslang.lang.tools.build,3,0,0,0,1,0,1,5
CloudSlang_cloud-slang,io.cloudslang.lang.tools.build.commands,0,0,0,0,0,0,1,1
CloudSlang_cloud-slang,io.cloudslang.lang.tools.build.configuration,0,0,0,0,0,0,1,1
CloudSlang_cloud-slang,io.cloudslang.lang.tools.build.constants,0,0,0,0,0,0,1,1
CloudSlang_cloud-slang,io.cloudslang.lang.tools.build.validation,0,0,0,0,0,2,1,3
CloudSlang_cloud-slang,io.cloudslang.lang.tools.build.verifier,0,0,0,0,0,0,1,1
CloudSlang_cloud-slang,io.cloudslang.lang.enforcer,0,0,0,0,0,0,1,1
CloudSlang_cloud-slang,configuration,1,0,0,0,0,0,1,2
CloudSlang_cloud-slang,io.cloudslang.lang.entities,0,0,0,0,1,1,1,3
CloudSlang_cloud-slang,io.cloudslang.lang.entities.bindings,0,0,0,0,1,3,1,5
CloudSlang_cloud-slang,io.cloudslang.lang.entities.bindings.values,0,1,0,0,1,7,1,10
CloudSlang_cloud-slang,io.cloudslang.lang.entities.constants,0,0,0,0,0,0,1,1
CloudSlang_cloud-slang,io.cloudslang.lang.entities.encryption,1,1,0,0,0,1,1,4
CloudSlang_cloud-slang,io.cloudslang.lang.entities.utils,0,0,0,0,1,0,1,2
CloudSlang_cloud-slang,io.cloudslang.lang.runtime.bindings,0,0,0,0,1,3,1,5
CloudSlang_cloud-slang,io.cloudslang.lang.runtime.bindings.scripts,0,0,0,0,0,2,1,3
CloudSlang_cloud-slang,io.cloudslang.lang.runtime.configuration,0,0,0,0,0,0,1,1
CloudSlang_cloud-slang,io.cloudslang.lang.runtime.env,0,0,0,0,1,3,1,5
CloudSlang_cloud-slang,io.cloudslang.lang.runtime.events,0,0,0,0,0,0,1,1
CloudSlang_cloud-slang,io.cloudslang.lang.runtime.navigations,0,0,0,0,0,0,1,1
CloudSlang_cloud-slang,io.cloudslang.lang.runtime,0,0,0,0,0,0,1,1
CloudSlang_cloud-slang,io.cloudslang.lang.runtime.steps,0,0,0,0,1,1,1,3
CloudSlang_cloud-slang,io.cloudslang.lang.spi.encryption,0,0,0,0,0,1,1,2
Co0sh_BetonQuest,pl.betoncraft.betonquest,27,1,0,1,1,4,1,35
Co0sh_BetonQuest,pl.betoncraft.betonquest.api,2,0,0,0,1,0,1,4
Co0sh_BetonQuest,pl.betoncraft.betonquest.commands,0,0,0,0,1,0,1,2
Co0sh_BetonQuest,pl.betoncraft.betonquest.compatibility.betonlangapi,0,0,0,0,0,0,1,1
Co0sh_BetonQuest,pl.betoncraft.betonquest.compatibility.bountifulapi,0,0,0,0,0,0,1,1
Co0sh_BetonQuest,pl.betoncraft.betonquest.compatibility.brewery,0,0,0,0,0,0,1,1
Co0sh_BetonQuest,pl.betoncraft.betonquest.compatibility.citizens,0,0,0,0,1,0,1,2
Co0sh_BetonQuest,pl.betoncraft.betonquest.compatibility,2,1,0,0,0,0,1,4
Co0sh_BetonQuest,pl.betoncraft.betonquest.compatibility.denizen,0,0,0,0,0,0,1,1
Co0sh_BetonQuest,pl.betoncraft.betonquest.compatibility.effectlib,0,0,0,0,0,0,1,1
Co0sh_BetonQuest,pl.betoncraft.betonquest.compatibility.heroes,0,0,0,0,0,0,1,1
Co0sh_BetonQuest,pl.betoncraft.betonquest.compatibility.holographicdisplays,0,0,0,0,0,0,1,1
Co0sh_BetonQuest,pl.betoncraft.betonquest.compatibility.jobsreborn,0,0,0,0,0,0,1,1
Co0sh_BetonQuest,pl.betoncraft.betonquest.compatibility.legendquest,0,0,0,0,0,0,1,1
Co0sh_BetonQuest,pl.betoncraft.betonquest.compatibility.magic,0,0,0,0,0,0,1,1
Co0sh_BetonQuest,pl.betoncraft.betonquest.compatibility.mcmmo,0,0,0,0,0,0,1,1
Co0sh_BetonQuest,pl.betoncraft.betonquest.compatibility.mythicmobs,0,0,0,0,0,0,1,1
Co0sh_BetonQuest,pl.betoncraft.betonquest.compatibility.placeholderapi,0,0,0,0,0,0,1,1
Co0sh_BetonQuest,pl.betoncraft.betonquest.compatibility.playerpoints,0,0,0,0,0,0,1,1
Co0sh_BetonQuest,pl.betoncraft.betonquest.compatibility.protocollib.conversation,0,0,0,0,0,0,1,1
Co0sh_BetonQuest,pl.betoncraft.betonquest.compatibility.protocollib,0,1,0,0,0,0,1,2
Co0sh_BetonQuest,pl.betoncraft.betonquest.compatibility.protocollib.wrappers,0,0,0,0,1,0,1,2
Co0sh_BetonQuest,pl.betoncraft.betonquest.compatibility.quests,0,0,0,0,0,0,1,1
Co0sh_BetonQuest,pl.betoncraft.betonquest.compatibility.racesandclasses,0,0,0,0,0,0,1,1
Co0sh_BetonQuest,pl.betoncraft.betonquest.compatibility.shopkeepers,0,0,0,0,0,0,1,1
Co0sh_BetonQuest,pl.betoncraft.betonquest.compatibility.skillapi,0,0,0,0,0,0,1,1
Co0sh_BetonQuest,pl.betoncraft.betonquest.compatibility.skript,0,0,0,0,1,0,1,2
Co0sh_BetonQuest,pl.betoncraft.betonquest.compatibility.vault,0,0,0,0,0,0,1,1
Co0sh_BetonQuest,pl.betoncraft.betonquest.compatibility.worldedit,0,0,0,0,0,0,1,1
Co0sh_BetonQuest,pl.betoncraft.betonquest.compatibility.worldguard,0,0,0,0,1,0,1,2
Co0sh_BetonQuest,pl.betoncraft.betonquest.conditions,4,0,0,1,1,1,1,8
Co0sh_BetonQuest,pl.betoncraft.betonquest.config,10,1,0,0,1,1,1,14
Co0sh_BetonQuest,pl.betoncraft.betonquest.conversation,3,0,0,0,1,0,1,5
Co0sh_BetonQuest,pl.betoncraft.betonquest.database,0,0,0,0,1,3,1,5
Co0sh_BetonQuest,pl.betoncraft.betonquest.events,4,0,0,1,1,2,1,9
Co0sh_BetonQuest,pl.betoncraft.betonquest.exceptions,0,0,0,0,0,0,1,1
Co0sh_BetonQuest,pl.betoncraft.betonquest.item,3,0,0,0,0,0,1,4
Co0sh_BetonQuest,pl.betoncraft.betonquest.item.typehandler,0,0,0,0,1,0,1,2
Co0sh_BetonQuest,pl.betoncraft.betonquest.notify,3,1,0,0,1,0,1,6
Co0sh_BetonQuest,pl.betoncraft.betonquest.objectives,3,0,0,1,1,0,1,6
Co0sh_BetonQuest,pl.betoncraft.betonquest.utils,16,1,0,0,1,0,1,19
Co0sh_BetonQuest,pl.betoncraft.betonquest.variables,2,0,0,0,1,1,1,5
codecentric_spring-boot-starter-batch-web,de.codecentric.batch.configuration,0,0,0,0,1,0,0,1
codecentric_spring-boot-starter-batch-web,de.codecentric.batch.jsr352,0,0,0,0,0,0,0,0
codecentric_spring-boot-starter-batch-web,de.codecentric.batch.listener,0,0,0,0,1,0,0,1
codecentric_spring-boot-starter-batch-web,de.codecentric.batch.logging,0,0,0,0,0,0,0,0
codecentric_spring-boot-starter-batch-web,de.codecentric.batch.metrics,0,0,0,0,1,0,0,1
codecentric_spring-boot-starter-batch-web,de.codecentric.batch.monitoring,0,0,0,0,0,0,0,0
codecentric_spring-boot-starter-batch-web,de.codecentric.batch.scheduling.concurrent,0,0,0,0,0,0,0,0
codecentric_spring-boot-starter-batch-web,de.codecentric.batch.web,0,0,0,0,0,0,0,0
codecentric_spring-boot-starter-batch-web,de.codecentric.batch,0,0,0,0,0,0,0,0
codecentric_spring-boot-starter-batch-web,de.codecentric.batch.item,0,0,0,0,1,0,0,1
codecentric_spring-boot-starter-batch-web,de.codecentric.batch.jobs,0,0,0,0,1,0,0,1
codecentric_spring-boot-starter-batch-web,de.codecentric.batch.metrics.item,0,0,0,0,1,0,0,1
codecentric_spring-boot-starter-batch-web,de.codecentric.batch.filetodb,0,0,0,0,0,0,0,0
codecentric_spring-boot-starter-batch-web,de.codecentric.batch.filetodb.configuration,0,0,0,0,0,0,0,0
codecentric_spring-boot-starter-batch-web,de.codecentric.batch.filetodb.domain,0,0,0,0,0,0,0,0
codecentric_spring-boot-starter-batch-web,de.codecentric.batch.filetodb.item,0,0,0,0,0,0,0,0
codecentric_spring-boot-starter-batch-web,de.codecentric.batch.simple,0,0,0,0,0,0,0,0
codecentric_spring-boot-starter-batch-web,de.codecentric.batch.simple.item,0,0,0,0,0,0,0,0
codecentric_spring-boot-starter-batch-web,de.codecentric.batch.simple.job,0,0,0,0,0,0,0,0
codecentric_spring-boot-starter-batch-web,de.codecentric.batch.simplejsr,0,0,0,0,0,0,0,0
codecentric_spring-boot-starter-batch-web,de.codecentric.batch.simplejsr.item,0,0,0,0,0,0,0,0
codefollower_Tomcat-Research,javax.el,9,1,0,1,1,13,1,26
codefollower_Tomcat-Research,javax.mail,0,0,0,0,1,1,1,3
codefollower_Tomcat-Research,javax.mail.internet,0,0,0,0,1,1,1,3
codefollower_Tomcat-Research,javax.servlet,0,0,0,1,1,153,1,156
codefollower_Tomcat-Research,javax.servlet.descriptor,0,0,0,0,1,3,1,5
codefollower_Tomcat-Research,javax.servlet.http,0,0,0,1,1,89,1,92
codefollower_Tomcat-Research,javax.servlet.jsp.el,1,0,0,0,1,4,1,7
codefollower_Tomcat-Research,javax.servlet.jsp,0,0,0,0,1,13,1,15
codefollower_Tomcat-Research,javax.servlet.jsp.tagext,0,0,0,1,1,10,1,13
codefollower_Tomcat-Research,javax.websocket,0,0,0,1,1,15,1,18
codefollower_Tomcat-Research,javax.websocket.server,0,0,0,0,1,8,1,10
codefollower_Tomcat-Research,org.apache.catalina,7,1,0,1,1,301,1,312
codefollower_Tomcat-Research,org.apache.catalina.ant,0,0,0,1,1,0,1,3
codefollower_Tomcat-Research,org.apache.catalina.ant.jmx,0,0,0,0,1,0,1,2
codefollower_Tomcat-Research,org.apache.catalina.authenticator,4,1,0,1,1,29,1,37
codefollower_Tomcat-Research,org.apache.catalina.comet,4,1,0,0,1,13,1,20
codefollower_Tomcat-Research,org.apache.catalina.connector,16,1,0,1,1,147,1,167
codefollower_Tomcat-Research,org.apache.catalina.core,23,1,0,2,1,132,1,160
codefollower_Tomcat-Research,org.apache.catalina.deploy,3,1,0,0,0,18,1,23
codefollower_Tomcat-Research,org.apache.catalina.filters,0,0,0,1,1,15,1,18
codefollower_Tomcat-Research,org.apache.catalina.ha.authenticator,0,0,0,0,1,5,1,7
codefollower_Tomcat-Research,org.apache.catalina.ha.backend,0,0,0,0,1,1,1,3
codefollower_Tomcat-Research,org.apache.catalina.ha,0,0,0,0,1,27,1,29
codefollower_Tomcat-Research,org.apache.catalina.ha.context,0,0,0,0,1,2,1,4
codefollower_Tomcat-Research,org.apache.catalina.ha.deploy,0,0,0,0,1,7,1,9
codefollower_Tomcat-Research,org.apache.catalina.ha.session,0,0,0,0,0,26,1,27
codefollower_Tomcat-Research,org.apache.catalina.ha.tcp,0,0,0,0,1,22,1,24
codefollower_Tomcat-Research,org.apache.catalina.loader,3,0,0,1,1,12,1,18
codefollower_Tomcat-Research,org.apache.catalina.manager,0,0,0,0,1,17,1,19
codefollower_Tomcat-Research,org.apache.catalina.manager.host,0,0,0,0,1,7,1,9
codefollower_Tomcat-Research,org.apache.catalina.manager.util,0,0,0,0,1,1,1,3
codefollower_Tomcat-Research,org.apache.catalina.mapper,1,0,0,0,1,10,1,13
codefollower_Tomcat-Research,org.apache.catalina.mbeans,7,1,0,1,1,19,1,30
codefollower_Tomcat-Research,org.apache.catalina.realm,3,1,0,1,0,14,1,20
codefollower_Tomcat-Research,org.apache.catalina.security,7,1,0,0,1,4,1,14
codefollower_Tomcat-Research,org.apache.catalina.servlets,0,1,0,0,1,16,1,19
codefollower_Tomcat-Research,org.apache.catalina.session,4,1,0,1,1,22,1,30
codefollower_Tomcat-Research,org.apache.catalina.ssi,0,0,0,1,0,4,1,6
codefollower_Tomcat-Research,org.apache.catalina.startup,32,1,0,1,1,133,1,169
codefollower_Tomcat-Research,org.apache.catalina.storeconfig,0,0,0,1,0,6,1,8
codefollower_Tomcat-Research,org.apache.catalina.tribes,11,1,0,1,1,49,1,64
codefollower_Tomcat-Research,org.apache.catalina.tribes.group,11,1,0,1,1,23,1,38
codefollower_Tomcat-Research,org.apache.catalina.tribes.group.interceptors,7,0,0,1,1,24,1,34
codefollower_Tomcat-Research,org.apache.catalina.tribes.io,6,1,0,0,1,22,1,31
codefollower_Tomcat-Research,org.apache.catalina.tribes.membership,7,0,0,0,0,16,1,24
codefollower_Tomcat-Research,org.apache.catalina.tribes.tipis,0,1,0,0,1,11,1,14
codefollower_Tomcat-Research,org.apache.catalina.tribes.transport,2,1,0,0,1,15,1,20
codefollower_Tomcat-Research,org.apache.catalina.tribes.transport.bio,0,0,0,0,1,5,1,7
codefollower_Tomcat-Research,org.apache.catalina.tribes.transport.bio.util,0,0,0,0,1,1,1,3
codefollower_Tomcat-Research,org.apache.catalina.tribes.transport.nio,5,0,0,0,1,9,1,16
codefollower_Tomcat-Research,org.apache.catalina.tribes.util,16,1,0,0,1,21,1,40
codefollower_Tomcat-Research,org.apache.catalina.users,0,0,0,0,1,2,1,4
codefollower_Tomcat-Research,org.apache.catalina.util,2,0,0,1,1,111,1,116
codefollower_Tomcat-Research,org.apache.catalina.valves,4,0,0,1,0,38,1,44
codefollower_Tomcat-Research,org.apache.catalina.valves.rewrite,0,0,0,1,0,6,1,8
codefollower_Tomcat-Research,org.apache.catalina.webresources,3,1,0,1,0,7,1,13
codefollower_Tomcat-Research,org.apache.coyote,7,1,0,1,1,86,1,97
codefollower_Tomcat-Research,org.apache.coyote.ajp,0,0,0,1,0,17,1,19
codefollower_Tomcat-Research,org.apache.coyote.http11,1,0,0,1,1,30,1,34
codefollower_Tomcat-Research,org.apache.coyote.http11.filters,1,1,0,0,1,5,1,9
codefollower_Tomcat-Research,org.apache.coyote.http11.upgrade,0,1,0,1,1,5,1,9
codefollower_Tomcat-Research,org.apache.coyote.spdy,0,0,0,0,1,10,1,12
codefollower_Tomcat-Research,org.apache.el,4,0,0,1,1,6,1,13
codefollower_Tomcat-Research,org.apache.el.lang,9,1,0,1,0,7,1,19
codefollower_Tomcat-Research,org.apache.el.parser,3,0,0,1,1,6,1,12
codefollower_Tomcat-Research,org.apache.el.stream,7,0,0,0,1,1,1,10
codefollower_Tomcat-Research,org.apache.el.util,5,1,0,0,1,4,1,12
codefollower_Tomcat-Research,org.apache.jasper.compiler,13,1,0,2,0,49,1,66
codefollower_Tomcat-Research,org.apache.jasper.compiler.tagplugin,0,0,0,0,0,0,1,1
codefollower_Tomcat-Research,org.apache.jasper,9,1,0,0,1,27,1,39
codefollower_Tomcat-Research,org.apache.jasper.el,11,1,0,1,1,6,1,21
codefollower_Tomcat-Research,org.apache.jasper.runtime,7,0,0,1,1,13,1,23
codefollower_Tomcat-Research,org.apache.jasper.security,2,1,0,0,0,0,1,4
codefollower_Tomcat-Research,org.apache.jasper.servlet,4,1,0,0,1,23,1,30
codefollower_Tomcat-Research,org.apache.jasper.tagplugins.jstl.core,0,0,0,1,1,1,1,4
codefollower_Tomcat-Research,org.apache.jasper.tagplugins.jstl,0,0,0,0,0,1,1,2
codefollower_Tomcat-Research,org.apache.jasper.util,2,1,0,0,1,1,1,6
codefollower_Tomcat-Research,org.apache.jasper.xmlparser,1,0,0,0,1,1,1,4
codefollower_Tomcat-Research,org.apache.juli,0,0,0,1,1,3,1,6
codefollower_Tomcat-Research,org.apache.juli.logging,0,0,0,0,1,308,1,310
codefollower_Tomcat-Research,org.apache.naming,1,1,0,1,1,6,1,11
codefollower_Tomcat-Research,org.apache.naming.factory,1,0,0,0,1,2,1,5
codefollower_Tomcat-Research,org.apache.naming.factory.webservices,0,0,0,0,0,0,1,1
codefollower_Tomcat-Research,org.apache.naming.java,0,0,0,0,0,0,1,1
codefollower_Tomcat-Research,org.apache.tomcat.buildutil,0,0,0,0,1,0,1,2
codefollower_Tomcat-Research,org.apache.tomcat,0,0,0,0,1,12,1,14
codefollower_Tomcat-Research,org.apache.tomcat.jni,0,0,0,1,1,12,1,15
codefollower_Tomcat-Research,org.apache.tomcat.jni.socket,0,0,0,0,1,0,1,2
codefollower_Tomcat-Research,org.apache.tomcat.spdy,0,1,0,0,0,8,1,10
codefollower_Tomcat-Research,org.apache.tomcat.util.bcel.classfile,0,0,0,1,0,3,1,5
codefollower_Tomcat-Research,org.apache.tomcat.util.bcel,0,0,0,0,0,0,1,1
codefollower_Tomcat-Research,org.apache.tomcat.util.bcel.util,0,0,0,0,0,0,1,1
codefollower_Tomcat-Research,org.apache.tomcat.util.buf,0,0,0,1,1,91,1,94
codefollower_Tomcat-Research,org.apache.tomcat.util.codec.binary,0,0,0,0,1,2,1,4
codefollower_Tomcat-Research,org.apache.tomcat.util.codec,0,0,0,0,1,0,1,2
codefollower_Tomcat-Research,org.apache.tomcat.util.collections,0,0,0,0,1,3,1,5
codefollower_Tomcat-Research,org.apache.tomcat.util.descriptor,0,0,0,0,1,7,1,9
codefollower_Tomcat-Research,org.apache.tomcat.util.descriptor.tagplugin,0,0,0,0,0,3,1,4
codefollower_Tomcat-Research,org.apache.tomcat.util.descriptor.tld,0,0,0,0,1,8,1,10
codefollower_Tomcat-Research,org.apache.tomcat.util.descriptor.web,0,0,0,1,1,71,1,74
codefollower_Tomcat-Research,org.apache.tomcat.util,0,0,0,0,1,0,1,2
codefollower_Tomcat-Research,org.apache.tomcat.util.digester,0,0,0,1,1,22,1,25
codefollower_Tomcat-Research,org.apache.tomcat.util.file,0,0,0,0,0,0,1,1
codefollower_Tomcat-Research,org.apache.tomcat.util.http,8,1,0,1,1,36,1,48
codefollower_Tomcat-Research,org.apache.tomcat.util.http.fileupload,1,1,0,1,1,3,1,8
codefollower_Tomcat-Research,org.apache.tomcat.util.http.fileupload.disk,0,0,0,0,0,2,1,3
codefollower_Tomcat-Research,org.apache.tomcat.util.http.fileupload.servlet,0,0,0,0,0,2,1,3
codefollower_Tomcat-Research,org.apache.tomcat.util.http.fileupload.util,1,1,0,0,1,0,1,4
codefollower_Tomcat-Research,org.apache.tomcat.util.http.fileupload.util.mime,0,0,0,0,1,0,1,2
codefollower_Tomcat-Research,org.apache.tomcat.util.http.parser,0,0,0,0,0,2,1,3
codefollower_Tomcat-Research,org.apache.tomcat.util.log,0,0,0,0,1,5,1,7
codefollower_Tomcat-Research,org.apache.tomcat.util.modeler,0,0,0,0,1,28,1,30
codefollower_Tomcat-Research,org.apache.tomcat.util.modeler.modules,0,0,0,0,1,4,1,6
codefollower_Tomcat-Research,org.apache.tomcat.util.net,11,1,0,1,1,51,1,66
codefollower_Tomcat-Research,org.apache.tomcat.util.net.jsse,1,1,0,0,1,3,1,7
codefollower_Tomcat-Research,org.apache.tomcat.util.res,0,0,0,0,0,158,1,159
codefollower_Tomcat-Research,org.apache.tomcat.util.scan,0,0,0,0,1,14,1,16
codefollower_Tomcat-Research,org.apache.tomcat.util.threads,2,1,0,0,1,3,1,8
codefollower_Tomcat-Research,org.apache.tomcat.websocket,3,1,0,1,1,10,1,17
codefollower_Tomcat-Research,org.apache.tomcat.websocket.pojo,4,0,0,1,1,7,1,14
codefollower_Tomcat-Research,org.apache.tomcat.websocket.server,3,1,0,1,1,9,1,16
codefollower_Tomcat-Research,(default package),0,0,0,0,1,2,1,4
codefollower_Tomcat-Research,async,0,0,0,0,1,2,1,4
codefollower_Tomcat-Research,cal,0,0,0,0,1,0,1,2
codefollower_Tomcat-Research,chat,0,0,0,0,0,2,1,3
codefollower_Tomcat-Research,checkbox,0,0,0,0,0,0,1,1
codefollower_Tomcat-Research,colors,0,0,0,0,0,0,1,1
codefollower_Tomcat-Research,compressionFilters,0,0,0,0,1,1,1,3
codefollower_Tomcat-Research,dates,0,0,0,0,0,0,1,1
codefollower_Tomcat-Research,error,0,0,0,0,0,0,1,1
codefollower_Tomcat-Research,examples,0,0,0,0,1,2,1,4
codefollower_Tomcat-Research,filters,0,0,0,0,0,0,1,1
codefollower_Tomcat-Research,jsp2.examples,0,0,0,0,1,0,1,2
codefollower_Tomcat-Research,jsp2.examples.el,0,0,0,0,0,0,1,1
codefollower_Tomcat-Research,jsp2.examples.simpletag,0,0,0,0,1,1,1,3
codefollower_Tomcat-Research,listeners,0,0,0,0,0,0,1,1
codefollower_Tomcat-Research,nonblocking,0,0,0,0,1,0,1,2
codefollower_Tomcat-Research,num,0,0,0,0,0,0,1,1
codefollower_Tomcat-Research,sessions,0,0,0,0,0,0,1,1
codefollower_Tomcat-Research,util,0,0,0,0,0,2,1,3
codefollower_Tomcat-Research,validators,0,0,0,0,0,0,1,1
codefollower_Tomcat-Research,websocket.chat,0,0,0,0,0,0,1,1
codefollower_Tomcat-Research,websocket.drawboard,0,0,0,0,1,2,1,4
codefollower_Tomcat-Research,websocket.drawboard.wsmessages,0,0,0,0,1,1,1,3
codefollower_Tomcat-Research,websocket.echo,0,0,0,0,1,0,1,2
codefollower_Tomcat-Research,websocket,0,0,0,0,0,0,1,1
codefollower_Tomcat-Research,websocket.snake,0,0,0,0,0,0,1,1
codefollower_Tomcat-Research,org.apache.cometd.bayeux,0,0,0,0,0,0,1,1
codefollower_Tomcat-Research,org.apache.tomcat.bayeux,0,0,0,0,0,2,1,3
codefollower_Tomcat-Research,org.apache.tomcat.bayeux.request,0,0,0,0,1,0,1,2
codefollower_Tomcat-Research,org.apache.tomcat.jdbc.naming,0,0,0,0,0,0,1,1
codefollower_Tomcat-Research,org.apache.tomcat.jdbc.pool,1,1,0,0,0,0,1,3
codefollower_Tomcat-Research,org.apache.tomcat.jdbc.pool.interceptor,0,0,0,0,0,0,1,1
codefollower_Tomcat-Research,org.apache.tomcat.jdbc.pool.jmx,1,0,0,0,0,0,1,2
codefollower_Tomcat-Research,org.apache.tomcat.jdbc.bugs,0,0,0,0,0,0,1,1
codefollower_Tomcat-Research,org.apache.coyote.lite,0,0,0,0,1,2,1,4
codefollower_Tomcat-Research,org.apache.tomcat.lite.http,3,1,0,1,0,0,1,6
codefollower_Tomcat-Research,org.apache.tomcat.lite.io,5,1,0,1,0,0,1,8
codefollower_Tomcat-Research,org.apache.tomcat.lite.io.jsse,1,0,0,0,0,0,1,2
codefollower_Tomcat-Research,org.apache.tomcat.lite.proxy,3,0,0,0,1,0,1,5
codefollower_Tomcat-Research,org.apache.tomcat.lite.service,0,0,0,0,0,0,1,1
codefollower_Tomcat-Research,org.apache.tomcat.lite.util,0,0,0,0,1,0,1,2
codefollower_Tomcat-Research,org.apache.tomcat.lite.http.services,0,0,0,0,0,0,1,1
codefollower_Tomcat-Research,org.apache.tomcat.lite.load,0,0,0,0,0,0,1,1
codefollower_Tomcat-Research,org.apache.tomcat.lite,7,1,0,0,0,0,1,9
codefollower_Tomcat-Research,javax.servlet.resources,0,0,0,0,0,1,1,2
codefollower_Tomcat-Research,org.apache.catalina.nonblocking,0,0,0,0,1,4,1,6
codefollower_Tomcat-Research,org.apache.catalina.tribes.demos,0,0,0,1,1,7,1,10
codefollower_Tomcat-Research,org.apache.naming.resources,0,0,0,0,1,6,1,8
codefollower_Tomcat-Research,mypackage,0,0,0,0,0,0,1,1
codeine-cd_codeine,codeine,53,0,0,0,1,0,1,55
codeine-cd_codeine,codeine.api,4,1,0,0,1,0,1,7
codeine-cd_codeine,codeine.configuration,5,0,0,0,1,1,1,8
codeine-cd_codeine,codeine.db,0,0,0,0,0,0,1,1
codeine-cd_codeine,codeine.db.mysql.connectors,3,0,0,0,1,0,1,5
codeine-cd_codeine,codeine.db.mysql,3,0,0,0,1,1,1,6
codeine-cd_codeine,codeine.executer,54,1,0,0,1,0,1,57
codeine-cd_codeine,codeine.issues,0,0,0,0,0,0,1,1
codeine-cd_codeine,codeine.jsons.auth,2,0,0,0,0,0,1,3
codeine-cd_codeine,codeine.jsons.collectors,1,0,0,0,0,0,1,2
codeine-cd_codeine,codeine.jsons.command,0,0,0,0,0,0,1,1
codeine-cd_codeine,codeine.jsons.global,4,1,0,0,1,2,1,9
codeine-cd_codeine,codeine.jsons.info,0,0,0,0,0,0,1,1
codeine-cd_codeine,codeine.jsons,0,0,0,0,0,2,1,3
codeine-cd_codeine,codeine.jsons.labels,1,0,0,0,0,0,1,2
codeine-cd_codeine,codeine.jsons.mails,1,0,0,0,0,0,1,2
codeine-cd_codeine,codeine.jsons.nodes,0,0,0,0,0,0,1,1
codeine-cd_codeine,codeine.jsons.peer_status,2,0,0,0,1,0,1,4
codeine-cd_codeine,codeine.jsons.project,0,0,0,0,0,0,1,1
codeine-cd_codeine,codeine.mail,3,0,0,0,1,0,1,5
codeine-cd_codeine,codeine.model,15,1,0,0,1,0,1,18
codeine-cd_codeine,codeine.permissions,4,1,0,0,1,0,1,7
codeine-cd_codeine,codeine.servlet,2,0,0,0,1,0,1,4
codeine-cd_codeine,codeine.servlet.manage_statistics,2,0,0,0,1,0,1,4
codeine-cd_codeine,codeine.stdout,0,0,0,0,0,0,1,1
codeine-cd_codeine,codeine.utils,53,1,0,0,1,0,1,56
codeine-cd_codeine,codeine.utils.exceptions,0,0,0,0,1,0,1,2
codeine-cd_codeine,codeine.utils.logging,1,0,0,0,0,0,1,2
codeine-cd_codeine,codeine.utils.network,4,1,0,0,1,0,1,7
codeine-cd_codeine,codeine.utils.os,0,0,0,0,0,0,1,1
codeine-cd_codeine,codeine.utils.os_process,2,0,0,0,1,0,1,4
codeine-cd_codeine,codeine.peers_status,0,0,0,0,0,0,1,1
codeine-cd_codeine,codeine.servlets,4,1,0,0,1,0,1,7
codeine-cd_codeine,codeine.version,2,0,0,0,1,0,1,4
codeine-cd_codeine,com.mysql.jdbc,0,0,0,0,0,0,1,1
codeine-cd_codeine,com.mysql.management.driverlaunched,0,0,0,0,0,0,1,1
codeine-cd_codeine,com.mysql.management,1,0,0,0,1,0,1,3
codeine-cd_codeine,com.mysql.management.util,1,1,0,1,0,0,1,4
codeine-cd_codeine,codeine.collectors,2,0,0,0,1,0,1,4
codeine-cd_codeine,codeine.collectors.tags,1,0,0,0,0,0,1,2
codeine-cd_codeine,codeine.collectors.version,2,0,0,0,0,0,1,3
codeine-cd_codeine,codeine.credentials,0,0,0,0,0,0,1,1
codeine-cd_codeine,codeine.nodes,3,0,0,0,1,0,1,5
codeine-cd_codeine,codeine.servlets.command_backup,1,0,0,0,0,0,1,2
codeine-cd_codeine,simple_server,0,0,0,0,0,0,1,1
codeine-cd_codeine,codeine.command_peer,2,0,0,0,1,0,1,4
codeine-cd_codeine,codeine.fork_join,0,0,0,0,0,0,1,1
codeine-cd_codeine,codeine.plugins,2,0,0,0,1,0,1,4
codeine-cd_codeine,codeine.servlets.api_servlets.angular,0,0,0,0,1,0,1,2
codeine-cd_codeine,codeine.servlets.api_servlets,2,0,0,0,1,0,1,4
codeine-cd_codeine,codeine.servlets.api_servlets.projects,1,0,0,0,0,0,1,2
codeine-cd_codeine,codeine.statistics,2,0,0,0,0,0,1,3
codeine-cd_codeine,codeine.users,0,0,0,0,0,0,1,1
codelibs_elasticsearch-cluster-runner,org.codelibs.elasticsearch.runner,0,0,0,0,1,0,0,1
codelibs_elasticsearch-cluster-runner,org.codelibs.elasticsearch.runner.net,0,0,0,0,0,0,0,0
codelibs_elasticsearch-cluster-runner,org.codelibs.elasticsearch.runner.node,0,0,0,0,0,0,0,0
codelibs_elasticsearch-taste,org.codelibs.elasticsearch.taste.common,0,0,0,1,1,6,0,8
codelibs_elasticsearch-taste,org.codelibs.elasticsearch.taste.common.iterator,0,0,0,0,0,0,0,0
codelibs_elasticsearch-taste,org.codelibs.elasticsearch.taste.eval,0,0,0,0,1,3,0,4
codelibs_elasticsearch-taste,org.codelibs.elasticsearch.taste.exception,0,0,0,0,0,0,0,0
codelibs_elasticsearch-taste,org.codelibs.elasticsearch.taste.model,0,0,0,0,1,6,0,7
codelibs_elasticsearch-taste,org.codelibs.elasticsearch.taste.model.cache,0,0,0,0,0,0,0,0
codelibs_elasticsearch-taste,org.codelibs.elasticsearch.taste.module,0,0,0,0,0,0,0,0
codelibs_elasticsearch-taste,org.codelibs.elasticsearch.taste.neighborhood,0,0,0,0,0,0,0,0
codelibs_elasticsearch-taste,org.codelibs.elasticsearch.taste.recommender,0,1,0,1,1,5,0,8
codelibs_elasticsearch-taste,org.codelibs.elasticsearch.taste.recommender.svd,0,0,0,0,1,1,0,2
codelibs_elasticsearch-taste,org.codelibs.elasticsearch.taste.rest.handler,1,0,0,0,1,0,0,2
codelibs_elasticsearch-taste,org.codelibs.elasticsearch.taste.rest,2,1,0,0,0,0,0,3
codelibs_elasticsearch-taste,org.codelibs.elasticsearch.taste.service,0,0,0,0,0,0,0,0
codelibs_elasticsearch-taste,org.codelibs.elasticsearch.taste.similarity,0,0,0,1,0,2,0,3
codelibs_elasticsearch-taste,org.codelibs.elasticsearch.taste.similarity.precompute,0,0,0,0,1,0,0,1
codelibs_elasticsearch-taste,org.codelibs.elasticsearch.taste,2,1,0,0,0,0,0,3
codelibs_elasticsearch-taste,org.codelibs.elasticsearch.taste.util,0,0,0,0,0,0,0,0
codelibs_elasticsearch-taste,org.codelibs.elasticsearch.taste.worker,0,0,0,0,0,1,0,1
codelibs_elasticsearch-taste,org.codelibs.elasticsearch.taste.writer,0,0,0,0,0,1,0,1
cognitect_transit-java,com.cognitect.transit,1,0,0,0,1,0,0,2
cognitect_transit-java,com.cognitect.transit.impl,1,1,0,1,1,0,0,4
cognitect_transit-java,com.cognitect.transit.SPI,0,0,0,0,0,0,0,0
commons-rdf_commons-rdf,org.apache.commons.rdf.api,0,0,0,0,1,0,0,1
commons-rdf_commons-rdf,org.apache.commons.rdf.simple,0,0,0,0,0,0,0,0
consulo_consulo-dotnet,consulo.csharp.cfs.ide.completion,0,0,0,0,0,0,0,0
consulo_consulo-dotnet,consulo.csharp.cfs.ide.highlight,0,0,0,0,1,0,0,1
consulo_consulo-dotnet,consulo.csharp.cfs.lang,0,0,0,0,0,0,0,0
consulo_consulo-dotnet,consulo.csharp.cfs.lang.lexer,0,0,0,0,0,0,0,0
consulo_consulo-dotnet,consulo.csharp.cfs.lang.parser,0,0,0,0,0,0,0,0
consulo_consulo-dotnet,consulo.csharp.cfs.psi,0,0,0,0,0,0,0,0
consulo_consulo-dotnet,consulo.dotnet.compiler,0,0,0,0,1,0,0,1
consulo_consulo-dotnet,consulo.dotnet.dll,0,0,0,0,0,0,0,0
consulo_consulo-dotnet,consulo.dotnet,2,0,0,0,1,0,0,3
consulo_consulo-dotnet,consulo.dotnet.execution,0,0,0,0,0,0,0,0
consulo_consulo-dotnet,consulo.dotnet.externalAttributes,0,0,0,0,1,0,0,1
consulo_consulo-dotnet,consulo.dotnet.module,1,0,0,0,0,0,0,1
consulo_consulo-dotnet,consulo.dotnet.module.extension,1,1,0,0,1,0,0,3
consulo_consulo-dotnet,consulo.dotnet.module.macro,0,0,0,0,0,0,0,0
consulo_consulo-dotnet,consulo.dotnet.sdk,0,0,0,0,0,0,0,0
consulo_consulo-dotnet,consulo.dotnet.util,0,0,0,0,0,0,0,0
consulo_consulo-dotnet,consulo.dotnet.debugger,4,1,0,0,1,0,0,6
consulo_consulo-dotnet,consulo.dotnet.debugger.proxy,1,0,0,0,1,0,0,2
consulo_consulo-dotnet,consulo.dotnet.debugger.proxy.light,0,0,0,0,0,0,0,0
consulo_consulo-dotnet,consulo.dotnet.debugger.proxy.value,0,0,0,0,1,0,0,1
consulo_consulo-dotnet,consulo.dotnet.debugger.breakpoint,1,0,0,0,1,0,0,2
consulo_consulo-dotnet,consulo.dotnet.debugger.breakpoint.properties,0,0,0,0,0,0,0,0
consulo_consulo-dotnet,consulo.dotnet.debugger.breakpoint.ui,0,0,0,0,0,0,0,0
consulo_consulo-dotnet,consulo.dotnet.debugger.nodes,3,1,0,0,1,0,0,5
consulo_consulo-dotnet,consulo.dotnet.debugger.nodes.logicView,2,0,0,0,1,0,0,3
consulo_consulo-dotnet,consulo.dotnet.debugger.nodes.logicView.enumerator,0,0,0,0,0,0,0,0
consulo_consulo-dotnet,consulo.dotnet.debugger.nodes.objectReview,0,0,0,0,0,0,0,0
consulo_consulo-dotnet,consulo.dotnet.debugger.nodes.valueRender,0,0,0,0,0,0,0,0
consulo_consulo-dotnet,consulo.dotnet.run,0,1,0,0,1,0,0,2
consulo_consulo-dotnet,consulo.dotnet.run.remote,0,0,0,0,0,0,0,0
consulo_consulo-dotnet,consulo.debugger,0,0,0,0,0,0,0,0
consulo_consulo-dotnet,consulo.dotnet.documentation,0,0,0,0,0,0,0,0
consulo_consulo-dotnet,org.emonic.base.codehierarchy,0,0,0,0,0,0,0,0
consulo_consulo-dotnet,org.emonic.base.documentation,0,0,0,0,1,0,0,1
consulo_consulo-dotnet,consulo.dotnet.run.coverage,0,0,0,0,1,0,0,1
consulo_consulo-dotnet,consulo.dotnet.run.filters,0,0,0,0,0,0,0,0
consulo_consulo-dotnet,consulo.dotnet.dll.vfs,0,0,0,0,0,0,0,0
consulo_consulo-dotnet,consulo.dotnet.ide,0,1,0,0,0,0,0,1
consulo_consulo-dotnet,consulo.dotnet.library,0,0,0,0,0,0,0,0
consulo_consulo-dotnet,consulo.dotnet.module.dependency,0,0,0,0,0,0,0,0
consulo_consulo-dotnet,consulo.dotnet.packageSupport,0,0,0,0,0,0,0,0
consulo_consulo-dotnet,consulo.dotnet.psi.impl,0,0,0,0,0,0,0,0
consulo_consulo-dotnet,consulo.dotnet.roots.orderEntry,0,0,0,0,0,0,0,0
consulo_consulo-dotnet,consulo.dotnet.ui.chooser,0,0,0,0,0,0,0,0
consulo_consulo-dotnet,consulo.dotnet.psi,2,1,0,1,1,0,0,5
consulo_consulo-dotnet,consulo.dotnet.psi.search.searches,0,0,0,0,1,0,0,1
consulo_consulo-dotnet,consulo.dotnet.resolve,1,0,0,0,1,0,0,2
consulo_consulo-dotnet,consulo.dotnet.externalAttributes.nodes,0,0,0,0,0,0,0,0
consulo_consulo-dotnet,consulo.dotnet.lang,0,0,0,0,0,0,0,0
consulo_consulo-dotnet,consulo.dotnet.lang.psi.impl,0,0,0,0,1,0,0,1
consulo_consulo-dotnet,consulo.dotnet.lang.psi.impl.stub,0,0,0,0,0,0,0,0
consulo_consulo-dotnet,consulo.dotnet.resolve.impl,0,0,0,0,0,0,0,0
consulo_consulo-dotnet,consulo.msil.lang.psi,0,0,0,0,1,0,0,1
consulo_consulo-dotnet,consulo.msil,0,0,0,0,0,0,0,0
consulo_consulo-dotnet,consulo.msil.representation,0,0,0,0,1,0,0,1
consulo_consulo-dotnet,consulo.msil.ide.highlight,0,0,0,0,0,0,0,0
consulo_consulo-dotnet,consulo.msil.ide,0,0,0,0,0,0,0,0
consulo_consulo-dotnet,consulo.msil.ide.navigation,0,0,0,0,0,0,0,0
consulo_consulo-dotnet,consulo.msil.ide.presentation,0,0,0,0,0,0,0,0
consulo_consulo-dotnet,consulo.msil.lang.lexer,0,0,0,0,0,0,0,0
consulo_consulo-dotnet,consulo.msil.lang,0,0,0,0,0,0,0,0
consulo_consulo-dotnet,consulo.msil.lang.parser,0,0,0,0,0,0,0,0
consulo_consulo-dotnet,consulo.msil.lang.psi.impl.elementType,0,0,0,0,1,0,0,1
consulo_consulo-dotnet,consulo.msil.lang.psi.impl.elementType.stub.index,0,0,0,0,0,0,0,0
consulo_consulo-dotnet,consulo.msil.lang.psi.impl.elementType.stub,0,0,0,0,1,0,0,1
consulo_consulo-dotnet,consulo.msil.lang.psi.impl,0,0,0,1,1,0,0,2
consulo_consulo-dotnet,consulo.msil.lang.psi.impl.resolve,0,0,0,0,0,0,0,0
consulo_consulo-dotnet,consulo.msil.lang.psi.impl.searchers,0,0,0,0,0,0,0,0
consulo_consulo-dotnet,consulo.msil.lang.psi.impl.type,0,0,0,0,1,0,0,1
consulo_consulo-dotnet,consulo.msil.lang.stubbing,0,0,0,0,0,0,0,0
consulo_consulo-dotnet,consulo.msil.lang.stubbing.values,0,0,0,0,0,0,0,0
consulo_consulo-dotnet,consulo.msil.representation.projectView,0,0,0,0,0,0,0,0
consulo_consulo-dotnet,parsing,0,0,0,0,0,0,0,0
contentful_contentful-management.java,com.contentful.java.cma,2,0,0,1,1,0,0,4
contentful_contentful-management.java,com.contentful.java.cma.gson,0,0,0,0,0,0,0,0
contentful_contentful-management.java,com.contentful.java.cma.interceptor,1,0,0,0,1,0,0,2
contentful_contentful-management.java,com.contentful.java.cma.model,2,1,0,1,1,0,0,5
contentful_contentful-management.java,com.contentful.java.cma.model.rich,0,0,0,0,0,0,0,0
contentful_contentful-management.java,com.contentful.java.cma.build,0,0,0,0,0,0,0,0
copper-engine_copper-engine,org.copperengine.core.persistent.cassandra,0,1,0,0,0,0,1,2
copper-engine_copper-engine,org.copperengine.core.persistent.hybrid,0,0,0,0,0,0,1,1
copper-engine_copper-engine,org.copperengine.core.persistent.cassandra.workflows,0,0,0,0,0,0,1,1
copper-engine_copper-engine,org.copperengine.core,4,1,0,1,0,0,1,7
copper-engine_copper-engine,org.copperengine.core.audit,0,0,0,0,0,0,1,1
copper-engine_copper-engine,org.copperengine.core.batcher,1,0,0,0,0,0,1,2
copper-engine_copper-engine,org.copperengine.core.batcher.impl,0,0,0,0,0,0,1,1
copper-engine_copper-engine,org.copperengine.core.common,3,0,0,0,1,0,1,5
copper-engine_copper-engine,org.copperengine.core.db.utility,0,0,0,0,0,0,1,1
copper-engine_copper-engine,org.copperengine.core.db.utility.oracle,0,0,0,0,0,0,1,1
copper-engine_copper-engine,org.copperengine.core.instrument,0,0,0,0,0,0,1,1
copper-engine_copper-engine,org.copperengine.core.internal,3,1,0,0,0,0,1,5
copper-engine_copper-engine,org.copperengine.core.lockmgr,0,0,0,0,0,0,1,1
copper-engine_copper-engine,org.copperengine.core.lockmgr.tranzient,0,0,0,0,0,0,1,1
copper-engine_copper-engine,org.copperengine.core.monitoring,0,0,0,0,0,0,1,1
copper-engine_copper-engine,org.copperengine.core.persistent,6,1,0,1,0,0,1,9
copper-engine_copper-engine,org.copperengine.core.persistent.adapter,0,0,0,0,0,0,1,1
copper-engine_copper-engine,org.copperengine.core.persistent.alpha.generator,0,0,0,0,1,0,1,2
copper-engine_copper-engine,org.copperengine.core.persistent.lock,0,0,0,0,0,0,1,1
copper-engine_copper-engine,org.copperengine.core.persistent.txn,0,0,0,0,0,0,1,1
copper-engine_copper-engine,org.copperengine.core.tranzient,0,0,0,0,0,0,1,1
copper-engine_copper-engine,org.copperengine.core.util,0,0,0,0,1,0,1,2
copper-engine_copper-engine,org.copperengine.core.wfrepo,0,0,0,0,0,0,1,1
copper-engine_copper-engine,org.copperengine.ext.persistent,0,0,0,0,0,0,1,1
copper-engine_copper-engine,org.copperengine.ext.util,0,0,0,0,0,0,1,1
copper-engine_copper-engine,org.copperengine.ext.wfrepo.classpath,0,0,0,0,0,0,1,1
copper-engine_copper-engine,org.copperengine.management,0,0,0,0,1,0,1,2
copper-engine_copper-engine,org.copperengine.management.model,0,0,0,0,1,0,1,2
copper-engine_copper-engine,example,0,0,0,0,0,0,1,1
copper-engine_copper-engine,org.copperengine.spring.audit,0,0,0,0,0,0,1,1
copper-engine_copper-engine,org.copperengine.spring,0,0,0,0,0,0,1,1
CorfuDB_CorfuDB,(default package),0,0,0,0,0,0,1,1
CorfuDB_CorfuDB,org.corfudb.annotations,0,0,0,0,0,0,1,1
CorfuDB_CorfuDB,org.corfudb.runtime.object,5,1,0,0,1,0,1,8
CorfuDB_CorfuDB,org.corfudb.benchmarks.runtime.collections,0,0,0,0,0,0,1,1
CorfuDB_CorfuDB,org.corfudb.benchmarks.runtime.collections.helper,0,0,0,0,0,0,1,1
CorfuDB_CorfuDB,org.corfudb.benchmarks.runtime.collections.state,0,0,0,0,1,0,1,2
CorfuDB_CorfuDB,org.corfudb.benchmarks.util,0,0,0,0,0,0,1,1
CorfuDB_CorfuDB,org.corfudb.benchmarks.runtime.collections.experiment.ehcache,0,0,0,0,0,0,1,1
CorfuDB_CorfuDB,org.corfudb.benchmarks.runtime.collections.experiment.rocksdb,0,0,0,0,0,0,1,1
CorfuDB_CorfuDB,org.corfudb.metrics,0,0,0,0,0,0,1,1
CorfuDB_CorfuDB,org.corfudb.shell,0,0,0,0,0,0,1,1
CorfuDB_CorfuDB,org.corfudb.common.metrics,0,0,0,0,0,0,1,1
CorfuDB_CorfuDB,org.corfudb.common.metrics.servers,0,0,0,0,0,0,1,1
CorfuDB_CorfuDB,org.corfudb.common.result,0,0,0,0,0,0,1,1
CorfuDB_CorfuDB,org.corfudb.common.util,0,0,0,0,0,0,1,1
CorfuDB_CorfuDB,org.corfudb.format,0,0,0,0,0,0,1,1
CorfuDB_CorfuDB,org.corfudb.generator,2,1,0,0,0,0,1,4
CorfuDB_CorfuDB,org.corfudb.generator.distributions,1,0,0,0,0,0,1,2
CorfuDB_CorfuDB,org.corfudb.generator.operations,1,0,0,0,0,0,1,2
CorfuDB_CorfuDB,org.corfudb.infrastructure,13,1,0,1,0,0,1,16
CorfuDB_CorfuDB,org.corfudb.infrastructure.datastore,3,0,0,0,0,0,1,4
CorfuDB_CorfuDB,org.corfudb.infrastructure.log,6,1,0,0,1,0,1,9
CorfuDB_CorfuDB,org.corfudb.infrastructure.management,4,0,0,0,1,0,1,6
CorfuDB_CorfuDB,org.corfudb.infrastructure.management.failuredetector,2,0,0,0,0,0,1,3
CorfuDB_CorfuDB,org.corfudb.infrastructure.orchestrator,3,0,0,0,0,0,1,4
CorfuDB_CorfuDB,org.corfudb.infrastructure.orchestrator.actions,2,0,0,0,0,0,1,3
CorfuDB_CorfuDB,org.corfudb.infrastructure.orchestrator.workflows,0,0,0,0,1,0,1,2
CorfuDB_CorfuDB,org.corfudb.infrastructure.paxos,2,1,0,0,0,0,1,4
CorfuDB_CorfuDB,org.corfudb.infrastructure.utils,0,0,0,0,0,0,1,1
CorfuDB_CorfuDB,org.corfudb.universe.group.cluster,1,0,0,0,0,0,1,2
CorfuDB_CorfuDB,org.corfudb.universe.group.cluster.docker,0,0,0,0,0,0,1,1
CorfuDB_CorfuDB,org.corfudb.universe.group.cluster.vm,6,0,0,0,0,0,1,7
CorfuDB_CorfuDB,org.corfudb.universe.group,1,0,0,0,0,0,1,2
CorfuDB_CorfuDB,org.corfudb.universe.logging,0,0,0,0,0,0,1,1
CorfuDB_CorfuDB,org.corfudb.universe.node.client,0,0,0,0,0,0,1,1
CorfuDB_CorfuDB,org.corfudb.universe.node,0,0,0,0,0,0,1,1
CorfuDB_CorfuDB,org.corfudb.universe.node.server,0,0,0,0,1,0,1,2
CorfuDB_CorfuDB,org.corfudb.universe.node.server.docker,0,0,0,0,0,0,1,1
CorfuDB_CorfuDB,org.corfudb.universe.node.server.vm,4,1,0,0,0,0,1,6
CorfuDB_CorfuDB,org.corfudb.universe.node.stress,0,0,0,0,0,0,1,1
CorfuDB_CorfuDB,org.corfudb.universe.node.stress.vm,3,1,0,0,0,0,1,5
CorfuDB_CorfuDB,org.corfudb.universe.scenario.action,0,0,0,0,0,0,1,1
CorfuDB_CorfuDB,org.corfudb.universe.scenario.fixture,0,0,0,0,1,0,1,2
CorfuDB_CorfuDB,org.corfudb.universe.scenario,0,0,0,0,1,0,1,2
CorfuDB_CorfuDB,org.corfudb.universe.scenario.spec,0,0,0,0,0,0,1,1
CorfuDB_CorfuDB,org.corfudb.universe.universe,1,1,0,0,0,0,1,3
CorfuDB_CorfuDB,org.corfudb.universe.universe.docker,0,1,0,0,0,0,1,2
CorfuDB_CorfuDB,org.corfudb.universe.universe.process,0,0,0,0,0,0,1,1
CorfuDB_CorfuDB,org.corfudb.universe.universe.vm,3,1,0,0,0,0,1,5
CorfuDB_CorfuDB,org.corfudb.universe,0,0,0,0,0,0,1,1
CorfuDB_CorfuDB,org.corfudb.universe.util,0,0,0,0,0,0,1,1
CorfuDB_CorfuDB,org.corfudb.comm,0,0,0,0,0,0,1,1
CorfuDB_CorfuDB,org.corfudb.protocols.logprotocol,2,1,0,0,0,0,1,4
CorfuDB_CorfuDB,org.corfudb.protocols.wireprotocol,24,1,0,1,0,0,1,27
CorfuDB_CorfuDB,org.corfudb.protocols.wireprotocol.failuredetector,8,0,0,0,0,0,1,9
CorfuDB_CorfuDB,org.corfudb.protocols.wireprotocol.orchestrator,2,1,0,0,0,0,1,4
CorfuDB_CorfuDB,org.corfudb.recovery,2,0,0,0,0,0,1,3
CorfuDB_CorfuDB,org.corfudb.runtime,44,1,0,0,0,0,1,46
CorfuDB_CorfuDB,org.corfudb.runtime.clients,14,1,0,1,0,0,1,17
CorfuDB_CorfuDB,org.corfudb.runtime.collections,3,1,0,0,1,0,1,6
CorfuDB_CorfuDB,org.corfudb.runtime.exceptions,4,1,0,1,1,0,1,8
CorfuDB_CorfuDB,org.corfudb.runtime.exceptions.unrecoverable,0,0,0,0,0,0,1,1
CorfuDB_CorfuDB,org.corfudb.runtime.object.transactions,6,1,0,0,0,0,1,8
CorfuDB_CorfuDB,org.corfudb.runtime.view,30,1,0,1,0,0,1,33
CorfuDB_CorfuDB,org.corfudb.runtime.view.replication,0,0,0,0,0,0,1,1
CorfuDB_CorfuDB,org.corfudb.runtime.view.stream,5,1,0,0,0,0,1,7
CorfuDB_CorfuDB,org.corfudb.runtime.view.workflows,0,0,0,0,0,0,1,1
CorfuDB_CorfuDB,org.corfudb.security.sasl.plaintext,0,0,0,0,1,0,1,2
CorfuDB_CorfuDB,org.corfudb.security.sasl,0,0,0,0,0,0,1,1
CorfuDB_CorfuDB,org.corfudb.security.tls,0,0,0,0,0,0,1,1
CorfuDB_CorfuDB,org.corfudb.util,19,1,0,0,1,0,1,22
CorfuDB_CorfuDB,org.corfudb.util.concurrent,0,0,0,0,0,0,1,1
CorfuDB_CorfuDB,org.corfudb.util.retry,0,0,0,0,1,0,1,2
CorfuDB_CorfuDB,org.corfudb.util.serializer,8,1,0,0,0,0,1,10
CorfuDB_CorfuDB,org.corfudb,2,0,0,0,1,0,1,4
CorfuDB_CorfuDB,org.corfudb.integration,0,0,0,0,0,0,1,1
CorfuDB_CorfuDB,org.corfudb.integration.cluster.Harness,0,0,0,0,0,0,1,1
CorfuDB_CorfuDB,org.corfudb.runtime.checkpoint,0,0,0,0,0,0,1,1
CorfuDB_CorfuDB,org.corfudb.runtime.concurrent,0,0,0,0,1,0,1,2
CorfuDB_CorfuDB,org.corfudb.runtime.utils,0,0,0,0,0,0,1,1
CorfuDB_CorfuDB,(default package),0,0,0,0,0,0,1,1
CorfuDB_CorfuDB,org.corfudb.annotations,0,0,0,0,0,0,1,1
CorfuDB_CorfuDB,org.corfudb.runtime.object,5,1,0,0,1,0,1,8
CorfuDB_CorfuDB,org.corfudb.benchmarks.runtime.collections,0,0,0,0,0,0,1,1
CorfuDB_CorfuDB,org.corfudb.benchmarks.runtime.collections.helper,0,0,0,0,0,0,1,1
CorfuDB_CorfuDB,org.corfudb.benchmarks.runtime.collections.state,0,0,0,0,1,0,1,2
CorfuDB_CorfuDB,org.corfudb.benchmarks.util,0,0,0,0,0,0,1,1
CorfuDB_CorfuDB,org.corfudb.benchmarks.runtime.collections.experiment.ehcache,0,0,0,0,0,0,1,1
CorfuDB_CorfuDB,org.corfudb.benchmarks.runtime.collections.experiment.rocksdb,0,0,0,0,0,0,1,1
CorfuDB_CorfuDB,org.corfudb.metrics,0,0,0,0,0,0,1,1
CorfuDB_CorfuDB,org.corfudb.shell,0,0,0,0,0,0,1,1
CorfuDB_CorfuDB,org.corfudb.common.metrics,0,0,0,0,0,0,1,1
CorfuDB_CorfuDB,org.corfudb.common.metrics.servers,0,0,0,0,0,0,1,1
CorfuDB_CorfuDB,org.corfudb.common.result,0,0,0,0,0,0,1,1
CorfuDB_CorfuDB,org.corfudb.common.util,0,0,0,0,0,0,1,1
CorfuDB_CorfuDB,org.corfudb.format,0,0,0,0,0,0,1,1
CorfuDB_CorfuDB,org.corfudb.generator,2,1,0,0,0,0,1,4
CorfuDB_CorfuDB,org.corfudb.generator.distributions,1,0,0,0,0,0,1,2
CorfuDB_CorfuDB,org.corfudb.generator.operations,1,0,0,0,0,0,1,2
CorfuDB_CorfuDB,org.corfudb.infrastructure,13,1,0,1,0,0,1,16
CorfuDB_CorfuDB,org.corfudb.infrastructure.datastore,3,0,0,0,0,0,1,4
CorfuDB_CorfuDB,org.corfudb.infrastructure.log,6,1,0,0,1,0,1,9
CorfuDB_CorfuDB,org.corfudb.infrastructure.management,4,0,0,0,1,0,1,6
CorfuDB_CorfuDB,org.corfudb.infrastructure.management.failuredetector,2,0,0,0,0,0,1,3
CorfuDB_CorfuDB,org.corfudb.infrastructure.orchestrator,3,0,0,0,0,0,1,4
CorfuDB_CorfuDB,org.corfudb.infrastructure.orchestrator.actions,2,0,0,0,0,0,1,3
CorfuDB_CorfuDB,org.corfudb.infrastructure.orchestrator.workflows,0,0,0,0,1,0,1,2
CorfuDB_CorfuDB,org.corfudb.infrastructure.paxos,2,1,0,0,0,0,1,4
CorfuDB_CorfuDB,org.corfudb.infrastructure.utils,0,0,0,0,0,0,1,1
CorfuDB_CorfuDB,org.corfudb.universe.group.cluster,1,0,0,0,0,0,1,2
CorfuDB_CorfuDB,org.corfudb.universe.group.cluster.docker,0,0,0,0,0,0,1,1
CorfuDB_CorfuDB,org.corfudb.universe.group.cluster.vm,6,0,0,0,0,0,1,7
CorfuDB_CorfuDB,org.corfudb.universe.group,1,0,0,0,0,0,1,2
CorfuDB_CorfuDB,org.corfudb.universe.logging,0,0,0,0,0,0,1,1
CorfuDB_CorfuDB,org.corfudb.universe.node.client,0,0,0,0,0,0,1,1
CorfuDB_CorfuDB,org.corfudb.universe.node,0,0,0,0,0,0,1,1
CorfuDB_CorfuDB,org.corfudb.universe.node.server,0,0,0,0,1,0,1,2
CorfuDB_CorfuDB,org.corfudb.universe.node.server.docker,0,0,0,0,0,0,1,1
CorfuDB_CorfuDB,org.corfudb.universe.node.server.vm,4,1,0,0,0,0,1,6
CorfuDB_CorfuDB,org.corfudb.universe.node.stress,0,0,0,0,0,0,1,1
CorfuDB_CorfuDB,org.corfudb.universe.node.stress.vm,3,1,0,0,0,0,1,5
CorfuDB_CorfuDB,org.corfudb.universe.scenario.action,0,0,0,0,0,0,1,1
CorfuDB_CorfuDB,org.corfudb.universe.scenario.fixture,0,0,0,0,1,0,1,2
CorfuDB_CorfuDB,org.corfudb.universe.scenario,0,0,0,0,1,0,1,2
CorfuDB_CorfuDB,org.corfudb.universe.scenario.spec,0,0,0,0,0,0,1,1
CorfuDB_CorfuDB,org.corfudb.universe.universe,1,1,0,0,0,0,1,3
CorfuDB_CorfuDB,org.corfudb.universe.universe.docker,0,1,0,0,0,0,1,2
CorfuDB_CorfuDB,org.corfudb.universe.universe.process,0,0,0,0,0,0,1,1
CorfuDB_CorfuDB,org.corfudb.universe.universe.vm,3,1,0,0,0,0,1,5
CorfuDB_CorfuDB,org.corfudb.universe,0,0,0,0,0,0,1,1
CorfuDB_CorfuDB,org.corfudb.universe.util,0,0,0,0,0,0,1,1
CorfuDB_CorfuDB,org.corfudb.comm,0,0,0,0,0,0,1,1
CorfuDB_CorfuDB,org.corfudb.protocols.logprotocol,2,1,0,0,0,0,1,4
CorfuDB_CorfuDB,org.corfudb.protocols.wireprotocol,24,1,0,1,0,0,1,27
CorfuDB_CorfuDB,org.corfudb.protocols.wireprotocol.failuredetector,8,0,0,0,0,0,1,9
CorfuDB_CorfuDB,org.corfudb.protocols.wireprotocol.orchestrator,2,1,0,0,0,0,1,4
CorfuDB_CorfuDB,org.corfudb.recovery,2,0,0,0,0,0,1,3
CorfuDB_CorfuDB,org.corfudb.runtime,44,1,0,0,0,0,1,46
CorfuDB_CorfuDB,org.corfudb.runtime.clients,14,1,0,1,0,0,1,17
CorfuDB_CorfuDB,org.corfudb.runtime.collections,3,1,0,0,1,0,1,6
CorfuDB_CorfuDB,org.corfudb.runtime.exceptions,4,1,0,1,1,0,1,8
CorfuDB_CorfuDB,org.corfudb.runtime.exceptions.unrecoverable,0,0,0,0,0,0,1,1
CorfuDB_CorfuDB,org.corfudb.runtime.object.transactions,6,1,0,0,0,0,1,8
CorfuDB_CorfuDB,org.corfudb.runtime.view,30,1,0,1,0,0,1,33
CorfuDB_CorfuDB,org.corfudb.runtime.view.replication,0,0,0,0,0,0,1,1
CorfuDB_CorfuDB,org.corfudb.runtime.view.stream,5,1,0,0,0,0,1,7
CorfuDB_CorfuDB,org.corfudb.runtime.view.workflows,0,0,0,0,0,0,1,1
CorfuDB_CorfuDB,org.corfudb.security.sasl.plaintext,0,0,0,0,1,0,1,2
CorfuDB_CorfuDB,org.corfudb.security.sasl,0,0,0,0,0,0,1,1
CorfuDB_CorfuDB,org.corfudb.security.tls,0,0,0,0,0,0,1,1
CorfuDB_CorfuDB,org.corfudb.util,19,1,0,0,1,0,1,22
CorfuDB_CorfuDB,org.corfudb.util.concurrent,0,0,0,0,0,0,1,1
CorfuDB_CorfuDB,org.corfudb.util.retry,0,0,0,0,1,0,1,2
CorfuDB_CorfuDB,org.corfudb.util.serializer,8,1,0,0,0,0,1,10
CorfuDB_CorfuDB,org.corfudb,2,0,0,0,1,0,1,4
CorfuDB_CorfuDB,org.corfudb.integration,0,0,0,0,0,0,1,1
CorfuDB_CorfuDB,org.corfudb.integration.cluster.Harness,0,0,0,0,0,0,1,1
CorfuDB_CorfuDB,org.corfudb.runtime.checkpoint,0,0,0,0,0,0,1,1
CorfuDB_CorfuDB,org.corfudb.runtime.concurrent,0,0,0,0,1,0,1,2
CorfuDB_CorfuDB,org.corfudb.runtime.utils,0,0,0,0,0,0,1,1
cternes_openkeepass,de.slackspace.openkeepass.api,1,0,0,0,0,3,1,5
cternes_openkeepass,de.slackspace.openkeepass.crypto,2,0,0,0,1,1,1,5
cternes_openkeepass,de.slackspace.openkeepass.domain,7,1,0,1,0,5,1,15
cternes_openkeepass,de.slackspace.openkeepass.domain.filter,1,0,0,0,0,0,1,2
cternes_openkeepass,de.slackspace.openkeepass.domain.xml.adapter,1,0,0,0,1,0,1,3
cternes_openkeepass,de.slackspace.openkeepass.domain.zipper,1,0,0,0,0,2,1,4
cternes_openkeepass,de.slackspace.openkeepass.exception,0,0,0,0,1,0,1,2
cternes_openkeepass,de.slackspace.openkeepass,1,1,0,0,0,2,1,5
cternes_openkeepass,de.slackspace.openkeepass.parser,5,1,0,0,1,0,1,8
cternes_openkeepass,de.slackspace.openkeepass.processor,2,0,0,0,1,2,1,6
cternes_openkeepass,de.slackspace.openkeepass.stream,0,0,0,0,0,0,1,1
cternes_openkeepass,de.slackspace.openkeepass.util,0,0,0,0,1,0,1,2
cternes_openkeepass,de.slackspace.openkeepass.domain.builder,0,0,0,0,1,0,1,2
cternes_openkeepass,de.slackspace.openkeepass.domain.enricher,0,0,0,0,0,1,1,2
cybergarage_cybergarage-upnp,org.cybergarage.http,11,1,0,0,0,12,0,24
cybergarage_cybergarage-upnp,org.cybergarage.net,0,0,0,0,0,2,0,2
cybergarage_cybergarage-upnp,org.cybergarage.soap,3,0,0,0,0,9,0,12
cybergarage_cybergarage-upnp,org.cybergarage.upnp,16,0,0,0,0,21,0,37
cybergarage_cybergarage-upnp,org.cybergarage.upnp.control,4,1,0,0,1,10,0,16
cybergarage_cybergarage-upnp,org.cybergarage.upnp.device,0,0,0,0,1,3,0,4
cybergarage_cybergarage-upnp,org.cybergarage.upnp.event,3,1,0,0,1,4,0,9
cybergarage_cybergarage-upnp,org.cybergarage.upnp.ssdp,3,1,0,0,0,4,0,8
cybergarage_cybergarage-upnp,org.cybergarage.upnp.xml,4,1,0,0,0,3,0,8
cybergarage_cybergarage-upnp,org.cybergarage.util,0,0,0,0,1,8,0,9
cybergarage_cybergarage-upnp,org.cybergarage.xml,5,1,0,0,1,10,0,17
cybergarage_cybergarage-upnp,org.cybergarage.xml.parser,0,0,0,0,0,0,0,0
cybergarage_cybergarage-upnp,(default package),0,0,0,1,1,2,0,4
cybergarage_cybergarage-upnp,org.cybergarage.mediagate.frame,0,0,0,0,0,1,0,1
cybergarage_cybergarage-upnp,org.cybergarage.mediagate.frame.swing,0,0,0,0,0,1,0,1
cybergarage_cybergarage-upnp,org.cybergarage.mediagate,0,0,0,0,0,1,0,1
cybergarage_cybergarage-upnp,org.cybergarage.sql,0,0,0,0,0,0,0,0
cybergarage_cybergarage-upnp,org.cybergarage.sql.mysql,0,0,0,0,0,0,0,0
cybergarage_cybergarage-upnp,org.cybergarage.upnp.std.av.controller,0,0,0,0,0,0,0,0
cybergarage_cybergarage-upnp,org.cybergarage.upnp.std.av.controller.server,0,0,0,0,0,0,0,0
cybergarage_cybergarage-upnp,org.cybergarage.upnp.std.av.player.action,0,0,0,0,0,0,0,0
cybergarage_cybergarage-upnp,org.cybergarage.upnp.std.av.player,0,0,0,0,0,1,0,1
cybergarage_cybergarage-upnp,org.cybergarage.upnp.std.av.renderer,0,1,0,0,1,2,0,4
cybergarage_cybergarage-upnp,org.cybergarage.upnp.std.av.server.action,0,0,0,0,0,1,0,1
cybergarage_cybergarage-upnp,org.cybergarage.upnp.std.av.server,5,1,0,0,1,4,0,11
cybergarage_cybergarage-upnp,org.cybergarage.upnp.std.av.server.directory.file,0,1,0,0,0,2,0,3
cybergarage_cybergarage-upnp,org.cybergarage.upnp.std.av.server.directory.gateway,0,0,0,0,0,0,0,0
cybergarage_cybergarage-upnp,org.cybergarage.upnp.std.av.server.directory.mythtv,0,1,0,0,0,0,0,1
cybergarage_cybergarage-upnp,org.cybergarage.upnp.std.av.server.object.container,3,1,0,0,0,4,0,8
cybergarage_cybergarage-upnp,org.cybergarage.upnp.std.av.server.object,3,1,0,0,1,5,0,10
cybergarage_cybergarage-upnp,org.cybergarage.upnp.std.av.server.object.format,0,0,0,0,1,0,0,1
cybergarage_cybergarage-upnp,org.cybergarage.upnp.std.av.server.object.item.file,0,0,0,0,0,2,0,2
cybergarage_cybergarage-upnp,org.cybergarage.upnp.std.av.server.object.item,3,1,0,0,0,1,0,5
cybergarage_cybergarage-upnp,org.cybergarage.upnp.std.av.server.object.item.mythtv,0,0,0,0,0,0,0,0
cybergarage_cybergarage-upnp,org.cybergarage.upnp.std.av.server.object.search,1,0,0,0,0,0,0,1
cybergarage_cybergarage-upnp,org.cybergarage.upnp.std.av.server.object.sort,1,0,0,0,0,0,0,1
DABSquared_gitlab-plugin,com.dabsquared.gitlabjenkins.cause,0,0,0,0,0,0,0,0
DABSquared_gitlab-plugin,com.dabsquared.gitlabjenkins.connection,8,1,0,0,0,0,0,9
DABSquared_gitlab-plugin,com.dabsquared.gitlabjenkins.environment,0,0,0,0,0,0,0,0
DABSquared_gitlab-plugin,com.dabsquared.gitlabjenkins.gitlab.api,0,0,0,0,0,1,0,1
DABSquared_gitlab-plugin,com.dabsquared.gitlabjenkins.gitlab.api.impl,0,0,0,0,1,0,0,1
DABSquared_gitlab-plugin,com.dabsquared.gitlabjenkins.gitlab.api.model,0,0,0,0,1,1,0,2
DABSquared_gitlab-plugin,com.dabsquared.gitlabjenkins.gitlab.hook.model,0,0,0,0,1,0,0,1
DABSquared_gitlab-plugin,com.dabsquared.gitlabjenkins.gitlab,0,0,0,0,0,0,0,0
DABSquared_gitlab-plugin,com.dabsquared.gitlabjenkins,11,1,0,0,0,0,0,12
DABSquared_gitlab-plugin,com.dabsquared.gitlabjenkins.listener,0,0,0,0,0,0,0,0
DABSquared_gitlab-plugin,com.dabsquared.gitlabjenkins.publisher,0,0,0,0,1,0,0,1
DABSquared_gitlab-plugin,com.dabsquared.gitlabjenkins.service,2,1,0,0,1,1,0,5
DABSquared_gitlab-plugin,com.dabsquared.gitlabjenkins.trigger.branch,3,1,0,0,0,0,0,4
DABSquared_gitlab-plugin,com.dabsquared.gitlabjenkins.trigger.exception,0,0,0,0,0,0,0,0
DABSquared_gitlab-plugin,com.dabsquared.gitlabjenkins.trigger.filter,0,0,0,0,0,0,0,0
DABSquared_gitlab-plugin,com.dabsquared.gitlabjenkins.trigger.handler,0,1,0,0,0,0,0,1
DABSquared_gitlab-plugin,com.dabsquared.gitlabjenkins.trigger.handler.merge,0,0,0,0,1,0,0,1
DABSquared_gitlab-plugin,com.dabsquared.gitlabjenkins.trigger.handler.note,0,0,0,0,0,0,0,0
DABSquared_gitlab-plugin,com.dabsquared.gitlabjenkins.trigger.handler.pipeline,0,0,0,0,0,0,0,0
DABSquared_gitlab-plugin,com.dabsquared.gitlabjenkins.trigger.handler.push,0,0,0,0,1,0,0,1
DABSquared_gitlab-plugin,com.dabsquared.gitlabjenkins.trigger.label,3,1,0,0,0,0,0,4
DABSquared_gitlab-plugin,com.dabsquared.gitlabjenkins.util,4,0,0,0,1,0,0,5
DABSquared_gitlab-plugin,com.dabsquared.gitlabjenkins.webhook,4,1,0,0,1,0,0,6
DABSquared_gitlab-plugin,com.dabsquared.gitlabjenkins.webhook.build,2,0,0,0,1,0,0,3
DABSquared_gitlab-plugin,com.dabsquared.gitlabjenkins.webhook.status,1,0,0,0,1,0,0,2
DABSquared_gitlab-plugin,com.dabsquared.gitlabjenkins.workflow,0,0,0,0,1,0,0,1
DABSquared_gitlab-plugin,com.dabsquared.gitlabjenkins.builder.generated,0,0,0,0,0,0,0,0
DABSquared_gitlab-plugin,com.dabsquared.gitlabjenkins.gitlab.api.model.builder.generated,0,0,0,0,1,0,0,1
DABSquared_gitlab-plugin,com.dabsquared.gitlabjenkins.gitlab.hook.model.builder.generated,0,0,0,0,1,0,0,1
DABSquared_gitlab-plugin,com.dabsquared.gitlabjenkins.trigger.handler.builder.generated,0,0,0,0,0,0,0,0
DABSquared_gitlab-plugin,(default package),0,0,0,0,0,0,0,0
damiencarol_jsr203-hadoop,hdfs.jsr203,0,0,0,1,1,0,0,2
dangdangdotcom_config-toolkit,com.dangdang.config.face.config,0,0,0,0,0,0,0,0
dangdangdotcom_config-toolkit,com.dangdang.config.face,0,0,0,0,0,0,0,0
dangdangdotcom_config-toolkit,com.dangdang.config.face.controller,0,0,0,0,0,0,0,0
dangdangdotcom_config-toolkit,com.dangdang.config.face.entity,0,0,0,0,0,0,0,0
dangdangdotcom_config-toolkit,com.dangdang.config.face.service,0,0,0,0,0,0,0,0
dangdangdotcom_config-toolkit,com.dangdang.config.face.util,0,0,0,0,0,0,0,0
dangdangdotcom_config-toolkit,com.dangdang.config.service,0,0,0,0,0,1,0,1
dangdangdotcom_config-toolkit,com.dangdang.config.service.exception,0,0,0,0,0,0,0,0
dangdangdotcom_config-toolkit,com.dangdang.config.service.file.contenttype,0,0,0,0,0,0,0,0
dangdangdotcom_config-toolkit,com.dangdang.config.service.file,1,1,0,0,0,0,0,2
dangdangdotcom_config-toolkit,com.dangdang.config.service.file.protocol,1,0,0,0,1,0,0,2
dangdangdotcom_config-toolkit,com.dangdang.config.service.observer,0,0,0,0,0,0,0,0
dangdangdotcom_config-toolkit,com.dangdang.config.service.proxy,0,0,0,0,0,0,0,0
dangdangdotcom_config-toolkit,com.dangdang.config.service.sugar,0,0,0,0,0,0,0,0
dangdangdotcom_config-toolkit,com.dangdang.config.service.support.spring,0,0,0,0,0,0,0,0
dangdangdotcom_config-toolkit,com.dangdang.config.service.util,0,0,0,0,0,0,0,0
dangdangdotcom_config-toolkit,com.dangdang.config.service.zookeeper,0,0,0,0,0,0,0,0
dangdangdotcom_config-toolkit,com.dangdang.config.service.easyzk.demo,0,0,0,0,0,0,0,0
dangdangdotcom_config-toolkit,com.dangdang.config.service.easyzk.demo.normal,0,0,0,0,0,1,0,1
dangdangdotcom_config-toolkit,com.dangdang.config.service.easyzk.demo.override,0,0,0,0,0,0,0,0
dangdangdotcom_config-toolkit,com.dangdang.config.service.easyzk.demo.simple,0,0,0,0,0,1,0,1
dangdangdotcom_config-toolkit,com.dangdang.config.service.easyzk.demo.spring.annotation,0,0,0,0,0,0,0,0
dangdangdotcom_config-toolkit,com.dangdang.config.service.easyzk.demo.spring,0,0,0,0,0,0,0,0
danielflower_multi-module-maven-release-plugin,com.github.danielflower.mavenplugins.release,1,0,0,1,1,0,0,3
danielflower_multi-module-maven-release-plugin,e2e,0,0,0,0,1,0,0,1
danielflower_multi-module-maven-release-plugin,scaffolding,1,1,0,0,1,0,0,3
danmbox_briss2,at.laborg.briss,0,0,0,0,1,0,0,1
danmbox_briss2,at.laborg.briss.exception,0,0,0,0,0,0,0,0
danmbox_briss2,at.laborg.briss.gui,0,0,0,0,1,0,0,1
danmbox_briss2,at.laborg.briss.model,0,0,0,0,1,0,0,1
danmbox_briss2,at.laborg.briss.utils,0,0,0,0,1,0,0,1
darcy-framework_darcy-ui,com.redhat.darcy.ui,7,1,0,1,0,1,0,10
darcy-framework_darcy-ui,com.redhat.darcy.ui.annotations,0,0,0,0,0,0,0,0
darcy-framework_darcy-ui,com.redhat.darcy.ui.api,4,1,0,0,1,1,0,7
darcy-framework_darcy-ui,com.redhat.darcy.ui.api.elements,5,1,0,1,1,1,0,9
darcy-framework_darcy-ui,com.redhat.darcy.ui.internal,7,0,0,1,1,0,0,9
darcy-framework_darcy-ui,com.redhat.darcy.ui.matchers,0,0,0,0,1,0,0,1
darcy-framework_darcy-ui,com.redhat.darcy.util,0,0,0,0,0,0,0,0
darcy-framework_darcy-webdriver,com.redhat.darcy.webdriver,1,0,0,0,1,0,0,2
darcy-framework_darcy-webdriver,com.redhat.darcy.webdriver.elements,0,0,0,0,1,0,0,1
darcy-framework_darcy-webdriver,com.redhat.darcy.webdriver.guice,0,0,0,0,0,0,0,0
darcy-framework_darcy-webdriver,com.redhat.darcy.webdriver.internal,1,1,0,1,1,0,0,4
darcy-framework_darcy-webdriver,com.redhat.darcy.webdriver.locators,0,0,0,0,1,0,0,1
dart-maven-plugin_dart-maven-plugin,com.google.dart,0,0,0,0,1,0,0,1
dart-maven-plugin_dart-maven-plugin,com.google.dart.util,0,0,0,0,0,0,0,0
dashbuilder_dashbuilder,org.dashbuilder,0,0,0,0,0,0,0,0
dashbuilder_dashbuilder,org.dashbuilder.config,0,0,0,0,0,0,0,0
dashbuilder_dashbuilder,org.dashbuilder.dataprovider,0,0,0,0,1,0,0,1
dashbuilder_dashbuilder,org.dashbuilder.dataset,0,0,0,0,1,0,0,1
dashbuilder_dashbuilder,org.dashbuilder.exception,0,0,0,0,0,0,0,0
dashbuilder_dashbuilder,org.dashbuilder.scheduler,0,0,0,0,0,0,0,0
dashbuilder_dashbuilder,(default package),0,0,0,0,0,0,0,0
dashbuilder_dashbuilder,org.dashbuilder.pojo,0,0,0,0,0,0,0,0
dashbuilder_dashbuilder,org.dashbuilder.dataprovider.sql,0,0,0,0,1,0,0,1
dashbuilder_dashbuilder,org.dashbuilder.navigation.service,0,0,0,0,1,0,0,1
dashbuilder_dashbuilder,org.dashbuilder.navigation.storage,0,0,0,0,0,0,0,0
dashbuilder_dashbuilder,org.dashbuilder.dataset.service,0,0,0,0,1,0,0,1
dashbuilder_dashbuilder,org.dashbuilder.client.cms.layout.editor,0,0,0,0,0,0,0,0
dashbuilder_dashbuilder,org.dashbuilder.client.cms.perspective,0,0,0,0,0,0,0,0
dashbuilder_dashbuilder,org.dashbuilder.client.cms.resources.i18n,0,0,0,0,0,0,0,0
dashbuilder_dashbuilder,org.dashbuilder.client.cms.screen.explorer,0,0,0,0,0,0,0,0
dashbuilder_dashbuilder,org.dashbuilder.client.cms.screen.home,0,1,0,0,0,0,0,1
dashbuilder_dashbuilder,org.dashbuilder.client.cms.widget,0,0,0,0,1,0,0,1
dashbuilder_dashbuilder,org.dashbuilder.common.client.backend,0,0,0,0,0,0,0,0
dashbuilder_dashbuilder,org.dashbuilder.common.client,0,0,0,0,1,0,0,1
dashbuilder_dashbuilder,org.dashbuilder.common.client.editor.file,0,0,0,0,0,0,0,0
dashbuilder_dashbuilder,org.dashbuilder.common.client.editor,0,0,0,0,1,0,0,1
dashbuilder_dashbuilder,org.dashbuilder.common.client.editor.list,0,0,0,0,1,0,0,1
dashbuilder_dashbuilder,org.dashbuilder.common.client.editor.map,0,0,0,0,0,0,0,0
dashbuilder_dashbuilder,org.dashbuilder.common.client.error,0,0,0,0,0,0,0,0
dashbuilder_dashbuilder,org.dashbuilder.common.client.event,0,0,0,0,0,0,0,0
dashbuilder_dashbuilder,org.dashbuilder.common.client.resources.bundles,0,0,0,0,0,0,0,0
dashbuilder_dashbuilder,org.dashbuilder.common.client.resources.i18n,0,0,0,0,0,0,0,0
dashbuilder_dashbuilder,org.dashbuilder.common.client.widgets,0,0,0,0,1,0,0,1
dashbuilder_dashbuilder,org.dashbuilder.dataset.client,0,0,0,0,1,0,0,1
dashbuilder_dashbuilder,org.dashbuilder.dataset.client.editor,0,0,0,0,1,0,0,1
dashbuilder_dashbuilder,org.dashbuilder.dataset.client.engine,0,0,0,0,1,0,0,1
dashbuilder_dashbuilder,org.dashbuilder.dataset.client.resources.bundles,0,0,0,0,0,0,0,0
dashbuilder_dashbuilder,org.dashbuilder.dataset.client.resources.i18n,0,0,0,0,1,0,0,1
dashbuilder_dashbuilder,org.dashbuilder.dataset.client.uuid,0,0,0,0,0,0,0,0
dashbuilder_dashbuilder,org.dashbuilder.dataset.editor.client.perspectives,0,0,0,0,0,0,0,0
dashbuilder_dashbuilder,org.dashbuilder.dataset.editor.client.resources.i18n,0,0,0,0,0,0,0,0
dashbuilder_dashbuilder,org.dashbuilder.dataset.editor.client.screens,0,0,0,0,1,0,0,1
dashbuilder_dashbuilder,org.dashbuilder.displayer.client,0,1,0,1,1,1,0,4
dashbuilder_dashbuilder,org.dashbuilder.displayer.client.events,0,0,0,0,1,0,0,1
dashbuilder_dashbuilder,org.dashbuilder.displayer.client.export,0,0,0,0,0,0,0,0
dashbuilder_dashbuilder,org.dashbuilder.displayer.client.formatter,0,0,0,0,0,0,0,0
dashbuilder_dashbuilder,org.dashbuilder.displayer.client.prototypes,0,0,0,0,0,0,0,0
dashbuilder_dashbuilder,org.dashbuilder.displayer.client.resources.i18n,0,0,0,0,1,0,0,1
dashbuilder_dashbuilder,org.dashbuilder.displayer.client.resources.images,0,0,0,0,0,0,0,0
dashbuilder_dashbuilder,org.dashbuilder.displayer.client.widgets,0,0,0,1,1,0,0,2
dashbuilder_dashbuilder,org.dashbuilder.displayer.client.widgets.filter,0,0,0,1,1,0,0,2
dashbuilder_dashbuilder,org.dashbuilder.displayer.client.widgets.group,0,0,0,0,1,0,0,1
dashbuilder_dashbuilder,org.dashbuilder.displayer.client.widgets.sourcecode,0,0,0,0,1,0,0,1
dashbuilder_dashbuilder,org.dashbuilder.client.editor,0,0,0,0,0,0,0,0
dashbuilder_dashbuilder,org.dashbuilder.client.editor.resources.i18n,0,0,0,0,0,0,0,0
dashbuilder_dashbuilder,org.dashbuilder.client.navigation.event,1,1,0,0,1,0,0,3
dashbuilder_dashbuilder,org.dashbuilder.client.navigation.impl,0,0,0,0,0,0,0,0
dashbuilder_dashbuilder,org.dashbuilder.client.navigation.layout.editor,0,0,0,0,1,0,0,1
dashbuilder_dashbuilder,org.dashbuilder.client.navigation,1,1,0,0,0,0,0,2
dashbuilder_dashbuilder,org.dashbuilder.client.navigation.plugin,0,0,0,0,0,0,0,0
dashbuilder_dashbuilder,org.dashbuilder.client.navigation.resources.i18n,0,0,0,0,0,0,0,0
dashbuilder_dashbuilder,org.dashbuilder.client.navigation.widget,1,0,0,1,1,1,0,4
dashbuilder_dashbuilder,org.dashbuilder.client.navigation.widget.editor,1,0,0,0,0,1,0,2
dashbuilder_dashbuilder,org.dashbuilder.renderer.chartjs,0,0,0,0,1,0,0,1
dashbuilder_dashbuilder,org.dashbuilder.renderer.chartjs.lib,0,0,0,0,1,0,0,1
dashbuilder_dashbuilder,org.dashbuilder.renderer.chartjs.lib.data,0,0,0,0,1,0,0,1
dashbuilder_dashbuilder,org.dashbuilder.renderer.chartjs.lib.event,0,0,0,0,1,0,0,1
dashbuilder_dashbuilder,org.dashbuilder.renderer.chartjs.lib.options,0,0,0,0,1,0,0,1
dashbuilder_dashbuilder,org.dashbuilder.renderer.chartjs.lib.resources,0,0,0,0,0,0,0,0
dashbuilder_dashbuilder,org.dashbuilder.renderer.chartjs.resources.i18n,0,0,0,0,0,0,0,0
dashbuilder_dashbuilder,org.dashbuilder.renderer.client,1,1,0,0,0,0,0,2
dashbuilder_dashbuilder,org.dashbuilder.renderer.client.metric,1,0,0,0,0,0,0,1
dashbuilder_dashbuilder,org.dashbuilder.renderer.client.resources.i18n,0,0,0,0,0,0,0,0
dashbuilder_dashbuilder,org.dashbuilder.renderer.client.selector,0,0,0,0,1,0,0,1
dashbuilder_dashbuilder,org.dashbuilder.renderer.client.table,0,0,0,0,1,0,0,1
dashbuilder_dashbuilder,org.dashbuilder.renderer.google.client,0,0,0,1,0,1,0,2
dashbuilder_dashbuilder,org.dashbuilder.renderer.google.client.resources.i18n,0,0,0,0,0,0,0,0
dashbuilder_dashbuilder,org.dashbuilder.renderer.lienzo.client,0,0,0,0,1,0,0,1
dashbuilder_dashbuilder,org.dashbuilder.renderer.lienzo.client.resources.i18n,0,0,0,0,0,0,0,0
dashbuilder_dashbuilder,org.dashbuilder.client.widgets.common,0,0,0,0,1,0,0,1
dashbuilder_dashbuilder,org.dashbuilder.client.widgets.dataset.editor.attributes,0,0,0,0,1,0,0,1
dashbuilder_dashbuilder,org.dashbuilder.client.widgets.dataset.editor.bean,0,0,0,0,1,0,0,1
dashbuilder_dashbuilder,org.dashbuilder.client.widgets.dataset.editor.column,0,0,0,0,1,0,0,1
dashbuilder_dashbuilder,org.dashbuilder.client.widgets.dataset.editor.csv,0,0,0,0,1,0,0,1
dashbuilder_dashbuilder,org.dashbuilder.client.widgets.dataset.editor,0,0,0,0,1,0,0,1
dashbuilder_dashbuilder,org.dashbuilder.client.widgets.dataset.editor.driver,0,0,0,0,1,0,0,1
dashbuilder_dashbuilder,org.dashbuilder.client.widgets.dataset.editor.elasticsearch,0,0,0,0,1,0,0,1
dashbuilder_dashbuilder,org.dashbuilder.client.widgets.dataset.editor.sql,0,0,0,0,1,0,0,1
dashbuilder_dashbuilder,org.dashbuilder.client.widgets.dataset.editor.workflow.create,0,0,0,0,1,0,0,1
dashbuilder_dashbuilder,org.dashbuilder.client.widgets.dataset.editor.workflow,0,1,0,0,1,0,0,2
dashbuilder_dashbuilder,org.dashbuilder.client.widgets.dataset.editor.workflow.edit,0,0,0,0,1,0,0,1
dashbuilder_dashbuilder,org.dashbuilder.client.widgets.dataset.event,0,0,0,0,1,0,0,1
dashbuilder_dashbuilder,org.dashbuilder.client.widgets.dataset.explorer,0,0,0,0,1,0,0,1
dashbuilder_dashbuilder,org.dashbuilder.client.widgets.resources.i18n,0,0,0,0,0,0,0,0
dashbuilder_dashbuilder,org.dashbuilder.displayer,0,0,0,0,1,1,0,2
dashbuilder_dashbuilder,org.dashbuilder.displayer.impl,0,0,0,0,1,0,0,1
dashbuilder_dashbuilder,org.dashbuilder.displayer.json,0,0,0,0,0,0,0,0
dashbuilder_dashbuilder,org.dashbuilder.navigation.impl,1,1,0,0,1,2,0,5
dashbuilder_dashbuilder,org.dashbuilder.navigation.json,1,0,0,0,0,0,0,1
dashbuilder_dashbuilder,org.dashbuilder.navigation.layout,0,0,0,0,1,0,0,1
dashbuilder_dashbuilder,org.dashbuilder.navigation,2,1,0,0,1,1,0,5
dashbuilder_dashbuilder,org.dashbuilder.navigation.workbench,0,0,0,0,0,2,0,2
dashbuilder_dashbuilder,org.dashbuilder.perspectives,0,0,0,0,0,0,0,0
dashbuilder_dashbuilder,org.dashbuilder.validations.dataset,0,0,0,0,1,0,0,1
dashbuilder_dashbuilder,org.dashbuilder.validations,0,0,0,0,0,0,0,0
dashbuilder_dashbuilder,org.dashbuilder.backend,0,0,0,0,0,0,0,0
dashbuilder_dashbuilder,org.dashbuilder.backend.command,0,0,0,0,0,0,0,0
dashbuilder_dashbuilder,org.dashbuilder.client.dashboard,0,1,0,0,0,0,0,1
dashbuilder_dashbuilder,org.dashbuilder.client.expenses,0,0,0,0,0,0,0,0
dashbuilder_dashbuilder,org.dashbuilder.client.gallery,0,0,0,0,1,0,0,1
dashbuilder_dashbuilder,org.dashbuilder.client.metrics,0,0,0,0,0,0,0,0
dashbuilder_dashbuilder,org.dashbuilder.client.navbar,0,0,0,0,0,0,0,0
dashbuilder_dashbuilder,org.dashbuilder.client.perspectives,0,0,0,0,0,0,0,0
dashbuilder_dashbuilder,org.dashbuilder.client.resources,0,0,0,0,0,0,0,0
dashbuilder_dashbuilder,org.dashbuilder.client.resources.i18n,0,0,0,0,0,0,0,0
dashbuilder_dashbuilder,org.dashbuilder.client.sales,0,0,0,0,0,0,0,0
dashbuilder_dashbuilder,org.dashbuilder.client.sales.widgets,0,0,0,0,1,0,0,1
dashbuilder_dashbuilder,org.dashbuilder.client.screens,0,0,0,0,0,0,0,0
dashbuilder_dashbuilder,org.dashbuilder.client.security,0,0,0,0,0,0,0,0
dashbuilder_dashbuilder,org.dashbuilder.client,0,0,0,0,0,0,0,0
dashbuilder_dashbuilder,org.dashbuilder.shared.dashboard.events,0,0,0,0,0,0,0,0
dashbuilder_dashbuilder,org.dashbuilder.shared.sales,0,0,0,0,0,0,0,0
dashbuilder_dashbuilder,org.dashbuilder.security,0,0,0,0,0,0,0,0
databricks_learning-spark,com.oreilly.learningsparkexamples.mini.java,0,0,0,0,0,0,0,0
databricks_learning-spark,com.oreilly.learningsparkexamples.java,0,0,0,1,1,0,0,2
databricks_learning-spark,com.oreilly.learningsparkexamples.java.logs,0,0,0,0,1,0,0,1
DataDog_jmxfetch,org.datadog.jmxfetch,1,0,0,1,1,0,0,3
DataDog_jmxfetch,org.datadog.jmxfetch.converter,0,0,0,0,0,0,0,0
DataDog_jmxfetch,org.datadog.jmxfetch.reporter,1,0,0,0,0,0,0,1
DataDog_jmxfetch,org.datadog.jmxfetch.tasks,0,0,0,0,1,0,0,1
DataDog_jmxfetch,org.datadog.jmxfetch.util,0,0,0,0,0,0,0,0
DataDog_jmxfetch,org.datadog.jmxfetch.validator,0,0,0,0,0,0,0,0
datanucleus_datanucleus-core,org.datanucleus,60,1,0,1,1,65,1,129
datanucleus_datanucleus-core,org.datanucleus.api,3,0,0,0,0,12,1,16
datanucleus_datanucleus-core,org.datanucleus.cache,4,0,0,0,1,4,1,10
datanucleus_datanucleus-core,org.datanucleus.enhancement,5,0,1,0,1,6,1,14
datanucleus_datanucleus-core,org.datanucleus.enhancer.asm,0,0,0,1,0,6,1,8
datanucleus_datanucleus-core,org.datanucleus.enhancer,4,1,0,1,0,9,1,16
datanucleus_datanucleus-core,org.datanucleus.enhancer.methods,2,0,0,1,1,3,1,8
datanucleus_datanucleus-core,org.datanucleus.exceptions,9,1,0,0,0,2,1,13
datanucleus_datanucleus-core,org.datanucleus.flush,3,1,0,0,0,3,1,8
datanucleus_datanucleus-core,org.datanucleus.identity,4,1,0,0,1,1,1,8
datanucleus_datanucleus-core,org.datanucleus.management,0,0,0,0,1,1,1,3
datanucleus_datanucleus-core,org.datanucleus.metadata,19,1,0,1,0,57,1,79
datanucleus_datanucleus-core,org.datanucleus.metadata.annotations,2,0,0,0,1,2,1,6
datanucleus_datanucleus-core,org.datanucleus.metadata.xml,3,0,0,0,0,0,1,4
datanucleus_datanucleus-core,org.datanucleus.plugin,5,0,0,0,0,4,1,10
datanucleus_datanucleus-core,org.datanucleus.properties,3,0,0,0,1,10,1,15
datanucleus_datanucleus-core,org.datanucleus.query.compiler,9,1,0,0,0,8,1,19
datanucleus_datanucleus-core,org.datanucleus.query.expression,8,1,0,0,0,6,1,16
datanucleus_datanucleus-core,org.datanucleus.query.inmemory,2,1,0,0,0,8,1,12
datanucleus_datanucleus-core,org.datanucleus.query.inmemory.method,4,1,0,1,1,2,1,10
datanucleus_datanucleus-core,org.datanucleus.query,14,1,0,0,0,1,1,17
datanucleus_datanucleus-core,org.datanucleus.state,10,0,0,0,1,45,1,57
datanucleus_datanucleus-core,org.datanucleus.store,15,1,0,0,1,12,1,30
datanucleus_datanucleus-core,org.datanucleus.store.autostart,6,1,0,0,0,1,1,9
datanucleus_datanucleus-core,org.datanucleus.store.connection,6,1,0,0,1,3,1,12
datanucleus_datanucleus-core,org.datanucleus.store.federation,3,0,0,0,0,2,1,6
datanucleus_datanucleus-core,org.datanucleus.store.fieldmanager,4,1,0,0,0,7,1,13
datanucleus_datanucleus-core,org.datanucleus.store.query,17,0,0,0,1,11,1,30
datanucleus_datanucleus-core,org.datanucleus.store.query.cache,3,0,0,0,0,2,1,6
datanucleus_datanucleus-core,org.datanucleus.store.schema,2,0,0,0,1,0,1,4
datanucleus_datanucleus-core,org.datanucleus.store.schema.naming,2,0,0,0,0,0,1,3
datanucleus_datanucleus-core,org.datanucleus.store.schema.table,0,0,0,0,1,0,1,2
datanucleus_datanucleus-core,org.datanucleus.store.types,12,1,0,0,1,18,1,33
datanucleus_datanucleus-core,org.datanucleus.store.types.containers,0,0,0,0,0,3,1,4
datanucleus_datanucleus-core,org.datanucleus.store.types.converters,2,0,0,1,0,0,1,4
datanucleus_datanucleus-core,org.datanucleus.store.types.scostore,0,0,0,0,0,7,1,8
datanucleus_datanucleus-core,org.datanucleus.store.types.wrappers,0,0,0,0,1,8,1,10
datanucleus_datanucleus-core,org.datanucleus.store.types.wrappers.backed,0,0,0,0,0,9,1,10
datanucleus_datanucleus-core,org.datanucleus.store.valuegenerator,2,0,0,0,0,1,1,4
datanucleus_datanucleus-core,org.datanucleus.transaction,3,0,0,0,1,0,1,5
datanucleus_datanucleus-core,org.datanucleus.transaction.jta,0,0,0,0,1,0,1,2
datanucleus_datanucleus-core,org.datanucleus.util,44,1,0,1,0,42,1,89
datanucleus_datanucleus-core,org.datanucleus.store.types.sco,0,0,0,0,0,0,1,1
davidmoten_rtree,com.github.davidmoten.rtree,7,1,0,1,1,2,0,12
davidmoten_rtree,com.github.davidmoten.rtree.fbs,2,0,0,0,1,0,0,3
davidmoten_rtree,com.github.davidmoten.rtree.fbs.generated,0,0,0,0,1,0,0,1
davidmoten_rtree,com.github.davidmoten.rtree.geometry,4,1,0,0,0,2,0,7
davidmoten_rtree,com.github.davidmoten.rtree.geometry.internal,3,0,0,0,0,0,0,3
davidmoten_rtree,com.github.davidmoten.rtree.internal,6,1,0,0,1,2,0,10
davidmoten_rtree,com.github.davidmoten.rtree.internal.operators,0,0,0,0,0,0,0,0
davidmoten_rtree,com.github.davidmoten.rtree.internal.util,0,0,0,0,1,0,0,1
davidmoten_rtree,com.github.davidmoten.rtree.kryo,2,1,0,0,0,0,0,3
davidmoten_rtree,com.github.davidmoten.internal.operators,0,0,0,0,0,0,0,0
davidmoten_rtree,com.github.davidmoten.rtree.generated,0,0,0,1,0,0,0,1
davidmoten_rtree,org.openjdk.jmh.infra.generated,0,0,0,0,0,0,0,0
davidmoten_rxjava-extras,com.github.davidmoten.rx,3,1,0,1,1,0,0,6
davidmoten_rxjava-extras,com.github.davidmoten.rx.buffertofile,0,0,0,0,1,1,0,2
davidmoten_rxjava-extras,com.github.davidmoten.rx.exceptions,0,0,0,0,0,0,0,0
davidmoten_rxjava-extras,com.github.davidmoten.rx.internal.operators,2,0,0,1,1,1,0,5
davidmoten_rxjava-extras,com.github.davidmoten.rx.internal,0,0,0,0,0,0,0,0
davidmoten_rxjava-extras,com.github.davidmoten.rx.observables,0,0,0,0,0,0,0,0
davidmoten_rxjava-extras,com.github.davidmoten.rx.subjects,0,0,0,0,0,0,0,0
davidmoten_rxjava-extras,com.github.davidmoten.rx.util,2,1,0,0,1,0,0,4
davidmoten_rxjava-extras,com.github.davidmoten.util,0,0,0,0,1,1,0,2
davidmoten_rxjava-extras,com.github.davidmoten.rx.perf,0,0,0,0,0,0,0,0
davidmoten_rxjava-jdbc,com.github.davidmoten.rx.jdbc,1,0,0,1,1,0,0,3
davidmoten_rxjava-jdbc,com.github.davidmoten.rx.jdbc.exceptions,0,0,0,0,0,0,0,0
davidmoten_rxjava-jdbc,com.github.davidmoten.rx.jdbc.tuple,1,1,0,0,0,0,0,2
davidmoten_rxjava-jdbc,com.github.davidmoten.rx,0,0,0,0,1,0,0,1
davidmoten_rxjava-jdbc,com.github.davidmoten.rx.jdbc.generated,0,0,0,0,0,0,0,0
dbfit_dbfit,dbfit.api,4,1,0,0,0,0,0,5
dbfit_dbfit,dbfit,0,0,0,0,0,0,0,0
dbfit_dbfit,dbfit.diff,2,0,0,0,0,0,0,2
dbfit_dbfit,dbfit.fixture,6,1,0,0,1,0,0,8
dbfit_dbfit,dbfit.fixture.report,1,0,0,0,0,0,0,1
dbfit_dbfit,dbfit.util,4,1,0,1,0,0,0,6
dbfit_dbfit,dbfit.util.crypto,0,0,0,0,0,0,0,0
dbfit_dbfit,dbfit.util.sql,0,0,0,0,0,0,0,0
dbfit_dbfit,dbfit.environment,0,0,0,1,1,0,0,2
dbfit_dbfit,dbfit.util.oracle,0,0,0,0,1,0,0,1
dbfit_dbfit,dbfit.environment.postgres,0,0,0,0,0,0,0,0
ddavison_conductor,io.ddavison.conductor,0,0,0,0,1,0,0,1
ddavison_conductor,io.ddavison.conductor.util,0,0,0,0,0,0,0,0
DeemOpen_zkui,com.deem.zkui.controller,0,0,0,0,1,0,0,1
DeemOpen_zkui,com.deem.zkui.dao,0,0,0,0,0,0,0,0
DeemOpen_zkui,com.deem.zkui.domain,0,0,0,0,0,0,0,0
DeemOpen_zkui,com.deem.zkui.filter,0,0,0,0,0,0,0,0
DeemOpen_zkui,com.deem.zkui.listener,0,0,0,0,0,0,0,0
DeemOpen_zkui,com.deem.zkui,0,0,0,0,0,0,0,0
DeemOpen_zkui,com.deem.zkui.utils,0,0,0,0,0,0,0,0
DeemOpen_zkui,com.deem.zkui.vo,0,0,0,0,0,0,0,0
Devexperts_aprof,com.devexperts.aprof.benchmark,0,0,0,0,1,0,0,1
Devexperts_aprof,com.devexperts.aprof.benchmark.generated,0,0,0,0,0,0,0,0
Devexperts_aprof,com.devexperts.aprof,2,1,0,0,1,1,0,5
Devexperts_aprof,com.devexperts.aprof.dump,1,0,0,0,1,1,0,3
Devexperts_aprof,com.devexperts.aprof.hotspot,1,0,0,0,1,0,0,2
Devexperts_aprof,com.devexperts.aprof.util,0,0,0,0,1,1,0,2
Devexperts_aprof,com.devexperts.util,0,0,0,0,0,0,0,0
Devexperts_aprof,com.devexperts.aprof.transformer,0,0,0,0,0,0,0,0
devnied_EMV-NFC-Paycard-Enrollment,com.github.devnied.emvnfccard.enums,0,0,0,0,0,0,0,0
devnied_EMV-NFC-Paycard-Enrollment,com.github.devnied.emvnfccard.exception,0,0,0,0,0,0,0,0
devnied_EMV-NFC-Paycard-Enrollment,com.github.devnied.emvnfccard.iso7816emv,1,1,0,0,1,0,0,3
devnied_EMV-NFC-Paycard-Enrollment,com.github.devnied.emvnfccard.iso7816emv.impl,1,0,0,0,0,0,0,1
devnied_EMV-NFC-Paycard-Enrollment,com.github.devnied.emvnfccard.model,1,1,0,0,1,2,0,5
devnied_EMV-NFC-Paycard-Enrollment,com.github.devnied.emvnfccard.model.enums,0,0,0,0,0,0,0,0
devnied_EMV-NFC-Paycard-Enrollment,com.github.devnied.emvnfccard.parser.apdu.annotation,0,0,0,0,0,0,0,0
devnied_EMV-NFC-Paycard-Enrollment,com.github.devnied.emvnfccard.parser.apdu,0,0,0,0,0,0,0,0
devnied_EMV-NFC-Paycard-Enrollment,com.github.devnied.emvnfccard.parser.apdu.impl,1,1,0,0,0,1,0,3
devnied_EMV-NFC-Paycard-Enrollment,com.github.devnied.emvnfccard.parser,0,1,0,0,1,2,0,4
devnied_EMV-NFC-Paycard-Enrollment,com.github.devnied.emvnfccard.parser.impl,0,0,0,0,0,0,0,0
devnied_EMV-NFC-Paycard-Enrollment,com.github.devnied.emvnfccard.utils,1,0,0,0,1,0,0,2
devnied_EMV-NFC-Paycard-Enrollment,com.github.devnied.emvnfccard,0,0,0,0,0,1,0,1
devnied_EMV-NFC-Paycard-Enrollment,com.github.devnied.emvnfccard.provider,0,0,0,0,0,0,0,0
devnied_EMV-NFC-Paycard-Enrollment,com.github.devnied.emvpcsccard,0,0,0,0,0,0,0,0
dgageot_simplelenium,net.codestory.simplelenium,1,0,0,1,1,0,0,3
dgageot_simplelenium,net.codestory.simplelenium.driver,0,0,0,0,0,0,0,0
dgageot_simplelenium,net.codestory.simplelenium.driver.chrome,0,0,0,0,0,0,0,0
dgageot_simplelenium,net.codestory.simplelenium.driver.firefox,0,0,0,0,0,0,0,0
dgageot_simplelenium,net.codestory.simplelenium.driver.phantomjs,0,0,0,0,0,0,0,0
dgageot_simplelenium,net.codestory.simplelenium.filters,0,0,0,0,1,0,0,1
dgageot_simplelenium,net.codestory.simplelenium.reflection,1,0,0,0,0,0,0,1
dgageot_simplelenium,net.codestory.simplelenium.rules,0,0,0,0,0,0,0,0
dgageot_simplelenium,net.codestory.simplelenium.selectors,0,0,0,0,0,0,0,0
dgageot_simplelenium,net.codestory.simplelenium.text,0,0,0,0,0,0,0,0
dibbhatt_kafka-spark-consumer,consumer.kafka,0,0,0,0,1,0,0,1
dibbhatt_kafka-spark-consumer,consumer.kafka.client,0,0,0,0,0,0,0,0
DICE-UNC_idrop,org.irods.jargon.idrop.desktop.systraygui,1,0,0,1,1,0,0,3
DICE-UNC_idrop,org.irods.jargon.idrop.desktop.systraygui.services,0,0,0,0,1,0,0,1
DICE-UNC_idrop,org.irods.jargon.idrop.desktop.systraygui.utils,0,1,0,0,1,0,0,2
DICE-UNC_idrop,org.irods.jargon.idrop.desktop.systraygui.viscomponents,0,0,0,1,1,0,0,2
DICE-UNC_idrop,org.irods.jargon.idrop.exceptions,0,0,0,0,0,0,0,0
DICE-UNC_idrop,org.irods.jargon.idrop.finder,1,1,0,0,1,0,0,3
DICE-UNC_idrop,org.irods.jargon.conveyor.basic,0,0,0,0,1,1,0,2
DICE-UNC_idrop,org.irods.jargon.conveyor.core,0,0,0,0,1,0,0,1
DICE-UNC_idrop,org.irods.jargon.conveyor.core.callables,0,0,0,0,1,0,0,1
DICE-UNC_idrop,org.irods.jargon.conveyor.flowmanager.flow.dsl,0,0,0,0,0,1,0,1
DICE-UNC_idrop,org.irods.jargon.conveyor.flowmanager.flow,0,0,0,0,1,1,0,2
DICE-UNC_idrop,org.irods.jargon.conveyor.flowmanager.microservice.builtins,0,0,0,0,1,0,0,1
DICE-UNC_idrop,org.irods.jargon.conveyor.flowmanager.microservice,0,0,0,0,1,0,0,1
DICE-UNC_idrop,org.irods.jargon.conveyor.gridaccount,0,0,0,0,0,0,0,0
DICE-UNC_idrop,org.irods.jargon.conveyor.synch,0,0,0,0,1,0,0,1
DICE-UNC_idrop,org.irods.jargon.conveyor.utils,0,0,0,0,0,0,0,0
DICE-UNC_idrop,org.irods.jargon.transfer.dao,0,0,0,0,1,0,0,1
DICE-UNC_idrop,org.irods.jargon.transfer.dao.domain,0,0,0,0,1,1,0,2
DICE-UNC_idrop,org.irods.jargon.transfer.dao.impl,0,0,0,0,1,0,0,1
DICE-UNC_idrop,org.irods.jargon.transfer.exception,0,0,0,0,0,0,0,0
DICE-UNC_idrop,org.irods.jargon.transfer.util,0,0,0,0,0,0,0,0
DICE-UNC_jargon,org.irods.jargon.dataprofile,0,0,0,0,1,2,1,4
DICE-UNC_jargon,org.irods.jargon.core.checksum,0,0,0,0,1,1,1,3
DICE-UNC_jargon,org.irods.jargon.core.connection,13,1,0,1,1,71,1,88
DICE-UNC_jargon,org.irods.jargon.core.connection.auth,4,0,0,0,0,1,1,6
DICE-UNC_jargon,org.irods.jargon.core.exception,0,0,0,1,0,1,1,3
DICE-UNC_jargon,org.irods.jargon.core.exception.dataformat,0,0,0,0,0,0,1,1
DICE-UNC_jargon,org.irods.jargon.core.packinstr,13,1,0,1,0,11,1,27
DICE-UNC_jargon,org.irods.jargon.core.protovalues,0,0,0,0,0,0,1,1
DICE-UNC_jargon,org.irods.jargon.core.pub,21,1,0,2,1,106,1,132
DICE-UNC_jargon,org.irods.jargon.core.pub.aohelper,3,0,0,0,1,1,1,6
DICE-UNC_jargon,org.irods.jargon.core.pub.domain,15,1,0,0,1,31,1,49
DICE-UNC_jargon,org.irods.jargon.core.pub.io,4,0,0,1,1,62,1,69
DICE-UNC_jargon,org.irods.jargon.core.query,19,1,0,1,1,41,1,64
DICE-UNC_jargon,org.irods.jargon.core.remoteexecute,4,0,0,0,0,3,1,8
DICE-UNC_jargon,org.irods.jargon.core.rule,4,0,0,0,0,8,1,13
DICE-UNC_jargon,org.irods.jargon.core.security,3,0,0,0,0,0,1,4
DICE-UNC_jargon,org.irods.jargon.core.service,0,0,0,0,0,3,1,4
DICE-UNC_jargon,org.irods.jargon.core.sql,0,0,0,0,0,0,1,1
DICE-UNC_jargon,org.irods.jargon.core.transfer,7,1,0,0,1,12,1,22
DICE-UNC_jargon,org.irods.jargon.core.transfer.encrypt,3,0,0,0,1,1,1,6
DICE-UNC_jargon,org.irods.jargon.core.transform,0,0,0,0,0,0,1,1
DICE-UNC_jargon,org.irods.jargon.core.utils,35,1,0,0,1,2,1,40
DICE-UNC_jargon,org.irods.jargon.datautils,0,0,0,0,0,0,1,1
DICE-UNC_jargon,org.irods.jargon.datautils.avuautocomplete,0,0,0,0,0,3,1,4
DICE-UNC_jargon,org.irods.jargon.datautils.connection,0,0,0,0,0,0,1,1
DICE-UNC_jargon,org.irods.jargon.datautils.datacache,0,0,0,0,1,1,1,3
DICE-UNC_jargon,org.irods.jargon.datautils.filearchive,0,0,0,0,0,1,1,2
DICE-UNC_jargon,org.irods.jargon.datautils.indexer,1,1,0,0,1,3,1,7
DICE-UNC_jargon,org.irods.jargon.datautils.metadatamanifest,0,0,0,0,0,0,1,1
DICE-UNC_jargon,org.irods.jargon.datautils.rule,0,0,0,0,0,1,1,2
DICE-UNC_jargon,org.irods.jargon.datautils.shoppingcart,0,0,0,0,1,0,1,2
DICE-UNC_jargon,org.irods.jargon.datautils.synchproperties,0,0,0,0,1,1,1,3
DICE-UNC_jargon,org.irods.jargon.datautils.tree,0,0,0,0,1,5,1,7
DICE-UNC_jargon,org.irods.jargon.datautils.visitor,1,0,0,0,1,3,1,6
DICE-UNC_jargon,org.irods.jargon.mdquery.exception,0,0,0,0,0,0,1,1
DICE-UNC_jargon,org.irods.jargon.mdquery,0,0,0,0,0,2,1,3
DICE-UNC_jargon,org.irods.jargon.mdquery.serialization,0,0,0,0,0,0,1,1
DICE-UNC_jargon,org.irods.jargon.mdquery.service,0,0,0,0,0,2,1,3
DICE-UNC_jargon,org.irods.jargon.pool.conncache,0,0,0,0,1,0,1,2
DICE-UNC_jargon,org.irods.jargon.ruleservice.composition,0,0,0,0,0,4,1,5
DICE-UNC_jargon,org.irods.jargon.ruleservice.formatting,0,0,0,0,0,0,1,1
DICE-UNC_jargon,org.irods.jargon.ticket,0,0,0,0,0,10,1,11
DICE-UNC_jargon,org.irods.jargon.ticket.io,0,0,0,0,0,1,1,2
DICE-UNC_jargon,org.irods.jargon.ticket.packinstr,0,0,0,0,0,1,1,2
DICE-UNC_jargon,org.irods.jargon.ticket.utils,0,0,0,0,0,0,1,1
DICE-UNC_jargon,org.irods.jargon.usertagging,0,0,0,0,0,18,1,19
DICE-UNC_jargon,org.irods.jargon.usertagging.domain,1,1,0,0,1,11,1,15
DICE-UNC_jargon,org.irods.jargon.usertagging.sharing,0,0,0,0,0,8,1,9
DICE-UNC_jargon,org.irods.jargon.usertagging.starring,0,0,0,0,0,4,1,5
DICE-UNC_jargon,org.irods.jargon.usertagging.tags,1,1,0,0,1,15,1,19
DICE-UNC_jargon,org.irods.jargon.zipservice.api,0,0,0,0,1,1,1,3
DICE-UNC_jargon,org.irods.jargon.zipservice.api.exception,0,0,0,0,0,0,1,1
digidotcom_XBeeJavaLibrary,com.digi.xbee.api.receivebluetoothdata,0,0,0,0,0,0,0,0
digidotcom_XBeeJavaLibrary,com.digi.xbee.api.receivebluetoothfile,0,0,0,0,0,0,0,0
digidotcom_XBeeJavaLibrary,com.digi.xbee.api.sendbluetoothdata,0,0,0,0,0,0,0,0
digidotcom_XBeeJavaLibrary,com.digi.xbee.api.receivesms,0,0,0,0,0,0,0,0
digidotcom_XBeeJavaLibrary,com.digi.xbee.api.sendsms,0,0,0,0,0,0,0,0
digidotcom_XBeeJavaLibrary,com.digi.xbee.api.receivecoapdata,0,0,0,0,0,0,0,0
digidotcom_XBeeJavaLibrary,com.digi.xbee.api.sendcoapdata,0,0,0,0,0,0,0,0
digidotcom_XBeeJavaLibrary,com.digi.xbee.api.receiveexplicitdatapolling,0,0,0,0,0,0,0,0
digidotcom_XBeeJavaLibrary,com.digi.xbee.api.receiveexplicitdata,0,0,0,0,0,0,0,0
digidotcom_XBeeJavaLibrary,com.digi.xbee.api.sendbroadcastexplicitdata,0,0,0,0,0,0,0,0
digidotcom_XBeeJavaLibrary,com.digi.xbee.api.sendexplicitdataasync,0,0,0,0,0,0,0,0
digidotcom_XBeeJavaLibrary,com.digi.xbee.api.sendexplicitdata,0,0,0,0,0,0,0,0
digidotcom_XBeeJavaLibrary,com.digi.xbee.api.connecttoechoserver,0,0,0,0,0,0,0,0
digidotcom_XBeeJavaLibrary,com.digi.xbee.api.knockknock,0,0,0,0,0,0,0,0
digidotcom_XBeeJavaLibrary,com.digi.xbee.api.receiveipdata,0,0,0,0,0,0,0,0
digidotcom_XBeeJavaLibrary,com.digi.xbee.api.receiveipv6data,0,0,0,0,0,0,0,0
digidotcom_XBeeJavaLibrary,com.digi.xbee.api.sendipdata,0,0,0,0,0,0,0,0
digidotcom_XBeeJavaLibrary,com.digi.xbee.api.sendipv6data,0,0,0,0,0,0,0,0
digidotcom_XBeeJavaLibrary,com.digi.xbee.api.sendudpdata,0,0,0,0,0,0,0,0
digidotcom_XBeeJavaLibrary,com.digi.xbee.api.receivemicropythondata,0,0,0,0,0,0,0,0
digidotcom_XBeeJavaLibrary,com.digi.xbee.api.sendmicropythondata,0,0,0,0,0,0,0,0
digidotcom_XBeeJavaLibrary,com.digi.xbee.api.receivedatapolling,0,0,0,0,0,0,0,0
digidotcom_XBeeJavaLibrary,com.digi.xbee.api.receivedata,0,0,0,0,0,0,0,0
digidotcom_XBeeJavaLibrary,com.digi.xbee.api.receivemodemstatus,0,0,0,0,0,0,0,0
digidotcom_XBeeJavaLibrary,com.digi.xbee.api.receiveuserdatarelay,0,0,0,0,0,0,0,0
digidotcom_XBeeJavaLibrary,com.digi.xbee.api.senduserdatarelay,0,0,0,0,0,0,0,0
digidotcom_XBeeJavaLibrary,com.digi.xbee.api.sendbroadcastdata,0,0,0,0,0,0,0,0
digidotcom_XBeeJavaLibrary,com.digi.xbee.api.senddataasync,0,0,0,0,0,0,0,0
digidotcom_XBeeJavaLibrary,com.digi.xbee.api.senddata,0,0,0,0,0,0,0,0
digidotcom_XBeeJavaLibrary,com.digi.xbee.api.connecttoaccesspoint,0,0,0,0,0,0,0,0
digidotcom_XBeeJavaLibrary,com.digi.xbee.api.managecommonparameters,0,0,0,0,0,0,0,0
digidotcom_XBeeJavaLibrary,com.digi.xbee.api.resetmodule,0,0,0,0,0,0,0,0
digidotcom_XBeeJavaLibrary,com.digi.xbee.api.setgetparameters,0,0,0,0,0,0,0,0
digidotcom_XBeeJavaLibrary,com.digi.xbee.api.iosampling,0,0,0,0,0,0,0,0
digidotcom_XBeeJavaLibrary,com.digi.xbee.api.localadc,0,0,0,0,0,0,0,0
digidotcom_XBeeJavaLibrary,com.digi.xbee.api.localdio,0,0,0,0,0,0,0,0
digidotcom_XBeeJavaLibrary,com.digi.xbee.api.remoteadc,0,0,0,0,0,0,0,0
digidotcom_XBeeJavaLibrary,com.digi.xbee.api.remotedio,0,0,0,0,0,0,0,0
digidotcom_XBeeJavaLibrary,com.digi.xbee.api.discoverdevices,0,0,0,0,0,0,0,0
digidotcom_XBeeJavaLibrary,com.digi.xbee.api,13,1,0,1,0,14,0,29
digidotcom_XBeeJavaLibrary,com.digi.xbee.api.connection.bluetooth,0,0,0,0,0,0,0,0
digidotcom_XBeeJavaLibrary,com.digi.xbee.api.connection,3,1,0,0,0,1,0,5
digidotcom_XBeeJavaLibrary,com.digi.xbee.api.connection.serial,0,0,0,0,1,0,0,1
digidotcom_XBeeJavaLibrary,com.digi.xbee.api.exceptions,0,0,0,1,0,0,0,1
digidotcom_XBeeJavaLibrary,com.digi.xbee.api.io,0,0,0,0,1,1,0,2
digidotcom_XBeeJavaLibrary,com.digi.xbee.api.listeners,3,0,0,0,1,8,0,12
digidotcom_XBeeJavaLibrary,com.digi.xbee.api.listeners.relay,0,0,0,0,0,1,0,1
digidotcom_XBeeJavaLibrary,com.digi.xbee.api.models,11,1,0,1,1,8,0,22
digidotcom_XBeeJavaLibrary,com.digi.xbee.api.packet,4,0,0,0,0,7,0,11
digidotcom_XBeeJavaLibrary,com.digi.xbee.api.packet.bluetooth,0,0,0,0,0,0,0,0
digidotcom_XBeeJavaLibrary,com.digi.xbee.api.packet.cellular,0,0,0,0,0,0,0,0
digidotcom_XBeeJavaLibrary,com.digi.xbee.api.packet.common,2,1,0,0,1,8,0,12
digidotcom_XBeeJavaLibrary,com.digi.xbee.api.packet.devicecloud,0,0,0,0,1,0,0,1
digidotcom_XBeeJavaLibrary,com.digi.xbee.api.packet.ip,2,1,0,0,0,0,0,3
digidotcom_XBeeJavaLibrary,com.digi.xbee.api.packet.raw,4,0,0,0,1,6,0,11
digidotcom_XBeeJavaLibrary,com.digi.xbee.api.packet.relay,0,0,0,0,0,0,0,0
digidotcom_XBeeJavaLibrary,com.digi.xbee.api.packet.thread,2,0,0,0,1,1,0,4
digidotcom_XBeeJavaLibrary,com.digi.xbee.api.packet.wifi,2,0,0,0,1,0,0,3
digidotcom_XBeeJavaLibrary,com.digi.xbee.api.utils,0,0,0,0,0,0,0,0
digidotcom_XBeeJavaLibrary,com.digi.xbee.api.utils.srp,0,0,0,0,0,0,0,0
digitalfondue_lavagna,io.lavagna.common,0,0,0,0,1,0,0,1
digitalfondue_lavagna,io.lavagna.config,0,0,0,0,1,0,0,1
digitalfondue_lavagna,io.lavagna.model.apihook,0,0,0,0,0,0,0,0
digitalfondue_lavagna,io.lavagna.model.util,0,0,0,0,0,0,0,0
digitalfondue_lavagna,io.lavagna.query,0,0,0,0,1,0,0,1
digitalfondue_lavagna,io.lavagna.service,0,0,0,1,1,0,0,2
digitalfondue_lavagna,io.lavagna.service.calendarutils,0,0,0,0,0,0,0,0
digitalfondue_lavagna,io.lavagna.service.importexport,0,0,0,0,0,0,0,0
digitalfondue_lavagna,io.lavagna.service.mailreceiver,0,0,0,0,1,0,0,1
digitalfondue_lavagna,io.lavagna.web.api,0,0,0,1,1,0,0,2
digitalfondue_lavagna,io.lavagna.web.helper,1,0,0,0,1,0,0,2
digitalfondue_lavagna,io.lavagna.web.security,1,1,0,0,1,0,0,3
digitalfondue_lavagna,io.lavagna.web.security.login,0,0,0,0,1,0,0,1
digitalfondue_lavagna,io.lavagna.web.security.login.oauth,0,0,0,0,1,0,0,1
digitalfondue_lavagna,io.lavagna.web.support,0,0,0,0,0,0,0,0
digitalfondue_lavagna,io.lavagna.loader,0,0,0,0,0,0,0,0
digitalfondue_lavagna,io.lavagna.model,0,0,0,0,0,0,0,0
digitalfondue_lavagna,io.lavagna.service.config,0,0,0,0,0,0,0,0
digitalfondue_lavagna,io.lavagna.web.config,0,0,0,0,0,0,0,0
dobrynya_nomin,org.nomin.context,0,0,0,0,0,0,0,0
dobrynya_nomin,org.nomin.core,2,1,0,1,1,0,0,5
dobrynya_nomin,org.nomin.core.preprocessing,2,1,0,0,0,0,0,3
dobrynya_nomin,org.nomin,0,0,0,0,0,0,0,0
dobrynya_nomin,org.nomin.util,3,0,0,1,1,0,0,5
dobrynya_nomin,org.nomin.dozer,0,0,0,0,0,0,0,0
dobrynya_nomin,org.nomin.entity,0,0,0,1,1,0,0,2
dobrynya_nomin,org.nomin.performance,0,0,0,0,0,0,0,0
dobrynya_nomin,org.nomin.functional,0,0,0,0,1,0,0,1
dobrynya_nomin,org.nomin.mappings,0,0,1,0,1,0,0,2
documents4j_documents4j,com.documents4j.api,0,0,0,0,1,0,0,1
documents4j_documents4j,com.documents4j.job,1,1,0,1,1,0,0,4
documents4j_documents4j,com.documents4j.throwables,0,0,0,0,0,0,0,0
documents4j_documents4j,com.documents4j.ws.endpoint,0,0,0,0,1,0,0,1
documents4j_documents4j,com.documents4j.standalone,0,0,0,0,1,0,0,1
documents4j_documents4j,com.documents4j.conversion,1,0,0,0,1,0,0,2
documents4j_documents4j,com.documents4j.demo,0,0,0,0,1,0,0,1
documents4j_documents4j,com.documents4j.ws.application,0,1,0,0,0,0,0,1
documents4j_documents4j,com.documents4j.builder,0,0,0,0,0,0,0,0
documents4j_documents4j,com.documents4j.server.auth,0,0,0,0,0,0,0,0
documents4j_documents4j,com.documents4j.ws,0,1,0,0,1,0,0,2
documents4j_documents4j,com.documents4j.conversion.msoffice,0,0,0,0,1,0,0,1
documents4j_documents4j,com.documents4j.util,0,0,0,0,0,0,0,0
dpaukov_combinatoricslib,org.paukov.combinatorics.cartesian,1,0,0,0,0,0,0,1
dpaukov_combinatoricslib,org.paukov.combinatorics.combination.multi,2,0,0,0,0,0,0,2
dpaukov_combinatoricslib,org.paukov.combinatorics.combination.simple,2,0,0,0,0,0,0,2
dpaukov_combinatoricslib,org.paukov.combinatorics,12,1,0,0,1,0,0,14
dpaukov_combinatoricslib,org.paukov.combinatorics.composition,2,0,0,0,1,0,0,3
dpaukov_combinatoricslib,org.paukov.combinatorics.partition,1,0,0,0,0,0,0,1
dpaukov_combinatoricslib,org.paukov.combinatorics.permutations,2,0,0,0,1,0,0,3
dpaukov_combinatoricslib,org.paukov.combinatorics.subsets,2,0,0,0,1,0,0,3
dpaukov_combinatoricslib,org.paukov.combinatorics.util,5,1,0,0,0,0,0,6
dpaukov_combinatoricslib,org.paukov.examples,0,0,0,0,0,0,0,0
dpaukov_combinatoricslib,org.paukov.tool,0,0,0,0,0,0,0,0
drankye_haox,(default package),0,0,0,0,0,0,0,0
drankye_haox,org.apache.commons.httpclient.contrib.ssl,0,0,0,0,0,0,0,0
drankye_haox,org.apache.commons.ssl.asn1,0,0,0,1,0,0,0,1
drankye_haox,org.apache.commons.ssl,0,0,0,1,0,0,0,1
drankye_haox,org.apache.commons.ssl.rmi,0,0,0,0,0,0,0,0
drankye_haox,org.apache.commons.ssl.util,0,0,0,0,1,0,0,1
drankye_haox,org.apache.kerberos.benchmark,0,0,0,0,0,0,0,0
drankye_haox,org.apache.haox.asn1,1,0,0,0,0,0,0,1
drankye_haox,org.apache.haox.asn1.type,1,1,0,1,0,3,0,6
drankye_haox,org.apache.haox.config,0,0,0,0,0,0,0,0
drankye_haox,org.apache.haox.event,0,0,0,0,1,9,0,10
drankye_haox,org.apache.haox.transport,0,1,0,0,1,7,0,9
drankye_haox,org.apache.haox.transport.buffer,0,0,0,0,0,2,0,2
drankye_haox,org.apache.haox.transport.event,0,0,0,0,0,7,0,7
drankye_haox,org.apache.haox.transport.tcp,0,0,0,0,1,2,0,3
drankye_haox,org.apache.haox.transport.udp,0,0,0,0,0,3,0,3
drankye_haox,org.apache.haox.event.network,0,0,0,0,0,1,0,1
drankye_haox,org.apache.haox.event.tcp,0,0,0,0,0,1,0,1
drankye_haox,org.apache.haox.event.udp,0,0,0,0,0,1,0,1
drankye_haox,org.haox.pki,0,0,0,0,0,0,0,0
drankye_haox,org.haox.token,0,0,0,0,1,0,0,1
drankye_haox,org.apache.kerberos.kdc.server,0,0,0,0,0,0,0,0
drankye_haox,org.apache.kerberos.kdc.identitybackend,0,0,0,0,0,0,0,0
drankye_haox,org.apache.kerberos.tool,0,0,0,0,0,0,0,0
drankye_haox,org.apache.kerberos.kerb.client.event,2,1,0,0,0,0,0,3
drankye_haox,org.apache.kerberos.kerb.client,5,1,0,0,0,0,0,6
drankye_haox,org.apache.kerberos.kerb.client.preauth,3,1,0,0,1,1,0,6
drankye_haox,org.apache.kerberos.kerb.client.preauth.builtin,0,0,0,0,0,0,0,0
drankye_haox,org.apache.kerberos.kerb.client.preauth.pkinit,0,0,0,0,0,0,0,0
drankye_haox,org.apache.kerberos.kerb.client.preauth.token,0,0,0,0,0,0,0,0
drankye_haox,org.apache.kerberos.kerb.client.request,4,0,0,0,0,0,0,4
drankye_haox,org.apache.kerberos.kerb.common,0,1,0,0,0,2,0,3
drankye_haox,org.apache.kerberos.kerb,1,1,0,0,1,1,0,4
drankye_haox,org.apache.kerberos.kerb.preauth.builtin,0,0,0,0,0,0,0,0
drankye_haox,org.apache.kerberos.kerb.preauth,0,0,0,0,0,0,0,0
drankye_haox,org.apache.kerberos.kerb.preauth.pkinit,0,0,0,0,0,0,0,0
drankye_haox,org.apache.kerberos.kerb.preauth.token,0,0,0,0,0,0,0,0
drankye_haox,org.apache.kerberos.kerb.codec,0,0,0,0,0,0,0,0
drankye_haox,org.apache.kerberos.kerb.spec.ap,0,0,0,0,0,0,0,0
drankye_haox,org.apache.kerberos.kerb.spec.common,1,0,0,0,1,8,0,10
drankye_haox,org.apache.kerberos.kerb.spec.fast,0,0,0,0,1,0,0,1
drankye_haox,org.apache.kerberos.kerb.spec.kdc,0,0,0,0,1,2,0,3
drankye_haox,org.apache.kerberos.kerb.spec,0,1,0,0,1,0,0,2
drankye_haox,org.apache.kerberos.kerb.spec.pa.otp,0,0,0,0,0,0,0,0
drankye_haox,org.apache.kerberos.kerb.spec.pa,0,0,0,0,0,1,0,1
drankye_haox,org.apache.kerberos.kerb.spec.pa.pkinit,0,0,0,0,1,0,0,1
drankye_haox,org.apache.kerberos.kerb.spec.pa.token,0,0,0,0,0,0,0,0
drankye_haox,org.apache.kerberos.kerb.spec.ticket,0,0,0,0,1,3,0,4
drankye_haox,org.apache.kerberos.kerb.spec.x509,0,0,0,0,0,0,0,0
drankye_haox,org.apache.kerberos.kerb.codec.kerberos,0,0,0,0,1,2,0,3
drankye_haox,org.apache.kerberos.kerb.codec.pac,0,0,0,0,0,0,0,0
drankye_haox,org.apache.kerberos.kerb.codec.spnego,0,0,0,0,0,0,0,0
drankye_haox,org.apache.kerberos.kerb.crypto,8,1,0,1,1,5,0,16
drankye_haox,org.apache.kerberos.kerb.crypto.cksum,4,0,0,0,1,2,0,7
drankye_haox,org.apache.kerberos.kerb.crypto.cksum.provider,1,1,0,0,1,0,0,3
drankye_haox,org.apache.kerberos.kerb.crypto.enc,2,0,0,0,0,4,0,6
drankye_haox,org.apache.kerberos.kerb.crypto.enc.provider,3,1,0,0,0,0,0,4
drankye_haox,org.apache.kerberos.kerb.crypto.key,2,1,0,0,0,2,0,5
drankye_haox,org.apache.kerberos.kerb.identity,0,0,0,0,1,1,0,2
drankye_haox,org.apache.kerberos.kerb.identity.backend,0,0,0,0,0,0,0,0
drankye_haox,org.apache.kerberos.kerb.server,4,1,0,0,0,0,0,5
drankye_haox,org.apache.kerberos.kerb.server.preauth,3,1,0,0,1,0,0,5
drankye_haox,org.apache.kerberos.kerb.server.preauth.builtin,0,0,0,0,0,0,0,0
drankye_haox,org.apache.kerberos.kerb.server.preauth.pkinit,0,0,0,0,0,0,0,0
drankye_haox,org.apache.kerberos.kerb.server.preauth.token,0,0,0,0,0,0,0,0
drankye_haox,org.apache.kerberos.kerb.server.replay,0,0,0,0,0,0,0,0
drankye_haox,org.apache.kerberos.kerb.server.request,3,0,0,0,0,2,0,5
drankye_haox,org.apache.kerberos.kerb.ccache,0,0,0,0,0,2,0,2
drankye_haox,org.apache.kerberos.kerb.keytab,0,0,0,0,0,0,0,0
drankye_haox,org.apache.kerberos.kerb.util,0,0,0,0,0,0,0,0
dropwizard_dropwizard-java8,io.dropwizard.java8,0,0,0,0,0,0,0,0
dropwizard_dropwizard-java8,io.dropwizard.java8.jersey,0,0,0,0,0,0,0,0
dropwizard_dropwizard-java8,io.dropwizard.java8.jersey.params,0,0,0,0,1,0,0,1
dropwizard_dropwizard-java8,io.dropwizard.java8.validation.valuehandling,0,0,0,0,0,0,0,0
dropwizard_dropwizard-java8,io.dropwizard.java8.auth,0,0,0,0,1,0,0,1
dropwizard_dropwizard-java8,io.dropwizard.java8.auth.basic,0,0,0,0,1,0,0,1
dropwizard_dropwizard-java8,io.dropwizard.java8.auth.chained,0,0,0,0,0,0,0,0
dropwizard_dropwizard-java8,io.dropwizard.java8.auth.oauth,0,0,0,0,0,0,0,0
dropwizard_dropwizard-java8,io.dropwizard.java8.auth.principal,0,0,0,0,0,0,0,0
dropwizard_dropwizard-java8,io.dropwizard.java8.auth.util,0,0,0,0,0,0,0,0
dropwizard_dropwizard-java8,com.example.helloworld.api,0,0,0,0,0,0,0,0
dropwizard_dropwizard-java8,com.example.helloworld.auth,0,0,0,0,0,0,0,0
dropwizard_dropwizard-java8,com.example.helloworld.cli,0,0,0,0,0,0,0,0
dropwizard_dropwizard-java8,com.example.helloworld.core,0,0,0,0,0,0,0,0
dropwizard_dropwizard-java8,com.example.helloworld.db,0,0,0,0,0,0,0,0
dropwizard_dropwizard-java8,com.example.helloworld.filter,0,0,0,0,0,0,0,0
dropwizard_dropwizard-java8,com.example.helloworld.health,0,0,0,0,0,0,0,0
dropwizard_dropwizard-java8,com.example.helloworld,0,0,0,0,0,0,0,0
dropwizard_dropwizard-java8,com.example.helloworld.resources,0,0,0,0,1,0,0,1
dropwizard_dropwizard-java8,com.example.helloworld.views,0,0,0,0,0,0,0,0
dropwizard_dropwizard-java8,io.dropwizard.java8.jdbi.args,0,0,0,0,1,0,0,1
dropwizard_dropwizard-java8,io.dropwizard.java8.jdbi,0,0,0,0,0,0,0,0
dropwizard_dropwizard-protobuf,(default package),0,0,0,0,0,0,0,0
dropwizard_dropwizard-protobuf,io.dropwizard.jersey.protobuf,0,0,0,0,1,0,0,1
dropwizard_dropwizard-protobuf,io.dropwizard.jersey.protobuf.protos,0,0,0,0,0,0,0,0
dropwizard_metrics,com.codahale.metrics.benchmarks,0,0,0,0,0,0,0,0
dropwizard_metrics,com.codahale.metrics.benchmarks.generated,0,0,0,0,0,0,0,0
dropwizard_metrics,com.codahale.metrics.collectd,0,0,0,0,1,0,0,1
dropwizard_metrics,com.codahale.metrics,0,0,0,1,0,0,0,1
dropwizard_metrics,com.codahale.metrics.ehcache,0,0,0,0,0,0,0,0
dropwizard_metrics,com.codahale.metrics.graphite,0,0,0,0,1,0,0,1
dropwizard_metrics,com.codahale.metrics.health,0,0,0,0,0,1,0,1
dropwizard_metrics,com.codahale.metrics.health.jvm,0,0,0,0,0,1,0,1
dropwizard_metrics,com.codahale.metrics.httpasyncclient,0,0,0,0,1,0,0,1
dropwizard_metrics,com.codahale.metrics.httpclient,0,0,0,0,1,0,0,1
dropwizard_metrics,com.codahale.metrics.jcache,0,0,0,0,0,0,0,0
dropwizard_metrics,(default package),0,0,0,0,0,0,0,0
dropwizard_metrics,org.openjdk.jcstress.infra.results,0,0,0,0,0,0,0,0
dropwizard_metrics,com.codahale.metrics.jdbi,0,0,0,0,0,0,0,0
dropwizard_metrics,com.codahale.metrics.jdbi.strategies,0,0,0,0,1,0,0,1
dropwizard_metrics,com.codahale.metrics.jdbi3,0,0,0,0,0,0,0,0
dropwizard_metrics,com.codahale.metrics.jdbi3.strategies,0,0,0,0,1,0,0,1
dropwizard_metrics,com.codahale.metrics.jersey2,1,0,0,0,0,0,0,1
dropwizard_metrics,com.codahale.metrics.jersey2.exception.mapper,0,0,0,0,0,0,0,0
dropwizard_metrics,com.codahale.metrics.jersey2.exception,0,0,0,0,0,0,0,0
dropwizard_metrics,com.codahale.metrics.jersey2.resources,1,1,0,0,1,0,0,3
dropwizard_metrics,com.codahale.metrics.jetty9,0,0,0,0,1,0,0,1
dropwizard_metrics,com.codahale.metrics.jmx,0,0,0,0,0,0,0,0
dropwizard_metrics,com.codahale.metrics.json,0,0,0,0,1,0,0,1
dropwizard_metrics,com.codahale.metrics.jvm,0,0,0,0,1,1,0,2
dropwizard_metrics,com.codahale.metrics.log4j2,0,0,0,0,0,0,0,0
dropwizard_metrics,com.codahale.metrics.logback,0,0,0,0,0,0,0,0
dropwizard_metrics,com.codahale.metrics.servlet,0,0,0,0,1,0,0,1
dropwizard_metrics,com.codahale.metrics.servlets,0,0,0,0,1,0,0,1
dropwizard_metrics,com.codahale.metrics.servlets.experiments,0,0,0,0,0,0,0,0
druid-io_druid,org.apache.druid.benchmark,0,0,0,1,1,1,1,4
druid-io_druid,org.apache.druid.benchmark.datagen,0,0,0,0,1,0,1,2
druid-io_druid,org.apache.druid.benchmark.indexing,0,0,0,0,0,0,1,1
druid-io_druid,org.apache.druid.benchmark.query,0,0,0,0,1,0,1,2
druid-io_druid,org.apache.druid.benchmark.query.timecompare,0,0,0,0,0,0,1,1
druid-io_druid,org.apache.druid.benchmark.sequences,0,0,0,0,0,0,1,1
druid-io_druid,org.apache.druid.server.coordinator,8,1,0,1,1,0,1,12
druid-io_druid,org.apache.druid.timeline,5,1,0,0,1,2,1,10
druid-io_druid,org.apache.druid.common.aws,0,1,0,0,0,0,1,2
druid-io_druid,org.apache.druid.common.gcp,0,0,0,0,0,0,1,1
druid-io_druid,org.apache.druid.annotations,0,0,0,0,0,0,1,1
druid-io_druid,org.apache.druid.audit,0,0,0,0,0,0,1,1
druid-io_druid,org.apache.druid.cli,0,0,0,1,0,0,1,2
druid-io_druid,org.apache.druid.collections,1,1,0,1,1,1,1,6
druid-io_druid,org.apache.druid.common.config,0,1,0,0,1,5,1,8
druid-io_druid,org.apache.druid.common.guava,2,0,0,0,1,0,1,4
druid-io_druid,org.apache.druid.common.utils,0,0,0,0,1,0,1,2
druid-io_druid,org.apache.druid.concurrent,0,0,0,0,1,0,1,2
druid-io_druid,org.apache.druid.data.input,11,1,0,1,1,3,1,18
druid-io_druid,org.apache.druid.data.input.impl,17,1,0,1,1,2,1,23
druid-io_druid,org.apache.druid.data.input.impl.prefetch,0,0,0,0,1,0,1,2
druid-io_druid,org.apache.druid.data,0,0,0,0,0,0,1,1
druid-io_druid,org.apache.druid.guice,86,1,0,1,1,0,1,90
druid-io_druid,org.apache.druid.indexer,18,1,0,1,1,0,1,22
druid-io_druid,org.apache.druid.indexer.partitions,1,1,0,0,0,0,1,3
druid-io_druid,org.apache.druid.initialization,12,1,0,0,1,0,1,15
druid-io_druid,org.apache.druid.io,0,0,0,0,0,0,1,1
druid-io_druid,org.apache.druid.jackson,5,1,0,0,1,0,1,8
druid-io_druid,org.apache.druid.java.util.common,7,1,0,1,1,1,1,12
druid-io_druid,org.apache.druid.java.util.common.collect,0,0,0,0,0,0,1,1
druid-io_druid,org.apache.druid.java.util.common.concurrent,2,1,0,0,1,1,1,6
druid-io_druid,org.apache.druid.java.util.common.config,0,0,0,0,0,0,1,1
druid-io_druid,org.apache.druid.java.util.common.granularity,1,0,0,0,1,0,1,3
druid-io_druid,org.apache.druid.java.util.common.guava,6,1,0,1,1,6,1,16
druid-io_druid,org.apache.druid.java.util.common.guava.nary,0,0,0,0,0,0,1,1
druid-io_druid,org.apache.druid.java.util.common.io,0,0,0,0,0,1,1,2
druid-io_druid,org.apache.druid.java.util.common.io.smoosh,0,0,0,0,0,0,1,1
druid-io_druid,org.apache.druid.java.util.common.jackson,0,0,0,0,0,0,1,1
druid-io_druid,org.apache.druid.java.util.common.lifecycle,1,0,0,0,0,1,1,3
druid-io_druid,org.apache.druid.java.util.common.logger,0,0,0,0,0,0,1,1
druid-io_druid,org.apache.druid.java.util.common.parsers,3,1,0,0,1,0,1,6
druid-io_druid,org.apache.druid.java.util.emitter.core,0,0,0,1,1,1,1,4
druid-io_druid,org.apache.druid.java.util.emitter,0,0,0,0,0,0,1,1
druid-io_druid,org.apache.druid.java.util.emitter.factory,0,0,0,0,0,0,1,1
druid-io_druid,org.apache.druid.java.util.emitter.service,0,0,0,0,1,3,1,5
druid-io_druid,org.apache.druid.java.util.http.client,0,0,0,0,1,0,1,2
druid-io_druid,org.apache.druid.java.util.http.client.auth,0,0,0,0,0,0,1,1
druid-io_druid,org.apache.druid.java.util.http.client.io,0,0,0,0,0,0,1,1
druid-io_druid,org.apache.druid.java.util.http.client.netty,0,0,0,0,0,0,1,1
druid-io_druid,org.apache.druid.java.util.http.client.pool,0,0,0,0,1,0,1,2
druid-io_druid,org.apache.druid.java.util.http.client.response,0,0,0,0,1,0,1,2
druid-io_druid,org.apache.druid.java.util.metrics,1,1,0,1,1,2,1,7
druid-io_druid,org.apache.druid.java.util.metrics.cgroups,1,1,0,0,0,0,1,3
druid-io_druid,org.apache.druid.js,0,0,0,0,0,0,1,1
druid-io_druid,org.apache.druid.math.expr,0,1,0,1,0,3,1,6
druid-io_druid,org.apache.druid.metadata,12,1,0,1,1,0,1,16
druid-io_druid,org.apache.druid.query,32,1,0,1,1,4,1,40
druid-io_druid,org.apache.druid.segment.loading,12,1,0,1,1,1,1,17
druid-io_druid,org.apache.druid.segment,48,1,0,1,1,14,1,66
druid-io_druid,org.apache.druid.tasklogs,0,0,0,0,0,0,1,1
druid-io_druid,org.apache.druid.timeline.partition,9,1,0,1,1,0,1,13
druid-io_druid,org.apache.druid.utils,3,0,0,0,1,0,1,5
druid-io_druid,org.apache.druid,0,0,0,0,0,0,1,1
druid-io_druid,org.apache.druid.math.expr.antlr,0,0,0,0,0,0,1,1
druid-io_druid,org.apache.druid.extendedset.intset,0,0,0,0,0,0,1,1
druid-io_druid,org.apache.druid.extendedset.utilities,0,0,0,0,0,0,1,1
druid-io_druid,org.apache.druid.emitter.ambari.metrics,0,0,0,0,1,0,1,2
druid-io_druid,org.apache.druid.firehose.azure,0,0,0,0,0,0,1,1
druid-io_druid,org.apache.druid.storage.azure,0,0,0,0,0,0,1,1
druid-io_druid,org.apache.druid.storage.cassandra,0,0,0,0,0,0,1,1
druid-io_druid,org.apache.druid.firehose.cloudfiles,0,0,0,0,0,0,1,1
druid-io_druid,org.apache.druid.storage.cloudfiles,0,0,0,0,1,0,1,2
druid-io_druid,org.apache.druid.query.aggregation.distinctcount,0,0,0,0,1,1,1,3
druid-io_druid,org.apache.druid.emitter.dropwizard,0,0,0,0,1,0,1,2
druid-io_druid,org.apache.druid.emitter.dropwizard.reporters,0,0,0,0,0,0,1,1
druid-io_druid,org.apache.druid.emitter.graphite,0,0,0,0,0,0,1,1
druid-io_druid,org.apache.druid.data.input.influx,0,0,0,0,0,0,1,1
druid-io_druid,org.apache.druid.emitter.influxdb,0,0,0,0,0,0,1,1
druid-io_druid,org.apache.druid.emitter.kafka,0,0,0,0,0,0,1,1
druid-io_druid,org.apache.druid.indexing.materializedview,0,0,0,0,1,0,1,2
druid-io_druid,org.apache.druid.query.materializedview,0,0,0,0,1,0,1,2
druid-io_druid,org.apache.druid.query.aggregation.momentsketch.aggregator,1,0,0,0,1,0,1,3
druid-io_druid,org.apache.druid.query.aggregation.momentsketch,1,1,0,0,1,0,1,4
druid-io_druid,org.apache.druid.query.movingaverage,0,0,0,0,1,0,1,2
druid-io_druid,org.apache.druid.query.movingaverage.averagers,0,0,0,1,0,0,1,2
druid-io_druid,org.apache.druid.emitter.opentsdb,0,0,0,0,0,0,1,1
druid-io_druid,org.apache.druid.client.cache,6,1,0,1,0,0,1,9
druid-io_druid,org.apache.druid.metadata.storage.sqlserver,0,0,0,0,0,0,1,1
druid-io_druid,org.apache.druid.emitter.statsd,0,0,0,0,1,0,1,2
druid-io_druid,org.apache.druid.query.aggregation.tdigestsketch.sql,1,0,0,0,0,0,1,2
druid-io_druid,org.apache.druid.query.aggregation.tdigestsketch,1,1,0,0,0,0,1,3
druid-io_druid,org.apache.druid.data.input.thrift,0,0,0,0,0,0,1,1
druid-io_druid,org.apache.druid.query.aggregation,27,1,0,1,1,9,1,40
druid-io_druid,org.apache.druid.data.input.avro,3,0,0,0,1,0,1,5
druid-io_druid,org.apache.druid.data.input.schemarepo,0,0,0,0,0,0,1,1
druid-io_druid,org.apache.druid.query.aggregation.datasketches.hll,1,1,0,0,1,1,1,5
druid-io_druid,org.apache.druid.query.aggregation.datasketches.hll.sql,1,0,0,0,1,0,1,3
druid-io_druid,org.apache.druid.query.aggregation.datasketches,0,0,0,0,0,0,1,1
druid-io_druid,org.apache.druid.query.aggregation.datasketches.quantiles,1,1,0,0,1,0,1,4
druid-io_druid,org.apache.druid.query.aggregation.datasketches.quantiles.sql,1,0,0,0,1,0,1,3
druid-io_druid,org.apache.druid.query.aggregation.datasketches.theta.oldapi,0,0,0,0,1,0,1,2
druid-io_druid,org.apache.druid.query.aggregation.datasketches.theta,1,1,0,0,0,0,1,3
druid-io_druid,org.apache.druid.query.aggregation.datasketches.theta.sql,1,0,0,0,1,0,1,3
druid-io_druid,org.apache.druid.query.aggregation.datasketches.tuple,0,0,0,1,1,0,1,3
druid-io_druid,org.apache.druid.security.basic.authentication,6,1,0,0,0,0,1,8
druid-io_druid,org.apache.druid.security.basic.authentication.db.cache,7,0,0,0,1,0,1,9
druid-io_druid,org.apache.druid.security.basic.authentication.db.updater,4,1,0,0,0,0,1,6
druid-io_druid,org.apache.druid.security.basic.authentication.endpoint,4,0,0,0,0,0,1,5
druid-io_druid,org.apache.druid.security.basic.authentication.entity,6,1,0,0,0,0,1,8
druid-io_druid,org.apache.druid.security.basic.authentication.validator,3,0,0,0,0,0,1,4
druid-io_druid,org.apache.druid.security.basic.authorization,3,1,0,0,0,0,1,5
druid-io_druid,org.apache.druid.security.basic.authorization.db.cache,5,0,0,0,1,0,1,7
druid-io_druid,org.apache.druid.security.basic.authorization.db.updater,3,1,0,0,0,0,1,5
druid-io_druid,org.apache.druid.security.basic.authorization.endpoint,4,0,0,0,0,0,1,5
druid-io_druid,org.apache.druid.security.basic.authorization.entity,0,0,0,0,1,0,1,2
druid-io_druid,org.apache.druid.security.basic,23,1,0,0,1,0,1,26
druid-io_druid,org.apache.druid.security.authentication,0,0,0,0,0,0,1,1
druid-io_druid,org.apache.druid.security.authentication.validator,0,0,0,0,0,0,1,1
druid-io_druid,org.apache.druid.security.authorization,0,0,0,0,0,0,1,1
druid-io_druid,org.apache.druid.security,0,0,0,0,0,0,1,1
druid-io_druid,org.apache.druid.query.aggregation.bloom,0,0,0,0,1,0,1,2
druid-io_druid,org.apache.druid.query.aggregation.bloom.sql,5,0,0,0,0,0,1,6
druid-io_druid,org.apache.druid.query.expressions,5,0,0,0,0,0,1,6
druid-io_druid,org.apache.druid.query.filter,27,1,0,1,0,5,1,35
druid-io_druid,org.apache.druid.query.filter.sql,8,0,0,0,0,0,1,9
druid-io_druid,org.apache.druid.security.kerberos,0,0,0,0,1,0,1,2
druid-io_druid,org.apache.druid.indexing.overlord.autoscaling.ec2,2,0,0,0,1,0,1,4
druid-io_druid,org.apache.druid.indexing.overlord.setup,4,1,0,0,0,0,1,6
druid-io_druid,org.apache.druid.data.input.google,0,0,0,0,0,0,1,1
druid-io_druid,org.apache.druid.firehose.google,0,0,0,0,0,0,1,1
druid-io_druid,org.apache.druid.storage.google,0,0,0,0,0,0,1,1
druid-io_druid,org.apache.druid.firehose.hdfs,0,0,0,0,0,0,1,1
druid-io_druid,org.apache.druid.inputsource.hdfs,0,1,0,0,1,0,1,3
druid-io_druid,org.apache.druid.storage.hdfs,4,0,0,0,1,0,1,6
druid-io_druid,org.apache.druid.storage.hdfs.tasklog,0,0,0,0,0,0,1,1
druid-io_druid,org.apache.hadoop.fs,0,0,0,0,0,0,1,1
druid-io_druid,org.apache.druid.indexing.common.tasklogs,0,0,0,0,1,0,1,2
druid-io_druid,org.apache.druid.query.aggregation.histogram,1,1,0,1,0,3,1,7
druid-io_druid,org.apache.druid.query.aggregation.histogram.sql,1,0,0,0,1,0,1,3
druid-io_druid,org.apache.druid.query.lookup,10,0,0,1,1,0,1,13
druid-io_druid,org.apache.druid.indexing.kafka,1,0,0,0,1,0,1,3
druid-io_druid,org.apache.druid.indexing.kafka.supervisor,1,1,0,0,1,0,1,4
druid-io_druid,org.apache.druid.indexing.kinesis,1,0,0,0,1,0,1,3
druid-io_druid,org.apache.druid.indexing.kinesis.supervisor,1,1,0,0,1,0,1,4
druid-io_druid,org.apache.druid.query.lookup.namespace,3,1,0,0,1,0,1,6
druid-io_druid,org.apache.druid.server.lookup.namespace.cache,6,1,0,0,1,0,1,9
druid-io_druid,org.apache.druid.server.lookup.namespace,4,1,0,0,1,0,1,7
druid-io_druid,org.apache.druid.server.lookup.cache.loading,0,0,0,0,0,0,1,1
druid-io_druid,org.apache.druid.server.lookup.cache.polling,0,0,0,0,0,0,1,1
druid-io_druid,org.apache.druid.server.lookup,0,0,0,0,1,0,1,2
druid-io_druid,org.apache.druid.server.lookup.jdbc,0,0,0,0,1,0,1,2
druid-io_druid,org.apache.druid.firehose.sql,0,0,0,0,0,0,1,1
druid-io_druid,org.apache.druid.metadata.storage.mysql,0,0,0,0,0,0,1,1
druid-io_druid,org.apache.druid.data.input.orc,0,0,0,0,1,0,1,2
druid-io_druid,org.apache.druid.data.input.parquet.avro,0,0,0,0,0,0,1,1
druid-io_druid,org.apache.druid.data.input.parquet,0,0,0,0,1,0,1,2
druid-io_druid,org.apache.druid.data.input.parquet.simple,0,0,0,0,1,0,1,2
druid-io_druid,org.apache.parquet.avro,0,0,0,0,0,0,1,1
druid-io_druid,org.apache.druid.firehose,0,0,0,0,0,0,1,1
druid-io_druid,org.apache.druid.metadata.storage.postgresql,0,0,0,0,0,0,1,1
druid-io_druid,org.apache.druid.data.input.protobuf,0,0,0,0,1,0,1,2
druid-io_druid,org.apache.druid.data.input.s3,0,0,0,0,1,0,1,2
druid-io_druid,org.apache.druid.firehose.s3,0,0,0,0,0,0,1,1
druid-io_druid,org.apache.druid.storage.s3,0,0,0,1,0,1,1,3
druid-io_druid,org.apache.druid.https,0,0,0,0,0,0,1,1
druid-io_druid,org.apache.druid.query.aggregation.stats,0,0,0,0,0,0,1,1
druid-io_druid,org.apache.druid.query.aggregation.variance,0,0,0,0,0,1,1,2
druid-io_druid,org.apache.druid.query.aggregation.variance.sql,0,0,0,0,1,0,1,2
druid-io_druid,org.apache.druid.hll,0,0,0,0,0,1,1,2
druid-io_druid,org.apache.druid.indexer.hadoop,5,1,0,0,1,0,1,8
druid-io_druid,org.apache.druid.indexer.path,5,0,0,0,0,0,1,6
druid-io_druid,org.apache.druid.indexer.updater,0,0,0,0,0,0,1,1
druid-io_druid,org.apache.druid.indexing.appenderator,3,0,0,0,0,0,1,4
druid-io_druid,org.apache.druid.indexing.common.actions,13,1,0,1,0,0,1,16
druid-io_druid,org.apache.druid.indexing.common.config,0,0,0,0,0,0,1,1
druid-io_druid,org.apache.druid.indexing.common,15,1,0,1,1,0,1,19
druid-io_druid,org.apache.druid.indexing.common.index,0,0,0,0,0,0,1,1
druid-io_druid,org.apache.druid.indexing.common.stats,0,1,0,0,0,0,1,2
druid-io_druid,org.apache.druid.indexing.common.task,21,1,0,1,1,0,1,25
druid-io_druid,org.apache.druid.indexing.common.task.batch.parallel,4,0,0,1,1,0,1,7
druid-io_druid,org.apache.druid.indexing.common.task.batch.parallel.distribution,0,0,0,0,1,0,1,2
druid-io_druid,org.apache.druid.indexing.common.task.batch.parallel.iterator,0,0,0,0,1,0,1,2
druid-io_druid,org.apache.druid.indexing.common.task.utils,0,0,0,0,0,0,1,1
druid-io_druid,org.apache.druid.indexing.firehose,0,0,0,0,1,0,1,2
druid-io_druid,org.apache.druid.indexing.hadoop,0,0,0,0,0,0,1,1
druid-io_druid,org.apache.druid.indexing.input,3,0,0,0,0,0,1,4
druid-io_druid,org.apache.druid.indexing.overlord.autoscaling,4,0,0,0,1,0,1,6
druid-io_druid,org.apache.druid.indexing.overlord,37,1,0,1,1,1,1,42
druid-io_druid,org.apache.druid.indexing.overlord.config,3,1,0,0,1,0,1,6
druid-io_druid,org.apache.druid.indexing.overlord.helpers,1,0,0,0,0,0,1,2
druid-io_druid,org.apache.druid.indexing.overlord.hrtr,0,0,0,0,1,0,1,2
druid-io_druid,org.apache.druid.indexing.overlord.http,0,0,0,0,1,0,1,2
druid-io_druid,org.apache.druid.indexing.overlord.http.security,0,0,0,0,0,0,1,1
druid-io_druid,org.apache.druid.indexing.overlord.supervisor,3,1,0,0,1,0,1,6
druid-io_druid,org.apache.druid.indexing,0,0,0,0,0,0,1,1
druid-io_druid,org.apache.druid.indexing.seekablestream.common,0,0,0,0,0,0,1,1
druid-io_druid,org.apache.druid.indexing.seekablestream,10,1,0,0,1,0,1,13
druid-io_druid,org.apache.druid.indexing.seekablestream.supervisor,3,0,0,0,1,0,1,5
druid-io_druid,org.apache.druid.indexing.worker.executor,0,0,0,0,0,0,1,1
druid-io_druid,org.apache.druid.indexing.worker.http,0,1,0,0,0,0,1,2
druid-io_druid,org.apache.druid.indexing.worker,6,1,0,0,1,0,1,9
druid-io_druid,org.apache.druid.server.initialization,13,1,0,0,1,0,1,16
druid-io_druid,org.apache.druid.collections.bitmap,1,0,0,0,1,6,1,9
druid-io_druid,org.apache.druid.collections.spatial,3,1,0,0,0,0,1,5
druid-io_druid,org.apache.druid.collections.spatial.search,1,0,0,0,1,0,1,3
druid-io_druid,org.apache.druid.collections.spatial.split,1,0,0,0,0,0,1,2
druid-io_druid,org.apache.druid.query.aggregation.cardinality,4,1,0,0,1,0,1,7
druid-io_druid,org.apache.druid.query.aggregation.cardinality.types,1,0,0,0,1,0,1,3
druid-io_druid,org.apache.druid.query.aggregation.first,4,0,0,0,1,1,1,7
druid-io_druid,org.apache.druid.query.aggregation.hyperloglog,8,0,0,0,1,2,1,12
druid-io_druid,org.apache.druid.query.aggregation.last,0,0,0,0,1,1,1,3
druid-io_druid,org.apache.druid.query.aggregation.mean,2,0,0,0,1,0,1,4
druid-io_druid,org.apache.druid.query.aggregation.post,5,1,0,0,0,1,1,8
druid-io_druid,org.apache.druid.query.cache,0,0,0,0,0,0,1,1
druid-io_druid,org.apache.druid.query.context,0,0,0,0,1,1,1,3
druid-io_druid,org.apache.druid.query.datasourcemetadata,0,0,0,0,1,0,1,2
druid-io_druid,org.apache.druid.query.dimension,3,1,0,0,1,1,1,7
druid-io_druid,org.apache.druid.query.expression,6,1,0,1,1,2,1,12
druid-io_druid,org.apache.druid.query.extraction,4,1,0,1,0,0,1,7
druid-io_druid,org.apache.druid.query.filter.vector,7,1,0,0,0,0,1,9
druid-io_druid,org.apache.druid.query.groupby,15,1,0,1,1,3,1,22
druid-io_druid,org.apache.druid.query.groupby.epinephelinae,5,1,0,1,1,0,1,9
druid-io_druid,org.apache.druid.query.groupby.epinephelinae.column,1,1,0,0,1,0,1,4
druid-io_druid,org.apache.druid.query.groupby.epinephelinae.vector,1,0,0,0,1,0,1,3
druid-io_druid,org.apache.druid.query.groupby.having,0,0,0,0,0,0,1,1
druid-io_druid,org.apache.druid.query.groupby.orderby,2,1,0,0,1,0,1,5
druid-io_druid,org.apache.druid.query.groupby.resource,0,0,0,0,0,0,1,1
druid-io_druid,org.apache.druid.query.groupby.strategy,5,1,0,0,0,0,1,7
druid-io_druid,org.apache.druid.query.metadata.metadata,2,0,0,0,1,1,1,5
druid-io_druid,org.apache.druid.query.metadata,4,0,0,0,1,1,1,7
druid-io_druid,org.apache.druid.query.monomorphicprocessing,0,0,0,0,1,2,1,4
druid-io_druid,org.apache.druid.query.ordering,0,1,0,0,0,0,1,2
druid-io_druid,org.apache.druid.query.scan,5,0,0,0,1,0,1,7
druid-io_druid,org.apache.druid.query.search,3,0,0,1,1,0,1,6
druid-io_druid,org.apache.druid.query.select,0,0,0,0,0,0,1,1
druid-io_druid,org.apache.druid.query.spec,1,0,0,0,1,0,1,3
druid-io_druid,org.apache.druid.query.timeboundary,3,0,0,0,1,0,1,5
druid-io_druid,org.apache.druid.query.timeseries,2,0,0,0,1,0,1,4
druid-io_druid,org.apache.druid.query.topn,6,0,0,1,1,7,1,16
druid-io_druid,org.apache.druid.query.topn.types,2,1,0,0,0,4,1,8
druid-io_druid,org.apache.druid.query.vector,0,0,0,0,0,0,1,1
druid-io_druid,org.apache.druid.segment.column,13,1,0,0,1,2,1,18
druid-io_druid,org.apache.druid.segment.data,5,1,0,1,0,13,1,21
druid-io_druid,org.apache.druid.segment.filter,6,1,0,1,1,3,1,13
druid-io_druid,org.apache.druid.segment.historical,0,0,0,0,0,1,1,2
druid-io_druid,org.apache.druid.segment.incremental,4,1,0,1,1,0,1,8
druid-io_druid,org.apache.druid.segment.selector.settable,0,0,0,0,1,1,1,3
druid-io_druid,org.apache.druid.segment.serde,7,1,0,1,1,3,1,14
druid-io_druid,org.apache.druid.segment.transform,4,1,0,0,1,1,1,8
druid-io_druid,org.apache.druid.segment.vector,11,0,0,0,1,1,1,14
druid-io_druid,org.apache.druid.segment.virtual,10,0,0,0,1,1,1,13
druid-io_druid,org.apache.druid.segment.writeout,2,1,0,0,0,0,1,4
druid-io_druid,org.apache.druid.granularity,0,0,0,0,0,0,1,1
druid-io_druid,org.apache.druid.client,15,1,0,1,1,0,1,19
druid-io_druid,org.apache.druid.client.coordinator,0,0,0,0,0,0,1,1
druid-io_druid,org.apache.druid.client.indexing,2,1,0,0,1,0,1,5
druid-io_druid,org.apache.druid.client.selector,2,0,0,0,1,0,1,4
druid-io_druid,org.apache.druid.curator.announcement,0,0,0,0,0,0,1,1
druid-io_druid,org.apache.druid.curator.cache,0,0,0,0,0,0,1,1
druid-io_druid,org.apache.druid.curator,3,1,0,0,1,0,1,6
druid-io_druid,org.apache.druid.curator.discovery,2,0,0,0,1,0,1,4
druid-io_druid,org.apache.druid.curator.inventory,0,0,0,0,1,0,1,2
druid-io_druid,org.apache.druid.discovery,7,1,0,0,0,0,1,9
druid-io_druid,org.apache.druid.guice.http,5,1,0,0,1,0,1,8
druid-io_druid,org.apache.druid.guice.security,0,0,0,0,0,0,1,1
druid-io_druid,org.apache.druid.indexing.worker.config,0,0,0,0,0,0,1,1
druid-io_druid,org.apache.druid.metadata.storage.derby,0,0,0,0,0,0,1,1
druid-io_druid,org.apache.druid.offheap,0,0,0,0,0,0,1,1
druid-io_druid,org.apache.druid.segment.indexing,9,1,0,0,1,0,1,12
druid-io_druid,org.apache.druid.segment.indexing.granularity,0,0,0,0,0,0,1,1
druid-io_druid,org.apache.druid.segment.realtime.appenderator,10,1,0,1,1,0,1,14
druid-io_druid,org.apache.druid.segment.realtime,3,0,0,0,1,0,1,5
druid-io_druid,org.apache.druid.segment.realtime.firehose,5,1,0,1,1,0,1,9
druid-io_druid,org.apache.druid.segment.realtime.plumber,7,0,0,1,1,0,1,10
druid-io_druid,org.apache.druid.server,36,1,0,1,1,0,1,40
druid-io_druid,org.apache.druid.server.audit,3,0,0,0,0,0,1,4
druid-io_druid,org.apache.druid.server.coordination,3,1,0,1,1,0,1,7
druid-io_druid,org.apache.druid.server.coordinator.cost,1,0,0,0,1,0,1,3
druid-io_druid,org.apache.druid.server.coordinator.helper,3,1,0,0,1,0,1,6
druid-io_druid,org.apache.druid.server.coordinator.rules,1,0,0,0,1,0,1,3
druid-io_druid,org.apache.druid.server.emitter,2,0,0,0,1,0,1,4
druid-io_druid,org.apache.druid.server.http,9,1,0,1,1,0,1,13
druid-io_druid,org.apache.druid.server.http.security,0,0,0,0,1,0,1,2
druid-io_druid,org.apache.druid.server.initialization.jetty,9,1,0,0,1,0,1,12
druid-io_druid,org.apache.druid.server.listener.announcer,0,0,0,0,0,0,1,1
druid-io_druid,org.apache.druid.server.listener.resource,0,0,0,0,1,0,1,2
druid-io_druid,org.apache.druid.server.log,3,0,0,0,1,0,1,5
druid-io_druid,org.apache.druid.server.lookup.cache,8,1,0,0,1,0,1,11
druid-io_druid,org.apache.druid.server.metrics,7,1,0,0,1,1,1,11
druid-io_druid,org.apache.druid.server.router,6,1,0,0,1,0,1,9
druid-io_druid,org.apache.druid.server.security,7,1,0,1,0,0,1,10
druid-io_druid,org.apache.druid.client.client,0,0,0,0,0,0,1,1
druid-io_druid,org.apache.druid.server.coordination.coordination,0,0,0,0,0,0,1,1
druid-io_druid,org.apache.druid.server.shard,0,0,0,0,0,0,1,1
druid-io_druid,org.apache.druid.cli.convert,0,0,0,0,0,0,1,1
druid-io_druid,org.apache.druid.cli.validate,0,0,0,0,0,0,1,1
druid-io_druid,org.apache.druid.sql.avatica,4,0,0,0,1,0,1,6
druid-io_druid,org.apache.druid.sql.calcite.aggregation,4,1,0,0,0,0,1,6
druid-io_druid,org.apache.druid.sql.calcite.aggregation.builtin,6,0,0,0,1,0,1,8
druid-io_druid,org.apache.druid.sql.calcite.expression,17,1,0,0,1,0,1,20
druid-io_druid,org.apache.druid.sql.calcite.expression.builtin,3,0,0,1,1,0,1,6
druid-io_druid,org.apache.druid.sql.calcite.filtration,4,0,0,0,0,0,1,5
druid-io_druid,org.apache.druid.sql.calcite.planner,23,1,0,0,1,0,1,26
druid-io_druid,org.apache.druid.sql.calcite.rel,7,1,0,0,0,0,1,9
druid-io_druid,org.apache.druid.sql.calcite.rule,4,0,0,0,1,0,1,6
druid-io_druid,org.apache.druid.sql.calcite.schema,7,0,0,0,1,0,1,9
druid-io_druid,org.apache.druid.sql.calcite.table,11,1,0,0,0,0,1,13
druid-io_druid,org.apache.druid.sql.calcite.view,1,1,0,0,0,0,1,3
druid-io_druid,org.apache.druid.sql.guice,11,1,0,0,0,0,1,13
druid-io_druid,org.apache.druid.sql.http,1,1,0,0,1,0,1,4
druid-io_druid,org.apache.druid.sql,2,0,0,0,0,0,1,3
druid-io_druid,org.apache.druid.sql.calcite,2,0,0,0,0,0,1,3
druid-io_druid,org.apache.druid.sql.calcite.http,0,0,0,0,0,0,1,1
druid-io_druid,org.apache.druid.sql.calcite.util,7,1,0,0,0,0,1,9
dschulten_hydra-java,de.escalon.hypermedia,0,0,0,0,0,0,0,0
dschulten_hydra-java,de.escalon.hypermedia.hydra.serialize,0,0,0,0,1,0,0,1
dschulten_hydra-java,de.escalon.hypermedia.hydra.beans.withterms,0,0,0,0,0,0,0,0
dschulten_hydra-java,de.escalon.hypermedia.hydra.beans.withvocab,0,0,0,0,0,0,0,0
dschulten_hydra-java,de.escalon.hypermedia.hydra,0,0,0,0,0,0,0,0
dschulten_hydra-java,de.escalon.hypermedia.spring.hydra,0,0,0,0,1,0,0,1
dschulten_hydra-java,de.escalon.hypermedia.spring,0,0,0,0,1,0,0,1
dschulten_hydra-java,de.escalon.hypermedia.action,0,0,0,0,1,0,0,1
dschulten_hydra-java,de.escalon.hypermedia.affordance,0,0,0,0,1,0,0,1
dschulten_hydra-java,de.escalon.hypermedia.spring.siren,0,0,0,1,1,0,0,2
dschulten_hydra-java,de.escalon.hypermedia.spring.uber,0,0,0,0,1,0,0,1
dschulten_hydra-java,de.escalon.hypermedia.spring.xhtml,0,0,0,0,1,0,0,1
dswarm_dswarm,org.dswarm.controller,0,0,0,0,0,0,1,1
dswarm_dswarm,org.dswarm.controller.doc,0,0,0,0,0,0,1,1
dswarm_dswarm,org.dswarm.controller.eventbus,0,0,0,0,1,0,1,2
dswarm_dswarm,org.dswarm.controller.guice,0,0,0,0,0,0,1,1
dswarm_dswarm,org.dswarm.controller.providers,0,0,0,0,1,0,1,2
dswarm_dswarm,org.dswarm.controller.providers.filter,0,0,0,0,0,0,1,1
dswarm_dswarm,org.dswarm.controller.providers.handler,0,0,0,0,0,0,1,1
dswarm_dswarm,org.dswarm.controller.resources,0,0,0,0,1,0,1,2
dswarm_dswarm,org.dswarm.controller.resources.job,0,1,0,0,1,0,1,3
dswarm_dswarm,org.dswarm.controller.resources.resource,0,0,0,0,1,0,1,2
dswarm_dswarm,org.dswarm.controller.resources.resource.utils,0,0,0,0,0,0,1,1
dswarm_dswarm,org.dswarm.controller.resources.schema,0,0,0,0,1,0,1,2
dswarm_dswarm,org.dswarm.controller.resources.status,0,0,0,0,0,0,1,1
dswarm_dswarm,org.dswarm.controller.status,0,0,0,0,0,0,1,1
dswarm_dswarm,org.dswarm.controller.utils,0,1,0,0,0,0,1,2
dswarm_dswarm,org.dswarm.converter,0,1,0,0,1,0,1,3
dswarm_dswarm,org.dswarm.converter.export,0,0,0,0,1,0,1,2
dswarm_dswarm,org.dswarm.converter.flow,0,0,0,0,1,0,1,2
dswarm_dswarm,org.dswarm.converter.flow.model,0,0,0,0,0,0,1,1
dswarm_dswarm,org.dswarm.converter.flow.utils,0,0,0,0,0,0,1,1
dswarm_dswarm,org.dswarm.converter.mf.framework,0,0,0,0,0,0,1,1
dswarm_dswarm,org.dswarm.converter.mf.stream.converter,0,0,0,0,0,0,1,1
dswarm_dswarm,org.dswarm.converter.mf.stream,0,0,0,0,0,0,1,1
dswarm_dswarm,org.dswarm.converter.mf.stream.reader,0,0,0,0,0,0,1,1
dswarm_dswarm,org.dswarm.converter.mf.stream.source,0,0,0,0,1,0,1,2
dswarm_dswarm,org.dswarm.converter.morph,0,0,0,0,0,0,1,1
dswarm_dswarm,org.dswarm.converter.morph.model,0,0,0,0,0,0,1,1
dswarm_dswarm,org.dswarm.converter.pipe,0,0,0,0,0,0,1,1
dswarm_dswarm,org.dswarm.converter.pipe.timing,0,0,0,0,1,0,1,2
dswarm_dswarm,org.dswarm.converter.schema,0,0,0,0,0,1,1,2
dswarm_dswarm,org.dswarm.converter.adapt,0,0,0,0,0,0,1,1
dswarm_dswarm,org.dswarm.init,0,0,0,0,1,0,1,2
dswarm_dswarm,org.dswarm.init.util,0,0,0,0,0,0,1,1
dswarm_dswarm,org.dswarm.persistence.converter,0,0,0,0,0,0,1,1
dswarm_dswarm,org.dswarm.persistence,4,1,0,0,1,0,1,7
dswarm_dswarm,org.dswarm.persistence.dto,0,0,0,0,0,0,1,1
dswarm_dswarm,org.dswarm.persistence.dto.resource,0,0,0,0,0,0,1,1
dswarm_dswarm,org.dswarm.persistence.model,0,0,0,0,0,2,1,3
dswarm_dswarm,org.dswarm.persistence.model.internal.gdm,0,0,0,0,0,0,1,1
dswarm_dswarm,org.dswarm.persistence.model.internal.gdm.helper,0,0,0,0,0,0,1,1
dswarm_dswarm,org.dswarm.persistence.model.internal.helper,0,0,0,0,0,0,1,1
dswarm_dswarm,org.dswarm.persistence.model.internal,0,0,0,0,0,0,1,1
dswarm_dswarm,org.dswarm.persistence.model.job,0,0,0,0,1,0,1,2
dswarm_dswarm,org.dswarm.persistence.model.job.proxy,0,0,0,0,1,0,1,2
dswarm_dswarm,org.dswarm.persistence.model.job.utils,1,0,0,0,1,0,1,3
dswarm_dswarm,org.dswarm.persistence.model.proxy,0,0,0,0,0,0,1,1
dswarm_dswarm,org.dswarm.persistence.model.representation,0,0,0,0,1,1,1,3
dswarm_dswarm,org.dswarm.persistence.model.resource,0,0,0,0,0,0,1,1
dswarm_dswarm,org.dswarm.persistence.model.resource.proxy,0,0,0,0,0,0,1,1
dswarm_dswarm,org.dswarm.persistence.model.resource.utils,0,0,0,0,0,0,1,1
dswarm_dswarm,org.dswarm.persistence.model.schema,0,0,0,0,1,2,1,4
dswarm_dswarm,org.dswarm.persistence.model.schema.proxy,0,0,0,0,1,0,1,2
dswarm_dswarm,org.dswarm.persistence.model.schema.utils,0,1,0,0,1,0,1,3
dswarm_dswarm,org.dswarm.persistence.model.types,0,0,0,0,0,0,1,1
dswarm_dswarm,org.dswarm.persistence.model.utils,0,0,0,0,0,0,1,1
dswarm_dswarm,org.dswarm.persistence.monitoring,1,0,0,0,1,0,1,3
dswarm_dswarm,org.dswarm.persistence.service,4,1,0,0,1,0,1,7
dswarm_dswarm,org.dswarm.persistence.service.internal.graph,0,1,0,0,0,0,1,2
dswarm_dswarm,org.dswarm.persistence.service.internal.graph.util,0,0,0,0,0,0,1,1
dswarm_dswarm,org.dswarm.persistence.service.internal,0,0,0,0,0,0,1,1
dswarm_dswarm,org.dswarm.persistence.service.job,0,0,0,0,1,0,1,2
dswarm_dswarm,org.dswarm.persistence.service.resource,0,0,0,0,0,0,1,1
dswarm_dswarm,org.dswarm.persistence.service.schema,1,0,0,0,1,0,1,3
dswarm_dswarm,org.dswarm.persistence.service.util,0,0,0,0,0,0,1,1
dswarm_dswarm,org.dswarm.persistence.util,0,0,0,0,0,0,1,1
dswarm_dswarm,org.dswarm.persistence.adapt,0,0,0,0,0,0,1,1
ebay_oink,org.pig.oink.bean,0,0,0,0,1,0,0,1
ebay_oink,org.pig.oink.common.config,0,0,0,0,0,2,0,2
ebay_oink,org.pig.oink.common.service,0,0,0,0,0,0,0,0
ebay_oink,org.pig.oink.common.service.impl,0,0,0,0,1,0,0,1
ebay_oink,org.pig.oink.commons,0,0,0,0,0,0,0,0
ebay_oink,org.pig.oink.operation.impl,0,0,0,0,0,3,0,3
ebay_oink,org.pig.oink.operation,0,0,0,0,0,2,0,2
ebay_oink,org.pig.oink.rest,0,0,0,0,0,3,0,3
ebay_oink,org.pig.oink.util,0,0,0,0,0,0,0,0
eclecticlogic_whisper,com.eclecticlogic.whisper.core,0,0,0,0,1,0,0,1
eclecticlogic_whisper,com.eclecticlogic.whisper.logback,0,0,0,0,0,0,0,0
eclecticlogic_whisper,com.eclecticlogic.whisper.spi,0,0,0,0,0,0,0,0
eclipse-jetty_eclipse-jetty-plugin,net.sourceforge.eclipsejetty.jetty,0,1,0,0,1,0,0,2
eclipse-jetty_eclipse-jetty-plugin,net.sourceforge.eclipsejetty.jetty.embedded,0,0,0,0,0,0,0,0
eclipse-jetty_eclipse-jetty-plugin,net.sourceforge.eclipsejetty.jetty6,0,0,0,0,0,0,0,0
eclipse-jetty_eclipse-jetty-plugin,net.sourceforge.eclipsejetty.jetty7,0,0,0,0,0,0,0,0
eclipse-jetty_eclipse-jetty-plugin,net.sourceforge.eclipsejetty.jetty8,0,0,0,0,0,0,0,0
eclipse-jetty_eclipse-jetty-plugin,net.sourceforge.eclipsejetty.jetty9,0,0,0,0,0,0,0,0
eclipse-jetty_eclipse-jetty-plugin,net.sourceforge.eclipsejetty,0,0,0,0,0,0,0,0
eclipse-jetty_eclipse-jetty-plugin,net.sourceforge.eclipsejetty.launch.configuration,0,0,0,0,1,0,0,1
eclipse-jetty_eclipse-jetty-plugin,net.sourceforge.eclipsejetty.launch.shortcut,0,0,0,0,0,0,0,0
eclipse-jetty_eclipse-jetty-plugin,net.sourceforge.eclipsejetty.launch.util,0,0,0,0,1,0,0,1
eclipse-jetty_eclipse-jetty-plugin,net.sourceforge.eclipsejetty.util,0,0,0,0,1,0,0,1
eclipse-jetty_eclipse-jetty-plugin,org.demo,0,0,0,0,0,0,0,0
eclipse-jetty_eclipse-jetty-plugin,demo,0,0,0,0,1,0,0,1
eclipse-jetty_eclipse-jetty-plugin,net.sourceforge.eclipsejetty.starter.common,0,0,0,0,0,0,0,0
eclipse-jetty_eclipse-jetty-plugin,net.sourceforge.eclipsejetty.starter.common.command,0,0,0,0,0,0,0,0
eclipse-jetty_eclipse-jetty-plugin,net.sourceforge.eclipsejetty.starter.console,1,0,0,0,1,1,0,3
eclipse-jetty_eclipse-jetty-plugin,net.sourceforge.eclipsejetty.starter.console.command,0,0,0,0,1,1,0,2
eclipse-jetty_eclipse-jetty-plugin,net.sourceforge.eclipsejetty.starter.console.util,1,1,0,0,1,1,0,4
eclipse-jetty_eclipse-jetty-plugin,net.sourceforge.eclipsejetty.starter.jetty9.command,0,0,0,0,0,0,0,0
eclipse-jetty_eclipse-jetty-plugin,net.sourceforge.eclipsejetty.starter.jetty9,0,0,0,0,0,0,0,0
eclipse-jetty_eclipse-jetty-plugin,net.sourceforge.eclipsejetty.starter.jetty6,0,0,0,0,0,0,0,0
eclipse-jetty_eclipse-jetty-plugin,net.sourceforge.eclipsejetty.starter.jetty7,0,0,0,0,0,0,0,0
eclipse-jetty_eclipse-jetty-plugin,net.sourceforge.eclipsejetty.starter.jetty8.command,0,0,0,0,0,0,0,0
eclipse-jetty_eclipse-jetty-plugin,net.sourceforge.eclipsejetty.starter.jetty8,0,0,0,0,0,0,0,0
eclipse-jetty_eclipse-jetty-plugin,net.sourceforge.eclipsejetty.starter.util.service,0,0,0,0,0,0,0,0
eclipse-jetty_eclipse-jetty-plugin,net.sourceforge.eclipsejetty.starter.util,0,0,0,0,0,0,0,0
eclipsesource_J2V8,com.eclipsesource.v8.debug,0,0,0,0,0,1,0,1
eclipsesource_J2V8,com.eclipsesource.v8.debug.mirror,0,0,0,0,0,1,0,1
eclipsesource_J2V8,com.eclipsesource.v8,1,1,0,1,0,1,0,4
eclipsesource_J2V8,com.eclipsesource.v8.utils,1,0,0,0,0,0,0,1
eclipse_leshan,org.eclipse.leshan.server.bootstrap.demo,0,0,0,0,0,0,1,1
eclipse_leshan,org.eclipse.leshan.server.bootstrap.demo.json,0,0,0,0,0,0,1,1
eclipse_leshan,org.eclipse.leshan.server.bootstrap.demo.servlet,0,0,0,0,0,0,1,1
eclipse_leshan,org.eclipse.leshan.client.californium.bootstrap,0,0,0,0,0,0,1,1
eclipse_leshan,org.eclipse.leshan.client.californium,0,0,0,0,1,0,1,2
eclipse_leshan,org.eclipse.leshan.client.californium.object,0,0,0,0,0,0,1,1
eclipse_leshan,org.eclipse.leshan.client.californium.request,0,0,0,0,0,0,1,1
eclipse_leshan,org.eclipse.leshan.client.bootstrap,0,0,0,0,0,0,1,1
eclipse_leshan,org.eclipse.leshan.client,0,0,0,0,0,0,1,1
eclipse_leshan,org.eclipse.leshan.client.object,0,0,0,0,0,1,1,2
eclipse_leshan,org.eclipse.leshan.client.observer,0,0,0,0,0,0,1,1
eclipse_leshan,org.eclipse.leshan.client.request,0,0,0,0,0,2,1,3
eclipse_leshan,org.eclipse.leshan.client.resource,1,1,0,0,1,6,1,10
eclipse_leshan,org.eclipse.leshan.client.servers,0,0,0,0,0,3,1,4
eclipse_leshan,org.eclipse.leshan.client.util,1,0,0,0,1,2,1,5
eclipse_leshan,org.eclipse.leshan.client.demo,0,0,0,0,0,0,1,1
eclipse_leshan,org.eclipse.leshan.core.attributes,0,0,0,0,0,0,1,1
eclipse_leshan,org.eclipse.leshan.core.credentials,0,0,0,0,0,1,1,2
eclipse_leshan,org.eclipse.leshan.core.model,0,0,0,0,1,7,1,9
eclipse_leshan,org.eclipse.leshan.core.node.codec,3,1,0,0,1,4,1,10
eclipse_leshan,org.eclipse.leshan.core.node.codec.json,1,0,0,0,0,5,1,7
eclipse_leshan,org.eclipse.leshan.core.node.codec.opaque,1,1,0,0,0,1,1,4
eclipse_leshan,org.eclipse.leshan.core.node.codec.text,1,0,0,0,0,1,1,3
eclipse_leshan,org.eclipse.leshan.core.node.codec.tlv,0,0,0,0,0,0,1,1
eclipse_leshan,org.eclipse.leshan.core.node,0,0,0,0,1,12,1,14
eclipse_leshan,org.eclipse.leshan.core.observation,0,0,0,0,0,0,1,1
eclipse_leshan,org.eclipse.leshan.core.request,0,0,0,0,0,8,1,9
eclipse_leshan,org.eclipse.leshan.core.request.exception,0,0,0,0,1,0,1,2
eclipse_leshan,org.eclipse.leshan.core.response,0,0,0,0,0,6,1,7
eclipse_leshan,org.eclipse.leshan.json,0,0,0,0,1,5,1,7
eclipse_leshan,org.eclipse.leshan,0,0,0,0,0,1,1,2
eclipse_leshan,org.eclipse.leshan.tlv,0,0,0,0,0,1,1,2
eclipse_leshan,org.eclipse.leshan.util,0,0,0,0,1,7,1,9
eclipse_leshan,org.eclipse.leshan.util.json,0,0,0,0,0,0,1,1
eclipse_leshan,org.eclipse.leshan.core.californium,0,0,0,0,1,0,1,2
eclipse_leshan,org.eclipse.leshan.server.californium.bootstrap,0,0,0,0,1,0,1,2
eclipse_leshan,org.eclipse.leshan.server.californium,0,0,0,0,1,0,1,2
eclipse_leshan,org.eclipse.leshan.server.californium.observation,0,0,0,0,0,0,1,1
eclipse_leshan,org.eclipse.leshan.server.californium.registration,0,0,0,0,0,1,1,2
eclipse_leshan,org.eclipse.leshan.server.californium.request,0,0,0,0,1,0,1,2
eclipse_leshan,org.eclipse.leshan.server.bootstrap,0,0,0,0,1,1,1,3
eclipse_leshan,org.eclipse.leshan.server,0,0,0,0,1,0,1,2
eclipse_leshan,org.eclipse.leshan.server.model,0,0,0,0,0,1,1,2
eclipse_leshan,org.eclipse.leshan.server.observation,0,0,0,0,0,0,1,1
eclipse_leshan,org.eclipse.leshan.server.queue,0,0,0,0,1,1,1,3
eclipse_leshan,org.eclipse.leshan.server.registration,0,0,0,0,1,4,1,6
eclipse_leshan,org.eclipse.leshan.server.request,0,0,0,0,0,0,1,1
eclipse_leshan,org.eclipse.leshan.server.security,0,0,0,0,1,2,1,4
eclipse_leshan,org.eclipse.leshan.server.demo,0,0,0,0,0,0,1,1
eclipse_leshan,org.eclipse.leshan.server.demo.model,0,0,0,0,0,0,1,1
eclipse_leshan,org.eclipse.leshan.server.demo.servlet,0,0,0,0,1,0,1,2
eclipse_leshan,org.eclipse.leshan.server.demo.servlet.json,0,0,0,0,1,1,1,3
eclipse_leshan,org.eclipse.leshan.server.demo.servlet.log,0,0,0,0,0,0,1,1
eclipse_leshan,org.eclipse.leshan.server.demo.utils,0,0,0,0,0,0,1,1
eclipse_leshan,org.eclipse.leshan.server.redis,0,0,0,0,0,0,1,1
eclipse_leshan,org.eclipse.leshan.server.redis.serialization,0,0,0,0,1,2,1,4
edgedalmacio_phisix,com.googlecode.phisix.api.client,0,1,0,0,0,0,0,1
edgedalmacio_phisix,com.googlecode.phisix.api.ext,0,0,0,0,0,0,0,0
edgedalmacio_phisix,com.googlecode.phisix.api.parser,0,0,0,0,0,0,0,0
edgedalmacio_phisix,com.googlecode.phisix.api.repository,0,0,0,0,0,0,0,0
edgedalmacio_phisix,com.googlecode.phisix.api.resource,0,0,0,0,0,0,0,0
edgedalmacio_phisix,com.googlecode.phisix.api.urlfetch,0,0,0,0,0,0,0,0
edgedalmacio_phisix,javax.xml.bind,0,0,0,0,0,0,0,0
edgedalmacio_phisix,com.googlecode.phisix.api.model,0,0,0,0,1,0,0,1
edwardcapriolo_nibiru,io.teknek.nibiru.cli,0,0,0,0,0,0,1,1
edwardcapriolo_nibiru,io.teknek.nibiru.client,7,0,0,0,1,5,1,14
edwardcapriolo_nibiru,io.teknek.nibiru.cluster,7,1,0,0,0,2,1,11
edwardcapriolo_nibiru,io.teknek.nibiru.config,0,0,0,0,0,0,1,1
edwardcapriolo_nibiru,io.teknek.nibiru,23,1,0,0,1,16,1,42
edwardcapriolo_nibiru,io.teknek.nibiru.coordinator,8,1,0,0,0,10,1,20
edwardcapriolo_nibiru,io.teknek.nibiru.engine,6,0,0,0,0,7,1,14
edwardcapriolo_nibiru,io.teknek.nibiru.engine.atom,3,1,0,0,1,3,1,9
edwardcapriolo_nibiru,io.teknek.nibiru.io,0,0,0,0,0,2,1,3
edwardcapriolo_nibiru,io.teknek.nibiru.keyvalue,0,0,0,0,0,1,1,2
edwardcapriolo_nibiru,io.teknek.nibiru.metadata,9,1,0,0,0,7,1,18
edwardcapriolo_nibiru,io.teknek.nibiru.partitioner,4,1,0,0,0,3,1,9
edwardcapriolo_nibiru,io.teknek.nibiru.personality,0,0,0,0,0,0,1,1
edwardcapriolo_nibiru,io.teknek.nibiru.plugins,5,1,0,0,0,2,1,9
edwardcapriolo_nibiru,io.teknek.nibiru.router,8,0,0,0,0,1,1,10
edwardcapriolo_nibiru,io.teknek.nibiru.transport,6,1,0,0,1,6,1,15
edwardcapriolo_nibiru,io.teknek.nibiru.transport.columnfamily,0,0,0,0,0,1,1,2
edwardcapriolo_nibiru,io.teknek.nibiru.transport.columnfamilyadmin,0,0,0,0,0,0,1,1
edwardcapriolo_nibiru,io.teknek.nibiru.transport.directsstable,0,0,0,0,0,0,1,1
edwardcapriolo_nibiru,io.teknek.nibiru.transport.keyvalue,0,0,0,0,0,0,1,1
edwardcapriolo_nibiru,io.teknek.nibiru.transport.metadata,0,0,0,0,1,3,1,5
edwardcapriolo_nibiru,io.teknek.nibiru.transport.rpc,0,0,0,0,0,0,1,1
edwardcapriolo_nibiru,io.teknek.nibiru.transport.sponsor,0,0,0,0,0,0,1,1
edwardcapriolo_nibiru,io.teknek.nibiru.trigger,3,0,0,0,0,1,1,5
edwardcapriolo_nibiru,io.teknek.nibiru.rpc,0,0,0,0,0,0,1,1
edwardcapriolo_nibiru,io.teknek.nibiru.sponsor,0,0,0,0,0,0,1,1
effektif_effektif,com.effektif.adapter,0,0,0,0,1,0,1,2
effektif_effektif,com.effektif.adapter.helpers,0,0,0,0,0,0,1,1
effektif_effektif,com.effektif.adapter.activity,0,0,0,0,0,0,1,1
effektif_effektif,com.effektif.adapter.service,0,0,0,0,1,0,1,2
effektif_effektif,com.effektif.email,0,0,0,0,1,0,1,2
effektif_effektif,com.effektif.example.cli,1,1,0,0,0,0,1,3
effektif_effektif,com.effektif.example.cli.command,1,0,0,0,0,1,1,3
effektif_effektif,(default package),0,0,0,0,0,1,1,2
effektif_effektif,com.effektif.mongo,0,0,0,1,1,1,1,4
effektif_effektif,com.effektif.script,0,0,0,0,0,1,1,2
effektif_effektif,com.effektif.server,0,1,0,0,1,0,1,3
effektif_effektif,com.effektif.workflow.api.activities,0,0,0,0,1,0,1,2
effektif_effektif,com.effektif.workflow.api.bpmn,0,0,0,0,1,3,1,5
effektif_effektif,com.effektif.workflow.api.condition,0,0,0,0,0,1,1,2
effektif_effektif,com.effektif.workflow.api,0,0,0,0,0,2,1,3
effektif_effektif,com.effektif.workflow.api.datasource,0,0,0,0,0,0,1,1
effektif_effektif,com.effektif.workflow.api.json,0,0,0,0,0,0,1,1
effektif_effektif,com.effektif.workflow.api.model,0,0,0,0,1,5,1,7
effektif_effektif,com.effektif.workflow.api.query,0,0,0,0,0,0,1,1
effektif_effektif,com.effektif.workflow.api.types,0,0,0,0,0,3,1,4
effektif_effektif,com.effektif.workflow.api.workflow,0,0,0,0,1,6,1,8
effektif_effektif,com.effektif.workflow.api.workflow.diagram,0,0,0,0,0,0,1,1
effektif_effektif,com.effektif.workflow.api.workflowinstance,0,0,0,0,0,0,1,1
effektif_effektif,com.effektif.workflow.impl.activity,1,1,0,0,1,1,1,5
effektif_effektif,com.effektif.workflow.impl.activity.types,0,0,0,0,1,0,1,2
effektif_effektif,com.effektif.workflow.impl,7,1,0,0,1,3,1,13
effektif_effektif,com.effektif.workflow.impl.bpmn,1,0,0,0,0,0,1,2
effektif_effektif,com.effektif.workflow.impl.bpmn.xml,0,0,0,0,0,0,1,1
effektif_effektif,com.effektif.workflow.impl.conditions,0,0,0,0,0,1,1,2
effektif_effektif,com.effektif.workflow.impl.configuration,0,0,0,0,0,0,1,1
effektif_effektif,com.effektif.workflow.impl.data,1,1,0,0,0,0,1,3
effektif_effektif,com.effektif.workflow.impl.data.source,0,0,0,0,0,0,1,1
effektif_effektif,com.effektif.workflow.impl.data.types,2,0,0,0,1,0,1,4
effektif_effektif,com.effektif.workflow.impl.exceptions,0,0,0,0,0,0,1,1
effektif_effektif,com.effektif.workflow.impl.job,3,1,0,0,1,0,1,6
effektif_effektif,com.effektif.workflow.impl.json,2,1,0,0,1,5,1,10
effektif_effektif,com.effektif.workflow.impl.json.configuration,3,1,0,0,0,0,1,5
effektif_effektif,com.effektif.workflow.impl.json.types,0,0,0,1,0,4,1,6
effektif_effektif,com.effektif.workflow.impl.memory,0,1,0,0,0,0,1,2
effektif_effektif,com.effektif.workflow.impl.template,2,1,0,0,0,1,1,5
effektif_effektif,com.effektif.workflow.impl.util,0,0,0,0,1,1,1,3
effektif_effektif,com.effektif.workflow.impl.workflow,3,1,0,0,1,3,1,9
effektif_effektif,com.effektif.workflow.impl.workflow.boundary,0,0,0,0,0,0,1,1
effektif_effektif,com.effektif.workflow.impl.workflowinstance,3,0,0,0,1,0,1,5
ehcache_ehcache-jcache,org.ehcache.jcache,0,0,0,0,1,0,0,1
ehcache_ehcache-jcache,org.ehcache.jcache.tck,0,0,0,0,0,0,0,0
ehcache_sizeof,org.ehcache.sizeof.annotations,0,0,0,0,0,0,0,0
ehcache_sizeof,org.ehcache.sizeof,0,0,0,1,0,0,0,1
ehcache_sizeof,org.ehcache.sizeof.filters,0,0,0,0,0,0,0,0
ehcache_sizeof,org.ehcache.sizeof.impl,0,0,0,0,1,0,0,1
ehcache_sizeof,org.ehcache.sizeof.util,0,0,0,0,0,0,0,0
Eldelshell_jongo,jongo.rest,0,0,0,0,0,0,0,0
Eldelshell_jongo,jongo.config,3,1,0,0,0,0,0,4
Eldelshell_jongo,jongo.demo,3,0,0,0,0,0,0,3
Eldelshell_jongo,jongo.exceptions,0,0,0,0,0,0,0,0
Eldelshell_jongo,jongo.filter,0,0,0,0,0,0,0,0
Eldelshell_jongo,jongo.handler,0,0,0,0,0,0,0,0
Eldelshell_jongo,jongo.jdbc,2,1,0,0,1,1,0,5
Eldelshell_jongo,jongo,4,0,0,0,1,0,0,5
Eldelshell_jongo,jongo.rest.xstream,0,0,0,0,1,1,0,2
Eldelshell_jongo,jongo.sql,1,1,0,0,1,1,0,4
Eldelshell_jongo,jongo.sql.dialect,0,0,0,0,1,0,0,1
Eldelshell_jongo,org.jongo,1,0,0,0,1,1,0,3
Eldelshell_jongo,org.jongo.filter,0,0,0,0,0,0,0,0
Eldelshell_jongo,org.jongo.jdbc,0,0,0,0,0,0,0,0
Eldelshell_jongo,org.jongo.mocks,1,1,0,0,0,0,0,2
Eldelshell_jongo,org.jongo.sql.dialect,0,0,0,0,1,0,0,1
ElectronicChartCentre_java-vector-tile,no.ecc.vectortile,0,0,0,0,1,0,0,1
ElectronicChartCentre_java-vector-tile,vector_tile,0,0,0,0,0,0,0,0
elibom_jogger,com.elibom.jogger.asset,0,0,0,0,0,1,0,1
elibom_jogger,com.elibom.jogger,0,0,0,0,1,0,0,1
elibom_jogger,com.elibom.jogger.exception,0,0,0,0,0,0,0,0
elibom_jogger,com.elibom.jogger.http,0,0,0,0,1,1,0,2
elibom_jogger,com.elibom.jogger.http.servlet.multipart,0,0,0,0,1,0,0,1
elibom_jogger,com.elibom.jogger.http.servlet,0,0,0,0,0,0,0,0
elibom_jogger,com.elibom.jogger.middleware.router.interceptor,0,0,0,0,0,0,0,0
elibom_jogger,com.elibom.jogger.middleware.router.loader,0,1,0,0,0,0,0,1
elibom_jogger,com.elibom.jogger.middleware.router,0,0,0,0,0,0,0,0
elibom_jogger,com.elibom.jogger.middleware.statik,0,0,0,0,0,1,0,1
elibom_jogger,com.elibom.jogger.template,0,0,0,0,0,0,0,0
elibom_jogger,com.elibom.jogger.util,0,0,0,0,0,0,0,0
elibom_jogger,com.elibom.jogger.exceptions,0,0,0,0,1,0,0,1
elibom_jogger,com.elibom.jogger.router,0,0,0,0,0,0,0,0
embulk_embulk,org.embulk.cli,1,0,0,0,0,0,1,2
embulk_embulk,org.embulk.command,2,0,0,0,0,0,1,3
embulk_embulk,org.embulk.config,16,1,0,1,0,0,1,19
embulk_embulk,org.embulk.deps,0,0,0,0,0,0,1,1
embulk_embulk,org.embulk.deps.cli,1,1,0,0,0,0,1,3
embulk_embulk,org.embulk.deps.maven,0,0,0,0,1,0,1,2
embulk_embulk,org.embulk,20,1,0,0,0,0,1,22
embulk_embulk,org.embulk.exec,12,0,0,1,0,0,1,14
embulk_embulk,org.embulk.jruby,5,0,0,0,0,0,1,6
embulk_embulk,org.embulk.plugin,6,1,0,0,0,0,1,8
embulk_embulk,org.embulk.plugin.compat,3,0,0,0,0,0,1,4
embulk_embulk,org.embulk.plugin.jar,0,0,0,0,0,0,1,1
embulk_embulk,org.embulk.plugin.maven,0,0,0,0,0,0,1,1
embulk_embulk,org.embulk.spi,23,1,0,1,0,0,1,26
embulk_embulk,org.embulk.spi.json,0,0,0,0,0,0,1,1
embulk_embulk,org.embulk.spi.time,9,1,0,1,0,0,1,12
embulk_embulk,org.embulk.spi.type,6,1,0,0,0,0,1,8
embulk_embulk,org.embulk.spi.unit,3,0,0,0,1,0,1,5
embulk_embulk,org.embulk.spi.util,10,1,0,1,1,0,1,14
embulk_embulk,org.embulk.spi.util.dynamic,3,0,0,0,0,0,1,4
embulk_embulk,org.embulk.standards,0,0,0,1,1,0,1,3
embulk_embulk,org.embulk.standards.guess,0,0,0,0,0,0,1,1
embulk_embulk,org.embulk.standards.preview,0,0,0,0,0,0,1,1
englishtown_vertx-cassandra,com.englishtown.vertx.cassandra,0,0,0,0,0,0,0,0
englishtown_vertx-cassandra,com.englishtown.vertx.cassandra.guice,0,0,0,0,0,0,0,0
englishtown_vertx-cassandra,com.englishtown.vertx.cassandra.hk2,0,0,0,0,0,0,0,0
englishtown_vertx-cassandra,com.englishtown.vertx.cassandra.impl,0,0,0,0,1,0,0,1
englishtown_vertx-cassandra,com.englishtown.vertx.cassandra.keyspacebuilder,0,0,0,0,0,0,0,0
englishtown_vertx-cassandra,com.englishtown.vertx.cassandra.promises.impl,0,0,0,0,0,0,0,0
englishtown_vertx-cassandra,com.englishtown.vertx.cassandra.promises,0,0,0,0,0,0,0,0
englishtown_vertx-cassandra,com.englishtown.vertx.cassandra.tablebuilder,0,0,0,0,0,0,0,0
englishtown_vertx-cassandra,com.englishtown.vertx.cassandra.zookeeper,0,0,0,0,0,0,0,0
englishtown_vertx-cassandra,com.englishtown.vertx.cassandra.integration,0,0,0,0,0,0,0,0
englishtown_vertx-cassandra,com.englishtown.vertx.cassandra.integration.guice,0,0,0,0,0,0,0,0
englishtown_vertx-cassandra,com.englishtown.vertx.cassandra.integration.hk2,0,0,0,0,0,0,0,0
englishtown_vertx-cassandra,com.englishtown.vertx.cassandra.mapping.guice,0,0,0,0,0,0,0,0
englishtown_vertx-cassandra,com.englishtown.vertx.cassandra.mapping.hk2,0,0,0,0,0,0,0,0
englishtown_vertx-cassandra,com.englishtown.vertx.cassandra.mapping.impl,0,1,0,0,0,0,0,1
englishtown_vertx-cassandra,com.englishtown.vertx.cassandra.mapping.promises.impl,0,0,0,0,0,0,0,0
englishtown_vertx-cassandra,com.englishtown.vertx.cassandra.mapping.promises,0,0,0,0,0,0,0,0
englishtown_vertx-cassandra,com.englishtown.vertx.cassandra.mapping,0,0,0,0,0,0,0,0
englishtown_vertx-cassandra,com.englishtown.vertx.cassandra.mapping.integration.guice,0,0,0,0,0,0,0,0
englishtown_vertx-cassandra,com.englishtown.vertx.cassandra.mapping.integration.hk2,0,0,0,0,0,0,0,0
englishtown_vertx-cassandra,com.englishtown.vertx.cassandra.mapping.integration,0,1,0,0,0,0,0,1
englishtown_vertx-jersey,com.englishtown.vertx.jersey.examples.resources,0,0,0,0,1,0,0,1
englishtown_vertx-jersey,com.englishtown.vertx.jersey.examples.integration,0,0,0,0,1,0,0,1
englishtown_vertx-jersey,com.englishtown.vertx.jersey.examples,0,0,0,0,1,0,0,1
englishtown_vertx-jersey,com.englishtown.vertx.jersey.examples.guice,0,0,0,0,0,0,0,0
englishtown_vertx-jersey,com.englishtown.vertx.jersey.examples.guice.impl,0,0,0,0,0,0,0,0
englishtown_vertx-jersey,com.englishtown.vertx.jersey.examples.guice.inject,0,0,0,0,1,0,0,1
englishtown_vertx-jersey,com.englishtown.vertx.jersey.examples.guice.resources,0,0,0,0,0,0,0,0
englishtown_vertx-jersey,com.englishtown.vertx.jersey.features.jackson.internal,1,1,0,0,1,0,0,3
englishtown_vertx-jersey,com.englishtown.vertx.jersey.features.jackson,1,0,0,0,0,0,0,1
englishtown_vertx-jersey,com.englishtown.vertx.jersey.features.jackson.integration,0,0,0,0,0,0,0,0
englishtown_vertx-jersey,com.englishtown.vertx.jersey.features.swagger.internal,1,1,0,0,1,0,0,3
englishtown_vertx-jersey,com.englishtown.vertx.jersey.features.swagger,1,0,0,0,0,0,0,1
englishtown_vertx-jersey,com.englishtown.vertx.jersey.features.swagger.integration,0,0,0,0,0,0,0,0
englishtown_vertx-jersey,com.englishtown.vertx.guice,0,0,0,0,1,0,0,1
englishtown_vertx-jersey,com.englishtown.vertx.hk2,0,0,0,0,1,0,0,1
englishtown_vertx-jersey,com.englishtown.vertx.jersey,0,0,0,0,1,0,0,1
englishtown_vertx-jersey,com.englishtown.vertx.jersey.impl,0,0,0,0,1,0,0,1
englishtown_vertx-jersey,com.englishtown.vertx.jersey.inject,0,0,0,0,1,0,0,1
englishtown_vertx-jersey,com.englishtown.vertx.jersey.inject.impl,0,0,0,0,0,0,0,0
englishtown_vertx-jersey,com.englishtown.vertx.jersey.promises.impl,0,0,0,0,0,0,0,0
englishtown_vertx-jersey,com.englishtown.vertx.jersey.promises,0,0,0,0,0,0,0,0
englishtown_vertx-jersey,com.englishtown.vertx.jersey.security,0,0,0,0,0,0,0,0
englishtown_vertx-jersey,com.englishtown.vertx.jersey.integration,1,1,0,0,0,0,0,2
englishtown_vertx-jersey,com.englishtown.vertx.jersey.promises.integration,0,0,0,0,0,0,0,0
englishtown_vertx-jersey,com.englishtown.vertx.jersey.promises.integration.resources,0,0,0,0,0,0,0,0
englishtown_vertx-jersey,com.englishtown.vertx.jersey.resources,1,1,0,0,0,0,0,2
englishtown_vertx-jersey,com.englishtown.vertx.jersey.metrics.hk2,0,0,0,0,0,0,0,0
englishtown_vertx-jersey,com.englishtown.vertx.jersey.metrics,0,0,0,0,0,0,0,0
englishtown_vertx-jersey,com.englishtown.vertx.jersey.metrics.integration,0,0,0,0,0,0,0,0
englishtown_vertx-when,com.englishtown.vertx.examples.integration,0,0,0,0,0,0,0,0
englishtown_vertx-when,com.englishtown.vertx.promises.guice,0,0,0,0,0,0,0,0
englishtown_vertx-when,com.englishtown.vertx.promises.hk2,0,0,0,0,0,0,0,0
englishtown_vertx-when,com.englishtown.vertx.promises,0,0,0,0,1,0,0,1
englishtown_vertx-when,com.englishtown.vertx.promises.impl,0,0,0,0,1,0,0,1
englishtown_vertx-when,com.englishtown.vertx.promises.integration,0,0,0,0,0,0,0,0
englishtown_vertx-when,com.englishtown.vertx.promises.integration.guice,0,0,0,0,0,0,0,0
englishtown_vertx-when,com.englishtown.vertx.promises.integration.hk2,0,0,0,0,0,0,0,0
englishtown_vertx-when,com.englishtown.vertx.promises.integration.simple,0,0,0,0,0,0,0,0
enonic_xp,com.enonic.gradle,0,0,0,0,0,0,1,1
enonic_xp,com.enonic.xp.admin.tool,0,0,0,0,0,0,1,1
enonic_xp,com.enonic.xp.admin.widget,0,0,0,0,0,0,1,1
enonic_xp,com.enonic.xp.admin.event.impl,0,0,0,0,0,0,1,1
enonic_xp,com.enonic.xp.admin.event.impl.json,0,0,0,0,0,0,1,1
enonic_xp,com.enonic.xp.admin.impl.app,0,0,0,0,0,0,1,1
enonic_xp,com.enonic.xp.admin.impl.json.aggregation,0,0,0,0,0,0,1,1
enonic_xp,com.enonic.xp.admin.impl.json,0,0,0,0,0,0,1,1
enonic_xp,com.enonic.xp.admin.impl.json.content,4,1,0,1,1,0,1,8
enonic_xp,com.enonic.xp.admin.impl.json.content.attachment,0,0,0,0,0,0,1,1
enonic_xp,com.enonic.xp.admin.impl.json.content.page,0,1,0,0,0,0,1,2
enonic_xp,com.enonic.xp.admin.impl.json.content.page.region,0,0,0,0,0,0,1,1
enonic_xp,com.enonic.xp.admin.impl.json.form,3,0,0,0,0,0,1,4
enonic_xp,com.enonic.xp.admin.impl.json.issue,1,1,0,0,1,0,1,4
enonic_xp,com.enonic.xp.admin.impl.json.schema.content,6,1,0,0,0,0,1,8
enonic_xp,com.enonic.xp.admin.impl.json.schema.mixin,3,0,0,0,0,0,1,4
enonic_xp,com.enonic.xp.admin.impl.json.schema.relationship,0,0,0,0,0,0,1,1
enonic_xp,com.enonic.xp.admin.impl.json.schema.xdata,0,0,0,0,0,0,1,1
enonic_xp,com.enonic.xp.admin.impl.json.system,0,0,0,0,0,0,1,1
enonic_xp,com.enonic.xp.admin.impl.json.thumb,0,0,0,0,0,0,1,1
enonic_xp,com.enonic.xp.admin.impl.market,0,0,0,0,0,0,1,1
enonic_xp,com.enonic.xp.admin.impl.portal,0,0,0,0,1,0,1,2
enonic_xp,com.enonic.xp.admin.impl.rest,0,0,0,0,0,0,1,1
enonic_xp,com.enonic.xp.admin.impl.rest.resource.application,1,0,0,0,0,0,1,2
enonic_xp,com.enonic.xp.admin.impl.rest.resource.application.json,1,1,0,0,1,0,1,4
enonic_xp,com.enonic.xp.admin.impl.rest.resource.auth,0,0,0,0,0,0,1,1
enonic_xp,com.enonic.xp.admin.impl.rest.resource.auth.json,0,0,0,0,0,0,1,1
enonic_xp,com.enonic.xp.admin.impl.rest.resource,0,1,0,0,0,0,1,2
enonic_xp,com.enonic.xp.admin.impl.rest.resource.content,7,1,0,1,1,0,1,11
enonic_xp,com.enonic.xp.admin.impl.rest.resource.content.json,5,1,0,1,1,0,1,9
enonic_xp,com.enonic.xp.admin.impl.rest.resource.content.json.filter,0,0,0,0,0,0,1,1
enonic_xp,com.enonic.xp.admin.impl.rest.resource.content.page,0,0,0,0,1,0,1,2
enonic_xp,com.enonic.xp.admin.impl.rest.resource.content.page.fragment,0,0,0,0,0,0,1,1
enonic_xp,com.enonic.xp.admin.impl.rest.resource.content.page.layout,0,0,0,0,0,0,1,1
enonic_xp,com.enonic.xp.admin.impl.rest.resource.content.page.part,0,0,0,0,0,0,1,1
enonic_xp,com.enonic.xp.admin.impl.rest.resource.content.query,0,0,0,0,0,0,1,1
enonic_xp,com.enonic.xp.admin.impl.rest.resource.content.task,3,0,0,1,0,0,1,5
enonic_xp,com.enonic.xp.admin.impl.rest.resource.issue,1,0,0,0,0,0,1,2
enonic_xp,com.enonic.xp.admin.impl.rest.resource.issue.json,0,0,0,0,1,0,1,2
enonic_xp,com.enonic.xp.admin.impl.rest.resource.macro.json,1,0,0,0,1,0,1,3
enonic_xp,com.enonic.xp.admin.impl.rest.resource.macro,1,1,0,0,0,0,1,3
enonic_xp,com.enonic.xp.admin.impl.rest.resource.schema.content,6,1,0,0,0,0,1,8
enonic_xp,com.enonic.xp.admin.impl.rest.resource.schema,0,0,0,0,0,0,1,1
enonic_xp,com.enonic.xp.admin.impl.rest.resource.schema.mixin,5,1,0,0,1,0,1,8
enonic_xp,com.enonic.xp.admin.impl.rest.resource.schema.relationship,0,0,0,0,0,0,1,1
enonic_xp,com.enonic.xp.admin.impl.rest.resource.schema.xdata,0,0,0,0,0,0,1,1
enonic_xp,com.enonic.xp.admin.impl.rest.resource.security.json,0,0,0,1,1,0,1,3
enonic_xp,com.enonic.xp.admin.impl.rest.resource.security,0,0,0,0,0,0,1,1
enonic_xp,com.enonic.xp.admin.impl.rest.resource.status,0,0,0,0,0,0,1,1
enonic_xp,com.enonic.xp.admin.impl.rest.resource.task,0,0,0,0,0,0,1,1
enonic_xp,com.enonic.xp.admin.impl.rest.resource.tool.json,0,0,0,0,0,0,1,1
enonic_xp,com.enonic.xp.admin.impl.rest.resource.widget.json,0,0,0,0,0,0,1,1
enonic_xp,com.enonic.xp.admin.impl.rest.resource.widget,0,0,0,0,0,0,1,1
enonic_xp,com.enonic.xp.admin.impl.security,0,0,0,0,0,0,1,1
enonic_xp,com.enonic.xp.admin.impl.tool,0,0,0,0,0,0,1,1
enonic_xp,com.enonic.xp.admin.impl.widget,0,0,0,0,1,0,1,2
enonic_xp,com.enonic.xp.internal.blobstore.file.config,0,0,0,0,0,0,1,1
enonic_xp,com.enonic.xp.internal.blobstore.file,0,0,0,0,0,0,1,1
enonic_xp,com.enonic.xp.aggregation,0,0,0,1,0,0,1,2
enonic_xp,com.enonic.xp.app,35,1,0,0,0,0,1,37
enonic_xp,com.enonic.xp.attachment,4,0,0,0,0,0,1,5
enonic_xp,com.enonic.xp.audit,0,0,0,0,0,0,1,1
enonic_xp,com.enonic.xp.blob,2,1,0,0,0,0,1,4
enonic_xp,com.enonic.xp.branch,0,0,0,0,0,0,1,1
enonic_xp,com.enonic.xp.cluster,0,0,0,0,1,0,1,2
enonic_xp,com.enonic.xp.config,0,1,0,0,0,0,1,2
enonic_xp,com.enonic.xp.content,50,1,0,1,0,0,1,53
enonic_xp,com.enonic.xp.content.processor,0,0,0,0,1,0,1,2
enonic_xp,com.enonic.xp.context,4,1,0,0,1,0,1,7
enonic_xp,com.enonic.xp.convert,4,0,0,0,0,0,1,5
enonic_xp,com.enonic.xp.data,27,1,0,1,0,0,1,30
enonic_xp,com.enonic.xp.descriptor,4,0,0,0,1,0,1,6
enonic_xp,com.enonic.xp.dump,0,0,0,1,0,0,1,2
enonic_xp,com.enonic.xp.event,0,1,0,0,0,0,1,2
enonic_xp,com.enonic.xp.exception,0,0,0,0,0,0,1,1
enonic_xp,com.enonic.xp.export,0,0,0,0,0,0,1,1
enonic_xp,com.enonic.xp.extractor,0,0,0,0,0,0,1,1
enonic_xp,com.enonic.xp.form,17,1,0,1,0,0,1,20
enonic_xp,com.enonic.xp.highlight,0,0,0,0,0,0,1,1
enonic_xp,com.enonic.xp.home,0,0,0,0,0,0,1,1
enonic_xp,com.enonic.xp.i18n,0,1,0,0,0,0,1,2
enonic_xp,com.enonic.xp.icon,3,0,0,0,0,0,1,4
enonic_xp,com.enonic.xp.idprovider,2,0,0,0,0,0,1,3
enonic_xp,com.enonic.xp.image,3,0,0,0,0,0,1,4
enonic_xp,com.enonic.xp.index,8,1,0,1,0,0,1,11
enonic_xp,com.enonic.xp.init,0,0,0,0,1,0,1,2
enonic_xp,com.enonic.xp.inputtype,6,1,0,1,0,0,1,9
enonic_xp,com.enonic.xp.issue,0,0,0,1,0,0,1,2
enonic_xp,com.enonic.xp.json,0,0,0,0,0,0,1,1
enonic_xp,com.enonic.xp.macro,4,0,0,0,0,0,1,5
enonic_xp,com.enonic.xp.mail,0,0,0,0,0,0,1,1
enonic_xp,com.enonic.xp.market,0,0,0,0,0,0,1,1
enonic_xp,com.enonic.xp.media,10,0,0,0,0,0,1,11
enonic_xp,com.enonic.xp.name,0,0,0,0,0,0,1,1
enonic_xp,com.enonic.xp.node,16,1,0,1,0,0,1,19
enonic_xp,com.enonic.xp.page,13,1,0,1,0,0,1,16
enonic_xp,com.enonic.xp.query.aggregation,2,0,0,1,0,0,1,4
enonic_xp,com.enonic.xp.query.aggregation.metric,0,0,0,0,0,0,1,1
enonic_xp,com.enonic.xp.query,0,0,0,0,0,0,1,1
enonic_xp,com.enonic.xp.query.expr,7,1,0,0,0,0,1,9
enonic_xp,com.enonic.xp.query.filter,2,0,0,0,0,0,1,3
enonic_xp,com.enonic.xp.query.highlight,0,0,0,0,0,0,1,1
enonic_xp,com.enonic.xp.query.parser,1,0,0,0,0,0,1,2
enonic_xp,com.enonic.xp.query.suggester,0,0,0,0,0,0,1,1
enonic_xp,com.enonic.xp.region,5,1,0,1,0,0,1,8
enonic_xp,com.enonic.xp.repository,4,1,0,0,0,0,1,6
enonic_xp,com.enonic.xp.resource,4,1,0,0,0,0,1,6
enonic_xp,com.enonic.xp.schema,0,0,0,0,0,0,1,1
enonic_xp,com.enonic.xp.schema.content,18,1,0,0,0,0,1,20
enonic_xp,com.enonic.xp.schema.content.validator,0,0,0,0,0,0,1,1
enonic_xp,com.enonic.xp.schema.mixin,6,0,0,0,0,0,1,7
enonic_xp,com.enonic.xp.schema.relationship,4,0,0,0,0,0,1,5
enonic_xp,com.enonic.xp.schema.xdata,8,1,0,0,0,0,1,10
enonic_xp,com.enonic.xp.security.acl,11,1,0,0,0,0,1,13
enonic_xp,com.enonic.xp.security.auth,2,0,0,0,1,0,1,4
enonic_xp,com.enonic.xp.security,16,1,0,1,0,0,1,19
enonic_xp,com.enonic.xp.server,0,0,0,0,1,0,1,2
enonic_xp,com.enonic.xp.service,0,0,0,0,0,0,1,1
enonic_xp,com.enonic.xp.session,0,0,0,0,0,0,1,1
enonic_xp,com.enonic.xp.site,6,1,0,0,0,0,1,8
enonic_xp,com.enonic.xp.site.mapping,2,0,0,0,0,0,1,3
enonic_xp,com.enonic.xp.site.processor,2,0,0,0,0,0,1,3
enonic_xp,com.enonic.xp.snapshot,0,0,0,0,0,0,1,1
enonic_xp,com.enonic.xp.status,0,0,0,0,0,0,1,1
enonic_xp,com.enonic.xp.style,0,0,0,0,0,0,1,1
enonic_xp,com.enonic.xp.suggester,0,0,0,0,1,0,1,2
enonic_xp,com.enonic.xp.support,2,1,0,0,1,0,1,5
enonic_xp,com.enonic.xp.task,0,1,0,0,0,0,1,2
enonic_xp,com.enonic.xp.trace,0,0,0,0,1,0,1,2
enonic_xp,com.enonic.xp.upgrade,0,0,0,0,0,0,1,1
enonic_xp,com.enonic.xp.util,23,1,0,1,1,0,1,27
enonic_xp,com.enonic.xp.vacuum,0,0,0,0,0,0,1,1
enonic_xp,com.enonic.xp.vfs,0,0,0,0,0,0,1,1
enonic_xp,com.enonic.xp.xml,2,1,0,0,0,0,1,4
enonic_xp,com.enonic.xp.xml.parser,0,0,0,1,0,0,1,2
enonic_xp,com.enonic.xp.xml.schema,0,0,0,0,0,0,1,1
enonic_xp,com.enonic.xp.content.query,0,0,0,0,0,0,1,1
enonic_xp,com.enonic.xp.query.suggestion,0,0,0,0,0,0,1,1
enonic_xp,com.enonic.xp,0,0,0,0,0,0,1,1
enonic_xp,com.enonic.xp.core.impl.app,3,0,0,1,0,0,1,5
enonic_xp,com.enonic.xp.core.impl.app.config,1,1,0,0,0,0,1,3
enonic_xp,com.enonic.xp.core.impl.app.descriptor,0,0,0,0,0,0,1,1
enonic_xp,com.enonic.xp.core.impl.app.event,1,1,0,0,1,0,1,4
enonic_xp,com.enonic.xp.core.impl.app.resolver,0,0,0,0,0,0,1,1
enonic_xp,com.enonic.xp.core.impl.app.resource,1,1,0,0,0,0,1,3
enonic_xp,com.enonic.xp.core.impl.audit,1,0,0,0,0,0,1,2
enonic_xp,com.enonic.xp.core.impl.audit.config,0,0,0,0,0,0,1,1
enonic_xp,com.enonic.xp.core.impl.audit.serializer,1,1,0,0,0,0,1,3
enonic_xp,com.enonic.xp.core.impl.idprovider,0,0,0,0,0,0,1,1
enonic_xp,com.enonic.xp.internal.blobstore,2,1,0,0,0,0,1,4
enonic_xp,com.enonic.xp.internal.blobstore.cache,1,0,0,0,0,0,1,2
enonic_xp,com.enonic.xp.internal.blobstore.config,0,0,0,0,0,0,1,1
enonic_xp,com.enonic.xp.internal.blobstore.readthrough,1,0,0,0,0,0,1,2
enonic_xp,com.enonic.xp.cluster.impl,0,0,0,0,1,0,1,2
enonic_xp,com.enonic.xp.cluster.impl.discovery,0,0,0,0,0,0,1,1
enonic_xp,com.enonic.xp.cluster.impl.report,0,0,0,0,0,0,1,1
enonic_xp,com.enonic.xp.core.impl.content,0,0,0,1,0,0,1,2
enonic_xp,com.enonic.xp.core.impl.content.index,1,1,0,0,0,0,1,3
enonic_xp,com.enonic.xp.core.impl.content.index.processor,1,0,0,0,0,0,1,2
enonic_xp,com.enonic.xp.core.impl.content.page,0,0,0,0,1,0,1,2
enonic_xp,com.enonic.xp.core.impl.content.page.region,0,0,0,0,1,0,1,2
enonic_xp,com.enonic.xp.core.impl.content.processor,0,0,0,0,1,0,1,2
enonic_xp,com.enonic.xp.core.impl.content.serializer,0,1,0,0,0,0,1,2
enonic_xp,com.enonic.xp.core.impl.content.validate,0,0,0,0,0,0,1,1
enonic_xp,com.enonic.xp.core.impl.issue,1,0,0,1,0,0,1,3
enonic_xp,com.enonic.xp.core.impl.issue.serializer,1,1,0,0,0,0,1,3
enonic_xp,com.enonic.xp.core.impl.content.page.layout,0,0,0,0,0,0,1,1
enonic_xp,com.enonic.xp.core.impl.content.page.part,0,0,0,0,0,0,1,1
enonic_xp,com.enonic.xp.elasticsearch.impl,0,0,0,0,1,0,1,2
enonic_xp,com.enonic.xp.elasticsearch.impl.status.cluster,0,0,0,0,0,0,1,1
enonic_xp,com.enonic.xp.elasticsearch.impl.status.index,0,0,0,0,0,0,1,1
enonic_xp,com.enonic.xp.core.impl.event.cluster,0,0,0,0,0,0,1,1
enonic_xp,com.enonic.xp.core.impl.event,0,0,0,0,0,0,1,1
enonic_xp,com.enonic.xp.core.impl.export,0,0,0,0,0,0,1,1
enonic_xp,com.enonic.xp.core.impl.export.reader,0,0,0,0,0,0,1,1
enonic_xp,com.enonic.xp.core.impl.export.validator,0,0,0,0,0,0,1,1
enonic_xp,com.enonic.xp.core.impl.export.writer,0,0,0,0,0,0,1,1
enonic_xp,com.enonic.xp.core.impl.export.xml,0,0,0,0,0,0,1,1
enonic_xp,com.enonic.xp.extractor.impl,0,0,0,0,0,0,1,1
enonic_xp,com.enonic.xp.extractor.impl.config,0,0,0,0,0,0,1,1
enonic_xp,com.enonic.xp.core.impl.i18n,0,0,0,0,0,0,1,1
enonic_xp,com.enonic.xp.ignite.impl.config,0,0,0,0,0,0,1,1
enonic_xp,com.enonic.xp.ignite.impl,0,1,0,0,0,0,1,2
enonic_xp,com.enonic.xp.ignite.impl.reporter,0,0,0,0,0,0,1,1
enonic_xp,com.enonic.xp.core.impl.image,0,0,0,0,0,0,1,1
enonic_xp,com.enonic.xp.core.impl.image.command,0,0,0,1,0,0,1,2
enonic_xp,com.enonic.xp.core.impl.image.effect,0,0,0,0,0,0,1,1
enonic_xp,com.enonic.xp.core.impl.image.parser,0,0,0,0,0,0,1,1
enonic_xp,com.enonic.xp.core.internal,0,0,0,0,0,0,1,1
enonic_xp,com.enonic.xp.impl.macro,0,0,0,0,0,0,1,1
enonic_xp,com.enonic.xp.mail.impl,0,0,0,0,0,0,1,1
enonic_xp,com.enonic.xp.core.impl.media,0,0,0,0,1,0,1,2
enonic_xp,com.enonic.xp.repo.impl.binary,4,1,0,0,0,0,1,6
enonic_xp,com.enonic.xp.repo.impl.branch,0,0,0,0,0,0,1,1
enonic_xp,com.enonic.xp.repo.impl.branch.search,8,1,0,0,0,0,1,10
enonic_xp,com.enonic.xp.repo.impl.branch.storage,14,0,0,0,1,0,1,16
enonic_xp,com.enonic.xp.repo.impl.cache,1,1,0,0,0,0,1,3
enonic_xp,com.enonic.xp.repo.impl.cluster,0,0,0,0,0,0,1,1
enonic_xp,com.enonic.xp.repo.impl.commit,2,0,0,0,0,0,1,3
enonic_xp,com.enonic.xp.repo.impl.commit.search,2,0,0,0,0,0,1,3
enonic_xp,com.enonic.xp.repo.impl.commit.storage,3,0,0,0,0,0,1,4
enonic_xp,com.enonic.xp.repo.impl.config,0,0,0,0,0,0,1,1
enonic_xp,com.enonic.xp.repo.impl.dump,2,0,0,0,0,0,1,3
enonic_xp,com.enonic.xp.repo.impl.dump.model,0,0,0,0,0,0,1,1
enonic_xp,com.enonic.xp.repo.impl.dump.reader,1,1,0,0,0,0,1,3
enonic_xp,com.enonic.xp.repo.impl.dump.serializer,0,0,0,0,0,0,1,1
enonic_xp,com.enonic.xp.repo.impl.dump.serializer.json,0,1,0,0,0,0,1,2
enonic_xp,com.enonic.xp.repo.impl.dump.upgrade,0,0,0,0,0,0,1,1
enonic_xp,com.enonic.xp.repo.impl.dump.upgrade.commit,0,0,0,0,0,0,1,1
enonic_xp,com.enonic.xp.repo.impl.dump.upgrade.flattenedpage,0,0,0,0,1,0,1,2
enonic_xp,com.enonic.xp.repo.impl.dump.upgrade.htmlarea,0,0,0,0,0,0,1,1
enonic_xp,com.enonic.xp.repo.impl.dump.upgrade.indexaccesssegments,0,0,0,0,0,0,1,1
enonic_xp,com.enonic.xp.repo.impl.dump.upgrade.obsoletemodel.pre2,0,0,0,0,0,0,1,1
enonic_xp,com.enonic.xp.repo.impl.dump.upgrade.obsoletemodel.pre4,0,0,0,0,1,0,1,2
enonic_xp,com.enonic.xp.repo.impl.dump.upgrade.obsoletemodel.pre5,0,0,0,0,0,0,1,1
enonic_xp,com.enonic.xp.repo.impl.dump.upgrade.obsoletemodel.pre6,0,0,0,0,0,0,1,1
enonic_xp,com.enonic.xp.repo.impl.dump.writer,1,1,0,0,0,0,1,3
enonic_xp,com.enonic.xp.repo.impl.elasticsearch,14,1,0,0,1,0,1,17
enonic_xp,com.enonic.xp.repo.impl.elasticsearch.aggregation,0,0,1,0,0,0,1,2
enonic_xp,com.enonic.xp.repo.impl.elasticsearch.aggregation.query,0,0,0,0,0,0,1,1
enonic_xp,com.enonic.xp.repo.impl.elasticsearch.document,2,1,0,0,0,0,1,4
enonic_xp,com.enonic.xp.repo.impl.elasticsearch.document.indexitem,5,1,0,0,0,0,1,7
enonic_xp,com.enonic.xp.repo.impl.elasticsearch.executor,17,1,0,0,0,0,1,19
enonic_xp,com.enonic.xp.repo.impl.elasticsearch.highlight,0,0,0,0,0,0,1,1
enonic_xp,com.enonic.xp.repo.impl.elasticsearch.query,0,0,0,0,0,0,1,1
enonic_xp,com.enonic.xp.repo.impl.elasticsearch.query.source,0,0,0,0,0,0,1,1
enonic_xp,com.enonic.xp.repo.impl.elasticsearch.query.translator,3,0,0,0,0,0,1,4
enonic_xp,com.enonic.xp.repo.impl.elasticsearch.query.translator.factory,8,1,0,0,1,0,1,11
enonic_xp,com.enonic.xp.repo.impl.elasticsearch.query.translator.factory.function,3,1,0,1,0,0,1,6
enonic_xp,com.enonic.xp.repo.impl.elasticsearch.query.translator.factory.query,3,0,0,0,0,0,1,4
enonic_xp,com.enonic.xp.repo.impl.elasticsearch.query.translator.resolver,5,1,0,0,0,0,1,7
enonic_xp,com.enonic.xp.repo.impl.elasticsearch.result,2,1,0,0,1,0,1,5
enonic_xp,com.enonic.xp.repo.impl.elasticsearch.search,2,1,0,0,0,0,1,4
enonic_xp,com.enonic.xp.repo.impl.elasticsearch.snapshot,4,0,0,0,0,0,1,5
enonic_xp,com.enonic.xp.repo.impl.elasticsearch.storage,3,1,0,0,0,0,1,5
enonic_xp,com.enonic.xp.repo.impl.elasticsearch.suggistion,0,0,0,0,0,0,1,1
enonic_xp,com.enonic.xp.repo.impl.elasticsearch.suggistion.query,0,0,0,0,0,0,1,1
enonic_xp,com.enonic.xp.repo.impl.elasticsearch.xcontent,2,0,0,0,0,0,1,3
enonic_xp,com.enonic.xp.repo.impl.index,34,1,0,0,1,0,1,37
enonic_xp,com.enonic.xp.repo.impl,0,0,0,0,1,0,1,2
enonic_xp,com.enonic.xp.repo.impl.node,27,1,0,1,0,0,1,30
enonic_xp,com.enonic.xp.repo.impl.node.dao,5,1,0,0,0,0,1,7
enonic_xp,com.enonic.xp.repo.impl.node.event,0,0,0,0,1,0,1,2
enonic_xp,com.enonic.xp.repo.impl.node.executor,0,0,0,0,0,0,1,1
enonic_xp,com.enonic.xp.repo.impl.node.json,0,0,0,0,0,0,1,1
enonic_xp,com.enonic.xp.repo.impl.repository,15,1,0,0,1,0,1,18
enonic_xp,com.enonic.xp.repo.impl.repository.event,2,0,0,0,0,0,1,3
enonic_xp,com.enonic.xp.repo.impl.search,16,1,0,0,1,0,1,19
enonic_xp,com.enonic.xp.repo.impl.search.result,11,1,0,0,0,0,1,13
enonic_xp,com.enonic.xp.repo.impl.storage,37,1,0,1,0,0,1,40
enonic_xp,com.enonic.xp.repo.impl.vacuum,0,1,0,0,1,0,1,3
enonic_xp,com.enonic.xp.repo.impl.vacuum.blob,0,0,0,0,0,0,1,1
enonic_xp,com.enonic.xp.repo.impl.vacuum.segment,0,0,0,0,0,0,1,1
enonic_xp,com.enonic.xp.repo.impl.vacuum.versiontable,0,0,0,0,0,0,1,1
enonic_xp,com.enonic.xp.repo.impl.version,8,1,0,0,0,0,1,10
enonic_xp,com.enonic.xp.repo.impl.version.search,2,0,0,0,1,0,1,4
enonic_xp,com.enonic.xp.repo.impl.version.storage,3,0,0,0,0,0,1,4
enonic_xp,com.enonic.xp.repo.impl.elasticsearch.branch,0,0,0,0,0,0,1,1
enonic_xp,com.enonic.xp.repo.impl.elasticsearch.query.result,0,0,0,0,0,0,1,1
enonic_xp,com.enonic.xp.repo.impl.elasticsearch.suggestion.query,0,0,0,0,0,0,1,1
enonic_xp,com.enonic.xp.repo.impl.elasticsearch.suggestion,0,0,0,0,0,0,1,1
enonic_xp,com.enonic.xp.repo.impl.node.query.aggregation,0,0,0,0,1,0,1,2
enonic_xp,com.enonic.xp.repo.impl.node.query,0,0,0,0,0,0,1,1
enonic_xp,com.enonic.xp.repo.impl.storage.branch,0,0,0,0,0,0,1,1
enonic_xp,com.enonic.xp.repo.impl.storage.result,0,0,0,0,0,0,1,1
enonic_xp,com.enonic.xp.core.impl.form,0,0,0,0,0,0,1,1
enonic_xp,com.enonic.xp.core.impl.schema.content,0,0,0,0,0,0,1,1
enonic_xp,com.enonic.xp.core.impl.schema.mixin,0,0,0,0,0,0,1,1
enonic_xp,com.enonic.xp.core.impl.schema.relationship,0,0,0,0,0,0,1,1
enonic_xp,com.enonic.xp.core.impl.schema,0,0,0,0,0,0,1,1
enonic_xp,com.enonic.xp.core.impl.schema.xdata,0,0,0,0,0,0,1,1
enonic_xp,com.enonic.xp.core.impl.security,0,0,0,0,0,0,1,1
enonic_xp,com.enonic.xp.core.impl.service,0,0,0,0,0,0,1,1
enonic_xp,com.enonic.xp.core.impl.site,0,0,0,0,0,0,1,1
enonic_xp,com.enonic.xp.core.impl.style,0,0,0,0,0,0,1,1
enonic_xp,com.enonic.xp.impl.task.cluster,1,1,0,0,0,0,1,3
enonic_xp,com.enonic.xp.impl.task.event,0,0,0,0,0,0,1,1
enonic_xp,com.enonic.xp.impl.task.script,0,0,0,0,0,0,1,1
enonic_xp,com.enonic.xp.impl.task,1,0,0,0,1,0,1,3
enonic_xp,com.enonic.xp.core.audit,0,0,0,0,0,0,1,1
enonic_xp,com.enonic.xp.core.content,0,0,0,1,0,0,1,2
enonic_xp,com.enonic.xp.core.issue,0,0,0,0,0,0,1,1
enonic_xp,com.enonic.xp.core.repo.vacuum.versiontable,0,0,0,0,0,0,1,1
enonic_xp,com.enonic.xp.jaxrs,0,0,0,0,0,0,1,1
enonic_xp,com.enonic.xp.jaxrs.impl,0,1,0,0,0,0,1,2
enonic_xp,com.enonic.xp.jaxrs.impl.exception,0,0,0,0,0,0,1,1
enonic_xp,com.enonic.xp.jaxrs.impl.image,0,0,0,0,0,0,1,1
enonic_xp,com.enonic.xp.jaxrs.impl.json,0,1,0,0,0,0,1,2
enonic_xp,com.enonic.xp.jaxrs.impl.multipart,0,0,0,0,0,0,1,1
enonic_xp,com.enonic.xp.jaxrs.impl.security,0,0,0,0,0,0,1,1
enonic_xp,com.enonic.xp.launcher,1,1,0,0,1,0,1,4
enonic_xp,com.enonic.xp.launcher.impl.config,0,0,0,0,0,0,1,1
enonic_xp,com.enonic.xp.launcher.impl.env,0,0,0,0,0,0,1,1
enonic_xp,com.enonic.xp.launcher.impl.framework,1,0,0,0,0,0,1,2
enonic_xp,com.enonic.xp.launcher.impl,2,0,0,0,0,0,1,3
enonic_xp,com.enonic.xp.launcher.impl.provision,0,0,0,0,0,0,1,1
enonic_xp,com.enonic.xp.launcher.impl.util,2,1,0,0,0,0,1,4
enonic_xp,com.enonic.xp.launcher.ui,2,1,0,0,0,0,1,4
enonic_xp,com.enonic.xp.launcher.ui.panel,1,0,0,0,0,0,1,2
enonic_xp,com.enonic.xp.launcher.ui.util,0,0,0,0,0,0,1,1
enonic_xp,com.enonic.xp.lib.admin,0,0,0,0,0,0,1,1
enonic_xp,com.enonic.xp.lib.audit,0,0,0,0,1,0,1,2
enonic_xp,com.enonic.xp.lib.audit.mapper,0,0,0,0,0,0,1,1
enonic_xp,com.enonic.xp.lib.auth,0,0,0,1,1,0,1,3
enonic_xp,com.enonic.xp.lib.cluster,0,0,0,0,0,0,1,1
enonic_xp,com.enonic.xp.lib.common,0,0,0,0,1,0,1,2
enonic_xp,com.enonic.xp.lib.content,0,0,0,1,1,0,1,3
enonic_xp,com.enonic.xp.lib.content.mapper,0,0,0,0,1,0,1,2
enonic_xp,com.enonic.xp.lib.context,0,0,0,0,0,0,1,1
enonic_xp,com.enonic.xp.lib.event,0,0,0,0,0,0,1,1
enonic_xp,com.enonic.xp.lib.i18n,0,0,0,0,0,0,1,1
enonic_xp,com.enonic.xp.lib.io,0,0,0,0,0,0,1,1
enonic_xp,com.enonic.xp.lib.mail,0,0,0,0,0,0,1,1
enonic_xp,com.enonic.xp.lib.node,1,0,0,1,0,0,1,3
enonic_xp,com.enonic.xp.lib.node.mapper,1,1,0,0,1,0,1,4
enonic_xp,com.enonic.xp.lib.portal.current,0,0,0,0,1,0,1,2
enonic_xp,com.enonic.xp.lib.portal.multipart,0,0,0,0,0,0,1,1
enonic_xp,com.enonic.xp.lib.portal,0,0,0,0,0,0,1,1
enonic_xp,com.enonic.xp.lib.portal.url,0,0,0,0,1,0,1,2
enonic_xp,com.enonic.xp.lib.repo,0,0,0,0,1,0,1,2
enonic_xp,com.enonic.xp.lib.repo.mapper,0,0,0,0,0,0,1,1
enonic_xp,com.enonic.xp.lib.task,0,0,0,0,1,0,1,2
enonic_xp,com.enonic.xp.lib.value,0,0,0,0,0,0,1,1
enonic_xp,com.enonic.xp.lib.websocket,0,0,0,0,0,0,1,1
enonic_xp,com.enonic.xp.portal.controller,1,0,0,0,0,0,1,2
enonic_xp,com.enonic.xp.portal.filter,0,0,0,0,0,0,1,1
enonic_xp,com.enonic.xp.portal.handler,0,0,0,0,1,0,1,2
enonic_xp,com.enonic.xp.portal.idprovider,0,0,0,0,0,0,1,1
enonic_xp,com.enonic.xp.portal.macro,0,0,0,0,0,0,1,1
enonic_xp,com.enonic.xp.portal.owasp,0,0,0,0,0,0,1,1
enonic_xp,com.enonic.xp.portal,1,1,0,0,1,0,1,4
enonic_xp,com.enonic.xp.portal.postprocess,0,0,0,0,0,0,1,1
enonic_xp,com.enonic.xp.portal.script,0,0,0,0,0,0,1,1
enonic_xp,com.enonic.xp.portal.url,0,0,0,0,0,0,1,1
enonic_xp,com.enonic.xp.portal.view,0,1,0,0,0,0,1,2
enonic_xp,com.enonic.xp.portal.websocket,0,0,0,0,0,0,1,1
enonic_xp,com.enonic.xp.portal.impl.app,0,0,0,0,0,0,1,1
enonic_xp,com.enonic.xp.portal.impl.controller,1,0,0,0,0,0,1,2
enonic_xp,com.enonic.xp.portal.impl.error,1,0,0,0,0,0,1,2
enonic_xp,com.enonic.xp.portal.impl.exception,0,0,0,0,1,0,1,2
enonic_xp,com.enonic.xp.portal.impl.filter,0,0,0,0,0,0,1,1
enonic_xp,com.enonic.xp.portal.impl.handler.asset,0,0,0,0,0,0,1,1
enonic_xp,com.enonic.xp.portal.impl.handler.attachment,0,0,0,0,0,0,1,1
enonic_xp,com.enonic.xp.portal.impl.handler.error,0,0,0,0,0,0,1,1
enonic_xp,com.enonic.xp.portal.impl.handler.identity,0,0,0,0,0,0,1,1
enonic_xp,com.enonic.xp.portal.impl.handler.image,0,0,0,0,0,0,1,1
enonic_xp,com.enonic.xp.portal.impl.handler.mapping,0,0,0,0,0,0,1,1
enonic_xp,com.enonic.xp.portal.impl.handler.portal,0,0,0,0,0,0,1,1
enonic_xp,com.enonic.xp.portal.impl.handler.render,0,0,0,0,0,0,1,1
enonic_xp,com.enonic.xp.portal.impl.handler.service,0,0,0,0,0,0,1,1
enonic_xp,com.enonic.xp.portal.impl.idprovider,0,0,0,0,1,0,1,2
enonic_xp,com.enonic.xp.portal.impl.macro,0,0,0,0,0,0,1,1
enonic_xp,com.enonic.xp.portal.impl.main,0,0,0,0,0,0,1,1
enonic_xp,com.enonic.xp.portal.impl.mapper,1,1,0,0,0,0,1,3
enonic_xp,com.enonic.xp.portal.impl.parser,2,1,0,0,0,0,1,4
enonic_xp,com.enonic.xp.portal.impl,0,0,0,0,0,0,1,1
enonic_xp,com.enonic.xp.portal.impl.postprocess.injection,0,0,0,0,0,0,1,1
enonic_xp,com.enonic.xp.portal.impl.postprocess.instruction,2,0,0,0,0,0,1,3
enonic_xp,com.enonic.xp.portal.impl.postprocess,2,0,0,0,0,0,1,3
enonic_xp,com.enonic.xp.portal.impl.processor,2,1,0,0,1,0,1,5
enonic_xp,com.enonic.xp.portal.impl.rendering,4,1,0,0,0,0,1,6
enonic_xp,com.enonic.xp.portal.impl.script,0,0,0,0,0,0,1,1
enonic_xp,com.enonic.xp.portal.impl.url,2,1,0,0,0,0,1,4
enonic_xp,com.enonic.xp.portal.impl.view,0,0,0,1,1,0,1,3
enonic_xp,com.enonic.xp.portal.impl.websocket,0,0,0,0,1,0,1,2
enonic_xp,com.enonic.xp.portal.impl.serializer,0,0,0,0,0,0,1,1
enonic_xp,com.enonic.xp.portal.owasp.impl,0,0,0,0,0,0,1,1
enonic_xp,com.enonic.xp.script.bean,0,0,0,0,0,0,1,1
enonic_xp,com.enonic.xp.script.event,0,0,0,0,0,0,1,1
enonic_xp,com.enonic.xp.script.runtime,0,0,0,0,0,0,1,1
enonic_xp,com.enonic.xp.script,0,0,0,0,0,0,1,1
enonic_xp,com.enonic.xp.script.serializer,0,0,0,0,0,0,1,1
enonic_xp,com.enonic.xp.script.impl.bean,1,0,0,0,1,0,1,3
enonic_xp,com.enonic.xp.script.impl.event,0,0,0,0,0,0,1,1
enonic_xp,com.enonic.xp.script.impl.executor,2,1,0,0,0,0,1,4
enonic_xp,com.enonic.xp.script.impl.function,2,0,0,0,1,0,1,4
enonic_xp,com.enonic.xp.script.impl.purplejs,0,0,0,0,0,0,1,1
enonic_xp,com.enonic.xp.script.impl,0,0,0,0,1,0,1,2
enonic_xp,com.enonic.xp.script.impl.service,0,0,0,0,0,0,1,1
enonic_xp,com.enonic.xp.script.impl.standard,0,1,0,0,0,0,1,2
enonic_xp,com.enonic.xp.script.impl.util,0,0,0,0,1,0,1,2
enonic_xp,com.enonic.xp.script.impl.value,0,0,0,0,0,0,1,1
enonic_xp,com.enonic.xp.script.impl.serializer,0,0,0,0,0,0,1,1
enonic_xp,com.enonic.xp.server.internal.config,0,0,0,0,0,0,1,1
enonic_xp,com.enonic.xp.server.internal.deploy,0,0,0,0,0,0,1,1
enonic_xp,com.enonic.xp.impl.server.rest,3,1,0,0,1,0,1,6
enonic_xp,com.enonic.xp.impl.server.rest.model,2,1,0,1,1,0,1,6
enonic_xp,com.enonic.xp.impl.server.rest.task,2,0,0,0,0,0,1,3
enonic_xp,com.enonic.xp.impl.server.rest.task.listener,0,0,0,0,1,0,1,2
enonic_xp,com.enonic.xp.server.shell.impl,0,0,0,0,0,0,1,1
enonic_xp,com.enonic.xp.server.impl.status,0,0,0,0,1,0,1,2
enonic_xp,com.enonic.xp.server.internal.trace.event,0,0,0,0,0,0,1,1
enonic_xp,com.enonic.xp.server.internal.trace,0,0,0,0,0,0,1,1
enonic_xp,com.enonic.xp.server.udc.impl,0,0,0,0,0,0,1,1
enonic_xp,com.enonic.xp.web.dispatch,0,0,0,0,1,0,1,2
enonic_xp,com.enonic.xp.web.exception,0,0,0,0,0,0,1,1
enonic_xp,com.enonic.xp.web.filter,0,0,0,0,1,0,1,2
enonic_xp,com.enonic.xp.web.handler,0,0,0,0,0,0,1,1
enonic_xp,com.enonic.xp.web,0,1,0,0,1,0,1,3
enonic_xp,com.enonic.xp.web.multipart,0,0,0,0,0,0,1,1
enonic_xp,com.enonic.xp.web.serializer,0,0,0,0,0,0,1,1
enonic_xp,com.enonic.xp.web.servlet,0,0,0,0,0,0,1,1
enonic_xp,com.enonic.xp.web.thread,0,0,0,0,0,0,1,1
enonic_xp,com.enonic.xp.web.vhost,0,0,0,0,0,0,1,1
enonic_xp,com.enonic.xp.web.websocket,0,0,0,0,1,0,1,2
enonic_xp,com.enonic.xp.web.impl.dispatch,0,0,0,0,0,0,1,1
enonic_xp,com.enonic.xp.web.impl.dispatch.mapping,0,0,0,0,0,0,1,1
enonic_xp,com.enonic.xp.web.impl.dispatch.pipeline,0,0,0,0,1,0,1,2
enonic_xp,com.enonic.xp.web.impl.dispatch.status,0,0,0,0,0,0,1,1
enonic_xp,com.enonic.xp.web.impl.dos,0,0,0,0,0,0,1,1
enonic_xp,com.enonic.xp.web.impl.header,0,0,0,0,0,0,1,1
enonic_xp,com.enonic.xp.web.impl.auth,0,0,0,0,0,0,1,1
enonic_xp,com.enonic.xp.web.impl.context,0,0,0,0,0,0,1,1
enonic_xp,com.enonic.xp.web.impl.exception,0,0,0,0,0,0,1,1
enonic_xp,com.enonic.xp.web.impl.handler,0,0,0,0,0,0,1,1
enonic_xp,com.enonic.xp.web.impl.multipart,0,0,0,0,0,0,1,1
enonic_xp,com.enonic.xp.web.impl.serializer,0,0,0,0,0,0,1,1
enonic_xp,com.enonic.xp.web.impl.trace,0,0,0,0,0,0,1,1
enonic_xp,com.enonic.xp.web.jetty.impl.configurator,0,0,0,0,0,0,1,1
enonic_xp,com.enonic.xp.web.jetty.impl,0,0,0,0,1,0,1,2
enonic_xp,com.enonic.xp.web.jetty.impl.session,0,0,0,0,0,0,1,1
enonic_xp,com.enonic.xp.web.jetty.impl.websocket,0,0,0,0,0,0,1,1
enonic_xp,com.enonic.xp.web.session.impl,0,0,0,0,1,0,1,2
enonic_xp,com.enonic.xp.web.session.impl.reporter,0,0,0,0,0,0,1,1
enonic_xp,com.enonic.xp.web.vhost.impl.config,0,0,0,0,0,0,1,1
enonic_xp,com.enonic.xp.web.vhost.impl.mapping,0,0,0,0,0,0,1,1
enonic_xp,com.enonic.xp.web.vhost.impl,0,0,0,0,0,0,1,1
ESAPI_esapi-java-legacy,(default package),0,0,0,0,0,1,0,1
ESAPI_esapi-java-legacy,org.owasp.esapi,4,1,0,1,1,7,0,14
ESAPI_esapi-java-legacy,org.owasp.esapi.codecs,2,0,0,1,0,2,0,5
ESAPI_esapi-java-legacy,org.owasp.esapi.configuration,1,1,0,0,0,3,0,5
ESAPI_esapi-java-legacy,org.owasp.esapi.crypto,2,1,0,0,0,2,0,5
ESAPI_esapi-java-legacy,org.owasp.esapi.errors,2,0,0,0,0,1,0,3
ESAPI_esapi-java-legacy,org.owasp.esapi.filters,0,0,0,0,1,1,0,2
ESAPI_esapi-java-legacy,org.owasp.esapi.logging.cleaning,0,0,0,0,1,0,0,1
ESAPI_esapi-java-legacy,org.owasp.esapi.logging.slf4j,0,0,0,0,1,0,0,1
ESAPI_esapi-java-legacy,org.owasp.esapi.reference,3,0,0,1,1,2,0,7
ESAPI_esapi-java-legacy,org.owasp.esapi.reference.accesscontrol,0,0,0,0,1,0,0,1
ESAPI_esapi-java-legacy,org.owasp.esapi.reference.accesscontrol.policyloader,0,0,0,0,1,0,0,1
ESAPI_esapi-java-legacy,org.owasp.esapi.reference.crypto,1,0,0,0,1,1,0,3
ESAPI_esapi-java-legacy,org.owasp.esapi.reference.validation,1,1,0,0,0,1,0,3
ESAPI_esapi-java-legacy,org.owasp.esapi.tags,0,0,0,0,1,0,0,1
ESAPI_esapi-java-legacy,org.owasp.esapi.util,4,0,0,0,1,1,0,6
ESAPI_esapi-java-legacy,org.owasp.esapi.waf.actions,0,0,0,0,0,0,0,0
ESAPI_esapi-java-legacy,org.owasp.esapi.waf.configuration,0,0,0,0,0,0,0,0
ESAPI_esapi-java-legacy,org.owasp.esapi.waf,0,0,0,0,0,0,0,0
ESAPI_esapi-java-legacy,org.owasp.esapi.waf.internal,0,0,0,0,1,0,0,1
ESAPI_esapi-java-legacy,org.owasp.esapi.waf.rules,0,0,0,0,1,0,0,1
ESAPI_esapi-java-legacy,org.owasp.esapi.codecs.abstraction,0,0,0,0,0,0,0,0
ESAPI_esapi-java-legacy,org.owasp.esapi.codecs.percent,0,0,0,0,0,0,0,0
ESAPI_esapi-java-legacy,org.owasp.esapi.http,0,0,0,0,1,0,0,1
ESAPI_esapi-java-legacy,org.owasp.esapi.reference.regex,0,0,0,0,0,0,0,0
ESAPI_esapi-java-legacy,org.owasp.esapi.util.generated,0,0,0,0,0,0,0,0
eseifert_gral,de.erichseifert.gral.data,5,1,0,1,0,0,1,8
eseifert_gral,de.erichseifert.gral.data.comparators,2,0,0,0,0,0,1,3
eseifert_gral,de.erichseifert.gral.data.filters,0,0,0,0,0,0,1,1
eseifert_gral,de.erichseifert.gral.data.statistics,2,0,0,0,1,0,1,4
eseifert_gral,de.erichseifert.gral.graphics,1,1,0,0,0,0,1,3
eseifert_gral,de.erichseifert.gral.graphics.layout,1,0,0,0,0,0,1,2
eseifert_gral,de.erichseifert.gral.io,0,0,0,0,1,0,1,2
eseifert_gral,de.erichseifert.gral.io.data,0,0,0,0,0,0,1,1
eseifert_gral,de.erichseifert.gral.io.plots,0,0,0,0,1,0,1,2
eseifert_gral,de.erichseifert.gral.navigation,0,0,0,0,1,0,1,2
eseifert_gral,de.erichseifert.gral,4,0,0,0,1,0,1,6
eseifert_gral,de.erichseifert.gral.plots,0,0,0,1,0,0,1,2
eseifert_gral,de.erichseifert.gral.plots.areas,0,0,0,0,1,0,1,2
eseifert_gral,de.erichseifert.gral.plots.axes,0,0,0,0,0,0,1,1
eseifert_gral,de.erichseifert.gral.plots.colors,0,0,0,0,0,0,1,1
eseifert_gral,de.erichseifert.gral.plots.legends,0,0,0,0,1,0,1,2
eseifert_gral,de.erichseifert.gral.plots.lines,0,0,0,0,0,0,1,1
eseifert_gral,de.erichseifert.gral.plots.points,0,0,0,0,0,0,1,1
eseifert_gral,de.erichseifert.gral.ui,0,0,0,0,0,0,1,1
eseifert_gral,de.erichseifert.gral.util,2,1,0,1,1,0,1,6
eseifert_gral,de.erichseifert.gral.examples.barplot,0,0,0,0,0,0,1,1
eseifert_gral,de.erichseifert.gral.examples.boxplot,0,0,0,0,0,0,1,1
eseifert_gral,de.erichseifert.gral.examples,0,0,0,0,0,0,1,1
eseifert_gral,de.erichseifert.gral.examples.io,0,0,0,0,0,0,1,1
eseifert_gral,de.erichseifert.gral.examples.pieplot,0,0,0,0,0,0,1,1
eseifert_gral,de.erichseifert.gral.examples.rasterplot,0,0,0,0,0,0,1,1
eseifert_gral,de.erichseifert.gral.examples.xyplot,0,0,0,0,1,0,1,2
eseifert_vectorgraphics2d,de.erichseifert.vectorgraphics2d,2,0,0,0,1,0,1,4
eseifert_vectorgraphics2d,de.erichseifert.vectorgraphics2d.eps,0,0,0,0,0,0,1,1
eseifert_vectorgraphics2d,de.erichseifert.vectorgraphics2d.intermediate.commands,2,1,0,0,0,0,1,4
eseifert_vectorgraphics2d,de.erichseifert.vectorgraphics2d.intermediate,1,1,0,0,0,0,1,3
eseifert_vectorgraphics2d,de.erichseifert.vectorgraphics2d.intermediate.filters,0,0,0,0,0,0,1,1
eseifert_vectorgraphics2d,de.erichseifert.vectorgraphics2d.pdf,0,0,0,0,0,0,1,1
eseifert_vectorgraphics2d,de.erichseifert.vectorgraphics2d.svg,0,0,0,0,0,0,1,1
eseifert_vectorgraphics2d,de.erichseifert.vectorgraphics2d.util,0,0,0,0,1,0,1,2
eseifert_vectorgraphics2d,de.erichseifert.vectorgraphics2d.visual,0,0,0,0,0,0,1,1
esigate_esigate,org.esigate.cas,0,0,0,0,0,0,1,1
esigate_esigate,org.esigate.aggregator,0,0,0,0,0,0,1,1
esigate_esigate,org.esigate.api,0,0,0,0,0,2,1,3
esigate_esigate,org.esigate.authentication,0,0,0,0,0,0,1,1
esigate_esigate,org.esigate.cache,3,0,0,0,1,0,1,5
esigate_esigate,org.esigate,19,1,0,0,1,2,1,24
esigate_esigate,org.esigate.cookie,0,0,0,0,0,0,1,1
esigate_esigate,org.esigate.esi,0,0,0,1,0,1,1,3
esigate_esigate,org.esigate.events,0,0,0,0,0,0,1,1
esigate_esigate,org.esigate.events.impl,0,0,0,0,1,0,1,2
esigate_esigate,org.esigate.extension,7,1,0,0,1,0,1,10
esigate_esigate,org.esigate.extension.http,2,0,0,0,0,0,1,3
esigate_esigate,org.esigate.extension.monitoring,0,0,0,0,0,0,1,1
esigate_esigate,org.esigate.extension.parallelesi,0,0,0,1,0,1,1,3
esigate_esigate,org.esigate.extension.surrogate,4,0,0,0,0,0,1,5
esigate_esigate,org.esigate.extension.surrogate.http,0,0,0,0,0,0,1,1
esigate_esigate,org.esigate.http,14,1,0,0,1,2,1,19
esigate_esigate,org.esigate.http.cookie,1,0,0,0,0,0,1,2
esigate_esigate,org.esigate.impl,7,0,0,0,1,0,1,9
esigate_esigate,org.esigate.parser,0,0,0,0,1,1,1,3
esigate_esigate,org.esigate.parser.future,0,0,0,0,1,1,1,3
esigate_esigate,org.esigate.renderers,2,0,0,0,0,0,1,3
esigate_esigate,org.esigate.tags,0,0,0,0,1,0,1,2
esigate_esigate,org.esigate.url,3,0,0,0,1,1,1,6
esigate_esigate,org.esigate.util,7,1,0,0,0,0,1,9
esigate_esigate,org.esigate.vars,2,0,0,0,1,2,1,6
esigate_esigate,org.esigate.xml,0,0,0,0,1,0,1,2
esigate_esigate,org.esigate.resource,0,0,0,0,0,1,1,2
esigate_esigate,org.esigate.server,0,0,0,0,0,0,1,1
esigate_esigate,org.esigate.server.metrics,0,0,0,0,0,0,1,1
esigate_esigate,org.esigate.servlet,0,0,0,0,1,0,1,2
esigate_esigate,org.esigate.servlet.impl,0,0,0,0,1,0,1,2
esigate_esigate,org.esigate.servlet.user,0,0,0,0,0,0,1,1
EsmerilProgramming_cloverx,org.esmerilprogramming.overtownacceptance.main,0,0,0,0,0,0,0,0
EsmerilProgramming_cloverx,org.esmerilprogramming.overtownacceptance.withappcontext.controllers,0,0,0,0,0,0,0,0
EsmerilProgramming_cloverx,org.esmerilprogramming.overtownacceptance,0,0,0,0,0,0,0,0
EsmerilProgramming_cloverx,br.esmerilprogramming,0,0,0,0,0,0,0,0
EsmerilProgramming_cloverx,br.esmerilprogramming.controller,0,0,0,0,0,0,0,0
EsmerilProgramming_cloverx,br.esmerilprogramming.model,0,0,0,0,0,0,0,0
EsmerilProgramming_cloverx,org.esmerilprogramming.overtown.annotation.session,0,0,0,0,0,0,0,0
EsmerilProgramming_cloverx,org.esmerilprogramming.overtown.http.converter,1,0,0,0,0,0,0,1
EsmerilProgramming_cloverx,org.esmerilprogramming.overtown.http,1,1,0,0,1,0,0,3
EsmerilProgramming_cloverx,org.esmerilprogramming.overtown.http.exception,0,0,0,0,0,0,0,0
EsmerilProgramming_cloverx,org.esmerilprogramming.overtown.management,0,0,0,0,0,0,0,0
EsmerilProgramming_cloverx,org.esmerilprogramming.overtown.management.model,0,0,0,0,0,0,0,0
EsmerilProgramming_cloverx,org.esmerilprogramming.overtown.scanner,0,0,0,0,1,0,0,1
EsmerilProgramming_cloverx,org.esmerilprogramming.overtown.scanner.exception,0,0,0,0,0,0,0,0
EsmerilProgramming_cloverx,org.esmerilprogramming.overtown.server,0,0,0,0,1,0,0,1
EsmerilProgramming_cloverx,org.esmerilprogramming.overtown.server.exception,0,0,0,0,0,0,0,0
EsmerilProgramming_cloverx,org.esmerilprogramming.overtown.server.handlers,0,0,0,0,1,0,0,1
EsmerilProgramming_cloverx,org.esmerilprogramming.overtown.server.handlers.exception,0,0,0,0,0,0,0,0
EsmerilProgramming_cloverx,org.esmerilprogramming.overtown.server.injection,0,0,0,0,0,0,0,0
EsmerilProgramming_cloverx,org.esmerilprogramming.overtown.server.mounters,0,0,0,0,0,0,0,0
EsmerilProgramming_cloverx,org.esmerilprogramming.overtown.view,0,0,0,0,0,0,0,0
EsmerilProgramming_cloverx,org.esmerilprogramming.overtown.server.handlers.helpers,0,0,0,0,0,0,0,0
EsmerilProgramming_cloverx,org.esmerilprogramming.overtown.server.mounters.helpers,0,0,0,0,0,0,0,0
ethereum_ethereumj,org.ethereum.cli,2,0,0,0,0,0,1,3
ethereum_ethereumj,org.ethereum,5,0,0,0,0,0,1,6
ethereum_ethereumj,org.ethereum.config.blockchain,0,0,0,0,0,0,1,1
ethereum_ethereumj,org.ethereum.config,76,1,0,0,0,0,1,78
ethereum_ethereumj,org.ethereum.config.net,3,1,0,0,0,0,1,5
ethereum_ethereumj,org.ethereum.core,60,1,0,1,0,0,1,63
ethereum_ethereumj,org.ethereum.core.genesis,3,0,0,0,1,0,1,5
ethereum_ethereumj,org.ethereum.crypto.cryptohash,0,0,0,0,0,0,1,1
ethereum_ethereumj,org.ethereum.crypto,17,1,0,0,0,0,1,19
ethereum_ethereumj,org.ethereum.crypto.jce,0,0,0,0,1,0,1,2
ethereum_ethereumj,org.ethereum.crypto.zksnark,0,0,0,0,0,0,1,1
ethereum_ethereumj,org.ethereum.datasource,16,1,0,1,0,0,1,19
ethereum_ethereumj,org.ethereum.datasource.inmem,4,1,0,0,0,0,1,6
ethereum_ethereumj,org.ethereum.datasource.leveldb,4,0,0,0,0,0,1,5
ethereum_ethereumj,org.ethereum.datasource.rocksdb,4,0,0,0,0,0,1,5
ethereum_ethereumj,org.ethereum.db,60,1,0,0,1,0,1,63
ethereum_ethereumj,org.ethereum.db.index,0,0,0,0,0,0,1,1
ethereum_ethereumj,org.ethereum.db.migrate,3,0,0,0,0,0,1,4
ethereum_ethereumj,org.ethereum.db.prune,3,0,0,0,0,0,1,4
ethereum_ethereumj,org.ethereum.facade,9,1,0,0,1,0,1,12
ethereum_ethereumj,org.ethereum.json,0,0,0,0,0,0,1,1
ethereum_ethereumj,org.ethereum.listener,17,1,0,0,0,0,1,19
ethereum_ethereumj,org.ethereum.manager,8,1,0,0,1,0,1,11
ethereum_ethereumj,org.ethereum.mine,3,1,0,1,0,0,1,6
ethereum_ethereumj,org.ethereum.net.client,4,1,0,0,0,0,1,6
ethereum_ethereumj,org.ethereum.net.dht,0,0,0,0,0,0,1,1
ethereum_ethereumj,org.ethereum.net.eth,0,0,0,0,0,0,1,1
ethereum_ethereumj,org.ethereum.net.eth.handler,6,1,0,0,0,0,1,8
ethereum_ethereumj,org.ethereum.net.eth.message,3,0,0,0,0,0,1,4
ethereum_ethereumj,org.ethereum.net.message,3,1,0,0,0,0,1,5
ethereum_ethereumj,org.ethereum.net,9,0,0,0,1,0,1,11
ethereum_ethereumj,org.ethereum.net.p2p,7,1,0,0,0,0,1,9
ethereum_ethereumj,org.ethereum.net.rlpx,16,1,0,1,0,0,1,19
ethereum_ethereumj,org.ethereum.net.rlpx.discover,3,1,0,0,0,0,1,5
ethereum_ethereumj,org.ethereum.net.rlpx.discover.table,5,1,0,0,0,0,1,7
ethereum_ethereumj,org.ethereum.net.server,14,1,0,0,0,0,1,16
ethereum_ethereumj,org.ethereum.net.shh,4,1,0,0,0,0,1,6
ethereum_ethereumj,org.ethereum.net.submit,3,0,0,0,0,0,1,4
ethereum_ethereumj,org.ethereum.net.swarm.bzz,6,1,0,0,0,0,1,8
ethereum_ethereumj,org.ethereum.net.swarm,7,1,0,1,0,0,1,10
ethereum_ethereumj,org.ethereum.solidity,4,0,0,0,0,0,1,5
ethereum_ethereumj,org.ethereum.solidity.compiler,3,1,0,0,1,0,1,6
ethereum_ethereumj,org.ethereum.sync,16,0,0,1,0,0,1,18
ethereum_ethereumj,org.ethereum.trie,4,1,0,0,0,0,1,6
ethereum_ethereumj,org.ethereum.util,29,1,0,1,1,0,1,33
ethereum_ethereumj,org.ethereum.util.blockchain,6,1,0,0,0,0,1,8
ethereum_ethereumj,org.ethereum.validator,6,1,0,0,0,0,1,8
ethereum_ethereumj,org.ethereum.vm,20,1,0,1,0,0,1,23
ethereum_ethereumj,org.ethereum.vm.hook,4,1,0,0,0,0,1,6
ethereum_ethereumj,org.ethereum.vm.program,14,1,0,0,0,0,1,16
ethereum_ethereumj,org.ethereum.vm.program.invoke,3,1,0,0,0,0,1,5
ethereum_ethereumj,org.ethereum.vm.program.listener,3,1,0,0,0,0,1,5
ethereum_ethereumj,org.ethereum.vm.trace,3,0,0,0,1,0,1,5
ethereum_ethereumj,org.ethereum.log,0,0,0,0,0,0,1,1
ethereum_ethereumj,org.ethereum.longrun,0,0,0,0,0,0,1,1
ethereum_ethereumj,org.ethereum.net.wire,0,0,0,0,0,0,1,1
ethereum_ethereumj,org.ethereum.tck,0,0,0,0,0,0,1,1
etsy_statsd-jvm-profiler,com.etsy.statsd.profiler,1,0,0,0,0,0,0,1
etsy_statsd-jvm-profiler,com.etsy.statsd.profiler.profilers,0,0,0,0,1,0,0,1
etsy_statsd-jvm-profiler,com.etsy.statsd.profiler.reporter,1,0,0,0,1,0,0,2
etsy_statsd-jvm-profiler,com.etsy.statsd.profiler.server,0,0,0,0,0,0,0,0
etsy_statsd-jvm-profiler,com.etsy.statsd.profiler.util,1,1,0,0,1,0,0,3
etsy_statsd-jvm-profiler,com.etsy.statsd.profiler.worker,0,0,0,0,1,0,0,1
etsy_statsd-jvm-profiler,com.etsy.statsd.profiler.reporter.mock,0,0,0,0,0,0,0,0
EugeneKay_subsonic,org.json,0,0,0,0,0,0,1,1
EugeneKay_subsonic,org.libresonic.player.ajax,6,0,0,0,1,0,1,8
EugeneKay_subsonic,org.libresonic.player.boot,0,0,0,0,0,0,1,1
EugeneKay_subsonic,org.libresonic.player.cache,0,0,0,0,0,0,1,1
EugeneKay_subsonic,org.libresonic.player.command,1,0,0,0,1,0,1,3
EugeneKay_subsonic,org.libresonic.player.controller,14,1,0,1,1,0,1,18
EugeneKay_subsonic,org.libresonic.player.dao,5,0,0,1,1,0,1,8
EugeneKay_subsonic,org.libresonic.player.domain,8,1,0,1,1,0,1,12
EugeneKay_subsonic,org.libresonic.player.filter,0,1,0,0,1,0,1,3
EugeneKay_subsonic,org.libresonic.player.i18n,2,0,0,0,0,0,1,3
EugeneKay_subsonic,org.libresonic.player.io,4,0,0,0,1,0,1,6
EugeneKay_subsonic,org.libresonic.player,21,1,0,0,0,0,1,23
EugeneKay_subsonic,org.libresonic.player.monitor,0,0,0,0,0,0,1,1
EugeneKay_subsonic,org.libresonic.player.security,0,0,0,0,0,0,1,1
EugeneKay_subsonic,org.libresonic.player.service,26,1,0,1,0,0,1,29
EugeneKay_subsonic,org.libresonic.player.service.jukebox,1,0,0,0,0,0,1,2
EugeneKay_subsonic,org.libresonic.player.service.metadata,4,0,0,0,1,0,1,6
EugeneKay_subsonic,org.libresonic.player.service.sonos,6,1,0,0,1,0,1,9
EugeneKay_subsonic,org.libresonic.player.service.upnp,2,0,0,0,1,0,1,4
EugeneKay_subsonic,org.libresonic.player.spring,0,0,0,0,1,0,1,2
EugeneKay_subsonic,org.libresonic.player.taglib,0,0,0,0,1,0,1,2
EugeneKay_subsonic,org.libresonic.player.theme,0,0,0,0,0,0,1,1
EugeneKay_subsonic,org.libresonic.player.upload,0,0,0,0,0,0,1,1
EugeneKay_subsonic,org.libresonic.player.util,4,0,0,0,1,0,1,6
EugeneKay_subsonic,org.libresonic.player.validator,2,0,0,0,0,0,1,3
EugeneKay_subsonic,org.libresonic.restapi,0,0,0,1,0,0,1,2
EugeneKay_subsonic,com.sonos.services._1,0,0,0,1,0,0,1,2
EugeneKay_subsonic,com.sonos.services._1_1,0,0,0,0,0,0,1,1
Evil-Co_NBT-Lib,com.evilco.mc.nbt.error,0,0,0,0,0,0,0,0
Evil-Co_NBT-Lib,com.evilco.mc.nbt.stream,0,0,0,0,0,0,0,0
Evil-Co_NBT-Lib,com.evilco.mc.nbt.tag,0,0,0,0,1,0,0,1
Evil-Co_NBT-Lib,(default package),0,0,0,0,0,0,0,0
evrythng_evrythng-java-sdk,com.evrythng.commons.domain,0,1,0,0,0,0,0,1
evrythng_evrythng-java-sdk,com.evrythng.commons,0,0,0,0,1,0,0,1
evrythng_evrythng-java-sdk,com.evrythng.commons.pagination,0,0,0,0,0,0,0,0
evrythng_evrythng-java-sdk,com.evrythng.commons.validation,0,0,0,0,0,0,0,0
evrythng_evrythng-java-sdk,com.evrythng.commons.validation.preconditions,0,0,0,0,0,0,0,0
evrythng_evrythng-java-sdk,com.evrythng.api.wrapper.param,0,0,0,0,0,0,0,0
evrythng_evrythng-java-sdk,com.evrythng.java.wrapper,0,0,0,0,0,1,0,1
evrythng_evrythng-java-sdk,com.evrythng.java.wrapper.core.api,0,0,0,0,1,0,0,1
evrythng_evrythng-java-sdk,com.evrythng.java.wrapper.core.api.param,0,0,0,0,1,0,0,1
evrythng_evrythng-java-sdk,com.evrythng.java.wrapper.core,0,0,0,0,1,1,0,2
evrythng_evrythng-java-sdk,com.evrythng.java.wrapper.core.http,0,0,0,0,0,0,0,0
evrythng_evrythng-java-sdk,com.evrythng.java.wrapper.examples,0,0,0,0,1,1,0,2
evrythng_evrythng-java-sdk,com.evrythng.java.wrapper.exception,1,0,0,0,0,0,0,1
evrythng_evrythng-java-sdk,com.evrythng.java.wrapper.mapping,0,0,0,0,1,0,0,1
evrythng_evrythng-java-sdk,com.evrythng.java.wrapper.service,0,0,0,0,1,1,0,2
evrythng_evrythng-java-sdk,com.evrythng.java.wrapper.util,1,1,0,0,1,0,0,3
evrythng_evrythng-java-sdk,com.evrythng.thng.commons.config,0,0,0,0,0,0,0,0
evrythng_evrythng-java-sdk,com.evrythng.thng.resource.model.access,0,0,0,0,0,0,0,0
evrythng_evrythng-java-sdk,com.evrythng.thng.resource.model.core,0,0,0,0,1,1,0,2
evrythng_evrythng-java-sdk,com.evrythng.thng.resource.model.exception,0,0,0,0,0,0,0,0
evrythng_evrythng-java-sdk,com.evrythng.thng.resource.model.li,0,0,0,0,0,0,0,0
evrythng_evrythng-java-sdk,com.evrythng.thng.resource.model.store,1,1,0,1,1,1,0,5
evrythng_evrythng-java-sdk,com.evrythng.thng.resource.model.store.action,0,1,0,0,1,0,0,2
evrythng_evrythng-java-sdk,com.evrythng.thng.resource.model.store.action.jobs.creation,0,0,0,0,0,0,0,0
evrythng_evrythng-java-sdk,com.evrythng.thng.resource.model.store.content,0,0,0,0,0,0,0,0
evrythng_evrythng-java-sdk,com.evrythng.thng.resource.model.store.geojson,1,0,0,0,0,0,0,1
evrythng_evrythng-java-sdk,com.evrythng.thng.resource.model.store.jobs,0,0,0,0,1,0,0,1
evrythng_evrythng-java-sdk,com.evrythng.thng.resource.model.store.rule.reaction,0,0,0,0,0,0,0,0
evrythng_evrythng-java-sdk,com.evrythng.thng.resource.model.store.security.passwords,0,0,0,0,0,0,0,0
evrythng_evrythng-java-sdk,com.evrythng.thng.resource.model.utils,0,0,0,0,0,0,0,0
ExactTarget_fuel-java,com.exacttarget.fuelsdk,0,0,0,1,0,0,0,1
ExactTarget_fuel-java,com.exacttarget.fuelsdk.internal,0,0,0,2,0,0,0,2
eXparity_hamcrest-date,org.exparity.hamcrest.date.core.function,0,0,0,0,1,0,0,1
eXparity_hamcrest-date,org.exparity.hamcrest.date.core,1,0,0,1,1,0,0,3
eXparity_hamcrest-date,org.exparity.hamcrest.date.core.types,0,0,0,0,1,0,0,1
eXparity_hamcrest-date,org.exparity.hamcrest.date,1,1,0,0,1,0,0,3
expercise_expercise,com.expercise,0,0,0,0,0,0,0,0
expercise_expercise,com.expercise.configuration.redis,0,0,0,0,0,0,0,0
expercise_expercise,com.expercise.configuration,0,0,0,0,0,0,0,0
expercise_expercise,com.expercise.controller,0,0,0,0,0,0,0,0
expercise_expercise,com.expercise.controller.caching,0,0,0,0,0,0,0,0
expercise_expercise,com.expercise.controller.challenge,0,0,0,0,0,0,0,0
expercise_expercise,com.expercise.controller.challenge.management,0,0,0,0,0,0,0,0
expercise_expercise,com.expercise.controller.challenge.model,0,0,0,0,1,0,0,1
expercise_expercise,com.expercise.controller.error,0,0,0,0,0,0,0,0
expercise_expercise,com.expercise.controller.leaderboard,0,0,0,0,0,0,0,0
expercise_expercise,com.expercise.controller.user,0,0,0,0,0,0,0,0
expercise_expercise,com.expercise.controller.user.management,0,0,0,0,0,0,0,0
expercise_expercise,com.expercise.controller.user.model,0,0,0,0,0,0,0,0
expercise_expercise,com.expercise.controller.utils,0,0,0,0,0,0,0,0
expercise_expercise,com.expercise.domain,0,0,0,0,0,0,0,0
expercise_expercise,com.expercise.domain.challenge,0,1,0,0,1,1,0,3
expercise_expercise,com.expercise.domain.quote,0,0,0,0,0,0,0,0
expercise_expercise,com.expercise.domain.token,0,0,0,0,0,0,0,0
expercise_expercise,com.expercise.domain.user,0,0,0,0,0,0,0,0
expercise_expercise,com.expercise.enums,0,0,0,0,0,0,0,0
expercise_expercise,com.expercise.exception,0,0,0,0,0,0,0,0
expercise_expercise,com.expercise.interceptor,0,0,0,0,0,0,0,0
expercise_expercise,com.expercise.interpreter,1,0,0,0,1,4,0,6
expercise_expercise,com.expercise.interpreter.javascript,0,0,0,0,0,0,0,0
expercise_expercise,com.expercise.repository,0,0,0,0,0,0,0,0
expercise_expercise,com.expercise.repository.challenge,0,0,0,0,1,0,0,1
expercise_expercise,com.expercise.repository.quote,0,0,0,0,0,0,0,0
expercise_expercise,com.expercise.repository.user,0,0,0,0,0,0,0,0
expercise_expercise,com.expercise.service.cache,0,0,0,0,0,0,0,0
expercise_expercise,com.expercise.service.challenge.action.postaction,0,0,0,0,1,3,0,4
expercise_expercise,com.expercise.service.challenge.action,0,0,0,0,1,0,0,1
expercise_expercise,com.expercise.service.challenge,0,0,0,0,1,2,0,3
expercise_expercise,com.expercise.service.challenge.model,1,1,0,0,0,3,0,5
expercise_expercise,com.expercise.service.configuration,0,0,0,0,0,0,0,0
expercise_expercise,com.expercise.service.email,0,0,0,0,1,0,0,1
expercise_expercise,com.expercise.service.email.model,0,0,0,0,0,0,0,0
expercise_expercise,com.expercise.service.i18n,0,0,0,0,0,0,0,0
expercise_expercise,com.expercise.service.language,0,0,0,0,1,0,0,1
expercise_expercise,com.expercise.service.notification,0,0,0,0,0,0,0,0
expercise_expercise,com.expercise.service.quote,0,0,0,0,0,0,0,0
expercise_expercise,com.expercise.service.user,0,0,0,0,1,2,0,3
expercise_expercise,com.expercise.service.util,0,0,0,0,0,0,0,0
expercise_expercise,com.expercise.utils.caching,0,0,0,0,0,0,0,0
expercise_expercise,com.expercise.utils,0,0,0,0,1,0,0,1
expercise_expercise,com.expercise.utils.collection,0,0,0,0,0,0,0,0
expercise_expercise,com.expercise.utils.validation,0,0,0,0,0,0,0,0
extjwnl_extjwnl,net.sf.extjwnl.data,6,1,0,1,1,7,0,16
extjwnl_extjwnl,net.sf.extjwnl.data.list,3,1,0,0,0,3,0,7
extjwnl_extjwnl,net.sf.extjwnl.data.relationship,4,0,0,0,0,3,0,7
extjwnl_extjwnl,net.sf.extjwnl.dictionary,3,1,0,1,0,10,0,15
extjwnl_extjwnl,net.sf.extjwnl.dictionary.database,0,0,0,0,0,3,0,3
extjwnl_extjwnl,net.sf.extjwnl.dictionary.file,0,0,0,0,1,0,0,1
extjwnl_extjwnl,net.sf.extjwnl.dictionary.file_manager,0,0,0,0,0,1,0,1
extjwnl_extjwnl,net.sf.extjwnl.dictionary.morph,0,0,0,0,0,1,0,1
extjwnl_extjwnl,net.sf.extjwnl,0,0,0,0,0,0,0,0
extjwnl_extjwnl,net.sf.extjwnl.princeton.data,0,0,0,0,0,0,0,0
extjwnl_extjwnl,net.sf.extjwnl.princeton.file,0,0,0,0,1,1,0,2
extjwnl_extjwnl,net.sf.extjwnl.util,0,0,0,0,1,8,0,9
extjwnl_extjwnl,net.sf.extjwnl.util.cache,0,0,0,0,1,0,0,1
extjwnl_extjwnl,net.sf.extjwnl.util.factory,0,1,0,0,1,1,0,3
extjwnl_extjwnl,net.sf.extjwnl.cli,0,0,0,0,0,0,0,0
extjwnl_extjwnl,net.sf.extjwnl.utilities,0,0,0,0,0,2,0,2
exxeleron_qJava,com.exxeleron.qjava,0,0,0,1,0,0,0,1
exxeleron_qJava,(default package),0,0,0,0,1,0,0,1
fabric8io_quickstarts,io.fabric8.tooling.archetype,0,0,0,0,0,0,0,0
fabric8io_quickstarts,io.fabric8.tooling.archetype.builder,0,0,0,0,1,0,0,1
fabric8io_quickstarts,io.fabric8.tooling.archetype.generator,0,0,0,0,0,0,0,0
fabric8io_quickstarts,io.fabric8.examples.helloworld,0,0,0,0,0,0,0,0
fabric8io_quickstarts,io.fabric8.examples.helloworld.impl,0,0,0,0,0,0,0,0
fabric8io_quickstarts,$,0,0,0,1,1,0,0,2
fabric8io_quickstarts,io.fabric8.funktion.example,0,0,0,0,0,0,0,0
fabric8io_quickstarts,io.fabric8.quickstarts.cxf.wstx,0,0,0,1,1,0,0,2
fabric8io_quickstarts,io.fabric8.archetypes.catalog,0,0,0,0,0,0,0,0
fabric8io_quickstarts,org.apache.camel.cassandraql,0,0,0,0,0,0,0,0
fabric8io_quickstarts,io.fabric8.example.camel.cassandra.routes,0,0,0,0,0,0,0,0
fabric8io_quickstarts,io.fabric8.quickstarts.camelcdi,0,0,0,0,1,0,0,1
fabric8io_quickstarts,io.fabric8.quickstarts.camelcdi.mq,0,0,0,0,0,0,0,0
fabric8io_quickstarts,org.apache.camel.example.cdi,0,0,0,0,0,0,0,0
fabric8io_quickstarts,io.fabric8.quickstarts.cxfcdi,0,0,0,0,1,0,0,1
fabric8io_quickstarts,io.fabric8.example.camel.infinispan.routes,0,0,0,0,0,0,0,0
fabric8io_quickstarts,io.fabric8.quickstarts.java.simple.fatjar,0,0,0,0,0,0,0,0
fabric8io_quickstarts,io.fabric8.quickstarts.java.simple,0,0,0,0,0,0,0,0
fabric8io_quickstarts,io.fabric8.quickstarts.camelamq,0,0,0,0,0,0,0,0
fabric8io_quickstarts,org.apache.camel.example.sql,0,0,0,0,0,0,0,0
fabric8io_quickstarts,org.apache.camel.example.sql.model,0,0,0,0,0,0,0,0
fabric8io_quickstarts,io.fabric8.quickstarts.rest,0,0,0,0,1,0,0,1
fabric8io_quickstarts,io.fabric8.quickstarts.camel.amq,0,0,0,0,0,0,0,0
fabric8io_quickstarts,io.fabric8.quickstarts.camel,0,0,0,0,1,0,0,1
fabric8io_quickstarts,io.fabric8.quickstarts.camel.config,0,0,0,0,0,0,0,0
fabric8io_quickstarts,io.fabric8.quickstarts.camel.drools,0,0,0,0,0,0,0,0
fabric8io_quickstarts,io.fabric8.quickstarts.camel.drools.model,0,0,0,0,0,0,0,0
fabric8io_quickstarts,io.fabric8.quickstarts.camel.infinispan,0,0,0,0,0,0,0,0
fabric8io_quickstarts,io.fabric8.quickstarts.camel.teiid,0,0,0,0,0,0,0,0
fabric8io_quickstarts,io.fabric8.quickstarts.cxf.jaxrs,0,0,0,0,1,0,0,1
fabric8io_quickstarts,io.fabric8.quickstarts.cxf.jaxws,0,0,0,0,1,0,0,1
fabric8io_quickstarts,io.fabric8.quickstarts.hystrix,0,0,0,0,0,0,0,0
fabric8io_quickstarts,io.fabric8.quickstarts.springbootmvc,0,0,0,0,1,0,0,1
fabric8io_quickstarts,io.fabric8.quickstarts.ribbon,0,0,0,0,0,0,0,0
fabric8io_quickstarts,io.fabric8.quickstarts.springbootmvc.domain,0,0,0,0,0,0,0,0
fabric8io_quickstarts,io.fabric8.quickstarts.swarm,0,0,0,0,0,0,0,0
fabric8io_quickstarts,io.fabric8.quickstarts.swarm.route,0,0,0,0,0,0,0,0
fabric8io_quickstarts,org.configmap.demo,0,0,0,0,0,0,0,0
fabric8io_quickstarts,io.vertx.example,0,0,0,0,0,0,0,0
FasterXML_jackson-dataformat-cbor,com.fasterxml.jackson.dataformat.cbor,0,0,0,0,1,0,0,1
feroult_yawp,io.yawp.driver.appengine,0,0,0,0,1,0,0,1
feroult_yawp,io.yawp.driver.appengine.pipes.flow,0,0,0,0,1,1,0,2
feroult_yawp,io.yawp.driver.appengine.pipes.flow.drops,0,1,0,0,0,0,0,1
feroult_yawp,io.yawp.driver.appengine.pipes.reflow,0,0,0,0,0,0,0,0
feroult_yawp,io.yawp.driver.appengine.pipes.reload,0,0,0,0,0,0,0,0
feroult_yawp,io.yawp.driver.appengine.pipes.utils,0,0,0,0,0,0,0,0
feroult_yawp,$,0,0,0,0,0,0,0,0
feroult_yawp,io.yawp.commons.config,0,0,0,0,0,0,0,0
feroult_yawp,io.yawp.commons.http,1,0,0,0,1,0,0,2
feroult_yawp,io.yawp.commons.utils,23,1,0,0,1,0,0,25
feroult_yawp,io.yawp.commons.utils.json.genson,0,0,0,0,1,0,0,1
feroult_yawp,io.yawp.commons.utils.json.gson,8,0,0,0,1,0,0,9
feroult_yawp,io.yawp.commons.utils.json,0,0,0,0,0,0,0,0
feroult_yawp,io.yawp.commons.utils.kind,0,0,0,0,0,0,0,0
feroult_yawp,io.yawp.driver.api,0,0,0,0,1,5,0,6
feroult_yawp,io.yawp.repository.actions,3,0,0,0,1,1,0,5
feroult_yawp,io.yawp.repository,31,1,0,0,1,9,0,42
feroult_yawp,io.yawp.repository.features,3,1,0,0,1,2,0,7
feroult_yawp,io.yawp.repository.features.scanner,6,0,0,0,0,0,0,6
feroult_yawp,io.yawp.repository.hooks,2,0,0,0,0,2,0,4
feroult_yawp,io.yawp.repository.models,9,1,0,0,0,5,0,15
feroult_yawp,io.yawp.repository.pipes,5,1,0,0,0,2,0,8
feroult_yawp,io.yawp.repository.pipes.pump,2,0,0,0,0,0,0,2
feroult_yawp,io.yawp.repository.query.condition,5,0,0,0,0,2,0,7
feroult_yawp,io.yawp.repository.query,10,0,0,0,1,5,0,16
feroult_yawp,io.yawp.repository.shields,3,0,0,0,1,3,0,7
feroult_yawp,io.yawp.repository.transformers,0,0,0,0,0,0,0,0
feroult_yawp,io.yawp.servlet.cache,3,1,0,0,0,0,0,4
feroult_yawp,io.yawp.servlet,0,0,0,0,1,2,0,3
feroult_yawp,io.yawp.servlet.rest,0,0,0,0,0,1,0,1
feroult_yawp,io.yawp.tools.datastore,0,0,0,0,0,1,0,1
feroult_yawp,io.yawp.tools.pipes,0,0,0,0,0,1,0,1
feroult_yawp,io.yawp.tools,0,0,0,0,0,0,0,0
feroult_yawp,io.yawp.driver.mock,0,0,0,0,0,0,0,0
feroult_yawp,io.yawp.repository.actions.basic,0,0,0,0,1,0,0,1
feroult_yawp,io.yawp.repository.actions.hierarchy,0,0,0,0,0,0,0,0
feroult_yawp,io.yawp.repository.actions.parents,0,0,0,0,1,0,0,1
feroult_yawp,io.yawp.repository.cache,0,0,0,0,0,0,0,0
feroult_yawp,io.yawp.repository.hooks.basic,0,0,0,0,0,0,0,0
feroult_yawp,io.yawp.repository.hooks.hierarchy,0,0,0,0,0,0,0,0
feroult_yawp,io.yawp.repository.hooks.parents,0,0,0,0,0,0,0,0
feroult_yawp,io.yawp.repository.models.basic,3,1,0,0,1,0,0,5
feroult_yawp,io.yawp.repository.models.basic.facades,0,0,0,0,0,0,0,0
feroult_yawp,io.yawp.repository.models.hierarchy,0,0,0,0,0,0,0,0
feroult_yawp,io.yawp.repository.models.parents,2,1,0,0,1,0,0,4
feroult_yawp,io.yawp.repository.pipes.basic,0,0,0,0,0,0,0,0
feroult_yawp,io.yawp.repository.pipes.parents,0,0,0,0,0,0,0,0
feroult_yawp,io.yawp.repository.shields.basic,0,0,0,0,0,1,0,1
feroult_yawp,io.yawp.repository.shields.hierarchy,0,0,0,0,0,0,0,0
feroult_yawp,io.yawp.repository.shields.parents,0,0,0,0,0,0,0,0
feroult_yawp,io.yawp.repository.transformers.basic,0,0,0,0,0,0,0,0
feroult_yawp,io.yawp.repository.transformers.hierarchy,0,0,0,0,0,0,0,0
feroult_yawp,io.yawp.repository.transformers.parents,0,0,0,0,0,0,0,0
feroult_yawp,io.yawp.servlet.child,0,0,0,0,0,0,0,0
feroult_yawp,io.yawp.servlet.grandchild,0,0,0,0,0,0,0,0
feroult_yawp,io.yawp.servlet.hierarchy,0,0,0,0,0,0,0,0
feroult_yawp,io.yawp.servlet.parent,0,0,0,0,0,0,0,0
feroult_yawp,io.yawp.plugin.devserver.appengine,0,0,0,0,1,0,0,1
feroult_yawp,io.yawp.plugin.devserver,0,0,0,0,0,0,0,0
feroult_yawp,io.yawp.plugin.mojos.base,0,0,0,0,0,0,0,0
feroult_yawp,io.yawp.plugin.mojos.devserver,0,0,0,0,0,0,0,0
feroult_yawp,io.yawp.plugin.mojos.scaffolding,0,0,0,0,1,0,0,1
feroult_yawp,io.yawp.plugin.mojos.scaffolding.mojo,0,0,0,0,1,0,0,1
feroult_yawp,io.yawp.plugin.mojos.sync,0,0,0,0,0,0,0,0
feroult_yawp,io.yawp.driver.postgresql.configuration,0,0,0,0,1,0,0,1
feroult_yawp,io.yawp.driver.postgresql.configuration.java,0,0,0,0,0,0,0,0
feroult_yawp,io.yawp.driver.postgresql.datastore,1,1,0,0,0,4,0,6
feroult_yawp,io.yawp.driver.postgresql,1,0,0,0,0,3,0,4
feroult_yawp,io.yawp.driver.postgresql.sql,0,0,0,0,0,0,0,0
feroult_yawp,io.yawp.driver.postgresql.tools,0,0,0,0,0,0,0,0
feroult_yawp,io.yawp.driver.postgresql.datastore.models,0,0,0,0,0,0,0,0
fesh0r_fernflower,org.jetbrains.java.decompiler.code.cfg,14,1,0,0,0,0,1,16
fesh0r_fernflower,org.jetbrains.java.decompiler.code,9,1,0,0,1,0,1,12
fesh0r_fernflower,org.jetbrains.java.decompiler.code.interpreter,2,0,0,0,0,0,1,3
fesh0r_fernflower,org.jetbrains.java.decompiler.main,38,1,0,0,0,0,1,40
fesh0r_fernflower,org.jetbrains.java.decompiler.main.collectors,12,1,0,0,0,0,1,14
fesh0r_fernflower,org.jetbrains.java.decompiler.main.decompiler,0,0,0,0,0,0,1,1
fesh0r_fernflower,org.jetbrains.java.decompiler.main.extern,9,1,0,0,0,0,1,11
fesh0r_fernflower,org.jetbrains.java.decompiler.main.rels,13,1,0,0,1,0,1,16
fesh0r_fernflower,org.jetbrains.java.decompiler.modules.code,4,0,0,0,0,0,1,5
fesh0r_fernflower,org.jetbrains.java.decompiler.modules.decompiler,15,1,0,0,0,0,1,17
fesh0r_fernflower,org.jetbrains.java.decompiler.modules.decompiler.decompose,5,1,0,0,1,0,1,8
fesh0r_fernflower,org.jetbrains.java.decompiler.modules.decompiler.deobfuscator,4,0,0,0,0,0,1,5
fesh0r_fernflower,org.jetbrains.java.decompiler.modules.decompiler.exps,28,1,0,0,0,0,1,30
fesh0r_fernflower,org.jetbrains.java.decompiler.modules.decompiler.sforms,4,1,0,0,0,0,1,6
fesh0r_fernflower,org.jetbrains.java.decompiler.modules.decompiler.stats,13,1,0,0,0,0,1,15
fesh0r_fernflower,org.jetbrains.java.decompiler.modules.decompiler.vars,3,1,0,0,0,0,1,5
fesh0r_fernflower,org.jetbrains.java.decompiler.modules.renamer,4,0,0,0,0,0,1,5
fesh0r_fernflower,org.jetbrains.java.decompiler.struct.attr,7,1,0,0,0,0,1,9
fesh0r_fernflower,org.jetbrains.java.decompiler.struct.consts,3,1,0,0,0,0,1,5
fesh0r_fernflower,org.jetbrains.java.decompiler.struct,12,1,0,0,0,0,1,14
fesh0r_fernflower,org.jetbrains.java.decompiler.struct.gen,12,1,0,0,0,0,1,14
fesh0r_fernflower,org.jetbrains.java.decompiler.struct.gen.generics,3,0,0,0,0,0,1,4
fesh0r_fernflower,org.jetbrains.java.decompiler.struct.lazy,3,0,0,0,0,0,1,4
fesh0r_fernflower,org.jetbrains.java.decompiler.struct.match,4,1,0,0,0,0,1,6
fesh0r_fernflower,org.jetbrains.java.decompiler.util,29,1,0,0,1,0,1,32
fesh0r_fernflower,org.jetbrains.java.decompiler,0,0,0,0,0,0,1,1
fesh0r_fernflower,pkg,0,0,0,1,1,0,1,3
fesh0r_fernflower,pkg.res,0,0,0,0,0,0,1,1
fesh0r_fernflower,(default package),0,0,0,1,1,0,1,3
fesh0r_fernflower,ext,0,0,0,0,0,0,1,1
fesh0r_fernflower,java11,0,0,0,0,0,0,1,1
fesh0r_fernflower,java9,0,0,0,0,0,0,1,1
fesh0r_fernflower,decompiler,0,0,0,0,1,0,1,2
fhoeben_hsac-fitnesse-fixtures,nl.hsac.fitnesse.fixture,10,1,0,0,0,0,0,11
fhoeben_hsac-fitnesse-fixtures,nl.hsac.fitnesse.fixture.fit,2,0,0,0,0,0,0,2
fhoeben_hsac-fitnesse-fixtures,nl.hsac.fitnesse.fixture.leanapps,3,0,0,0,0,0,0,3
fhoeben_hsac-fitnesse-fixtures,nl.hsac.fitnesse.fixture.slim,3,0,0,1,0,0,0,4
fhoeben_hsac-fitnesse-fixtures,nl.hsac.fitnesse.fixture.slim.web,0,0,0,0,1,0,0,1
fhoeben_hsac-fitnesse-fixtures,nl.hsac.fitnesse.fixture.util,11,1,0,1,1,0,0,14
fhoeben_hsac-fitnesse-fixtures,nl.hsac.fitnesse.fixture.util.selenium,6,0,0,0,1,0,0,7
fhoeben_hsac-fitnesse-fixtures,nl.hsac.fitnesse.fixture.util.selenium.by,2,1,0,1,0,0,0,4
fhoeben_hsac-fitnesse-fixtures,nl.hsac.fitnesse.fixture.util.selenium.by.grid,0,0,0,0,1,0,0,1
fhoeben_hsac-fitnesse-fixtures,nl.hsac.fitnesse.fixture.util.selenium.caching,0,0,0,0,0,0,0,0
fhoeben_hsac-fitnesse-fixtures,nl.hsac.fitnesse.fixture.util.selenium.driverfactory,4,1,0,0,0,0,0,5
fhoeben_hsac-fitnesse-fixtures,nl.hsac.fitnesse.junit,0,1,0,0,0,0,0,1
fhoeben_hsac-fitnesse-fixtures,nl.hsac.fitnesse.junit.reportmerge,0,1,0,0,0,0,0,1
fhoeben_hsac-fitnesse-fixtures,nl.hsac.fitnesse.junit.reportmerge.writer,0,0,0,0,1,0,0,1
fhoeben_hsac-fitnesse-fixtures,nl.hsac.fitnesse.junit.selenium,0,1,0,0,0,0,0,1
fhoeben_hsac-fitnesse-fixtures,nl.hsac.fitnesse.slim.converter,0,0,0,0,0,0,0,0
fhoeben_hsac-fitnesse-fixtures,nl.hsac.fitnesse.slim.interaction,1,0,0,0,1,0,0,2
fhoeben_hsac-fitnesse-fixtures,nl.hsac.fitnesse.reportgen,0,0,0,0,0,0,0,0
fhussonnois_storm-trident-elasticsearch,com.github.fhuss.storm.elasticsearch.bolt,0,0,0,0,0,0,0,0
fhussonnois_storm-trident-elasticsearch,com.github.fhuss.storm.elasticsearch,0,0,0,0,1,0,0,1
fhussonnois_storm-trident-elasticsearch,com.github.fhuss.storm.elasticsearch.commons,0,0,0,0,0,0,0,0
fhussonnois_storm-trident-elasticsearch,com.github.fhuss.storm.elasticsearch.handler,0,0,0,0,0,0,0,0
fhussonnois_storm-trident-elasticsearch,com.github.fhuss.storm.elasticsearch.mapper.impl,0,0,0,0,0,0,0,0
fhussonnois_storm-trident-elasticsearch,com.github.fhuss.storm.elasticsearch.mapper,0,0,0,0,0,0,0,0
fhussonnois_storm-trident-elasticsearch,com.github.fhuss.storm.elasticsearch.state,0,0,0,0,1,0,0,1
fhussonnois_storm-trident-elasticsearch,com.github.fhuss.storm.elasticsearch.functions,0,0,0,0,0,0,0,0
fhussonnois_storm-trident-elasticsearch,com.github.fhuss.storm.elasticsearch.model,0,0,0,0,0,0,0,0
fiji_Stitching,(default package),0,0,0,0,1,0,0,1
fiji_Stitching,mpicbg.stitching,0,0,0,0,1,0,0,1
fiji_Stitching,mpicbg.stitching.fusion,0,0,0,0,1,0,0,1
fiji_Stitching,plugin,0,0,0,0,0,0,0,0
fiji_Stitching,stitching,0,0,0,0,1,0,0,1
fiji_Stitching,stitching.model,0,0,0,0,1,0,0,1
fiji_Stitching,stitching.utils,0,0,0,0,0,0,0,0
fiji_Stitching,tools,0,0,0,0,0,0,0,0
fiji_TrackMate,fiji.plugin.trackmate.action,3,0,0,1,1,1,1,7
fiji_TrackMate,fiji.plugin.trackmate,45,1,0,1,1,7,1,56
fiji_TrackMate,fiji.plugin.trackmate.detection,2,0,0,0,1,0,1,4
fiji_TrackMate,fiji.plugin.trackmate.detection.semiauto,0,0,0,0,0,0,1,1
fiji_TrackMate,fiji.plugin.trackmate.detection.util,0,0,0,0,0,0,1,1
fiji_TrackMate,fiji.plugin.trackmate.features,2,0,0,0,1,0,1,4
fiji_TrackMate,fiji.plugin.trackmate.features.edges,3,1,0,0,0,0,1,5
fiji_TrackMate,fiji.plugin.trackmate.features.manual,3,1,0,0,0,0,1,5
fiji_TrackMate,fiji.plugin.trackmate.features.spot,2,0,0,0,1,0,1,4
fiji_TrackMate,fiji.plugin.trackmate.features.track,4,1,0,0,1,0,1,7
fiji_TrackMate,fiji.plugin.trackmate.graph,2,0,0,0,1,0,1,4
fiji_TrackMate,fiji.plugin.trackmate.gui,17,1,0,0,1,2,1,22
fiji_TrackMate,fiji.plugin.trackmate.gui.descriptors,25,1,0,0,1,5,1,33
fiji_TrackMate,fiji.plugin.trackmate.gui.panels,10,0,0,0,1,3,1,15
fiji_TrackMate,fiji.plugin.trackmate.gui.panels.components,4,1,0,0,1,2,1,9
fiji_TrackMate,fiji.plugin.trackmate.gui.panels.detector,0,0,0,0,0,0,1,1
fiji_TrackMate,fiji.plugin.trackmate.gui.panels.tracker,0,0,0,0,0,0,1,1
fiji_TrackMate,fiji.plugin.trackmate.io,15,1,0,0,1,0,1,18
fiji_TrackMate,fiji.plugin.trackmate.providers,2,1,0,0,1,3,1,8
fiji_TrackMate,fiji.plugin.trackmate.tracking.kalman,0,0,0,0,1,0,1,2
fiji_TrackMate,fiji.plugin.trackmate.tracking.kdtree,2,0,0,0,0,0,1,3
fiji_TrackMate,fiji.plugin.trackmate.tracking,0,0,0,0,0,1,1,2
fiji_TrackMate,fiji.plugin.trackmate.tracking.oldlap.costfunction,0,0,0,0,0,0,1,1
fiji_TrackMate,fiji.plugin.trackmate.tracking.oldlap.costmatrix,0,0,0,0,0,0,1,1
fiji_TrackMate,fiji.plugin.trackmate.tracking.oldlap,2,0,0,0,1,0,1,4
fiji_TrackMate,fiji.plugin.trackmate.tracking.oldlap.hungarian,0,0,0,0,1,0,1,2
fiji_TrackMate,fiji.plugin.trackmate.tracking.sparselap.costfunction,0,0,0,0,0,0,1,1
fiji_TrackMate,fiji.plugin.trackmate.tracking.sparselap.costmatrix,0,0,0,0,1,0,1,2
fiji_TrackMate,fiji.plugin.trackmate.tracking.sparselap.linker,0,0,0,0,1,0,1,2
fiji_TrackMate,fiji.plugin.trackmate.tracking.sparselap,2,0,0,0,1,0,1,4
fiji_TrackMate,fiji.plugin.trackmate.util,3,1,0,0,1,0,1,6
fiji_TrackMate,fiji.plugin.trackmate.visualization,7,1,0,0,1,2,1,12
fiji_TrackMate,fiji.plugin.trackmate.visualization.hyperstack,4,0,0,0,1,0,1,6
fiji_TrackMate,fiji.plugin.trackmate.visualization.threedviewer,0,0,0,0,0,0,1,1
fiji_TrackMate,fiji.plugin.trackmate.visualization.trackscheme,5,0,0,0,1,0,1,7
fiji_TrackMate,fiji.plugin.trackmate.visualization.trackscheme.utils,2,0,0,0,0,0,1,3
fiji_TrackMate,org.jfree.chart.annotations,0,0,0,0,0,0,1,1
fiji_TrackMate,org.jfree.chart.renderer,0,0,0,0,0,1,1,2
fiji_TrackMate,org.jfree.data.statistics,0,0,0,0,0,0,1,1
fiji_TrackMate,fiji.plugin.trackmate.features.edge,0,0,0,0,1,0,1,2
fiji_Trainable_Segmentation,ai,0,0,0,0,1,0,0,1
fiji_Trainable_Segmentation,hr.irb.fastRandomForest,0,0,0,0,1,0,0,1
fiji_Trainable_Segmentation,trainableSegmentation,0,0,0,0,1,0,0,1
fiji_Trainable_Segmentation,trainableSegmentation.filters,0,0,0,0,0,0,0,0
fiji_Trainable_Segmentation,trainableSegmentation.metrics,0,0,0,0,1,0,0,1
fiji_Trainable_Segmentation,trainableSegmentation.unsupervised,0,0,0,0,0,0,0,0
fiji_Trainable_Segmentation,trainableSegmentation.utils,0,0,0,0,1,0,0,1
filoghost_HolographicDisplays,com.gmail.filoghost.holographicdisplays.api.handler,0,0,0,0,0,0,0,0
filoghost_HolographicDisplays,com.gmail.filoghost.holographicdisplays.api,0,0,0,0,0,0,0,0
filoghost_HolographicDisplays,com.gmail.filoghost.holographicdisplays.api.internal,0,0,0,0,0,0,0,0
filoghost_HolographicDisplays,com.gmail.filoghost.holographicdisplays.api.line,0,0,0,0,0,0,0,0
filoghost_HolographicDisplays,com.gmail.filoghost.holographicdisplays.api.placeholder,0,0,0,0,0,0,0,0
filoghost_HolographicDisplays,com.gmail.filoghost.holographicdisplays.disk,0,0,0,0,0,0,0,0
filoghost_HolographicDisplays,com.gmail.filoghost.holographicdisplays.exception,0,0,0,0,1,0,0,1
filoghost_HolographicDisplays,java.lang,0,0,0,0,0,0,0,0
filoghost_HolographicDisplays,com.gmail.filoghost.holographicdisplays.nms.interfaces.entity,0,0,0,0,0,0,0,0
filoghost_HolographicDisplays,com.gmail.filoghost.holographicdisplays.nms.interfaces,0,0,0,0,0,0,0,0
filoghost_HolographicDisplays,com.gmail.filoghost.holographicdisplays.nms.v1_10_R1,0,0,0,0,1,0,0,1
filoghost_HolographicDisplays,com.gmail.filoghost.holographicdisplays.nms.v1_11_R1,0,0,0,0,1,0,0,1
filoghost_HolographicDisplays,com.gmail.filoghost.holographicdisplays.nms.v1_12_R1,0,0,0,0,1,0,0,1
filoghost_HolographicDisplays,com.gmail.filoghost.holographicdisplays.nms.v1_13_R1,0,0,0,0,1,0,0,1
filoghost_HolographicDisplays,com.gmail.filoghost.holographicdisplays.nms.v1_13_R2,0,0,0,0,1,0,0,1
filoghost_HolographicDisplays,com.gmail.filoghost.holographicdisplays.nms.v1_14_R1,0,0,0,0,1,0,0,1
filoghost_HolographicDisplays,com.gmail.filoghost.holographicdisplays.nms.v1_8_R1,0,0,0,0,1,0,0,1
filoghost_HolographicDisplays,com.gmail.filoghost.holographicdisplays.nms.v1_8_R2,0,0,0,0,1,0,0,1
filoghost_HolographicDisplays,com.gmail.filoghost.holographicdisplays.nms.v1_8_R3,0,0,0,0,1,0,0,1
filoghost_HolographicDisplays,com.gmail.filoghost.holographicdisplays.nms.v1_9_R1,0,0,0,0,1,0,0,1
filoghost_HolographicDisplays,com.gmail.filoghost.holographicdisplays.nms.v1_9_R2,0,0,0,0,1,0,0,1
filoghost_HolographicDisplays,com.gmail.filoghost.holograms.api,0,0,0,0,1,0,0,1
filoghost_HolographicDisplays,com.gmail.filoghost.holograms.api.replacements,0,0,0,0,0,0,0,0
filoghost_HolographicDisplays,com.gmail.filoghost.holographicdisplays.bridge.bungeecord,5,0,0,0,0,0,0,5
filoghost_HolographicDisplays,com.gmail.filoghost.holographicdisplays.bridge.bungeecord.serverpinger,0,0,0,0,0,0,0,0
filoghost_HolographicDisplays,com.gmail.filoghost.holographicdisplays.bridge.protocollib.current,0,0,0,0,0,0,0,0
filoghost_HolographicDisplays,com.gmail.filoghost.holographicdisplays.bridge.protocollib.current.packet,0,0,0,0,1,0,0,1
filoghost_HolographicDisplays,com.gmail.filoghost.holographicdisplays.bridge.protocollib,0,0,0,0,0,0,0,0
filoghost_HolographicDisplays,com.gmail.filoghost.holographicdisplays.commands,0,1,0,0,0,0,0,1
filoghost_HolographicDisplays,com.gmail.filoghost.holographicdisplays.commands.main,0,0,0,0,0,0,0,0
filoghost_HolographicDisplays,com.gmail.filoghost.holographicdisplays.commands.main.subs,0,0,0,0,1,0,0,1
filoghost_HolographicDisplays,com.gmail.filoghost.holographicdisplays.event,0,0,0,0,0,0,0,0
filoghost_HolographicDisplays,com.gmail.filoghost.holographicdisplays,8,1,0,0,0,0,0,9
filoghost_HolographicDisplays,com.gmail.filoghost.holographicdisplays.image,0,0,0,0,0,0,0,0
filoghost_HolographicDisplays,com.gmail.filoghost.holographicdisplays.listener,0,0,0,0,0,0,0,0
filoghost_HolographicDisplays,com.gmail.filoghost.holographicdisplays.object,5,1,0,0,1,0,0,7
filoghost_HolographicDisplays,com.gmail.filoghost.holographicdisplays.object.line,0,0,0,0,0,0,0,0
filoghost_HolographicDisplays,com.gmail.filoghost.holographicdisplays.placeholder,7,1,0,0,1,0,0,9
filoghost_HolographicDisplays,com.gmail.filoghost.holographicdisplays.task,3,0,0,0,0,0,0,3
filoghost_HolographicDisplays,com.gmail.filoghost.holographicdisplays.util,0,0,0,0,1,0,0,1
filoghost_HolographicDisplays,com.gmail.filoghost.holographicdisplays.util.reflection,0,0,0,0,0,0,0,0
finn-no_cassandra-hadoop,org.apache.cassandra.hadoop2,0,0,0,0,1,0,0,1
finn-no_cassandra-hadoop,org.apache.cassandra.hadoop2.cql3,0,0,0,0,1,0,0,1
finn-no_cassandra-hadoop,org.apache.cassandra.hadoop2.pig,0,0,0,0,0,0,0,0
finn-no_cassandra-hadoop,org.apache.cassandra.hadoop1,0,0,0,0,0,0,0,0
Firebase_geofire-java,com.firebase.geofire.core,1,1,0,0,0,0,0,2
Firebase_geofire-java,com.firebase.geofire,1,0,0,0,1,0,0,2
Firebase_geofire-java,com.firebase.geofire.util,0,0,0,0,0,0,0,0
fizzed_java-stork,(default package),0,0,0,0,0,0,0,0
fizzed_java-stork,com.fizzed.stork.assembly,0,0,0,0,0,0,0,0
fizzed_java-stork,com.fizzed.stork.core,0,0,0,0,0,0,0,0
fizzed_java-stork,com.fizzed.stork.demo.dropwizard,0,0,0,0,0,0,0,0
fizzed_java-stork,com.fizzed.stork.demo.hellod,0,0,0,0,0,0,0,0
fizzed_java-stork,com.fizzed.stork.deploy,0,0,0,0,0,0,0,0
fizzed_java-stork,com.fizzed.stork.launcher,0,0,0,0,1,0,0,1
fizzed_java-stork,com.fizzed.stork.maven,0,0,0,0,0,0,0,0
fizzed_stork,(default package),0,0,0,0,0,0,0,0
fizzed_stork,com.fizzed.stork.assembly,0,0,0,0,0,0,0,0
fizzed_stork,com.fizzed.stork.core,0,0,0,0,0,0,0,0
fizzed_stork,com.fizzed.stork.demo.dropwizard,0,0,0,0,0,0,0,0
fizzed_stork,com.fizzed.stork.demo.hellod,0,0,0,0,0,0,0,0
fizzed_stork,com.fizzed.stork.deploy,0,0,0,0,0,0,0,0
fizzed_stork,com.fizzed.stork.launcher,0,0,0,0,1,0,0,1
fizzed_stork,com.fizzed.stork.maven,0,0,0,0,0,0,0,0
flaxsearch_luwak,uk.co.flax.luwak.benchmark,0,0,0,0,1,0,0,1
flaxsearch_luwak,uk.co.flax.luwak.analysis,0,0,0,0,1,0,0,1
flaxsearch_luwak,uk.co.flax.luwak,4,1,0,1,1,0,0,7
flaxsearch_luwak,uk.co.flax.luwak.matchers,3,1,0,0,1,0,0,5
flaxsearch_luwak,uk.co.flax.luwak.presearcher,3,0,0,0,1,0,0,4
flaxsearch_luwak,uk.co.flax.luwak.queryparsers,0,0,0,0,0,0,0,0
flaxsearch_luwak,uk.co.flax.luwak.termextractor,3,1,0,0,1,0,0,5
flaxsearch_luwak,uk.co.flax.luwak.termextractor.querytree,2,1,0,0,1,0,0,4
flaxsearch_luwak,uk.co.flax.luwak.termextractor.treebuilder,2,0,0,0,1,0,0,3
flaxsearch_luwak,uk.co.flax.luwak.termextractor.weights,0,0,0,0,1,0,0,1
flaxsearch_luwak,uk.co.flax.luwak.util,0,0,0,0,1,0,0,1
flaxsearch_luwak,uk.co.flax.luwak.assertions,1,0,0,0,0,0,0,1
flaxsearch_luwak,uk.co.flax.luwak.demo,0,0,0,0,0,0,0,0
FlexTradeUKLtd_jfixture,com.flextrade.jfixture.annotations,0,0,0,0,0,0,0,0
FlexTradeUKLtd_jfixture,com.flextrade.jfixture,10,1,0,1,0,7,0,19
FlexTradeUKLtd_jfixture,com.flextrade.jfixture.behaviours.autoproperty,0,0,0,0,0,1,0,1
FlexTradeUKLtd_jfixture,com.flextrade.jfixture.behaviours.intercept,0,0,0,0,0,1,0,1
FlexTradeUKLtd_jfixture,com.flextrade.jfixture.behaviours.noresolution,2,0,0,0,0,0,0,2
FlexTradeUKLtd_jfixture,com.flextrade.jfixture.behaviours.recursion,0,0,0,0,0,0,0,0
FlexTradeUKLtd_jfixture,com.flextrade.jfixture.behaviours.specimentype,1,0,0,0,0,0,0,1
FlexTradeUKLtd_jfixture,com.flextrade.jfixture.behaviours.tracing,2,0,0,0,1,0,0,3
FlexTradeUKLtd_jfixture,com.flextrade.jfixture.builders,3,0,0,1,0,4,0,8
FlexTradeUKLtd_jfixture,com.flextrade.jfixture.customisation,8,1,0,0,0,0,0,9
FlexTradeUKLtd_jfixture,com.flextrade.jfixture.customisation.fluent,4,0,0,0,1,1,0,6
FlexTradeUKLtd_jfixture,com.flextrade.jfixture.exceptions,0,0,0,0,0,0,0,0
FlexTradeUKLtd_jfixture,com.flextrade.jfixture.extensions,0,0,0,0,0,0,0,0
FlexTradeUKLtd_jfixture,com.flextrade.jfixture.requests,0,0,0,0,1,2,0,3
FlexTradeUKLtd_jfixture,com.flextrade.jfixture.requests.enrichers,0,0,0,0,1,0,0,1
FlexTradeUKLtd_jfixture,com.flextrade.jfixture.rules,0,0,0,0,0,0,0,0
FlexTradeUKLtd_jfixture,com.flextrade.jfixture.runners,0,0,0,0,0,0,0,0
FlexTradeUKLtd_jfixture,com.flextrade.jfixture.specifications,0,0,0,0,0,2,0,2
FlexTradeUKLtd_jfixture,com.flextrade.jfixture.utility,0,0,0,1,1,4,0,6
FlexTradeUKLtd_jfixture,com.flextrade.jfixture.utility.comparators,0,0,0,0,0,0,0,0
FlexTradeUKLtd_jfixture,component.annotations,0,0,0,0,0,0,0,0
FlexTradeUKLtd_jfixture,component.behaviours,0,0,0,0,0,0,0,0
FlexTradeUKLtd_jfixture,component.customisation,0,0,0,0,1,1,0,2
FlexTradeUKLtd_jfixture,component.extensions,0,0,0,0,0,0,0,0
FlexTradeUKLtd_jfixture,component.generics,0,0,0,0,1,0,0,1
FlexTradeUKLtd_jfixture,component.runners,0,0,0,0,0,0,0,0
FlexTradeUKLtd_jfixture,component,0,0,0,0,1,0,0,1
FlexTradeUKLtd_jfixture,com.flextrade.jfixture.jodatime.customisation,0,0,0,0,0,1,0,1
FlexTradeUKLtd_jfixture,com.flextrade.jfixture.jodatime.component,0,0,0,0,0,0,0,0
FlexTradeUKLtd_jfixture,com.flextrade.jfixture.jupiter,0,0,0,0,0,0,0,0
FlexTradeUKLtd_jfixture,com.flextrade.jfixture.mockito.customisation,0,0,0,0,0,0,0,0
FlexTradeUKLtd_jfixture,com.flextrade.jfixture.mockito.utility,0,0,0,0,0,0,0,0
flipkart-incubator_foxtrot,com.flipkart.foxtrot.common,0,0,0,0,1,6,0,7
flipkart-incubator_foxtrot,com.flipkart.foxtrot.common.count,0,0,0,0,0,1,0,1
flipkart-incubator_foxtrot,com.flipkart.foxtrot.common.distinct,0,0,0,0,0,1,0,1
flipkart-incubator_foxtrot,com.flipkart.foxtrot.common.estimation,0,0,0,0,1,0,0,1
flipkart-incubator_foxtrot,com.flipkart.foxtrot.common.group,0,0,0,0,0,2,0,2
flipkart-incubator_foxtrot,com.flipkart.foxtrot.common.histogram,0,0,0,0,0,1,0,1
flipkart-incubator_foxtrot,com.flipkart.foxtrot.common.query.datetime,0,0,0,0,0,0,0,0
flipkart-incubator_foxtrot,com.flipkart.foxtrot.common.query,0,0,0,0,1,5,0,6
flipkart-incubator_foxtrot,com.flipkart.foxtrot.common.query.general,0,0,0,0,1,0,0,1
flipkart-incubator_foxtrot,com.flipkart.foxtrot.common.query.numeric,0,0,0,0,1,0,0,1
flipkart-incubator_foxtrot,com.flipkart.foxtrot.common.query.string,0,0,0,0,0,0,0,0
flipkart-incubator_foxtrot,com.flipkart.foxtrot.common.stats,0,0,0,0,1,1,0,2
flipkart-incubator_foxtrot,com.flipkart.foxtrot.common.trend,0,0,0,0,0,1,0,1
flipkart-incubator_foxtrot,com.flipkart.foxtrot.common.util,0,0,0,0,0,0,0,0
flipkart-incubator_foxtrot,com.flipkart.foxtrot.core.alerts,0,0,0,0,0,0,0,0
flipkart-incubator_foxtrot,com.flipkart.foxtrot.core.cache,0,0,0,0,0,0,0,0
flipkart-incubator_foxtrot,com.flipkart.foxtrot.core.cache.impl,0,0,0,0,0,0,0,0
flipkart-incubator_foxtrot,com.flipkart.foxtrot.core.cardinality,0,0,0,0,0,0,0,0
flipkart-incubator_foxtrot,com.flipkart.foxtrot.core.common,2,0,0,0,1,0,0,3
flipkart-incubator_foxtrot,com.flipkart.foxtrot.core.config,0,0,0,0,0,0,0,0
flipkart-incubator_foxtrot,com.flipkart.foxtrot.core.datastore,0,0,0,0,0,0,0,0
flipkart-incubator_foxtrot,com.flipkart.foxtrot.core.datastore.impl.hbase,1,0,0,0,1,0,0,2
flipkart-incubator_foxtrot,com.flipkart.foxtrot.core.email,0,0,0,0,0,0,0,0
flipkart-incubator_foxtrot,com.flipkart.foxtrot.core.email.messageformatting,0,0,0,0,0,0,0,0
flipkart-incubator_foxtrot,com.flipkart.foxtrot.core.email.messageformatting.impl,0,0,0,0,0,0,0,0
flipkart-incubator_foxtrot,com.flipkart.foxtrot.core.exception,0,0,0,0,0,1,0,1
flipkart-incubator_foxtrot,com.flipkart.foxtrot.core.internalevents.events,0,0,0,0,0,0,0,0
flipkart-incubator_foxtrot,com.flipkart.foxtrot.core.internalevents.impl,0,0,0,0,0,0,0,0
flipkart-incubator_foxtrot,com.flipkart.foxtrot.core.internalevents,0,0,0,0,1,0,0,1
flipkart-incubator_foxtrot,com.flipkart.foxtrot.core.jobs,0,0,0,0,0,0,0,0
flipkart-incubator_foxtrot,com.flipkart.foxtrot.core.jobs.optimization,0,0,0,0,0,0,0,0
flipkart-incubator_foxtrot,com.flipkart.foxtrot.core.parsers,0,0,0,0,0,0,0,0
flipkart-incubator_foxtrot,com.flipkart.foxtrot.core.querystore,8,1,0,0,1,0,0,10
flipkart-incubator_foxtrot,com.flipkart.foxtrot.core.querystore.actions,4,0,0,0,1,7,0,12
flipkart-incubator_foxtrot,com.flipkart.foxtrot.core.querystore.actions.spi,0,0,0,0,0,0,0,0
flipkart-incubator_foxtrot,com.flipkart.foxtrot.core.querystore.handlers,0,0,0,0,0,0,0,0
flipkart-incubator_foxtrot,com.flipkart.foxtrot.core.querystore.impl,12,1,0,0,1,0,0,14
flipkart-incubator_foxtrot,com.flipkart.foxtrot.core.querystore.mutator,0,0,0,0,0,0,0,0
flipkart-incubator_foxtrot,com.flipkart.foxtrot.core.querystore.query,0,0,0,0,0,0,0,0
flipkart-incubator_foxtrot,com.flipkart.foxtrot.core.table.impl,7,1,0,0,1,1,0,10
flipkart-incubator_foxtrot,com.flipkart.foxtrot.core.table,0,0,0,0,0,1,0,1
flipkart-incubator_foxtrot,com.flipkart.foxtrot.core.util,0,0,0,0,0,0,0,0
flipkart-incubator_foxtrot,com.google.common.base,0,0,0,0,0,0,0,0
flipkart-incubator_foxtrot,com.flipkart.foxtrot.core.common.cacheable,0,0,0,0,0,0,0,0
flipkart-incubator_foxtrot,com.flipkart.foxtrot.core.common.noncacheable,0,0,0,0,0,0,0,0
flipkart-incubator_foxtrot,com.flipkart.foxtrot.core,9,1,0,0,0,0,0,10
flipkart-incubator_foxtrot,impl,0,0,0,0,0,0,0,0
flipkart-incubator_foxtrot,com.flipkart.foxtrot.server,0,0,0,0,0,0,0,0
flipkart-incubator_foxtrot,com.flipkart.foxtrot.server.cluster,0,0,0,0,0,0,0,0
flipkart-incubator_foxtrot,com.flipkart.foxtrot.server.config,0,0,0,0,0,0,0,0
flipkart-incubator_foxtrot,com.flipkart.foxtrot.server.console,0,0,0,0,1,0,0,1
flipkart-incubator_foxtrot,com.flipkart.foxtrot.server.healthcheck,0,0,0,0,0,0,0,0
flipkart-incubator_foxtrot,com.flipkart.foxtrot.server.jobs.consolehistory,0,0,0,0,0,0,0,0
flipkart-incubator_foxtrot,com.flipkart.foxtrot.server.providers.exception,0,0,0,0,0,0,0,0
flipkart-incubator_foxtrot,com.flipkart.foxtrot.server.providers,0,0,0,0,0,0,0,0
flipkart-incubator_foxtrot,com.flipkart.foxtrot.server.resources,0,0,0,0,1,0,0,1
flipkart-incubator_foxtrot,com.flipkart.foxtrot.server.utils,0,0,0,0,0,0,0,0
flipkart-incubator_foxtrot,com.flipkart.foxtrot.sql,0,0,0,0,1,0,0,1
flipkart-incubator_foxtrot,com.flipkart.foxtrot.sql.extendedsql.desc,0,0,0,0,0,0,0,0
flipkart-incubator_foxtrot,com.flipkart.foxtrot.sql.extendedsql,0,0,0,0,0,0,0,0
flipkart-incubator_foxtrot,com.flipkart.foxtrot.sql.extendedsql.showtables,0,0,0,0,0,0,0,0
flipkart-incubator_foxtrot,com.flipkart.foxtrot.sql.fqlstore,0,0,0,0,0,0,0,0
flipkart-incubator_foxtrot,com.flipkart.foxtrot.sql.query,0,0,0,0,0,0,0,0
flipkart-incubator_foxtrot,com.flipkart.foxtrot.sql.responseprocessors,0,0,0,0,0,0,0,0
flipkart-incubator_foxtrot,com.flipkart.foxtrot.sql.responseprocessors.model,0,0,0,0,0,0,0,0
flipkart-incubator_foxtrot,com.flipkart.foxtrot.sql.util,0,0,0,0,0,0,0,0
flipkart-incubator_Lois,com.flipkart.lois.channel.api,0,0,0,0,0,0,0,0
flipkart-incubator_Lois,com.flipkart.lois.channel.exceptions,0,0,0,0,0,0,0,0
flipkart-incubator_Lois,com.flipkart.lois.channel.impl,0,0,0,0,1,0,0,1
flipkart-incubator_Lois,com.flipkart.lois,0,0,0,0,0,0,0,0
flipkart-incubator_Lois,com.flipkart.lois.relay,0,0,0,0,0,0,0,0
flipkart-incubator_Lois,com.flipkart.lois.routine,0,0,0,0,0,0,0,0
flipkart-incubator_Lois,com.flipkart.lois.utils,0,0,0,0,0,0,0,0
Flow_Caustic,com.flowpowered.caustic.api,0,0,0,0,1,2,0,3
Flow_Caustic,com.flowpowered.caustic.api.data,0,0,0,0,1,0,0,1
Flow_Caustic,com.flowpowered.caustic.api.gl,0,0,0,0,1,2,0,3
Flow_Caustic,com.flowpowered.caustic.api.model,0,0,0,0,0,0,0,0
Flow_Caustic,com.flowpowered.caustic.api.util,0,0,0,0,1,0,0,1
Flow_Caustic,com.flowpowered.caustic.lwjgl.gl20,0,0,0,0,1,1,0,2
Flow_Caustic,com.flowpowered.caustic.lwjgl.gl21,0,0,0,0,0,0,0,0
Flow_Caustic,com.flowpowered.caustic.lwjgl.gl30,0,0,0,0,0,1,0,1
Flow_Caustic,com.flowpowered.caustic.lwjgl.gl32,0,0,0,0,0,0,0,0
Flow_Caustic,com.flowpowered.caustic.lwjgl,0,0,0,0,0,0,0,0
Flow_Caustic,com.flowpowered.caustic.software,0,0,0,0,0,0,0,0
Flow_engine,com.flowpowered.api,0,0,0,0,0,1,0,1
Flow_engine,com.flowpowered.api.component,0,0,0,0,1,1,0,2
Flow_engine,com.flowpowered.api.component.block,0,0,0,0,0,0,0,0
Flow_engine,com.flowpowered.api.component.entity,0,0,0,0,0,1,0,1
Flow_engine,com.flowpowered.api.component.world,0,0,0,0,0,0,0,0
Flow_engine,com.flowpowered.api.entity,0,0,0,0,0,0,0,0
Flow_engine,com.flowpowered.api.event.cause,0,0,0,0,0,0,0,0
Flow_engine,com.flowpowered.api.event.engine,0,0,0,0,0,0,0,0
Flow_engine,com.flowpowered.api.event,0,0,0,0,0,0,0,0
Flow_engine,com.flowpowered.api.generator,0,0,0,0,1,0,0,1
Flow_engine,com.flowpowered.api.geo,0,0,0,0,1,0,0,1
Flow_engine,com.flowpowered.api.geo.cuboid,2,1,0,0,1,0,0,4
Flow_engine,com.flowpowered.api.geo.discrete,2,1,0,0,0,0,0,3
Flow_engine,com.flowpowered.api.geo.reference,1,0,0,0,0,0,0,1
Flow_engine,com.flowpowered.api.geo.snapshot,0,0,0,0,0,0,0,0
Flow_engine,com.flowpowered.api.input,0,0,0,0,0,0,0,0
Flow_engine,com.flowpowered.api.io.bytearrayarray,0,0,0,0,1,0,0,1
Flow_engine,com.flowpowered.api.io.nbt,0,0,0,0,0,0,0,0
Flow_engine,com.flowpowered.api.io.regionfile,0,0,0,0,0,0,0,0
Flow_engine,com.flowpowered.api.material.basic,0,0,0,0,0,0,0,0
Flow_engine,com.flowpowered.api.material.block,1,1,0,0,0,0,0,2
Flow_engine,com.flowpowered.api.material,1,0,0,0,0,0,0,1
Flow_engine,com.flowpowered.api.model.mesh,0,0,0,0,0,0,0,0
Flow_engine,com.flowpowered.api.model.mesher,0,0,0,0,0,0,0,0
Flow_engine,com.flowpowered.api.player,0,0,0,0,0,1,0,1
Flow_engine,com.flowpowered.api.player.reposition,0,0,0,0,0,0,0,0
Flow_engine,com.flowpowered.api.plugins,0,0,0,0,0,0,0,0
Flow_engine,com.flowpowered.api.render,0,0,0,0,0,0,0,0
Flow_engine,com.flowpowered.api.scheduler,0,0,0,0,0,0,0,0
Flow_engine,com.flowpowered.api.scheduler.tickable,0,0,0,0,0,0,0,0
Flow_engine,com.flowpowered.api.util,0,0,0,0,1,0,0,1
Flow_engine,com.flowpowered.api.util.cuboid,0,0,0,0,0,0,0,0
Flow_engine,com.flowpowered.api.util.cuboid.procedure,0,0,0,0,0,0,0,0
Flow_engine,com.flowpowered.api.util.typechecker,0,0,0,0,0,0,0,0
Flow_engine,com.flowpowered.engine,11,1,0,0,0,0,0,12
Flow_engine,com.flowpowered.engine.entity,6,0,0,0,0,0,0,6
Flow_engine,com.flowpowered.engine.event,0,0,0,0,0,0,0,0
Flow_engine,com.flowpowered.engine.filesystem,4,1,0,0,0,0,0,5
Flow_engine,com.flowpowered.engine.geo.chunk,0,0,0,0,0,0,0,0
Flow_engine,com.flowpowered.engine.geo,0,0,0,0,0,0,0,0
Flow_engine,com.flowpowered.engine.geo.region,4,1,0,0,1,0,0,6
Flow_engine,com.flowpowered.engine.geo.snapshot,0,0,0,0,0,0,0,0
Flow_engine,com.flowpowered.engine.geo.world,7,1,0,0,0,0,0,8
Flow_engine,com.flowpowered.engine.network.codec,0,0,0,0,0,0,0,0
Flow_engine,com.flowpowered.engine.network,3,0,0,0,0,1,0,4
Flow_engine,com.flowpowered.engine.network.handler,3,0,0,0,0,1,0,4
Flow_engine,com.flowpowered.engine.network.message,0,0,0,0,0,0,0,0
Flow_engine,com.flowpowered.engine.physics,0,0,0,0,0,0,0,0
Flow_engine,com.flowpowered.engine.player,0,0,0,0,0,0,0,0
Flow_engine,com.flowpowered.engine.plugins,1,0,0,0,0,0,0,1
Flow_engine,com.flowpowered.engine.render,0,0,0,0,0,0,0,0
Flow_engine,com.flowpowered.engine.render.mesher,0,0,0,0,0,0,0,0
Flow_engine,com.flowpowered.engine.render.model,0,0,0,0,0,0,0,0
Flow_engine,com.flowpowered.engine.scheduler,3,0,0,0,1,0,0,4
Flow_engine,com.flowpowered.engine.scheduler.input,0,0,0,0,0,0,0,0
Flow_engine,com.flowpowered.engine.scheduler.render,0,0,0,0,0,0,0,0
Flow_engine,com.flowpowered.engine.util.argument,0,0,0,0,0,0,0,0
Flow_engine,com.flowpowered.engine.util,0,0,0,0,0,0,0,0
Flow_engine,com.flowpowered.engine.util.math,0,0,0,0,0,0,0,0
Flow_engine,com.flowpowered.engine.util.thread,0,0,0,0,0,0,0,0
Flow_engine,com.flowpowered.engine.util.thread.snapshotable,0,0,0,0,0,0,0,0
Flow_nbt,com.flowpowered.nbt,1,1,0,0,1,0,0,3
Flow_nbt,com.flowpowered.nbt.exception,0,0,0,0,0,0,0,0
Flow_nbt,com.flowpowered.nbt.gui,0,0,0,0,0,0,0,0
Flow_nbt,com.flowpowered.nbt.holder,0,0,0,0,1,0,0,1
Flow_nbt,com.flowpowered.nbt.itemmap,0,0,0,0,0,0,0,0
Flow_nbt,com.flowpowered.nbt.regionfile,0,1,0,0,0,0,0,1
Flow_nbt,com.flowpowered.nbt.stream,1,0,0,0,0,0,0,1
Flow_nbt,com.flowpowered.nbt.util,0,0,0,0,0,0,0,0
Flow_network,com.flowpowered.network,0,0,0,0,1,0,0,1
Flow_network,com.flowpowered.network.exception,0,0,0,0,0,0,0,0
Flow_network,com.flowpowered.network.pipeline,0,0,0,0,1,0,0,1
Flow_network,com.flowpowered.network.processor,0,0,0,0,0,0,0,0
Flow_network,com.flowpowered.network.processor.simple,0,0,0,0,0,0,0,0
Flow_network,com.flowpowered.network.protocol,0,0,0,0,0,0,0,0
Flow_network,com.flowpowered.network.protocol.keyed,0,0,0,0,0,0,0,0
Flow_network,com.flowpowered.network.protocol.simple,0,0,0,0,0,0,0,0
Flow_network,com.flowpowered.network.service,0,0,0,0,0,0,0,0
Flow_network,com.flowpowered.network.session,0,0,0,0,0,0,0,0
Flow_network,com.flowpowered.network.util,0,0,0,0,0,0,0,0
Flow_network,com.flowpowered.network.fake,0,0,0,0,0,0,0,0
Flow_React,com.flowpowered.react.body,1,0,0,0,0,2,1,4
Flow_React,com.flowpowered.react.collision.broadphase,5,0,0,0,0,4,1,10
Flow_React,com.flowpowered.react.collision,11,1,0,0,0,2,1,15
Flow_React,com.flowpowered.react.collision.linkedphase,3,0,0,0,0,0,1,4
Flow_React,com.flowpowered.react.collision.narrowphase.EPA,0,0,0,0,0,0,1,1
Flow_React,com.flowpowered.react.collision.narrowphase.GJK,2,0,0,0,0,0,1,3
Flow_React,com.flowpowered.react.collision.narrowphase,1,0,0,0,0,0,1,2
Flow_React,com.flowpowered.react.collision.shape,3,1,0,0,1,3,1,9
Flow_React,com.flowpowered.react.constraint,3,0,0,0,1,1,1,6
Flow_React,com.flowpowered.react.engine,5,0,0,0,1,2,1,9
Flow_React,com.flowpowered.react.engine.linked,0,0,0,0,0,0,1,1
Flow_React,com.flowpowered.react.math,12,1,0,0,0,5,1,19
Flow_React,com.flowpowered.react,22,1,0,0,1,2,1,27
fluo-io_fluo,org.apache.fluo.accumulo.format,1,0,0,0,0,0,1,2
fluo-io_fluo,org.apache.fluo.accumulo.iterators,3,0,0,0,1,0,1,5
fluo-io_fluo,org.apache.fluo.accumulo.summarizer,0,0,0,0,0,0,1,1
fluo-io_fluo,org.apache.fluo.accumulo.util,3,1,0,0,1,0,1,6
fluo-io_fluo,org.apache.fluo.accumulo.values,1,0,0,0,0,0,1,2
fluo-io_fluo,org.apache.fluo.api.client,0,0,0,0,1,13,1,15
fluo-io_fluo,org.apache.fluo.api.client.scanner,0,0,0,0,1,2,1,4
fluo-io_fluo,org.apache.fluo.api.config,0,0,0,0,0,5,1,6
fluo-io_fluo,org.apache.fluo.api.data,0,0,0,0,0,3,1,4
fluo-io_fluo,org.apache.fluo.api.exceptions,0,0,0,0,0,0,1,1
fluo-io_fluo,org.apache.fluo.api.metrics,0,0,0,0,0,1,1,2
fluo-io_fluo,org.apache.fluo.api.mini,0,0,0,0,0,4,1,5
fluo-io_fluo,org.apache.fluo.api.observer,0,0,0,0,1,3,1,5
fluo-io_fluo,org.apache.fluo.api.service,0,0,0,0,0,0,1,1
fluo-io_fluo,org.apache.fluo.cluster.command,0,0,0,0,0,0,1,1
fluo-io_fluo,org.apache.fluo.cluster.runnable,0,0,0,0,0,0,1,1
fluo-io_fluo,org.apache.fluo.cluster.runner,1,0,0,0,1,0,1,3
fluo-io_fluo,org.apache.fluo.cluster.util,0,0,0,0,0,0,1,1
fluo-io_fluo,org.apache.fluo.cluster.yarn,1,1,0,0,0,0,1,3
fluo-io_fluo,org.apache.fluo.command,0,0,0,0,0,1,1,2
fluo-io_fluo,org.apache.fluo.core.async,0,0,0,0,1,1,1,3
fluo-io_fluo,org.apache.fluo.core.client,8,1,0,0,0,2,1,12
fluo-io_fluo,org.apache.fluo.core.exceptions,0,0,0,0,0,0,1,1
fluo-io_fluo,org.apache.fluo.core.impl,12,1,0,1,1,3,1,19
fluo-io_fluo,org.apache.fluo.core.impl.scanner,0,0,0,0,0,0,1,1
fluo-io_fluo,org.apache.fluo.core.log,1,0,0,0,1,1,1,4
fluo-io_fluo,org.apache.fluo.core.metrics,6,1,0,0,1,0,1,9
fluo-io_fluo,org.apache.fluo.core.metrics.starters,0,0,0,0,0,0,1,1
fluo-io_fluo,org.apache.fluo.core.metrics.types,0,0,0,0,0,0,1,1
fluo-io_fluo,org.apache.fluo.core.observer,4,1,0,0,0,0,1,6
fluo-io_fluo,org.apache.fluo.core.observer.v1,2,0,0,0,0,0,1,3
fluo-io_fluo,org.apache.fluo.core.observer.v2,2,0,0,0,0,0,1,3
fluo-io_fluo,org.apache.fluo.core.oracle,0,0,0,0,1,2,1,4
fluo-io_fluo,org.apache.fluo.core.thrift,0,0,0,1,1,0,1,3
fluo-io_fluo,org.apache.fluo.core.util,4,1,0,0,1,0,1,7
fluo-io_fluo,org.apache.fluo.core.worker.finder.hash,2,0,0,0,1,0,1,4
fluo-io_fluo,org.apache.fluo.core.worker,0,0,0,0,1,0,1,2
fluo-io_fluo,org.apache.fluo.integration.accumulo,0,0,0,0,0,0,1,1
fluo-io_fluo,org.apache.fluo.integration,0,1,0,0,1,3,1,6
fluo-io_fluo,org.apache.fluo.integration.client,0,0,0,0,0,0,1,1
fluo-io_fluo,org.apache.fluo.integration.impl,0,0,0,1,1,12,1,15
fluo-io_fluo,org.apache.fluo.integration.log,0,0,0,0,0,2,1,3
fluo-io_fluo,org.apache.fluo.mapreduce,0,0,0,0,1,0,1,2
fluo-io_fluo,org.apache.fluo.mapreduce.it,0,0,0,0,0,0,1,1
fluo-io_fluo,org.apache.fluo.mini,0,0,0,0,0,0,1,1
forge_roaster,org.jboss.forge.roaster,0,0,0,0,1,2,0,3
forge_roaster,org.jboss.forge.roaster.model,0,0,0,1,1,4,0,6
forge_roaster,org.jboss.forge.roaster.model.source,0,0,0,1,0,4,0,5
forge_roaster,org.jboss.forge.roaster.model.util,0,0,0,0,1,3,0,4
forge_roaster,org.jboss.forge.roaster.spi,0,0,0,0,0,0,0,0
forge_roaster,org.jboss.forge.roaster.model.ast,0,0,0,0,0,0,0,0
forge_roaster,org.jboss.forge.roaster.model.impl,0,0,0,1,1,5,0,7
forge_roaster,org.jboss.forge.grammar.java,0,0,0,1,1,0,0,2
forge_roaster,experiment,0,0,0,0,0,0,0,0
foxinmy_weixin4j,com.foxinmy.weixin4j.api,1,0,0,0,1,1,0,3
foxinmy_weixin4j,com.foxinmy.weixin4j.cache,0,0,0,0,1,0,0,1
foxinmy_weixin4j,com.foxinmy.weixin4j.exception,0,0,0,0,0,0,0,0
foxinmy_weixin4j,com.foxinmy.weixin4j.http,10,1,0,0,1,2,0,14
foxinmy_weixin4j,com.foxinmy.weixin4j.http.apache.content,1,0,0,0,0,1,0,2
foxinmy_weixin4j,com.foxinmy.weixin4j.http.apache.mime,1,1,0,0,0,1,0,3
foxinmy_weixin4j,com.foxinmy.weixin4j.http.entity,2,0,0,0,0,1,0,3
foxinmy_weixin4j,com.foxinmy.weixin4j.http.factory,11,1,0,0,0,0,0,12
foxinmy_weixin4j,com.foxinmy.weixin4j.http.message,0,0,0,0,0,0,0,0
foxinmy_weixin4j,com.foxinmy.weixin4j.http.support.apache3,3,0,0,0,0,0,0,3
foxinmy_weixin4j,com.foxinmy.weixin4j.http.support.apache4,2,0,0,0,1,0,0,3
foxinmy_weixin4j,com.foxinmy.weixin4j.http.support.netty,3,0,0,0,0,0,0,3
foxinmy_weixin4j,com.foxinmy.weixin4j.http.support.okhttp,3,0,0,0,1,1,0,5
foxinmy_weixin4j,com.foxinmy.weixin4j.http.weixin,0,1,0,0,0,0,0,1
foxinmy_weixin4j,com.foxinmy.weixin4j.jssdk,0,0,0,0,0,0,0,0
foxinmy_weixin4j,com.foxinmy.weixin4j.logging,0,0,0,0,0,0,0,0
foxinmy_weixin4j,com.foxinmy.weixin4j.model,1,0,0,0,0,2,0,3
foxinmy_weixin4j,com.foxinmy.weixin4j.model.card,0,0,0,1,1,0,0,2
foxinmy_weixin4j,com.foxinmy.weixin4j.model.media,0,0,0,0,0,0,0,0
foxinmy_weixin4j,com.foxinmy.weixin4j.model.paging,0,0,0,0,0,0,0,0
foxinmy_weixin4j,com.foxinmy.weixin4j.model.qr,0,0,0,0,0,0,0,0
foxinmy_weixin4j,com.foxinmy.weixin4j.payment.coupon,0,0,0,0,0,0,0,0
foxinmy_weixin4j,com.foxinmy.weixin4j.payment,1,1,0,0,0,1,0,3
foxinmy_weixin4j,com.foxinmy.weixin4j.payment.mch,1,1,0,1,1,1,0,5
foxinmy_weixin4j,com.foxinmy.weixin4j.sign,0,0,0,0,0,0,0,0
foxinmy_weixin4j,com.foxinmy.weixin4j.token,0,1,0,0,0,0,0,1
foxinmy_weixin4j,com.foxinmy.weixin4j.tuple,0,0,0,0,0,0,0,0
foxinmy_weixin4j,com.foxinmy.weixin4j.type,0,0,0,0,0,0,0,0
foxinmy_weixin4j,com.foxinmy.weixin4j.util,9,1,0,1,1,0,0,12
foxinmy_weixin4j,com.foxinmy.weixin4j.xml,3,1,0,0,1,0,0,5
foxinmy_weixin4j,com.foxinmy.weixin4j.example.controller,0,0,0,0,0,0,0,0
foxinmy_weixin4j,com.foxinmy.weixin4j.example.server.handler,0,0,0,0,1,0,0,1
foxinmy_weixin4j,com.foxinmy.weixin4j.example.server,0,0,0,0,0,0,0,0
foxinmy_weixin4j,com.foxinmy.weixin4j.mp.api,0,0,0,0,1,0,0,1
foxinmy_weixin4j,com.foxinmy.weixin4j.mp.component,0,0,0,0,0,0,0,0
foxinmy_weixin4j,com.foxinmy.weixin4j.mp.datacube,0,0,0,0,1,0,0,1
foxinmy_weixin4j,com.foxinmy.weixin4j.mp.message,0,0,0,0,0,0,0,0
foxinmy_weixin4j,com.foxinmy.weixin4j.mp.model,0,0,0,0,1,0,0,1
foxinmy_weixin4j,com.foxinmy.weixin4j.mp.model.shakearound,0,0,0,0,0,0,0,0
foxinmy_weixin4j,com.foxinmy.weixin4j.mp.oldpayment,0,0,0,0,1,0,0,1
foxinmy_weixin4j,com.foxinmy.weixin4j.mp.token,0,0,0,0,0,0,0,0
foxinmy_weixin4j,com.foxinmy.weixin4j.mp.type,0,0,0,0,0,0,0,0
foxinmy_weixin4j,com.foxinmy.weixin4j.mp,0,0,0,0,0,0,0,0
foxinmy_weixin4j,com.foxinmy.weixin4j.pay.api,0,0,0,0,0,0,0,0
foxinmy_weixin4j,com.foxinmy.weixin4j.pay.model,0,0,0,0,0,0,0,0
foxinmy_weixin4j,com.foxinmy.weixin4j.pay.payment.coupon,0,0,0,0,0,0,0,0
foxinmy_weixin4j,com.foxinmy.weixin4j.pay.payment.face,0,0,0,0,0,0,0,0
foxinmy_weixin4j,com.foxinmy.weixin4j.pay.payment,0,0,0,0,0,0,0,0
foxinmy_weixin4j,com.foxinmy.weixin4j.pay.payment.mch,0,0,0,1,1,0,0,2
foxinmy_weixin4j,com.foxinmy.weixin4j.pay.sign,0,0,0,0,0,0,0,0
foxinmy_weixin4j,com.foxinmy.weixin4j.pay.type,0,0,0,0,0,0,0,0
foxinmy_weixin4j,com.foxinmy.weixin4j.pay,0,1,0,0,0,0,0,1
foxinmy_weixin4j,com.foxinmy.weixin4j.qy.api,0,0,0,0,1,1,0,2
foxinmy_weixin4j,com.foxinmy.weixin4j.qy.jssdk,0,0,0,0,0,0,0,0
foxinmy_weixin4j,com.foxinmy.weixin4j.qy.message,0,0,0,0,0,0,0,0
foxinmy_weixin4j,com.foxinmy.weixin4j.qy.model,0,0,0,0,1,0,0,1
foxinmy_weixin4j,com.foxinmy.weixin4j.qy.suite,0,0,0,0,0,0,0,0
foxinmy_weixin4j,com.foxinmy.weixin4j.qy.token,0,0,0,0,0,0,0,0
foxinmy_weixin4j,com.foxinmy.weixin4j.qy.type,0,0,0,0,0,0,0,0
foxinmy_weixin4j,com.foxinmy.weixin4j.qy,0,0,0,0,0,0,0,0
foxinmy_weixin4j,com.foxinmy.weixin4j.base64,1,0,0,0,0,0,0,1
foxinmy_weixin4j,com.foxinmy.weixin4j.dispatcher,0,0,0,0,1,0,0,1
foxinmy_weixin4j,com.foxinmy.weixin4j.handler,0,0,0,0,0,0,0,0
foxinmy_weixin4j,com.foxinmy.weixin4j.interceptor,0,0,0,0,0,0,0,0
foxinmy_weixin4j,com.foxinmy.weixin4j.listener,0,0,0,0,0,0,0,0
foxinmy_weixin4j,com.foxinmy.weixin4j.message.event,0,0,0,0,1,0,0,1
foxinmy_weixin4j,com.foxinmy.weixin4j.message,0,0,0,0,1,0,0,1
foxinmy_weixin4j,com.foxinmy.weixin4j.mp.event,0,0,0,0,1,0,0,1
foxinmy_weixin4j,com.foxinmy.weixin4j.qy.chat,0,0,0,0,0,0,0,0
foxinmy_weixin4j,com.foxinmy.weixin4j.qy.event,0,0,0,0,0,0,0,0
foxinmy_weixin4j,com.foxinmy.weixin4j.request,0,0,0,0,0,0,0,0
foxinmy_weixin4j,com.foxinmy.weixin4j.response,0,0,0,0,0,0,0,0
foxinmy_weixin4j,com.foxinmy.weixin4j.socket,2,0,0,0,1,0,0,3
foxinmy_weixin4j,com.foxinmy.weixin4j.spring,0,0,0,0,0,0,0,0
foxinmy_weixin4j,com.foxinmy.weixin4j.startup,0,0,0,0,0,0,0,0
foxinmy_weixin4j,com.foxinmy.weixin4j.server.ext,0,0,0,0,0,0,0,0
foxinmy_weixin4j,com.zone.weixin4j.base64,1,0,0,0,0,0,0,1
foxinmy_weixin4j,com.zone.weixin4j.controller,0,0,0,0,0,0,0,0
foxinmy_weixin4j,com.zone.weixin4j.dispatcher,0,0,0,0,0,0,0,0
foxinmy_weixin4j,com.zone.weixin4j.exception,0,0,0,0,0,0,0,0
foxinmy_weixin4j,com.zone.weixin4j.handler,0,0,0,0,0,0,0,0
foxinmy_weixin4j,com.zone.weixin4j.interceptor,0,0,0,0,0,0,0,0
foxinmy_weixin4j,com.zone.weixin4j.message.event,0,0,0,0,1,0,0,1
foxinmy_weixin4j,com.zone.weixin4j.message,0,0,0,0,1,0,0,1
foxinmy_weixin4j,com.zone.weixin4j.mp.component,0,0,0,0,0,0,0,0
foxinmy_weixin4j,com.zone.weixin4j.mp.event,0,0,0,0,1,0,0,1
foxinmy_weixin4j,com.zone.weixin4j.qy.chat,0,0,0,0,0,0,0,0
foxinmy_weixin4j,com.zone.weixin4j.qy.event,0,0,0,0,0,0,0,0
foxinmy_weixin4j,com.zone.weixin4j.qy.suite,0,0,0,0,0,0,0,0
foxinmy_weixin4j,com.zone.weixin4j.request,0,0,0,0,0,0,0,0
foxinmy_weixin4j,com.zone.weixin4j.response,0,0,0,0,0,0,0,0
foxinmy_weixin4j,com.zone.weixin4j.service.context,0,0,0,0,0,0,0,0
foxinmy_weixin4j,com.zone.weixin4j.service.impl,0,0,0,0,0,0,0,0
foxinmy_weixin4j,com.zone.weixin4j.service,0,0,0,0,0,0,0,0
foxinmy_weixin4j,com.zone.weixin4j.socket,0,0,0,0,0,0,0,0
foxinmy_weixin4j,com.zone.weixin4j.spring,0,0,0,0,0,0,0,0
foxinmy_weixin4j,com.zone.weixin4j.util,1,1,0,0,1,0,0,3
foxinmy_weixin4j,com.zone.weixin4j.xml,0,1,0,0,0,0,0,1
foxinmy_weixin4j,com.foxinmy.weixin4j.wxa,1,0,0,0,0,0,0,1
foxinmy_weixin4j,com.foxinmy.weixin4j.wxa.api,1,1,0,0,1,0,0,3
foxinmy_weixin4j,com.foxinmy.weixin4j.wxa.model.custommessage,0,0,0,0,1,0,0,1
foxinmy_weixin4j,com.foxinmy.weixin4j.wxa.model,0,0,0,0,0,0,0,0
foxinmy_weixin4j,com.foxinmy.weixin4j.wxa.model.template,0,0,0,0,0,0,0,0
freemarker_fmpp,fmpp.dataloaders,1,0,0,0,1,1,1,4
freemarker_fmpp,fmpp,2,1,0,1,1,1,1,7
freemarker_fmpp,fmpp.localdatabuilders,1,0,0,0,0,0,1,2
freemarker_fmpp,fmpp.models,1,0,0,1,1,0,1,4
freemarker_fmpp,fmpp.progresslisteners,0,0,0,0,0,0,1,1
freemarker_fmpp,fmpp.setting,1,1,0,0,1,0,1,4
freemarker_fmpp,fmpp.tdd,2,1,0,0,1,1,1,6
freemarker_fmpp,fmpp.tools,0,0,0,0,0,0,1,1
freemarker_fmpp,fmpp.util,1,1,0,0,1,0,1,4
freenet_plugin-Freetalk,plugins.Freetalk,10,1,0,1,0,0,0,12
freenet_plugin-Freetalk,plugins.Freetalk.exceptions,0,0,0,0,1,0,0,1
freenet_plugin-Freetalk,plugins.Freetalk.tasks,4,1,0,0,0,0,0,5
freenet_plugin-Freetalk,plugins.Freetalk.tasks.WoT,0,0,0,0,0,0,0,0
freenet_plugin-Freetalk,plugins.Freetalk.ui.FCP,2,0,0,0,0,0,0,2
freenet_plugin-Freetalk,plugins.Freetalk.ui.NNTP,1,0,0,0,0,0,0,1
freenet_plugin-Freetalk,plugins.Freetalk.ui.NNTP.MIME,0,0,0,0,0,0,0,0
freenet_plugin-Freetalk,plugins.Freetalk.ui.web,4,0,0,1,0,0,0,5
freenet_plugin-Freetalk,plugins.Freetalk.util,0,0,0,0,0,0,0,0
freenet_plugin-Freetalk,plugins.Freetalk.WoT,5,1,0,1,0,0,0,7
galenframework_galen,com.galenframework.actions,0,0,0,0,0,0,1,1
galenframework_galen,com.galenframework.api,2,1,0,0,0,0,1,4
galenframework_galen,com.galenframework.api.mutation,5,1,0,0,0,0,1,7
galenframework_galen,com.galenframework.browser,14,1,0,0,0,0,1,16
galenframework_galen,com.galenframework.browser.mutation,1,0,0,0,1,0,1,3
galenframework_galen,com.galenframework.config,4,1,0,0,0,0,1,6
galenframework_galen,com.galenframework,0,0,0,0,0,0,1,1
galenframework_galen,com.galenframework.generator,4,1,0,0,1,0,1,7
galenframework_galen,com.galenframework.generator.builders,2,1,0,0,1,0,1,5
galenframework_galen,com.galenframework.generator.filters,0,0,0,0,0,0,1,1
galenframework_galen,com.galenframework.generator.model,1,0,0,0,0,0,1,2
galenframework_galen,com.galenframework.generator.raycast,2,0,0,0,0,0,1,3
galenframework_galen,com.galenframework.generator.suggestions,0,0,0,0,0,0,1,1
galenframework_galen,com.galenframework.javascript,19,1,0,0,0,0,1,21
galenframework_galen,com.galenframework.ocr.google.pojo,0,0,0,0,0,0,1,1
galenframework_galen,com.galenframework.ocr.google.pojo.request,0,0,0,0,0,0,1,1
galenframework_galen,com.galenframework.ocr,0,0,0,0,0,0,1,1
galenframework_galen,com.galenframework.page,8,1,0,0,0,0,1,10
galenframework_galen,com.galenframework.page.selenium,4,0,0,0,0,0,1,5
galenframework_galen,com.galenframework.parser,17,1,0,1,0,0,1,20
galenframework_galen,com.galenframework.reports,15,1,0,0,1,0,1,18
galenframework_galen,com.galenframework.reports.json,1,0,0,0,0,0,1,2
galenframework_galen,com.galenframework.reports.model,6,1,0,0,1,0,1,9
galenframework_galen,com.galenframework.reports.nodes,6,0,0,0,0,0,1,7
galenframework_galen,com.galenframework.runner,7,1,0,0,1,0,1,10
galenframework_galen,com.galenframework.runner.events,3,0,0,0,0,0,1,4
galenframework_galen,com.galenframework.speclang2.pagespec,7,1,0,0,0,0,1,9
galenframework_galen,com.galenframework.speclang2.pagespec.rules,2,0,0,0,0,0,1,3
galenframework_galen,com.galenframework.speclang2.specs,2,0,0,0,0,0,1,3
galenframework_galen,com.galenframework.specs,12,1,0,1,0,0,1,15
galenframework_galen,com.galenframework.specs.colors,0,0,0,0,0,0,1,1
galenframework_galen,com.galenframework.specs.page,13,1,0,0,0,0,1,15
galenframework_galen,com.galenframework.suite.actions,0,1,0,0,1,0,1,3
galenframework_galen,com.galenframework.suite.actions.mutation,3,0,0,0,1,0,1,5
galenframework_galen,com.galenframework.suite,4,1,0,0,0,0,1,6
galenframework_galen,com.galenframework.suite.reader,2,0,0,0,0,0,1,3
galenframework_galen,com.galenframework.utils,18,1,0,0,0,0,1,20
galenframework_galen,com.galenframework.validation,10,1,0,0,0,0,1,12
galenframework_galen,com.galenframework.validation.specs,0,0,0,0,1,0,1,2
galenframework_galen,com.galenframework.xml,0,0,0,0,0,0,1,1
galenframework_galen,com.galenframework.components,0,1,0,0,1,0,1,3
galenframework_galen,com.galenframework.components.mocks.driver,0,0,0,0,0,0,1,1
galenframework_galen,com.galenframework.components.report,0,0,0,0,0,0,1,1
galenframework_galen,com.galenframework.components.specs,0,0,0,0,0,0,1,1
galenframework_galen,com.galenframework.components.validation,0,0,0,0,0,0,1,1
galenframework_galen,com.galenframework.util,0,0,0,0,0,0,1,1
galenframework_galen,com.galenframework.junit,0,0,0,0,1,0,1,2
galenframework_galen,com.galenframework.support,0,0,0,0,0,0,1,1
galenframework_galen,com.galenframework.rainbow4j,0,0,0,0,1,0,1,2
galenframework_galen,com.galenframework.rainbow4j.colorscheme,0,0,0,0,0,0,1,1
galenframework_galen,com.galenframework.rainbow4j.filters,0,0,0,0,1,0,1,2
ganshane_shakey,apidemo,0,0,0,1,0,2,0,3
ganshane_shakey,apidemo.util,0,0,0,0,1,2,0,3
ganshane_shakey,com.ib.client,0,0,0,0,1,1,0,2
ganshane_shakey,com.ib.contracts,0,0,0,0,0,0,0,0
ganshane_shakey,com.ib.controller,0,0,0,1,0,2,0,3
ganshane_shakey,shakey.app,0,0,0,0,0,0,0,0
ganshane_shakey,shakey.services,0,0,0,0,0,0,0,0
ganshane_shakey,shakey.server.app,0,0,0,0,0,0,0,0
geckoboard-java-api_highchart-java-api,nl.pvanassen.highchart.api.axis,0,0,0,0,0,0,0,0
geckoboard-java-api_highchart-java-api,nl.pvanassen.highchart.api,5,0,0,0,0,0,0,5
geckoboard-java-api_highchart-java-api,nl.pvanassen.highchart.api.base,6,0,0,0,0,0,0,6
geckoboard-java-api_highchart-java-api,nl.pvanassen.highchart.api.drilldown,0,0,0,0,0,0,0,0
geckoboard-java-api_highchart-java-api,nl.pvanassen.highchart.api.export,0,0,0,0,0,0,0,0
geckoboard-java-api_highchart-java-api,nl.pvanassen.highchart.api.format,0,0,0,0,0,0,0,0
geckoboard-java-api_highchart-java-api,nl.pvanassen.highchart.api.label,0,0,0,0,0,0,0,0
geckoboard-java-api_highchart-java-api,nl.pvanassen.highchart.api.plotoption,5,0,0,0,0,0,0,5
geckoboard-java-api_highchart-java-api,nl.pvanassen.highchart.api.serializer,2,1,0,0,0,0,0,3
geckoboard-java-api_highchart-java-api,nl.pvanassen.highchart.api.shared,3,1,0,0,1,0,0,5
geckoboard-java-api_highchart-java-api,nl.pvanassen.highchart.api.utils,6,1,0,0,0,0,0,7
geckoboard-java-api_highchart-java-api,nl.pvanassen.highchart,0,0,0,0,0,0,0,0
geftimov_MapReduce,com.eftimoff.mapreduce.filtering.bloomfilter,0,0,0,0,0,0,0,0
geftimov_MapReduce,com.eftimoff.mapreduce.filtering.distinct,0,0,0,0,0,0,0,0
geftimov_MapReduce,com.eftimoff.mapreduce.filtering.filtering,0,0,0,0,0,0,0,0
geftimov_MapReduce,com.eftimoff.mapreduce.filtering.sampling,0,0,0,0,0,0,0,0
geftimov_MapReduce,com.eftimoff.mapreduce.filtering.topten,0,0,0,0,0,0,0,0
geftimov_MapReduce,com.eftimoff.mapreduce.joins.cartesianproduct,0,0,0,0,0,0,0,0
geftimov_MapReduce,com.eftimoff.mapreduce.joins.compositejoin,0,0,0,0,0,0,0,0
geftimov_MapReduce,com.eftimoff.mapreduce.joins.reducesidejoin.bloomfilter,0,0,0,0,0,0,0,0
geftimov_MapReduce,com.eftimoff.mapreduce.joins.reducesidejoin,0,0,0,0,0,0,0,0
geftimov_MapReduce,com.eftimoff.mapreduce.joins.replicatedjoin,0,0,0,0,0,0,0,0
geftimov_MapReduce,com.eftimoff.mapreduce.meta.jobchaining,0,0,0,0,0,0,0,0
geftimov_MapReduce,com.eftimoff.mapreduce.organization.binning,0,0,0,0,0,0,0,0
geftimov_MapReduce,com.eftimoff.mapreduce.organization.hierarchical.advanced,0,0,0,0,0,0,0,0
geftimov_MapReduce,com.eftimoff.mapreduce.organization.hierarchical,0,0,0,0,0,0,0,0
geftimov_MapReduce,com.eftimoff.mapreduce.organization.partitioning,0,0,0,0,0,0,0,0
geftimov_MapReduce,com.eftimoff.mapreduce.organization.shuffling,0,0,0,0,0,0,0,0
geftimov_MapReduce,com.eftimoff.mapreduce.organization.totalordering,0,0,0,0,0,0,0,0
geftimov_MapReduce,com.eftimoff.mapreduce.summarization.counters,0,0,0,0,0,0,0,0
geftimov_MapReduce,com.eftimoff.mapreduce.summarization.invertedindex,0,0,0,0,0,0,0,0
geftimov_MapReduce,com.eftimoff.mapreduce.summarization.numerical.average,0,0,0,0,0,0,0,0
geftimov_MapReduce,com.eftimoff.mapreduce.summarization.numerical.medianstddev,0,0,0,0,0,0,0,0
geftimov_MapReduce,com.eftimoff.mapreduce.summarization.numerical.medianstddevbyhour,0,0,0,0,0,0,0,0
geftimov_MapReduce,com.eftimoff.mapreduce.summarization.numerical.minmaxcount,0,0,0,0,1,0,0,1
geftimov_MapReduce,com.eftimoff.mapreduce.summarization.numerical.wordcount,0,0,0,0,0,0,0,0
geftimov_MapReduce,com.eftimoff.mapreduce.utils,0,0,0,0,0,0,0,0
getsentry_raven-java,io.sentry.buffer,2,0,0,0,0,0,0,2
getsentry_raven-java,io.sentry.config,4,1,0,0,1,0,0,6
getsentry_raven-java,io.sentry.config.location,0,0,0,0,0,0,0,0
getsentry_raven-java,io.sentry.config.provider,3,1,0,0,0,0,0,4
getsentry_raven-java,io.sentry.connection,4,1,0,0,1,0,0,6
getsentry_raven-java,io.sentry.context,0,0,0,0,0,1,0,1
getsentry_raven-java,io.sentry,7,1,0,0,1,1,0,10
getsentry_raven-java,io.sentry.dsn,3,0,0,0,0,0,0,3
getsentry_raven-java,io.sentry.environment,0,0,0,0,0,0,0,0
getsentry_raven-java,io.sentry.event,7,1,0,0,0,2,0,10
getsentry_raven-java,io.sentry.event.helper,3,0,0,0,1,0,0,4
getsentry_raven-java,io.sentry.event.interfaces,0,0,0,0,0,1,0,1
getsentry_raven-java,io.sentry.jul,0,0,0,0,0,1,0,1
getsentry_raven-java,io.sentry.jvmti,0,0,0,0,0,0,0,0
getsentry_raven-java,io.sentry.marshaller.json,0,0,0,0,1,0,0,1
getsentry_raven-java,io.sentry.marshaller,0,0,0,0,0,0,0,0
getsentry_raven-java,io.sentry.servlet,2,1,0,0,0,0,0,3
getsentry_raven-java,io.sentry.time,0,0,0,0,0,0,0,0
getsentry_raven-java,io.sentry.util,0,0,0,0,0,0,0,0
getsentry_raven-java,(default package),0,0,0,0,0,0,0,0
getsentry_raven-java,io.sentry.helper,0,0,0,0,0,0,0,0
getsentry_raven-java,io.sentry.unmarshaller.event.interfaces,0,0,0,0,0,0,0,0
getsentry_raven-java,io.sentry.unmarshaller.event,0,0,0,0,0,0,0,0
getsentry_raven-java,io.sentry.unmarshaller,0,0,0,0,0,0,0,0
getsentry_raven-java,io.sentry.android,0,0,0,0,1,0,0,1
getsentry_raven-java,io.sentry.android.event.helper,0,0,0,0,0,0,0,0
getsentry_raven-java,io.sentry.appengine,1,0,0,0,0,0,0,1
getsentry_raven-java,io.sentry.appengine.connection,1,1,0,0,0,0,0,2
getsentry_raven-java,io.sentry.appengine.event.helper,0,0,0,0,0,0,0,0
getsentry_raven-java,io.sentry.log4j,0,0,0,0,1,0,0,1
getsentry_raven-java,io.sentry.log4j2,0,0,0,0,1,0,0,1
getsentry_raven-java,io.sentry.logback,0,0,0,0,1,0,0,1
getsentry_raven-java,io.sentry.spring,0,0,0,0,0,0,0,0
getsentry_raven-java,io.sentry.spring.autoconfigure,0,0,0,0,0,0,0,0
gid15_jpcsp,jpcsp.HLE.modules,98,1,0,2,1,0,1,103
gid15_jpcsp,jpcsp.HLE.modules150,0,0,0,2,1,0,1,4
gid15_jpcsp,com.savarese.rocksaw.net,0,0,0,0,0,0,1,1
gid15_jpcsp,com.twilight.h264.decoder,0,0,0,1,1,0,1,3
gid15_jpcsp,com.twilight.h264.player,0,0,0,0,0,0,1,1
gid15_jpcsp,com.twilight.h264.util,0,0,0,0,1,0,1,2
gid15_jpcsp,jpcsp.Allegrex,5,1,0,0,1,1,1,9
gid15_jpcsp,jpcsp.Allegrex.compiler,10,1,0,1,1,2,1,16
gid15_jpcsp,jpcsp.Allegrex.compiler.nativeCode,4,0,0,1,1,2,1,9
gid15_jpcsp,jpcsp.Allegrex.compiler.nativeCode.arithmetic,0,0,0,0,0,0,1,1
gid15_jpcsp,jpcsp.Allegrex.compiler.nativeCode.graphics,0,0,0,0,0,1,1,2
gid15_jpcsp,jpcsp,76,1,0,0,1,8,1,87
gid15_jpcsp,jpcsp.crypto,4,0,0,1,1,0,1,7
gid15_jpcsp,jpcsp.Debugger,4,1,0,0,1,3,1,10
gid15_jpcsp,jpcsp.Debugger.DisassemblerModule,4,0,0,0,1,0,1,6
gid15_jpcsp,jpcsp.Debugger.FileLogger,0,0,0,0,1,0,1,2
gid15_jpcsp,jpcsp.Debugger.MemoryBreakpoints,3,0,0,0,0,0,1,4
gid15_jpcsp,jpcsp.filesystems,0,0,0,0,0,0,1,1
gid15_jpcsp,jpcsp.filesystems.umdiso,5,0,0,0,1,0,1,7
gid15_jpcsp,jpcsp.filesystems.umdiso.iso9660,0,0,0,0,0,0,1,1
gid15_jpcsp,jpcsp.format,9,1,0,0,1,0,1,12
gid15_jpcsp,jpcsp.format.psmf,0,0,0,0,0,0,1,1
gid15_jpcsp,jpcsp.format.rco.anim,0,0,0,0,1,0,1,2
gid15_jpcsp,jpcsp.format.rco,2,0,0,0,1,0,1,4
gid15_jpcsp,jpcsp.format.rco.object,0,0,0,1,1,0,1,3
gid15_jpcsp,jpcsp.format.rco.sound,0,0,0,0,0,0,1,1
gid15_jpcsp,jpcsp.format.rco.type,0,0,0,0,0,0,1,1
gid15_jpcsp,jpcsp.format.rco.vsmx,0,0,0,0,1,0,1,2
gid15_jpcsp,jpcsp.format.rco.vsmx.interpreter,3,1,0,0,0,0,1,5
gid15_jpcsp,jpcsp.format.rco.vsmx.objects,5,0,0,0,1,0,1,7
gid15_jpcsp,jpcsp.graphics,24,1,0,1,1,0,1,28
gid15_jpcsp,jpcsp.graphics.capture,4,0,0,0,1,0,1,6
gid15_jpcsp,jpcsp.graphics.export,1,0,0,0,0,0,1,2
gid15_jpcsp,jpcsp.graphics.RE,8,1,0,0,1,0,1,11
gid15_jpcsp,jpcsp.graphics.RE.buffer,4,0,0,0,1,0,1,6
gid15_jpcsp,jpcsp.graphics.RE.externalge,4,1,0,0,1,0,1,7
gid15_jpcsp,jpcsp.graphics.RE.software,5,0,0,1,1,0,1,8
gid15_jpcsp,jpcsp.graphics.textures,4,0,0,0,1,0,1,6
gid15_jpcsp,jpcsp.GUI,6,0,0,0,1,1,1,9
gid15_jpcsp,jpcsp.hardware,7,1,0,0,1,1,1,11
gid15_jpcsp,jpcsp.HLE,67,1,0,0,1,1,1,71
gid15_jpcsp,jpcsp.HLE.kernel.managers,30,1,0,0,1,1,1,34
gid15_jpcsp,jpcsp.HLE.kernel,12,0,0,0,0,0,1,13
gid15_jpcsp,jpcsp.HLE.kernel.types,17,1,0,1,0,2,1,22
gid15_jpcsp,jpcsp.HLE.kernel.types.interrupts,3,0,0,0,1,0,1,5
gid15_jpcsp,jpcsp.HLE.VFS,0,0,0,0,1,0,1,2
gid15_jpcsp,jpcsp.HLE.VFS.compress,0,0,0,0,0,0,1,1
gid15_jpcsp,jpcsp.HLE.VFS.crypto,0,0,0,0,0,0,1,1
gid15_jpcsp,jpcsp.HLE.VFS.emulator,0,1,0,0,0,0,1,2
gid15_jpcsp,jpcsp.HLE.VFS.fat,0,0,0,0,1,1,1,3
gid15_jpcsp,jpcsp.HLE.VFS.filters,0,0,0,0,0,0,1,1
gid15_jpcsp,jpcsp.HLE.VFS.iso,0,0,0,0,0,0,1,1
gid15_jpcsp,jpcsp.HLE.VFS.local,0,0,0,0,0,0,1,1
gid15_jpcsp,jpcsp.HLE.VFS.memoryStick,0,0,0,0,0,0,1,1
gid15_jpcsp,jpcsp.HLE.VFS.nand,0,0,0,0,0,0,1,1
gid15_jpcsp,jpcsp.HLE.VFS.patch,0,0,0,0,0,0,1,1
gid15_jpcsp,jpcsp.HLE.VFS.synchronize,0,0,0,0,0,0,1,1
gid15_jpcsp,jpcsp.HLE.VFS.xmb,0,0,0,0,0,0,1,1
gid15_jpcsp,jpcsp.log,3,0,0,0,0,0,1,4
gid15_jpcsp,jpcsp.media.codec.aac,2,0,0,0,1,0,1,4
gid15_jpcsp,jpcsp.media.codec.atrac3,2,0,0,0,1,0,1,4
gid15_jpcsp,jpcsp.media.codec.atrac3plus,6,1,0,0,1,0,1,9
gid15_jpcsp,jpcsp.media.codec,9,1,0,0,0,0,1,11
gid15_jpcsp,jpcsp.media.codec.h264,0,0,0,0,0,0,1,1
gid15_jpcsp,jpcsp.media.codec.mp3,3,0,0,0,1,0,1,5
gid15_jpcsp,jpcsp.media.codec.util,10,1,0,0,1,0,1,13
gid15_jpcsp,jpcsp.media,0,0,0,0,0,0,1,1
gid15_jpcsp,jpcsp.mediaengine,4,1,0,0,1,1,1,8
gid15_jpcsp,jpcsp.memory,8,1,0,1,0,5,1,16
gid15_jpcsp,jpcsp.memory.mmio.audio,0,0,0,0,0,0,1,1
gid15_jpcsp,jpcsp.memory.mmio.cy27040,1,1,0,0,0,0,1,3
gid15_jpcsp,jpcsp.memory.mmio.dmac,0,0,0,0,0,0,1,1
gid15_jpcsp,jpcsp.memory.mmio.eflash,3,0,0,0,0,0,1,4
gid15_jpcsp,jpcsp.memory.mmio,12,0,0,1,1,0,1,15
gid15_jpcsp,jpcsp.memory.mmio.memorystick,2,0,0,0,1,0,1,4
gid15_jpcsp,jpcsp.memory.mmio.uart,0,0,0,0,0,0,1,1
gid15_jpcsp,jpcsp.memory.mmio.umd,4,1,0,0,0,0,1,6
gid15_jpcsp,jpcsp.memory.mmio.wm1801,0,0,0,0,0,0,1,1
gid15_jpcsp,jpcsp.memory.mmio.wm8750,2,0,0,0,0,0,1,3
gid15_jpcsp,jpcsp.network.accesspoint,0,0,0,0,0,0,1,1
gid15_jpcsp,jpcsp.network.adhoc,2,0,0,0,1,0,1,4
gid15_jpcsp,jpcsp.network,6,1,0,0,1,0,1,9
gid15_jpcsp,jpcsp.network.jpcsp,3,0,0,0,1,0,1,5
gid15_jpcsp,jpcsp.network.proonline,6,0,0,1,1,0,1,9
gid15_jpcsp,jpcsp.network.protocols,0,0,0,0,0,0,1,1
gid15_jpcsp,jpcsp.network.upnp,2,0,0,0,1,0,1,4
gid15_jpcsp,jpcsp.plugins,0,0,0,0,0,0,1,1
gid15_jpcsp,jpcsp.remote,4,0,0,0,1,0,1,6
gid15_jpcsp,jpcsp.scheduler,4,1,0,0,1,0,1,7
gid15_jpcsp,jpcsp.settings,8,1,0,0,1,0,1,11
gid15_jpcsp,jpcsp.sound,4,0,0,0,1,0,1,6
gid15_jpcsp,jpcsp.state,0,0,0,0,0,2,1,3
gid15_jpcsp,jpcsp.util,38,1,0,1,1,1,1,43
giltene_PauselessHashMap,org.giltene,0,0,0,0,0,0,0,0
glazedlists_glazedlists,ca.odell.glazedlists,27,1,0,1,0,0,1,30
glazedlists_glazedlists,ca.odell.glazedlists.event,12,1,0,1,0,0,1,15
glazedlists_glazedlists,ca.odell.glazedlists.gui,9,1,0,0,0,0,1,11
glazedlists_glazedlists,ca.odell.glazedlists.impl.adt,5,1,0,0,1,0,1,8
glazedlists_glazedlists,ca.odell.glazedlists.impl.adt.barcode2,2,0,0,0,0,0,1,3
glazedlists_glazedlists,ca.odell.glazedlists.impl.beans,3,0,0,0,0,0,1,4
glazedlists_glazedlists,ca.odell.glazedlists.impl,20,1,0,1,1,0,1,24
glazedlists_glazedlists,ca.odell.glazedlists.impl.event,3,0,0,0,0,0,1,4
glazedlists_glazedlists,ca.odell.glazedlists.impl.filter,2,0,0,0,0,0,1,3
glazedlists_glazedlists,ca.odell.glazedlists.impl.functions,0,0,0,0,0,0,1,1
glazedlists_glazedlists,ca.odell.glazedlists.impl.gui,6,1,0,0,1,0,1,9
glazedlists_glazedlists,ca.odell.glazedlists.impl.matchers,0,0,0,0,1,0,1,2
glazedlists_glazedlists,ca.odell.glazedlists.impl.reflect,0,0,0,0,0,0,1,1
glazedlists_glazedlists,ca.odell.glazedlists.impl.sort,3,0,0,0,1,0,1,5
glazedlists_glazedlists,ca.odell.glazedlists.impl.swing,1,0,0,0,1,0,1,3
glazedlists_glazedlists,ca.odell.glazedlists.impl.text,0,0,0,0,0,0,1,1
glazedlists_glazedlists,ca.odell.glazedlists.matchers,6,1,0,1,0,0,1,9
glazedlists_glazedlists,ca.odell.glazedlists.swing,6,1,0,1,1,0,1,10
glazedlists_glazedlists,ca.odell.glazedlists.util.concurrent,2,1,0,0,0,0,1,4
glazedlists_glazedlists,ca.odell.glazedlists.calculation,2,0,0,1,0,0,1,4
glazedlists_glazedlists,ca.odell.glazedlists.hibernate,0,0,0,0,0,0,1,1
glazedlists_glazedlists,ca.odell.glazedlists.impl.ctp,1,0,0,0,0,0,1,2
glazedlists_glazedlists,ca.odell.glazedlists.impl.io,4,1,0,0,1,0,1,7
glazedlists_glazedlists,ca.odell.glazedlists.impl.nio,0,0,0,0,0,0,1,1
glazedlists_glazedlists,ca.odell.glazedlists.impl.pmap,2,0,0,0,0,0,1,3
glazedlists_glazedlists,ca.odell.glazedlists.impl.rbp,2,0,0,0,0,0,1,3
glazedlists_glazedlists,ca.odell.glazedlists.io,5,1,0,0,0,0,1,7
glazedlists_glazedlists,com.publicobject.amazonbrowser,0,0,0,0,0,0,1,1
glazedlists_glazedlists,com.publicobject.amazonbrowser.swing,0,0,0,0,1,0,1,2
glazedlists_glazedlists,com.publicobject.filebrowser,0,0,0,0,0,0,1,1
glazedlists_glazedlists,com.publicobject.issuesbrowser,5,1,0,0,0,0,1,7
glazedlists_glazedlists,com.publicobject.issuesbrowser.javafx,0,0,0,0,1,0,1,2
glazedlists_glazedlists,com.publicobject.issuesbrowser.swing,0,0,0,1,0,0,1,2
glazedlists_glazedlists,com.publicobject.issuesbrowser.swt,0,0,0,0,0,0,1,1
glazedlists_glazedlists,com.publicobject.misc,0,0,0,0,0,0,1,1
glazedlists_glazedlists,com.publicobject.misc.swing,0,1,0,1,1,0,1,4
glazedlists_glazedlists,com.publicobject.misc.util.concurrent,0,0,0,0,1,0,1,2
glazedlists_glazedlists,com.publicobject.misc.xml,0,0,0,0,0,0,1,1
glazedlists_glazedlists,com.publicobject.xmlbrowser,0,0,0,0,1,0,1,2
glazedlists_glazedlists,ca.odell.glazedlists.javafx,0,0,0,0,1,0,1,2
glazedlists_glazedlists,ca.odell.glazedlists.jfreechart,2,0,0,0,1,0,1,4
glazedlists_glazedlists,ca.odell.glazedlists.swt,12,1,0,1,0,0,1,15
glazedlists_glazedlists,ca.odell.glazedlists.nachocalendar,0,0,0,0,0,0,1,1
glazedlists_glazedlists,ca.odell.glazedlists.impl.swt,3,0,0,0,1,0,1,5
glazedlists_glazedlists,ca.odell.glazedlists.generated,0,0,0,0,0,0,1,1
glazedlists_glazedlists,ca.odell.glazedlists.adt,0,0,0,0,0,0,1,1
GlenKPeterson_fp4java7,org.organicdesign.fp,12,1,0,1,0,2,0,16
GlenKPeterson_fp4java7,org.organicdesign.fp.collections,7,1,0,1,0,5,0,14
GlenKPeterson_fp4java7,org.organicdesign.fp.function,3,1,0,0,1,2,0,7
GlenKPeterson_fp4java7,org.organicdesign.fp.indent,0,0,0,0,0,0,0,0
GlenKPeterson_fp4java7,org.organicdesign.fp.oneOf,6,1,0,0,1,3,0,11
GlenKPeterson_fp4java7,org.organicdesign.fp.tuple,4,1,0,0,1,3,0,9
GlenKPeterson_fp4java7,org.organicdesign.fp.type,4,1,0,0,0,0,0,5
GlenKPeterson_fp4java7,org.organicdesign.fp.xform,6,0,0,0,1,3,0,10
GlenKPeterson_fp4java7,(default package),0,0,0,0,0,0,0,0
glowroot_glowroot,org.glowroot.agent.api,1,1,0,0,0,0,0,2
glowroot_glowroot,org.glowroot.agent.api.internal,1,0,0,0,0,0,0,1
glowroot_glowroot,org.glowroot.agent.plugin.jdbc,0,0,0,1,0,1,0,2
glowroot_glowroot,org.glowroot.agent.plugin.jdbc.support,0,0,0,0,0,0,0,0
glowroot_glowroot,org.glowroot.agent.plugin.servlet,1,0,0,1,1,3,0,6
glowroot_glowroot,org.glowroot.agent.plugin.servlet.support,0,0,0,0,0,0,0,0
glowroot_glowroot,org.glowroot.microbenchmarks,0,0,0,0,0,0,0,0
glowroot_glowroot,org.glowroot.microbenchmarks.support,0,0,0,0,1,0,0,1
glowroot_glowroot,org.glowroot.agent.plugin.jdbc.generated,0,0,0,0,0,0,0,0
glowroot_glowroot,org.glowroot.agent.plugin.servlet.generated,0,0,0,0,0,0,0,0
glowroot_glowroot,org.glowroot.microbenchmarks.generated,0,0,0,0,1,0,0,1
glowroot_glowroot,org.glowroot.agent.bytecode.api,0,0,0,0,1,0,0,1
glowroot_glowroot,org.glowroot.agent,0,1,0,0,1,0,0,2
glowroot_glowroot,org.glowroot.agent.central,0,0,0,0,1,0,0,1
glowroot_glowroot,org.glowroot.agent.collector,0,0,0,0,1,0,0,1
glowroot_glowroot,org.glowroot.agent.config,0,0,0,1,1,0,0,2
glowroot_glowroot,org.glowroot.agent.impl,2,0,0,1,1,1,0,5
glowroot_glowroot,org.glowroot.agent.init,0,0,0,0,1,0,0,1
glowroot_glowroot,org.glowroot.agent.jul,0,0,0,0,1,0,0,1
glowroot_glowroot,org.glowroot.agent.live,2,0,0,1,1,1,0,5
glowroot_glowroot,org.glowroot.agent.model,1,1,0,1,1,0,0,4
glowroot_glowroot,org.glowroot.agent.util,0,0,0,0,1,0,0,1
glowroot_glowroot,org.glowroot.agent.weaving,2,1,0,1,1,0,0,5
glowroot_glowroot,org.glowroot.agent.weaving.other,0,0,0,0,0,0,0,0
glowroot_glowroot,org.glowroot.agent.weaving.targets,0,0,0,1,0,0,0,1
glowroot_glowroot,org.glowroot.agent.dist,0,0,0,0,0,0,0,0
glowroot_glowroot,org.glowroot.agent.embedded.config,0,0,0,0,0,0,0,0
glowroot_glowroot,org.glowroot.agent.embedded.init,0,0,0,0,1,0,0,1
glowroot_glowroot,org.glowroot.agent.embedded,0,0,0,0,0,0,0,0
glowroot_glowroot,org.glowroot.agent.embedded.repo,0,0,0,1,1,0,0,2
glowroot_glowroot,org.glowroot.agent.embedded.sql,0,0,0,0,0,0,0,0
glowroot_glowroot,org.glowroot.agent.embedded.util,0,0,0,1,1,0,0,2
glowroot_glowroot,org.glowroot.agent.embedded.preinit,0,0,0,0,0,0,0,0
glowroot_glowroot,org.glowroot.agent.embedded.repo.proto,0,0,0,0,0,0,0,0
glowroot_glowroot,org.glowroot.agent.it.harness,1,1,0,0,1,0,0,3
glowroot_glowroot,org.glowroot.agent.it.harness.impl,1,1,0,0,1,0,0,3
glowroot_glowroot,org.glowroot.agent.it.harness.grpc,0,0,0,0,0,0,0,0
glowroot_glowroot,org.glowroot.agent.plugin.api,0,0,0,0,1,10,0,11
glowroot_glowroot,org.glowroot.agent.plugin.api.config,0,0,0,0,1,8,0,9
glowroot_glowroot,org.glowroot.agent.plugin.api.internal,1,0,0,0,1,0,0,2
glowroot_glowroot,org.glowroot.agent.plugin.api.util,1,1,0,0,1,5,0,8
glowroot_glowroot,org.glowroot.agent.plugin.api.weaving,0,0,0,0,0,0,0,0
glowroot_glowroot,org.glowroot.agent.plugin.camel,0,0,0,0,0,0,0,0
glowroot_glowroot,org.glowroot.agent.plugin.cassandra,0,0,0,1,0,0,0,1
glowroot_glowroot,org.glowroot.agent.plugin.ejb,0,0,0,1,1,0,0,2
glowroot_glowroot,org.glowroot.agent.plugin.elasticsearch,0,0,0,1,0,0,0,1
glowroot_glowroot,org.glowroot.agent.plugin.executor,0,0,0,1,1,0,0,2
glowroot_glowroot,org.glowroot.agent.plugin.grails,0,0,0,0,1,0,0,1
glowroot_glowroot,org.glowroot.agent.plugin.hibernate,0,0,0,0,0,0,0,0
glowroot_glowroot,org.glowroot.agent.plugin.httpclient,0,0,0,1,1,1,0,3
glowroot_glowroot,org.glowroot.agent.plugin.httpclient._,0,1,0,0,0,1,0,2
glowroot_glowroot,org.glowroot.agent.plugin.javahttpserver,0,0,0,1,0,1,0,2
glowroot_glowroot,org.glowroot.agent.plugin.jaxrs,0,0,0,1,1,1,0,3
glowroot_glowroot,org.glowroot.agent.plugin.jaxws,0,0,0,0,1,1,0,2
glowroot_glowroot,org.glowroot.agent.plugin.jdbc.message,0,0,0,0,0,0,0,0
glowroot_glowroot,org.glowroot.agent.plugin.jms,0,0,0,0,0,0,0,0
glowroot_glowroot,org.glowroot.agent.plugin.jsf,0,0,0,0,0,0,0,0
glowroot_glowroot,org.glowroot.agent.plugin.jsp,0,0,0,0,1,0,0,1
glowroot_glowroot,org.apache.jsp.WEB_002dINF.jsp,0,0,0,0,0,0,0,0
glowroot_glowroot,org.glowroot.agent.plugin.kafka,0,0,0,0,1,0,0,1
glowroot_glowroot,org.glowroot.agent.plugin.logger,0,0,0,1,1,0,0,2
glowroot_glowroot,org.glowroot.agent.plugin.mail,0,0,0,0,0,0,0,0
glowroot_glowroot,org.glowroot.agent.plugin.mongodb,0,0,0,0,1,0,0,1
glowroot_glowroot,org.glowroot.agent.plugin.netty,0,0,0,1,1,0,0,2
glowroot_glowroot,org.glowroot.agent.plugin.netty._,0,0,0,0,0,0,0,0
glowroot_glowroot,org.glowroot.agent.plugin.play,0,0,0,0,1,1,0,2
glowroot_glowroot,controllers,0,0,0,1,1,0,0,2
glowroot_glowroot,filters,0,0,0,0,0,0,0,0
glowroot_glowroot,(default package),0,0,0,0,0,0,0,0
glowroot_glowroot,org.glowroot.agent.plugin.quartz,0,0,0,0,0,0,0,0
glowroot_glowroot,org.glowroot.agent.plugin.redis,0,0,0,0,1,0,0,1
glowroot_glowroot,org.glowroot.agent.plugin.servlet._,1,1,0,0,1,4,0,7
glowroot_glowroot,org.glowroot.agent.plugin.spring,0,0,0,1,1,3,0,5
glowroot_glowroot,org.glowroot.agent.plugin.struts,0,0,0,0,1,0,0,1
glowroot_glowroot,org.glowroot.agent.ui.sandbox,0,0,0,0,1,0,0,1
glowroot_glowroot,org.glowroot.central,1,1,0,1,1,0,0,4
glowroot_glowroot,org.glowroot.central.repo,1,0,0,1,1,1,0,4
glowroot_glowroot,org.glowroot.central.util,0,1,0,1,1,0,0,3
glowroot_glowroot,org.glowroot.central.v09support,0,0,0,1,0,1,0,2
glowroot_glowroot,org.glowroot.central.repo.proto,0,0,0,0,0,0,0,0
glowroot_glowroot,org.glowroot.common.config,0,0,0,1,1,0,0,2
glowroot_glowroot,org.glowroot.common,0,0,0,0,0,0,0,0
glowroot_glowroot,org.glowroot.common.live,0,0,0,1,1,1,0,3
glowroot_glowroot,org.glowroot.common.model,0,0,0,1,1,0,0,2
glowroot_glowroot,org.glowroot.common.util,0,0,0,0,1,1,0,2
glowroot_glowroot,org.glowroot.common2.config,0,0,0,1,1,0,0,2
glowroot_glowroot,org.glowroot.common2.repo,1,1,0,1,1,0,0,4
glowroot_glowroot,org.glowroot.common2.repo.util,1,0,0,1,1,0,0,3
glowroot_glowroot,org.glowroot.ui,0,0,0,2,0,0,0,2
glowroot_glowroot,org.glowroot.wire.api.model,0,0,0,2,0,0,0,2
GlowstoneMC_Glowstone,net.glowstone.advancement,7,0,0,0,1,0,1,9
GlowstoneMC_Glowstone,net.glowstone.block.blocktype,17,1,0,1,1,0,1,21
GlowstoneMC_Glowstone,net.glowstone.block,9,1,0,0,1,0,1,12
GlowstoneMC_Glowstone,net.glowstone.block.entity,0,0,0,1,1,0,1,3
GlowstoneMC_Glowstone,net.glowstone.block.entity.state,7,0,0,1,1,0,1,10
GlowstoneMC_Glowstone,net.glowstone.block.itemtype,0,0,0,1,1,0,1,3
GlowstoneMC_Glowstone,net.glowstone.block.state,0,0,0,0,1,0,1,2
GlowstoneMC_Glowstone,net.glowstone.block.state.impl,0,0,0,0,0,0,1,1
GlowstoneMC_Glowstone,net.glowstone.boss,0,0,0,0,0,0,1,1
GlowstoneMC_Glowstone,net.glowstone.chunk,10,1,0,0,1,1,1,14
GlowstoneMC_Glowstone,net.glowstone.command,1,1,0,0,1,0,1,4
GlowstoneMC_Glowstone,net.glowstone.command.glowstone,0,0,0,0,1,0,1,2
GlowstoneMC_Glowstone,net.glowstone.command.minecraft,1,0,0,1,1,0,1,4
GlowstoneMC_Glowstone,net.glowstone,76,1,0,1,1,2,1,82
GlowstoneMC_Glowstone,net.glowstone.constants,6,1,0,1,1,0,1,10
GlowstoneMC_Glowstone,net.glowstone.data,0,0,0,0,0,0,1,1
GlowstoneMC_Glowstone,net.glowstone.dispenser,3,0,0,0,1,0,1,5
GlowstoneMC_Glowstone,net.glowstone.entity.ai,2,0,0,0,1,0,1,4
GlowstoneMC_Glowstone,net.glowstone.entity,13,0,0,1,1,1,1,17
GlowstoneMC_Glowstone,net.glowstone.entity.meta,0,0,0,0,1,0,1,2
GlowstoneMC_Glowstone,net.glowstone.entity.meta.profile,2,0,0,0,0,0,1,3
GlowstoneMC_Glowstone,net.glowstone.entity.monster.complex,0,0,0,0,1,0,1,2
GlowstoneMC_Glowstone,net.glowstone.entity.monster,4,1,0,1,1,0,1,8
GlowstoneMC_Glowstone,net.glowstone.entity.objects,4,0,0,1,1,0,1,7
GlowstoneMC_Glowstone,net.glowstone.entity.passive,3,0,0,1,1,0,1,6
GlowstoneMC_Glowstone,net.glowstone.entity.physics,0,0,0,0,1,0,1,2
GlowstoneMC_Glowstone,net.glowstone.entity.projectile,0,0,0,1,1,0,1,3
GlowstoneMC_Glowstone,net.glowstone.generator.biomegrid,2,0,0,1,1,0,1,5
GlowstoneMC_Glowstone,net.glowstone.generator.decorators,0,0,0,0,0,0,1,1
GlowstoneMC_Glowstone,net.glowstone.generator.decorators.nether,0,0,0,0,1,0,1,2
GlowstoneMC_Glowstone,net.glowstone.generator.decorators.overworld,0,0,0,1,1,0,1,3
GlowstoneMC_Glowstone,net.glowstone.generator.decorators.theend,0,0,0,0,0,0,1,1
GlowstoneMC_Glowstone,net.glowstone.generator,0,0,0,0,1,0,1,2
GlowstoneMC_Glowstone,net.glowstone.generator.ground,0,0,0,0,1,0,1,2
GlowstoneMC_Glowstone,net.glowstone.generator.objects,0,0,0,0,1,0,1,2
GlowstoneMC_Glowstone,net.glowstone.generator.objects.trees,0,0,0,1,1,0,1,3
GlowstoneMC_Glowstone,net.glowstone.generator.populators.nether,0,0,0,0,0,0,1,1
GlowstoneMC_Glowstone,net.glowstone.generator.populators,0,0,0,0,1,0,1,2
GlowstoneMC_Glowstone,net.glowstone.generator.populators.overworld,1,0,0,1,1,0,1,4
GlowstoneMC_Glowstone,net.glowstone.generator.structures,1,0,0,0,1,1,1,4
GlowstoneMC_Glowstone,net.glowstone.generator.structures.util,0,0,0,0,1,0,1,2
GlowstoneMC_Glowstone,net.glowstone.i18n,22,1,0,1,1,0,1,26
GlowstoneMC_Glowstone,net.glowstone.inventory,7,1,0,1,1,0,1,11
GlowstoneMC_Glowstone,net.glowstone.inventory.crafting,4,0,0,0,1,0,1,6
GlowstoneMC_Glowstone,net.glowstone.io.anvil,0,0,0,0,1,0,1,2
GlowstoneMC_Glowstone,net.glowstone.io,0,0,0,0,1,1,1,3
GlowstoneMC_Glowstone,net.glowstone.io.data,0,0,0,0,0,0,1,1
GlowstoneMC_Glowstone,net.glowstone.io.entity,10,1,0,1,1,0,1,14
GlowstoneMC_Glowstone,net.glowstone.io.json,0,0,0,0,0,1,1,2
GlowstoneMC_Glowstone,net.glowstone.io.nbt,7,1,0,0,1,1,1,11
GlowstoneMC_Glowstone,net.glowstone.io.structure,1,0,0,0,1,1,1,4
GlowstoneMC_Glowstone,net.glowstone.map,3,0,0,0,1,0,1,5
GlowstoneMC_Glowstone,net.glowstone.net.codec.handshake,0,0,0,0,0,0,1,1
GlowstoneMC_Glowstone,net.glowstone.net.codec,1,0,0,0,0,0,1,2
GlowstoneMC_Glowstone,net.glowstone.net.codec.login,0,0,0,0,1,0,1,2
GlowstoneMC_Glowstone,net.glowstone.net.codec.play.entity,1,0,0,1,1,0,1,4
GlowstoneMC_Glowstone,net.glowstone.net.codec.play.game,1,0,0,1,1,0,1,4
GlowstoneMC_Glowstone,net.glowstone.net.codec.play.inv,1,0,0,0,1,0,1,3
GlowstoneMC_Glowstone,net.glowstone.net.codec.play.player,1,0,0,1,1,0,1,4
GlowstoneMC_Glowstone,net.glowstone.net.codec.play.scoreboard,0,0,0,0,1,0,1,2
GlowstoneMC_Glowstone,net.glowstone.net.codec.status,0,0,0,0,1,0,1,2
GlowstoneMC_Glowstone,net.glowstone.net.config,0,0,0,0,0,0,1,1
GlowstoneMC_Glowstone,net.glowstone.net,36,1,0,0,1,0,1,39
GlowstoneMC_Glowstone,net.glowstone.net.handler.handshake,0,0,0,0,0,0,1,1
GlowstoneMC_Glowstone,net.glowstone.net.handler.legacyping,0,0,0,0,0,0,1,1
GlowstoneMC_Glowstone,net.glowstone.net.handler.login,2,0,0,0,1,0,1,4
GlowstoneMC_Glowstone,net.glowstone.net.handler.play.game,3,0,0,0,1,0,1,5
GlowstoneMC_Glowstone,net.glowstone.net.handler.play.inv,2,0,0,0,1,0,1,4
GlowstoneMC_Glowstone,net.glowstone.net.handler.play.player,3,0,0,1,1,0,1,6
GlowstoneMC_Glowstone,net.glowstone.net.handler.status,2,0,0,0,1,0,1,4
GlowstoneMC_Glowstone,net.glowstone.net.http,1,0,0,0,1,0,1,3
GlowstoneMC_Glowstone,net.glowstone.net.message.handshake,0,0,0,0,0,0,1,1
GlowstoneMC_Glowstone,net.glowstone.net.message,1,0,0,0,0,0,1,2
GlowstoneMC_Glowstone,net.glowstone.net.message.login,0,0,0,0,1,0,1,2
GlowstoneMC_Glowstone,net.glowstone.net.message.play.entity,4,1,0,1,1,0,1,8
GlowstoneMC_Glowstone,net.glowstone.net.message.play.game,5,1,0,1,1,0,1,9
GlowstoneMC_Glowstone,net.glowstone.net.message.play.inv,2,0,0,0,1,0,1,4
GlowstoneMC_Glowstone,net.glowstone.net.message.play.player,0,0,0,1,1,0,1,3
GlowstoneMC_Glowstone,net.glowstone.net.message.play.scoreboard,0,0,0,0,1,0,1,2
GlowstoneMC_Glowstone,net.glowstone.net.message.status,0,0,0,0,1,0,1,2
GlowstoneMC_Glowstone,net.glowstone.net.pipeline,0,0,0,0,1,0,1,2
GlowstoneMC_Glowstone,net.glowstone.net.protocol,21,0,0,0,1,0,1,23
GlowstoneMC_Glowstone,net.glowstone.net.query,0,0,0,0,1,0,1,2
GlowstoneMC_Glowstone,net.glowstone.net.rcon,0,0,0,0,1,0,1,2
GlowstoneMC_Glowstone,net.glowstone.scheduler,0,0,0,0,1,0,1,2
GlowstoneMC_Glowstone,net.glowstone.scoreboard,0,0,0,0,1,2,1,4
GlowstoneMC_Glowstone,net.glowstone.util.bans,0,0,0,0,1,0,1,2
GlowstoneMC_Glowstone,net.glowstone.util,14,1,0,1,1,2,1,20
GlowstoneMC_Glowstone,net.glowstone.util.collection,0,0,0,0,1,0,1,2
GlowstoneMC_Glowstone,net.glowstone.util.config,2,1,0,0,1,0,1,5
GlowstoneMC_Glowstone,net.glowstone.util.library,0,0,0,0,1,0,1,2
GlowstoneMC_Glowstone,net.glowstone.util.loot,2,0,0,0,1,0,1,4
GlowstoneMC_Glowstone,net.glowstone.util.mojangson.ex,0,0,0,0,0,0,1,1
GlowstoneMC_Glowstone,net.glowstone.util.mojangson,0,0,0,0,0,0,1,1
GlowstoneMC_Glowstone,net.glowstone.util.nbt,3,0,0,1,0,2,1,7
GlowstoneMC_Glowstone,net.glowstone.util.noise,0,0,0,0,1,0,1,2
GlowstoneMC_Glowstone,net.glowstone.util.pathfinding.algorithms,0,0,0,0,0,0,1,1
GlowstoneMC_Glowstone,net.glowstone.util.pathfinding,0,0,0,0,1,0,1,2
GlowstoneMC_Glowstone,net.glowstone.util.pattern,0,0,0,0,0,0,1,1
GluuFederation_oxAuth,org.gluu.oxauth.client,2,1,0,1,1,13,0,18
GluuFederation_oxAuth,org.gluu.oxauth.client.fido.u2f,0,0,0,0,0,0,0,0
GluuFederation_oxAuth,org.gluu.oxauth.client.model.authorize,0,0,0,0,0,2,0,2
GluuFederation_oxAuth,org.gluu.oxauth.client.model,0,0,0,0,0,0,0,0
GluuFederation_oxAuth,org.gluu.oxauth.client.service,0,0,0,0,0,0,0,0
GluuFederation_oxAuth,org.gluu.oxauth.client.uma.exception,0,0,0,0,0,0,0,0
GluuFederation_oxAuth,org.gluu.oxauth.client.uma,0,1,0,0,0,0,0,1
GluuFederation_oxAuth,org.gluu.oxauth.client.uma.wrapper,0,0,0,0,0,0,0,0
GluuFederation_oxAuth,org.gluu.oxauth.util,29,1,0,0,1,0,0,31
GluuFederation_oxAuth,org.gluu.oxauth,3,0,0,0,0,0,0,3
GluuFederation_oxAuth,org.gluu.oxauth.dev,0,0,0,0,0,0,0,0
GluuFederation_oxAuth,org.gluu.oxauth.dev.manual,0,0,0,0,0,0,0,0
GluuFederation_oxAuth,org.gluu.oxauth.interop,0,0,0,1,1,7,0,9
GluuFederation_oxAuth,org.gluu.oxauth.load.benchmark,0,0,0,0,0,0,0,0
GluuFederation_oxAuth,org.gluu.oxauth.load.benchmark.suite,0,0,0,0,0,0,0,0
GluuFederation_oxAuth,org.gluu.oxauth.load,0,0,0,0,0,0,0,0
GluuFederation_oxAuth,org.gluu.oxauth.ws.rs,0,0,0,2,1,5,0,8
GluuFederation_oxAuth,org.gluu.oxauth.ws.rs.uma,0,0,0,0,1,0,0,1
GluuFederation_oxAuth,org.gluu.oxauth.interception,0,0,0,0,0,0,0,0
GluuFederation_oxAuth,org.gluu.oxauth.model.common,17,1,0,0,1,0,0,19
GluuFederation_oxAuth,org.gluu.oxauth.model.config,5,1,0,0,1,0,0,7
GluuFederation_oxAuth,org.gluu.oxauth.model.event,0,0,0,0,0,0,0,0
GluuFederation_oxAuth,org.gluu.oxauth.model.ref,0,0,0,0,0,0,0,0
GluuFederation_oxAuth,org.gluu.oxauth.service.api,0,0,0,0,0,0,0,0
GluuFederation_oxAuth,org.gluu.oxauth.service,20,1,0,1,1,0,0,23
GluuFederation_oxAuth,org.gluu.oxauth.fido2.client,0,0,0,0,0,0,0,0
GluuFederation_oxAuth,org.gluu.oxauth.fido2.certification,0,0,0,0,0,0,0,0
GluuFederation_oxAuth,org.gluu.oxauth.fido2.cryptoutils,0,0,0,0,0,0,0,0
GluuFederation_oxAuth,org.gluu.oxauth.fido2.exception,0,0,0,0,0,0,0,0
GluuFederation_oxAuth,org.gluu.oxauth.fido2.google.safetynet,0,0,0,0,0,0,0,0
GluuFederation_oxAuth,org.gluu.oxauth.fido2.model.auth,0,0,0,0,0,0,0,0
GluuFederation_oxAuth,org.gluu.oxauth.fido2.model.cert,0,0,0,0,0,0,0,0
GluuFederation_oxAuth,org.gluu.oxauth.fido2.model.entry,0,0,0,0,1,0,0,1
GluuFederation_oxAuth,org.gluu.oxauth.fido2.model.error,0,0,0,0,0,0,0,0
GluuFederation_oxAuth,org.gluu.oxauth.fido2.persist,0,0,0,0,0,0,0,0
GluuFederation_oxAuth,org.gluu.oxauth.fido2.service,0,0,0,0,1,0,0,1
GluuFederation_oxAuth,org.gluu.oxauth.fido2.service.exception,0,0,0,0,0,0,0,0
GluuFederation_oxAuth,org.gluu.oxauth.fido2.service.mds,0,0,0,0,0,0,0,0
GluuFederation_oxAuth,org.gluu.oxauth.fido2.service.processors,0,0,0,0,0,0,0,0
GluuFederation_oxAuth,org.gluu.oxauth.fido2.service.processors.impl,0,0,0,0,1,0,0,1
GluuFederation_oxAuth,org.gluu.oxauth.fido2.service.verifier,0,0,0,0,0,0,0,0
GluuFederation_oxAuth,org.gluu.oxauth.fido2.ws.rs.controller,0,0,0,0,0,0,0,0
GluuFederation_oxAuth,org.gluu.oxauth.fido2.ws.rs.service,0,0,0,0,0,0,0,0
GluuFederation_oxAuth,org.gluu.oxauth.model.authorize,4,1,0,0,1,0,0,6
GluuFederation_oxAuth,org.gluu.oxauth.model.configuration,0,0,0,0,1,0,0,1
GluuFederation_oxAuth,org.gluu.oxauth.model.crypto,3,1,0,0,1,4,0,9
GluuFederation_oxAuth,org.gluu.oxauth.model.crypto.binding,0,0,0,0,0,0,0,0
GluuFederation_oxAuth,org.gluu.oxauth.model.crypto.signature,2,0,0,0,1,0,0,3
GluuFederation_oxAuth,org.gluu.oxauth.model.discovery,0,0,0,0,0,0,0,0
GluuFederation_oxAuth,org.gluu.oxauth.model.error,5,1,0,0,1,0,0,7
GluuFederation_oxAuth,org.gluu.oxauth.model.exception,0,0,0,0,1,0,0,1
GluuFederation_oxAuth,org.gluu.oxauth.model.fido.u2f,0,0,0,0,1,0,0,1
GluuFederation_oxAuth,org.gluu.oxauth.model.fido.u2f.exception,0,0,0,0,0,0,0,0
GluuFederation_oxAuth,org.gluu.oxauth.model.fido.u2f.message,0,0,0,0,0,1,0,1
GluuFederation_oxAuth,org.gluu.oxauth.model.fido.u2f.protocol,0,0,0,0,1,1,0,2
GluuFederation_oxAuth,org.gluu.oxauth.model.gluu,0,0,0,0,0,0,0,0
GluuFederation_oxAuth,org.gluu.oxauth.model.jwe,0,0,0,0,1,4,0,5
GluuFederation_oxAuth,org.gluu.oxauth.model.jwk,0,0,0,0,0,1,0,1
GluuFederation_oxAuth,org.gluu.oxauth.model.jws,0,0,0,0,0,6,0,6
GluuFederation_oxAuth,org.gluu.oxauth.model.jwt,0,0,0,0,1,11,0,12
GluuFederation_oxAuth,org.gluu.oxauth.model.session,1,0,0,0,0,0,0,1
GluuFederation_oxAuth,org.gluu.oxauth.model.token,4,0,0,0,1,10,0,15
GluuFederation_oxAuth,org.gluu.oxauth.model.uma,8,1,0,0,1,3,0,13
GluuFederation_oxAuth,org.gluu.oxauth.model.uma.persistence,0,0,0,0,0,3,0,3
GluuFederation_oxAuth,org.gluu.oxauth.model.uma.wrapper,0,0,0,0,0,1,0,1
GluuFederation_oxAuth,org.gluu.oxauth.model.userinfo,0,0,0,0,0,0,0,0
GluuFederation_oxAuth,org.gluu.oxauth.model.util,2,1,0,0,1,0,0,4
GluuFederation_oxAuth,org.gluu.oxauth.auth.mtls,0,0,0,0,0,0,0,0
GluuFederation_oxAuth,org.oxauth.persistence.model.base,0,0,0,0,0,0,0,0
GluuFederation_oxAuth,org.oxauth.persistence.model,0,0,0,0,0,1,0,1
GluuFederation_oxAuth,org.oxauth.persistence.model.configuration,0,0,0,0,0,0,0,0
GluuFederation_oxAuth,org.gluu.oxauth.action,0,0,0,0,1,0,0,1
GluuFederation_oxAuth,org.gluu.oxauth.validator,0,0,0,0,0,0,0,0
GluuFederation_oxAuth,org.gluu.oxauth.rp.demo,0,0,0,0,0,0,0,0
GluuFederation_oxAuth,com.toopher,0,0,0,0,0,0,0,0
GluuFederation_oxAuth,org.gluu.oxauth.audit,0,0,0,0,0,0,0,0
GluuFederation_oxAuth,org.gluu.oxauth.audit.debug.entity,0,0,0,0,0,0,0,0
GluuFederation_oxAuth,org.gluu.oxauth.audit.debug,0,0,0,0,0,0,0,0
GluuFederation_oxAuth,org.gluu.oxauth.audit.debug.wrapper,0,0,0,0,0,0,0,0
GluuFederation_oxAuth,org.gluu.oxauth.auth,3,0,0,0,0,0,0,3
GluuFederation_oxAuth,org.gluu.oxauth.authorize.ws.rs,4,0,0,0,1,0,0,5
GluuFederation_oxAuth,org.gluu.oxauth.cert.fingerprint,0,0,0,0,0,0,0,0
GluuFederation_oxAuth,org.gluu.oxauth.cert.validation,0,0,0,0,0,0,0,0
GluuFederation_oxAuth,org.gluu.oxauth.cert.validation.model,0,0,0,0,0,0,0,0
GluuFederation_oxAuth,org.gluu.oxauth.clientinfo.ws.rs,0,0,0,0,0,0,0,0
GluuFederation_oxAuth,org.gluu.oxauth.crypto.cert,0,0,0,0,0,0,0,0
GluuFederation_oxAuth,org.gluu.oxauth.crypto.random,0,0,0,0,0,0,0,0
GluuFederation_oxAuth,org.gluu.oxauth.crypto.signature,0,0,0,0,0,0,0,0
GluuFederation_oxAuth,org.gluu.oxauth.exception.fido.u2f,0,0,0,0,0,0,0,0
GluuFederation_oxAuth,org.gluu.oxauth.exception,0,0,0,0,0,0,0,0
GluuFederation_oxAuth,org.gluu.oxauth.filter,0,0,0,0,0,0,0,0
GluuFederation_oxAuth,org.gluu.oxauth.gluu.ws.rs,0,0,0,0,0,0,0,0
GluuFederation_oxAuth,org.gluu.oxauth.i18n,0,0,0,0,0,0,0,0
GluuFederation_oxAuth,org.gluu.oxauth.idgen.ws.rs,0,1,0,0,0,0,0,1
GluuFederation_oxAuth,org.gluu.oxauth.introspection.ws.rs,0,0,0,0,0,0,0,0
GluuFederation_oxAuth,org.gluu.oxauth.jwk.ws.rs,0,0,0,0,0,0,0,0
GluuFederation_oxAuth,org.gluu.oxauth.model.audit,0,0,0,0,0,0,0,0
GluuFederation_oxAuth,org.gluu.oxauth.model.auth,0,0,0,0,0,0,0,0
GluuFederation_oxAuth,org.gluu.oxauth.model.clientinfo,0,0,0,0,0,0,0,0
GluuFederation_oxAuth,org.gluu.oxauth.model,0,0,0,0,0,0,0,0
GluuFederation_oxAuth,org.gluu.oxauth.model.ldap,0,0,0,0,0,0,0,0
GluuFederation_oxAuth,org.gluu.oxauth.model.net,0,0,0,0,0,0,0,0
GluuFederation_oxAuth,org.gluu.oxauth.model.registration,6,0,0,0,0,0,0,6
GluuFederation_oxAuth,org.gluu.oxauth.register.ws.rs,0,0,0,0,0,0,0,0
GluuFederation_oxAuth,org.gluu.oxauth.revoke,0,0,0,0,0,0,0,0
GluuFederation_oxAuth,org.gluu.oxauth.security,3,0,0,0,0,0,0,3
GluuFederation_oxAuth,org.gluu.oxauth.service.cdi.event,0,0,0,0,0,0,0,0
GluuFederation_oxAuth,org.gluu.oxauth.service.custom,0,0,0,0,0,0,0,0
GluuFederation_oxAuth,org.gluu.oxauth.service.external.context,4,1,0,0,0,0,0,5
GluuFederation_oxAuth,org.gluu.oxauth.service.external,13,1,0,0,1,0,0,15
GluuFederation_oxAuth,org.gluu.oxauth.service.external.internal,1,1,0,0,0,0,0,2
GluuFederation_oxAuth,org.gluu.oxauth.service.fido.u2f,0,0,0,0,1,1,0,2
GluuFederation_oxAuth,org.gluu.oxauth.service.fido.u2f.util,0,0,0,0,0,0,0,0
GluuFederation_oxAuth,org.gluu.oxauth.service.logger,0,0,0,0,0,0,0,0
GluuFederation_oxAuth,org.gluu.oxauth.service.net,0,0,0,0,0,0,0,0
GluuFederation_oxAuth,org.gluu.oxauth.service.push.sns,0,0,0,0,0,0,0,0
GluuFederation_oxAuth,org.gluu.oxauth.service.status.ldap,0,0,0,0,0,0,0,0
GluuFederation_oxAuth,org.gluu.oxauth.service.token,2,0,0,0,0,0,0,2
GluuFederation_oxAuth,org.gluu.oxauth.servlet,0,0,0,0,0,0,0,0
GluuFederation_oxAuth,org.gluu.oxauth.session.ws.rs,0,0,0,0,0,0,0,0
GluuFederation_oxAuth,org.gluu.oxauth.token.ws.rs,0,0,0,0,0,0,0,0
GluuFederation_oxAuth,org.gluu.oxauth.uma.authorization,8,1,0,0,1,1,0,11
GluuFederation_oxAuth,org.gluu.oxauth.uma.service,29,0,0,0,0,2,0,31
GluuFederation_oxAuth,org.gluu.oxauth.uma.ws.rs,5,0,0,0,1,1,0,7
GluuFederation_oxAuth,org.gluu.oxauth.userinfo.ws.rs,0,0,0,0,0,0,0,0
GluuFederation_oxAuth,org.gluu.oxauth.ws.rs.fido.u2f,0,0,0,0,0,0,0,0
GluuFederation_oxAuth,org.gluu.oxauth.comp,0,0,0,0,1,1,0,2
GluuFederation_oxAuth,org.gluu.oxauth.dev.duo,0,0,0,0,0,0,0,0
GluuFederation_oxTrust,org.gluu.oxtrust.api.server.api.impl,0,0,0,0,1,0,0,1
GluuFederation_oxTrust,org.gluu.oxtrust.api.server.api.impl.radius,0,0,0,0,0,0,0,0
GluuFederation_oxTrust,org.gluu.oxtrust.api.server.model,0,1,0,0,1,0,0,2
GluuFederation_oxTrust,org.gluu.oxtrust.api.server.util,0,1,0,0,1,0,0,2
GluuFederation_oxTrust,org.api.server,0,0,0,0,0,0,0,0
GluuFederation_oxTrust,org.gluu.oxauth.cas.auth.client,0,0,0,0,0,0,0,0
GluuFederation_oxTrust,org.gluu.oxauth.cas.auth.conf,0,0,0,0,0,0,0,0
GluuFederation_oxTrust,org.gluu.oxauth.cas.auth.handler,0,0,0,0,0,0,0,0
GluuFederation_oxTrust,org.gluu.oxauth.cas.auth.login.flow,0,0,0,0,0,0,0,0
GluuFederation_oxTrust,org.gluu.oxauth.cas.auth.principal,0,0,0,0,0,0,0,0
GluuFederation_oxTrust,org.gluu.oxauth.client.dev,0,0,0,0,0,0,0,0
GluuFederation_oxTrust,org.gluu.oxtrust.api,0,0,0,0,0,0,0,0
GluuFederation_oxTrust,org.gluu.oxtrust.api.saml,0,0,0,0,0,0,0,0
GluuFederation_oxTrust,org.gluu.oxtrust.model.association,0,0,0,0,0,1,0,1
GluuFederation_oxTrust,org.gluu.oxtrust.model,3,1,0,1,1,1,0,7
GluuFederation_oxTrust,org.gluu.oxtrust.model.cert,0,0,0,0,0,0,0,0
GluuFederation_oxTrust,org.gluu.oxtrust.model.fido,0,0,0,0,0,0,0,0
GluuFederation_oxTrust,org.gluu.oxtrust.model.fido2,0,0,0,0,0,0,0,0
GluuFederation_oxTrust,org.gluu.oxtrust.model.oxchooser,0,0,0,0,0,0,0,0
GluuFederation_oxTrust,org.gluu.oxtrust.model.passport,0,0,0,0,0,0,0,0
GluuFederation_oxTrust,org.gluu.oxtrust.model.push,0,0,0,0,0,0,0,0
GluuFederation_oxTrust,org.gluu.oxtrust.model.scim,0,0,0,0,0,0,0,0
GluuFederation_oxTrust,org.gluu.oxtrust.model.sql,0,0,0,0,0,0,0,0
GluuFederation_oxTrust,org.gluu.oxtrust.model.table,0,0,0,0,0,0,0,0
GluuFederation_oxTrust,org.gluu.oxtrust.util,4,1,0,1,1,1,0,8
GluuFederation_oxTrust,org.gluu.oxauth.client.auth.principal,0,0,0,0,0,0,0,0
GluuFederation_oxTrust,org.gluu.oxauth.client.auth.user,0,0,0,0,0,0,0,0
GluuFederation_oxTrust,org.gluu.oxauth.client,0,0,0,0,0,0,0,0
GluuFederation_oxTrust,org.gluu.oxauth.client.conf,0,0,0,0,0,0,0,0
GluuFederation_oxTrust,org.gluu.oxauth.client.exception,0,0,0,0,0,0,0,0
GluuFederation_oxTrust,org.oxtrust.qa.configuration,1,1,0,0,0,0,0,2
GluuFederation_oxTrust,org.oxtrust.qa.pages,1,0,0,0,0,0,0,1
GluuFederation_oxTrust,org.oxtrust.qa.pages.configuration.attributesImExport,0,0,0,0,0,0,0,0
GluuFederation_oxTrust,org.oxtrust.qa.pages.configuration,0,0,0,0,1,0,0,1
GluuFederation_oxTrust,org.oxtrust.qa.pages.configuration.authentication,0,0,0,0,0,0,0,0
GluuFederation_oxTrust,org.oxtrust.qa.pages.configuration.cr,0,0,0,0,0,0,0,0
GluuFederation_oxTrust,org.oxtrust.qa.pages.configuration.json,0,0,0,0,0,0,0,0
GluuFederation_oxTrust,org.oxtrust.qa.pages.configuration.organization,0,0,0,0,0,0,0,0
GluuFederation_oxTrust,org.oxtrust.qa.pages.login,0,0,0,0,0,0,0,0
GluuFederation_oxTrust,org.oxtrust.qa.pages.openidconnect,0,0,0,0,1,0,0,1
GluuFederation_oxTrust,org.oxtrust.qa.pages.passport,0,0,0,0,0,0,0,0
GluuFederation_oxTrust,org.oxtrust.qa.pages.profile,0,0,0,0,0,0,0,0
GluuFederation_oxTrust,org.oxtrust.qa.pages.saml,0,0,0,0,0,0,0,0
GluuFederation_oxTrust,org.oxtrust.qa.pages.uma,0,0,0,0,0,0,0,0
GluuFederation_oxTrust,org.oxtrust.qa.pages.users,0,0,0,0,1,0,0,1
GluuFederation_oxTrust,org.oxtrust.qa.runner,0,0,0,0,0,0,0,0
GluuFederation_oxTrust,org.oxtrust.qa.steps,0,0,0,0,0,0,0,0
GluuFederation_oxTrust,org.gluu.oxauth.client.authentication,2,0,0,0,0,0,0,2
GluuFederation_oxTrust,org.gluu.oxauth.client.logout,0,0,0,0,0,0,0,0
GluuFederation_oxTrust,org.gluu.oxauth.client.session,2,1,0,0,0,0,0,3
GluuFederation_oxTrust,org.gluu.oxauth.client.util,3,1,0,0,1,0,0,5
GluuFederation_oxTrust,org.gluu.oxauth.client.validation,0,0,0,0,0,0,0,0
GluuFederation_oxTrust,org.gluu.oxtrust.model.exception,0,0,0,0,0,0,0,0
GluuFederation_oxTrust,org.gluu.oxtrust.model.scim2,1,1,0,0,1,0,0,3
GluuFederation_oxTrust,org.gluu.oxtrust.model.scim2.bulk,0,0,0,0,0,0,0,0
GluuFederation_oxTrust,org.gluu.oxtrust.model.scim2.extensions,1,0,0,0,0,0,0,1
GluuFederation_oxTrust,org.gluu.oxtrust.model.scim2.fido,0,0,0,0,0,0,0,0
GluuFederation_oxTrust,org.gluu.oxtrust.model.scim2.group,0,0,0,0,0,0,0,0
GluuFederation_oxTrust,org.gluu.oxtrust.model.scim2.patch,0,0,0,0,0,0,0,0
GluuFederation_oxTrust,org.gluu.oxtrust.model.scim2.provider.config,0,0,0,0,1,0,0,1
GluuFederation_oxTrust,org.gluu.oxtrust.model.scim2.provider.resourcetypes,0,0,0,0,0,0,0,0
GluuFederation_oxTrust,org.gluu.oxtrust.model.scim2.provider.schema,0,0,0,0,0,0,0,0
GluuFederation_oxTrust,org.gluu.oxtrust.model.scim2.user,0,0,0,0,1,0,0,1
GluuFederation_oxTrust,org.gluu.oxtrust.model.scim2.util,2,1,0,0,1,0,0,4
GluuFederation_oxTrust,org.gluu.oxtrust.ws.rs.scim2,0,0,0,0,1,0,0,1
GluuFederation_oxTrust,org.gluu.oxtrust.action,0,0,0,1,1,0,0,2
GluuFederation_oxTrust,org.gluu.oxtrust.action.push,0,0,0,0,0,0,0,0
GluuFederation_oxTrust,org.gluu.oxtrust.action.radius,0,0,0,0,0,0,0,0
GluuFederation_oxTrust,org.gluu.oxtrust.action.uma,0,0,0,0,0,0,0,0
GluuFederation_oxTrust,org.gluu.oxtrust.api.rest,0,0,0,0,0,0,0,0
GluuFederation_oxTrust,org.gluu.oxtrust.config,3,1,0,0,0,0,0,4
GluuFederation_oxTrust,org.gluu.oxtrust.exception,0,0,0,0,1,0,0,1
GluuFederation_oxTrust,org.gluu.oxtrust.i18n,0,0,0,0,0,0,0,0
GluuFederation_oxTrust,org.gluu.oxtrust,0,0,0,0,0,0,0,0
GluuFederation_oxTrust,org.gluu.oxtrust.ldap.cache.model,0,0,0,0,0,0,0,0
GluuFederation_oxTrust,org.gluu.oxtrust.ldap.cache.service,4,0,0,0,0,0,0,4
GluuFederation_oxTrust,org.gluu.oxtrust.ldap.load.conf,0,0,0,0,0,0,0,0
GluuFederation_oxTrust,org.gluu.oxtrust.ldap.service,12,1,0,1,1,0,0,15
GluuFederation_oxTrust,org.gluu.oxtrust.ldap.service.radius,0,1,0,0,0,0,0,1
GluuFederation_oxTrust,org.gluu.oxtrust.ldap.service.uma,0,0,0,0,0,0,0,0
GluuFederation_oxTrust,org.gluu.oxtrust.model.status,0,0,0,0,0,0,0,0
GluuFederation_oxTrust,org.gluu.oxtrust.security,0,0,0,0,0,0,0,0
GluuFederation_oxTrust,org.gluu.oxtrust.service.antlr.scimFilter.antlr4,0,0,0,0,0,0,0,0
GluuFederation_oxTrust,org.gluu.oxtrust.service.antlr.scimFilter,2,0,0,0,0,0,0,2
GluuFederation_oxTrust,org.gluu.oxtrust.service.antlr.scimFilter.util,2,1,0,0,0,0,0,3
GluuFederation_oxTrust,org.gluu.oxtrust.service,2,0,0,0,1,0,0,3
GluuFederation_oxTrust,org.gluu.oxtrust.service.cdi.event,0,0,0,0,1,0,0,1
GluuFederation_oxTrust,org.gluu.oxtrust.service.custom,0,1,0,0,0,0,0,1
GluuFederation_oxTrust,org.gluu.oxtrust.service.external,0,0,0,0,0,0,0,0
GluuFederation_oxTrust,org.gluu.oxtrust.service.filter,0,0,0,0,0,0,0,0
GluuFederation_oxTrust,org.gluu.oxtrust.service.logger,1,0,0,0,0,0,0,1
GluuFederation_oxTrust,org.gluu.oxtrust.service.push,0,0,0,0,0,0,0,0
GluuFederation_oxTrust,org.gluu.oxtrust.service.python.interfaces,0,0,0,0,0,0,0,0
GluuFederation_oxTrust,org.gluu.oxtrust.service.render,0,0,0,0,0,0,0,0
GluuFederation_oxTrust,org.gluu.oxtrust.service.scim2,3,1,0,0,0,0,0,4
GluuFederation_oxTrust,org.gluu.oxtrust.service.scim2.interceptor,0,0,0,0,1,0,0,1
GluuFederation_oxTrust,org.gluu.oxtrust.service.scim2.serialization,0,1,0,0,0,0,0,1
GluuFederation_oxTrust,org.gluu.oxtrust.service.status.ldap,1,0,0,0,0,0,0,1
GluuFederation_oxTrust,org.gluu.oxtrust.service.uma.annotations,0,0,0,0,0,0,0,0
GluuFederation_oxTrust,org.gluu.oxtrust.service.uma,0,0,0,0,0,0,0,0
GluuFederation_oxTrust,org.gluu.oxtrust.servlet,0,0,0,0,1,0,0,1
GluuFederation_oxTrust,org.gluu.oxtrust.util.jsf,0,0,0,0,1,0,0,1
GluuFederation_oxTrust,org.gluu.oxtrust.util.velocity,0,0,0,0,0,0,0,0
GluuFederation_oxTrust,org.gluu.oxtrust.ws.rs.passport,0,0,0,0,0,0,0,0
GluuFederation_oxTrust,org.gluu.oxtrust.ws.rs,0,0,0,0,0,0,0,0
GluuFederation_oxTrust,org.gluu.oxtrust.ldap.service.util,0,0,0,0,0,0,0,0
gmantele_taplib,adql.db,15,1,0,1,0,0,1,18
gmantele_taplib,adql.db.exception,4,1,0,0,0,0,1,6
gmantele_taplib,adql.parser,3,1,0,0,0,0,1,5
gmantele_taplib,adql.query,22,1,0,0,0,0,1,24
gmantele_taplib,adql.query.constraint,4,1,0,0,0,0,1,6
gmantele_taplib,adql.query.from,8,1,0,0,0,0,1,10
gmantele_taplib,adql.query.operand,11,1,0,0,0,0,1,13
gmantele_taplib,adql.query.operand.function,2,1,0,0,0,0,1,4
gmantele_taplib,adql.query.operand.function.geometry,3,0,0,0,0,0,1,4
gmantele_taplib,adql.search,2,0,0,0,0,0,1,3
gmantele_taplib,adql.translator,3,0,0,0,0,0,1,4
gmantele_taplib,cds.util,0,0,0,0,1,0,1,2
gmantele_taplib,cds.utils,0,0,0,0,0,0,1,1
gmantele_taplib,org.json,3,0,0,0,0,0,1,4
gmantele_taplib,tap,13,1,0,0,0,0,1,15
gmantele_taplib,tap.backup,0,1,0,0,0,0,1,2
gmantele_taplib,tap.config,0,0,0,0,1,0,1,2
gmantele_taplib,tap.data,9,1,0,0,0,0,1,11
gmantele_taplib,tap.db,8,1,0,0,0,0,1,10
gmantele_taplib,tap.error,0,0,0,0,0,0,1,1
gmantele_taplib,tap.formatter,4,0,0,0,0,0,1,5
gmantele_taplib,tap.log,3,1,0,0,0,0,1,5
gmantele_taplib,tap.metadata,13,1,0,0,0,0,1,15
gmantele_taplib,tap.parameters,5,1,0,0,0,0,1,7
gmantele_taplib,tap.resource,6,0,0,0,0,0,1,7
gmantele_taplib,tap.upload,7,0,0,0,0,0,1,8
gmantele_taplib,uws,8,1,0,0,1,0,1,11
gmantele_taplib,uws.config,0,0,0,0,1,0,1,2
gmantele_taplib,uws.job,38,1,0,0,0,0,1,40
gmantele_taplib,uws.job.jobInfo,2,0,0,0,0,0,1,3
gmantele_taplib,uws.job.manager,4,0,0,0,1,0,1,6
gmantele_taplib,uws.job.parameters,5,1,0,0,0,0,1,7
gmantele_taplib,uws.job.serializer.filter,2,0,0,0,0,0,1,3
gmantele_taplib,uws.job.serializer,15,1,0,0,0,0,1,17
gmantele_taplib,uws.job.user,17,1,0,0,0,0,1,19
gmantele_taplib,uws.service,31,1,0,0,0,0,1,33
gmantele_taplib,uws.service.actions,3,0,0,0,0,0,1,4
gmantele_taplib,uws.service.backup,2,0,0,0,0,0,1,3
gmantele_taplib,uws.service.error,4,0,0,0,0,0,1,5
gmantele_taplib,uws.service.file,7,1,0,0,1,0,1,10
gmantele_taplib,uws.service.file.io,0,0,0,0,0,0,1,1
gmantele_taplib,uws.service.log,11,1,0,0,0,0,1,13
gmantele_taplib,uws.service.request,6,1,0,0,0,0,1,8
gmantele_taplib,uws.service.wait,3,0,0,0,0,0,1,4
gonmarques_cdi-properties,com.byteslounge.cdi.configuration,0,0,0,0,0,0,0,0
gonmarques_cdi-properties,com.byteslounge.cdi.converter,0,0,0,0,0,0,0,0
gonmarques_cdi-properties,com.byteslounge.cdi.exception,0,0,0,0,0,0,0,0
gonmarques_cdi-properties,com.byteslounge.cdi.extension.param,0,0,0,0,0,0,0,0
gonmarques_cdi-properties,com.byteslounge.cdi.extension,0,0,0,0,0,0,0,0
gonmarques_cdi-properties,com.byteslounge.cdi.format,0,0,0,0,0,0,0,0
gonmarques_cdi-properties,com.byteslounge.cdi.resolver.bean,0,0,0,0,1,0,0,1
gonmarques_cdi-properties,com.byteslounge.cdi.resolver.context,0,0,0,0,0,0,0,0
gonmarques_cdi-properties,com.byteslounge.cdi.resolver,0,0,0,0,0,0,0,0
gonmarques_cdi-properties,com.byteslounge.cdi.resolver.extractor,0,0,0,0,0,0,0,0
gonmarques_cdi-properties,com.byteslounge.cdi.resolver.locale,0,0,0,0,0,0,0,0
gonmarques_cdi-properties,com.byteslounge.cdi.resolver.verifier,0,0,0,0,0,0,0,0
gonmarques_cdi-properties,com.byteslounge.cdi.utils,0,0,0,0,0,0,0,0
GoogleCloudPlatform_bigdata-interop,(default package),0,0,0,0,0,0,1,1
GoogleCloudPlatform_bigdata-interop,com.google.cloud.hadoop.io.bigquery,1,1,0,1,0,0,1,4
GoogleCloudPlatform_bigdata-interop,com.google.cloud.hadoop.io.bigquery.output,1,0,0,0,0,0,1,2
GoogleCloudPlatform_bigdata-interop,com.google.cloud.hadoop.fs.gcs.auth,1,1,0,0,1,0,1,4
GoogleCloudPlatform_bigdata-interop,com.google.cloud.hadoop.fs.gcs,1,0,0,1,0,0,1,3
GoogleCloudPlatform_bigdata-interop,com.google.cloud.hadoop.fs.gcs.contract,0,0,0,0,0,0,1,1
GoogleCloudPlatform_bigdata-interop,com.google.cloud.hadoop.fs.gcs.hcfs,0,0,0,0,0,0,1,1
GoogleCloudPlatform_bigdata-interop,com.google.cloud.hadoop.gcsio,3,1,0,1,0,0,1,6
GoogleCloudPlatform_bigdata-interop,com.google.cloud.hadoop.gcsio.cooplock,1,0,0,0,1,0,1,3
GoogleCloudPlatform_bigdata-interop,com.google.cloud.hadoop.gcsio.integration,2,0,0,0,0,0,1,3
GoogleCloudPlatform_bigdata-interop,com.google.cloud.hadoop.util,1,1,0,1,1,0,1,5
GoogleCloudPlatform_gcloud-java,com.google.cloud.examples.bigquery,0,0,0,0,0,0,0,0
GoogleCloudPlatform_gcloud-java,com.google.cloud.examples.bigquery.snippets,0,0,0,0,1,0,0,1
GoogleCloudPlatform_gcloud-java,com.google.cloud.examples.compute.deprecated,0,0,0,1,0,0,0,1
GoogleCloudPlatform_gcloud-java,com.google.cloud.examples.compute.snippets,0,0,0,0,0,0,0,0
GoogleCloudPlatform_gcloud-java,com.google.cloud.examples.compute.v1,0,0,0,0,0,0,0,0
GoogleCloudPlatform_gcloud-java,com.google.cloud.examples.datastore,0,0,0,0,0,0,0,0
GoogleCloudPlatform_gcloud-java,com.google.cloud.examples.datastore.snippets,0,0,0,0,1,0,0,1
GoogleCloudPlatform_gcloud-java,com.google.cloud.examples.dns,0,0,0,0,0,0,0,0
GoogleCloudPlatform_gcloud-java,com.google.cloud.examples.dns.snippets,0,0,0,0,0,0,0,0
GoogleCloudPlatform_gcloud-java,com.google.cloud.examples.language.snippets,0,0,0,0,0,0,0,0
GoogleCloudPlatform_gcloud-java,com.google.cloud.examples.logging,0,0,0,0,0,0,0,0
GoogleCloudPlatform_gcloud-java,com.google.cloud.examples.logging.snippets,0,0,0,0,1,0,0,1
GoogleCloudPlatform_gcloud-java,com.google.cloud.examples.nio,0,0,0,0,0,0,0,0
GoogleCloudPlatform_gcloud-java,com.google.cloud.examples.nio.snippets,0,0,0,0,1,0,0,1
GoogleCloudPlatform_gcloud-java,com.google.cloud.examples.pubsub.snippets,0,0,0,0,1,0,0,1
GoogleCloudPlatform_gcloud-java,com.google.cloud.examples.resourcemanager,0,0,0,0,0,0,0,0
GoogleCloudPlatform_gcloud-java,com.google.cloud.examples.resourcemanager.snippets,0,0,0,0,0,0,0,0
GoogleCloudPlatform_gcloud-java,com.google.cloud.examples.securitycenter.snippets,0,0,0,0,1,0,0,1
GoogleCloudPlatform_gcloud-java,com.google.cloud.examples.spanner.snippets,0,0,0,0,1,0,0,1
GoogleCloudPlatform_gcloud-java,com.google.cloud.examples.speech.snippets,0,0,0,0,0,0,0,0
GoogleCloudPlatform_gcloud-java,com.google.cloud.examples.storage.objects,0,0,0,0,0,0,0,0
GoogleCloudPlatform_gcloud-java,com.google.cloud.examples.storage.snippets,0,0,0,0,1,0,0,1
GoogleCloudPlatform_gcloud-java,com.google.cloud.examples.storage,0,0,0,0,0,0,0,0
GoogleCloudPlatform_gcloud-java,com.google.cloud.examples.translate.snippets,0,0,0,0,0,0,0,0
GoogleCloudPlatform_gcloud-java,com.google.cloud.examples.translate,0,0,0,0,0,0,0,0
GoogleCloudPlatform_gcloud-java,com.google.cloud.examples.vision.snippets,0,0,0,0,0,0,0,0
GoogleCloudPlatform_gcloud-java,com.google.cloud.benchwrapper,0,0,0,0,0,0,0,0
GoogleCloudPlatform_gcloud-java,com.google.cloud.compatchecker,0,0,0,0,0,0,0,0
googlegenomics_dataflow-java,com.google.cloud.genomics.dataflow.coders,0,0,0,0,0,0,0,0
googlegenomics_dataflow-java,com.google.cloud.genomics.dataflow.functions,0,0,0,0,1,0,0,1
googlegenomics_dataflow-java,com.google.cloud.genomics.dataflow.functions.ibs,0,0,0,0,1,0,0,1
googlegenomics_dataflow-java,com.google.cloud.genomics.dataflow.functions.pca,0,0,0,0,0,0,0,0
googlegenomics_dataflow-java,com.google.cloud.genomics.dataflow.functions.verifybamid,0,0,0,0,1,0,0,1
googlegenomics_dataflow-java,com.google.cloud.genomics.dataflow.model,0,0,0,0,1,0,0,1
googlegenomics_dataflow-java,com.google.cloud.genomics.dataflow.pipelines,0,0,0,1,1,0,0,2
googlegenomics_dataflow-java,com.google.cloud.genomics.dataflow.readers.bam,0,0,0,0,1,0,0,1
googlegenomics_dataflow-java,com.google.cloud.genomics.dataflow.readers,0,0,0,0,1,0,0,1
googlegenomics_dataflow-java,com.google.cloud.genomics.dataflow.utils,0,0,0,0,1,0,0,1
googlegenomics_dataflow-java,com.google.cloud.genomics.dataflow.writers.bam,0,0,0,0,1,0,0,1
googlegenomics_dataflow-java,htsjdk.samtools,0,0,0,0,1,0,0,1
googlemaps_google-maps-services-java,com.google.maps,2,0,0,1,1,0,0,4
googlemaps_google-maps-services-java,com.google.maps.errors,0,0,0,0,0,0,0,0
googlemaps_google-maps-services-java,com.google.maps.internal,3,1,0,1,1,0,0,6
googlemaps_google-maps-services-java,com.google.maps.internal.ratelimiter,0,0,0,0,1,0,0,1
googlemaps_google-maps-services-java,com.google.maps.model,2,1,0,1,1,0,0,5
google_acai,com.google.acai,0,0,0,1,1,0,0,2
google_closure-compiler,com.google.debugging.sourcemap.proto,0,0,0,0,0,0,0,0
google_closure-compiler,com.google.javascript.jscomp,22,1,0,2,1,12,0,38
google_closure-compiler,com.google.debugging.sourcemap,1,1,0,1,1,0,0,4
google_closure-compiler,com.google.javascript.jscomp.ant,0,0,0,0,0,0,0,0
google_closure-compiler,com.google.javascript.jscomp.bundle,2,0,0,0,1,0,0,3
google_closure-compiler,com.google.javascript.jscomp.debugger.gwt,0,0,0,0,0,0,0,0
google_closure-compiler,com.google.javascript.jscomp.deps,8,1,0,1,1,1,0,12
google_closure-compiler,com.google.javascript.jscomp.diagnostic,0,0,0,0,0,0,0,0
google_closure-compiler,com.google.javascript.jscomp.graph,0,0,0,1,0,1,0,2
google_closure-compiler,com.google.javascript.jscomp.gwt.client,0,0,0,0,1,0,0,1
google_closure-compiler,com.google.javascript.jscomp.gwt.linker,0,0,0,0,0,0,0,0
google_closure-compiler,com.google.common.io,0,0,0,0,0,0,0,0
google_closure-compiler,com.google.javascript.jscomp.serialization,0,0,0,0,0,0,0,0
google_closure-compiler,com.google.javascript.rhino.dtoa,0,0,0,0,0,1,0,1
google_closure-compiler,com.google.javascript.rhino,6,1,0,1,1,12,0,21
google_closure-compiler,java.io,0,0,0,0,0,0,0,0
google_closure-compiler,java.lang,0,0,0,0,0,0,0,0
google_closure-compiler,java.nio.file,0,0,0,0,0,0,0,0
google_closure-compiler,java.text,0,0,0,0,0,0,0,0
google_closure-compiler,java.util.regex,0,0,0,0,0,1,0,1
google_closure-compiler,java.util,6,0,0,0,0,0,0,6
google_closure-compiler,com.google.javascript.jscomp.ijs,2,0,0,0,1,0,0,3
google_closure-compiler,com.google.javascript.jscomp.lint,3,0,0,1,1,2,0,7
google_closure-compiler,com.google.javascript.jscomp.modules,2,1,0,1,1,0,0,5
google_closure-compiler,com.google.javascript.jscomp.parsing,5,0,0,0,1,1,0,7
google_closure-compiler,com.google.javascript.jscomp.parsing.parser,0,0,0,0,1,1,0,2
google_closure-compiler,com.google.javascript.jscomp.parsing.parser.trees,0,0,0,1,0,0,0,1
google_closure-compiler,com.google.javascript.jscomp.parsing.parser.util,0,0,0,0,0,0,0,0
google_closure-compiler,com.google.javascript.jscomp.parsing.parser.util.format,0,0,0,0,0,0,0,0
google_closure-compiler,com.google.javascript.jscomp.regex,0,0,0,0,0,1,0,1
google_closure-compiler,com.google.javascript.jscomp.resources,7,1,0,0,0,0,0,8
google_closure-compiler,com.google.javascript.jscomp.transpile,4,0,0,0,0,0,0,4
google_closure-compiler,com.google.javascript.jscomp.type,0,0,0,0,1,2,0,3
google_closure-compiler,com.google.javascript.jscomp.webservice.common,0,0,0,0,0,0,0,0
google_closure-compiler,com.google.javascript.refactoring,3,0,0,1,1,2,0,7
google_closure-compiler,com.google.javascript.refactoring.examples,0,0,0,0,1,0,0,1
google_closure-compiler,com.google.javascript.rhino.jstype,3,1,0,1,1,5,0,11
google_closure-stylesheets,com.google.common.css,0,0,0,1,1,1,0,3
google_closure-stylesheets,com.google.common.css.compiler.ast,6,1,0,1,0,1,0,9
google_closure-stylesheets,com.google.common.css.compiler.commandline,0,0,0,0,1,0,0,1
google_closure-stylesheets,com.google.common.css.compiler.gssfunctions,3,1,0,1,1,0,0,6
google_closure-stylesheets,com.google.common.css.compiler.passes,6,0,0,1,0,1,0,8
google_closure-templates,com.google.template.soy,35,1,0,1,1,0,1,39
google_closure-templates,com.google.template.soy.base.internal,0,0,0,0,1,3,1,5
google_closure-templates,com.google.template.soy.base,0,0,0,0,0,1,1,2
google_closure-templates,com.google.template.soy.basetree,0,0,0,0,1,3,1,5
google_closure-templates,com.google.template.soy.basicdirectives,4,0,0,1,0,1,1,7
google_closure-templates,com.google.template.soy.basicfunctions,5,0,0,1,1,2,1,10
google_closure-templates,com.google.template.soy.bididirectives,2,0,0,0,1,0,1,4
google_closure-templates,com.google.template.soy.bidifunctions,2,0,0,0,1,2,1,6
google_closure-templates,com.google.template.soy.conformance,4,0,0,1,1,0,1,7
google_closure-templates,com.google.template.soy.coredirectives,5,0,0,0,1,0,1,7
google_closure-templates,com.google.template.soy.data,28,1,0,1,1,10,1,42
google_closure-templates,com.google.template.soy.data.internal,2,0,0,0,1,2,1,6
google_closure-templates,com.google.template.soy.data.internalutils,7,0,0,0,1,0,1,9
google_closure-templates,com.google.template.soy.data.ordainers,0,0,0,0,0,0,1,1
google_closure-templates,com.google.template.soy.data.restricted,8,1,0,0,0,6,1,16
google_closure-templates,com.google.template.soy.error,0,0,0,0,1,3,1,5
google_closure-templates,com.google.template.soy.examples,0,0,0,1,1,0,1,3
google_closure-templates,com.google.template.soy.exprtree,5,1,0,1,0,3,1,11
google_closure-templates,com.google.template.soy.i18ndirectives,0,0,0,0,1,0,1,2
google_closure-templates,com.google.template.soy.incrementaldomsrc,0,0,0,0,1,0,1,2
google_closure-templates,com.google.template.soy.internal.base,0,0,0,0,0,0,1,1
google_closure-templates,com.google.template.soy.internal.i18n,0,0,0,0,0,1,1,2
google_closure-templates,com.google.template.soy.internal.proto,0,0,0,0,0,0,1,1
google_closure-templates,com.google.template.soy.internal.targetexpr,0,0,0,0,0,0,1,1
google_closure-templates,com.google.template.soy.invocationbuilders.javatypes,0,0,0,0,1,0,1,2
google_closure-templates,com.google.template.soy.invocationbuilders.passes,0,0,0,0,1,0,1,2
google_closure-templates,com.google.template.soy.jbcsrc,5,0,0,1,1,1,1,9
google_closure-templates,com.google.template.soy.jbcsrc.api,22,1,0,0,1,1,1,26
google_closure-templates,com.google.template.soy.jbcsrc.internal,4,1,0,0,1,1,1,8
google_closure-templates,com.google.template.soy.jbcsrc.restricted,14,1,0,1,1,1,1,19
google_closure-templates,com.google.template.soy.jbcsrc.runtime,3,0,0,0,1,0,1,5
google_closure-templates,com.google.template.soy.jbcsrc.shared,15,1,0,0,1,1,1,19
google_closure-templates,com.google.template.soy.jssrc.dsl,0,1,0,1,1,1,1,5
google_closure-templates,com.google.template.soy.jssrc.internal,0,0,0,1,1,1,1,4
google_closure-templates,com.google.template.soy.jssrc.restricted,1,1,0,0,1,0,1,4
google_closure-templates,com.google.template.soy.jssrc,0,0,0,0,0,1,1,2
google_closure-templates,com.google.template.soy.logging,0,0,0,0,1,0,1,2
google_closure-templates,com.google.template.soy.msgs.internal,3,0,0,0,1,0,1,5
google_closure-templates,com.google.template.soy.msgs.restricted,0,0,0,1,1,0,1,3
google_closure-templates,com.google.template.soy.msgs,0,0,0,0,1,0,1,2
google_closure-templates,com.google.template.soy.parseinfo.passes,0,0,0,0,0,0,1,1
google_closure-templates,com.google.template.soy.parseinfo,0,0,0,0,0,0,1,1
google_closure-templates,com.google.template.soy.parsepasses.contextautoesc,0,0,0,1,1,0,1,3
google_closure-templates,com.google.template.soy.passes,16,0,0,1,1,4,1,23
google_closure-templates,com.google.template.soy.passes.htmlmatcher,2,1,0,0,1,0,1,5
google_closure-templates,com.google.template.soy.plugin.internal,0,0,0,0,0,0,1,1
google_closure-templates,com.google.template.soy.plugin.java.internal,2,0,0,1,0,0,1,4
google_closure-templates,com.google.template.soy.plugin.java.restricted,0,0,0,0,1,0,1,2
google_closure-templates,com.google.template.soy.plugin.javascript.restricted,0,0,0,0,0,0,1,1
google_closure-templates,com.google.template.soy.plugin.python.restricted,0,0,0,0,0,0,1,1
google_closure-templates,com.google.template.soy.plugin.restricted,0,0,0,0,0,0,1,1
google_closure-templates,com.google.template.soy.pysrc.internal,0,0,0,1,1,0,1,3
google_closure-templates,com.google.template.soy.pysrc.restricted,1,1,0,0,1,0,1,4
google_closure-templates,com.google.template.soy.pysrc,0,0,0,0,0,0,1,1
google_closure-templates,com.google.template.soy.shared.internal,30,1,0,1,1,2,1,36
google_closure-templates,com.google.template.soy.shared.internal.gencode,0,0,0,0,0,0,1,1
google_closure-templates,com.google.template.soy.shared,5,1,0,0,1,2,1,10
google_closure-templates,com.google.template.soy.shared.restricted,2,0,0,0,1,0,1,4
google_closure-templates,com.google.template.soy.sharedpasses.opti,3,0,0,0,1,1,1,6
google_closure-templates,com.google.template.soy.sharedpasses.render,2,0,0,1,1,3,1,8
google_closure-templates,com.google.template.soy.soyparse,5,1,0,1,1,2,1,11
google_closure-templates,com.google.template.soy.soytree,25,1,0,2,1,8,1,38
google_closure-templates,com.google.template.soy.soytree.defn,4,0,0,0,1,1,1,7
google_closure-templates,com.google.template.soy.tofu.internal,0,0,0,0,1,0,1,2
google_closure-templates,com.google.template.soy.tofu,0,0,0,0,0,0,1,1
google_closure-templates,com.google.template.soy.types,18,1,0,1,1,1,1,23
google_closure-templates,com.google.template.soy.types.ast,3,0,0,0,1,0,1,5
google_closure-templates,com.google.template.soy.xliffmsgplugin,0,0,0,0,1,0,1,2
google_closure-templates,com.google.template.soy.css,0,0,0,0,0,0,1,1
google_closure-templates,com.google.template.soy,35,1,0,1,1,0,1,39
google_closure-templates,com.google.template.soy.base.internal,0,0,0,0,1,3,1,5
google_closure-templates,com.google.template.soy.base,0,0,0,0,0,1,1,2
google_closure-templates,com.google.template.soy.basetree,0,0,0,0,1,3,1,5
google_closure-templates,com.google.template.soy.basicdirectives,4,0,0,1,0,1,1,7
google_closure-templates,com.google.template.soy.basicfunctions,5,0,0,1,1,2,1,10
google_closure-templates,com.google.template.soy.bididirectives,2,0,0,0,1,0,1,4
google_closure-templates,com.google.template.soy.bidifunctions,2,0,0,0,1,2,1,6
google_closure-templates,com.google.template.soy.conformance,4,0,0,1,1,0,1,7
google_closure-templates,com.google.template.soy.coredirectives,5,0,0,0,1,0,1,7
google_closure-templates,com.google.template.soy.data,28,1,0,1,1,10,1,42
google_closure-templates,com.google.template.soy.data.internal,2,0,0,0,1,2,1,6
google_closure-templates,com.google.template.soy.data.internalutils,7,0,0,0,1,0,1,9
google_closure-templates,com.google.template.soy.data.ordainers,0,0,0,0,0,0,1,1
google_closure-templates,com.google.template.soy.data.restricted,8,1,0,0,0,6,1,16
google_closure-templates,com.google.template.soy.error,0,0,0,0,1,3,1,5
google_closure-templates,com.google.template.soy.examples,0,0,0,1,1,0,1,3
google_closure-templates,com.google.template.soy.exprtree,5,1,0,1,0,3,1,11
google_closure-templates,com.google.template.soy.i18ndirectives,0,0,0,0,1,0,1,2
google_closure-templates,com.google.template.soy.incrementaldomsrc,0,0,0,0,1,0,1,2
google_closure-templates,com.google.template.soy.internal.base,0,0,0,0,0,0,1,1
google_closure-templates,com.google.template.soy.internal.i18n,0,0,0,0,0,1,1,2
google_closure-templates,com.google.template.soy.internal.proto,0,0,0,0,0,0,1,1
google_closure-templates,com.google.template.soy.internal.targetexpr,0,0,0,0,0,0,1,1
google_closure-templates,com.google.template.soy.invocationbuilders.javatypes,0,0,0,0,1,0,1,2
google_closure-templates,com.google.template.soy.invocationbuilders.passes,0,0,0,0,1,0,1,2
google_closure-templates,com.google.template.soy.jbcsrc,5,0,0,1,1,1,1,9
google_closure-templates,com.google.template.soy.jbcsrc.api,22,1,0,0,1,1,1,26
google_closure-templates,com.google.template.soy.jbcsrc.internal,4,1,0,0,1,1,1,8
google_closure-templates,com.google.template.soy.jbcsrc.restricted,14,1,0,1,1,1,1,19
google_closure-templates,com.google.template.soy.jbcsrc.runtime,3,0,0,0,1,0,1,5
google_closure-templates,com.google.template.soy.jbcsrc.shared,15,1,0,0,1,1,1,19
google_closure-templates,com.google.template.soy.jssrc.dsl,0,1,0,1,1,1,1,5
google_closure-templates,com.google.template.soy.jssrc.internal,0,0,0,1,1,1,1,4
google_closure-templates,com.google.template.soy.jssrc.restricted,1,1,0,0,1,0,1,4
google_closure-templates,com.google.template.soy.jssrc,0,0,0,0,0,1,1,2
google_closure-templates,com.google.template.soy.logging,0,0,0,0,1,0,1,2
google_closure-templates,com.google.template.soy.msgs.internal,3,0,0,0,1,0,1,5
google_closure-templates,com.google.template.soy.msgs.restricted,0,0,0,1,1,0,1,3
google_closure-templates,com.google.template.soy.msgs,0,0,0,0,1,0,1,2
google_closure-templates,com.google.template.soy.parseinfo.passes,0,0,0,0,0,0,1,1
google_closure-templates,com.google.template.soy.parseinfo,0,0,0,0,0,0,1,1
google_closure-templates,com.google.template.soy.parsepasses.contextautoesc,0,0,0,1,1,0,1,3
google_closure-templates,com.google.template.soy.passes,16,0,0,1,1,4,1,23
google_closure-templates,com.google.template.soy.passes.htmlmatcher,2,1,0,0,1,0,1,5
google_closure-templates,com.google.template.soy.plugin.internal,0,0,0,0,0,0,1,1
google_closure-templates,com.google.template.soy.plugin.java.internal,2,0,0,1,0,0,1,4
google_closure-templates,com.google.template.soy.plugin.java.restricted,0,0,0,0,1,0,1,2
google_closure-templates,com.google.template.soy.plugin.javascript.restricted,0,0,0,0,0,0,1,1
google_closure-templates,com.google.template.soy.plugin.python.restricted,0,0,0,0,0,0,1,1
google_closure-templates,com.google.template.soy.plugin.restricted,0,0,0,0,0,0,1,1
google_closure-templates,com.google.template.soy.pysrc.internal,0,0,0,1,1,0,1,3
google_closure-templates,com.google.template.soy.pysrc.restricted,1,1,0,0,1,0,1,4
google_closure-templates,com.google.template.soy.pysrc,0,0,0,0,0,0,1,1
google_closure-templates,com.google.template.soy.shared.internal,30,1,0,1,1,2,1,36
google_closure-templates,com.google.template.soy.shared.internal.gencode,0,0,0,0,0,0,1,1
google_closure-templates,com.google.template.soy.shared,5,1,0,0,1,2,1,10
google_closure-templates,com.google.template.soy.shared.restricted,2,0,0,0,1,0,1,4
google_closure-templates,com.google.template.soy.sharedpasses.opti,3,0,0,0,1,1,1,6
google_closure-templates,com.google.template.soy.sharedpasses.render,2,0,0,1,1,3,1,8
google_closure-templates,com.google.template.soy.soyparse,5,1,0,1,1,2,1,11
google_closure-templates,com.google.template.soy.soytree,25,1,0,2,1,8,1,38
google_closure-templates,com.google.template.soy.soytree.defn,4,0,0,0,1,1,1,7
google_closure-templates,com.google.template.soy.tofu.internal,0,0,0,0,1,0,1,2
google_closure-templates,com.google.template.soy.tofu,0,0,0,0,0,0,1,1
google_closure-templates,com.google.template.soy.types,18,1,0,1,1,1,1,23
google_closure-templates,com.google.template.soy.types.ast,3,0,0,0,1,0,1,5
google_closure-templates,com.google.template.soy.xliffmsgplugin,0,0,0,0,1,0,1,2
google_closure-templates,com.google.template.soy.css,0,0,0,0,0,0,1,1
google_error-prone,com.google.errorprone,16,1,0,1,1,0,0,19
google_error-prone,com.google.errorprone.apply,3,0,0,0,1,0,0,4
google_error-prone,com.google.errorprone.bugpatterns,8,1,0,2,1,0,0,12
google_error-prone,com.google.errorprone.dataflow,1,0,0,0,1,0,0,2
google_error-prone,com.google.errorprone.dataflow.nullnesspropagation,3,1,0,0,1,0,0,5
google_error-prone,com.google.errorprone.dataflow.nullnesspropagation.inference,1,0,0,0,1,0,0,2
google_error-prone,com.google.errorprone.fixes,5,1,0,1,1,0,0,8
google_error-prone,com.google.errorprone.matchers,18,1,0,1,1,0,0,21
google_error-prone,com.google.errorprone.matchers.method,4,1,0,1,1,0,0,7
google_error-prone,com.google.errorprone.names,0,0,0,0,0,0,0,0
google_error-prone,com.google.errorprone.predicates.type,0,0,0,0,0,0,0,0
google_error-prone,com.google.errorprone.predicates,1,0,0,0,0,0,0,1
google_error-prone,com.google.errorprone.scanner,8,1,0,0,1,0,0,10
google_error-prone,com.google.errorprone.suppliers,11,0,0,0,0,0,0,11
google_error-prone,com.google.errorprone.util,15,1,0,1,1,0,0,18
google_error-prone,com.google.errorprone.bugpatterns.android,0,0,0,0,1,0,0,1
google_error-prone,com.google.errorprone.bugpatterns.apidiff,0,0,0,1,1,0,0,2
google_error-prone,com.google.errorprone.bugpatterns.argumentselectiondefects,3,0,0,1,1,0,0,5
google_error-prone,com.google.errorprone.bugpatterns.collectionincompatibletype,0,0,0,0,1,0,0,1
google_error-prone,com.google.errorprone.bugpatterns.formatstring,0,0,0,0,0,0,0,0
google_error-prone,com.google.errorprone.bugpatterns.inject,0,0,0,1,1,0,0,2
google_error-prone,com.google.errorprone.bugpatterns.inject.dagger,0,0,0,0,1,0,0,1
google_error-prone,com.google.errorprone.bugpatterns.inject.guice,0,0,0,0,1,0,0,1
google_error-prone,com.google.errorprone.bugpatterns.javadoc,0,0,0,0,1,0,0,1
google_error-prone,com.google.errorprone.bugpatterns.nullness,2,0,0,0,1,0,0,3
google_error-prone,com.google.errorprone.bugpatterns.overloading,0,0,0,0,1,0,0,1
google_error-prone,com.google.errorprone.bugpatterns.threadsafety,0,0,0,1,1,0,0,2
google_error-prone,com.google.errorprone.bugpatterns.time,0,0,0,1,1,0,0,2
google_error-prone,com.google.errorprone.refaster.annotation,0,0,0,0,0,0,0,0
google_error-prone,com.google.errorprone.refaster,0,0,0,1,1,0,0,2
google_error-prone,android.app,0,0,0,0,1,0,0,1
google_error-prone,android.graphics,0,0,0,0,0,0,0,0
google_error-prone,android.os,0,0,0,0,1,0,0,1
google_error-prone,android.preference,0,0,0,0,0,0,0,0
google_error-prone,android,0,0,0,0,0,0,0,0
google_error-prone,android.support.v4.app,0,0,0,0,0,0,0,0
google_error-prone,android.util,0,0,0,0,0,0,0,0
google_error-prone,dagger.android,0,1,0,0,0,0,0,1
google_error-prone,android.content,0,0,0,0,0,0,0,0
google_error-prone,(default package),0,0,0,0,1,0,0,1
google_error-prone,java.util,0,0,0,0,0,0,0,0
google_error-prone,com.google.errorprone.bugpatterns.proto,0,0,0,0,0,0,0,0
google_google-api-java-client,com.google.api.client.googleapis.apache,0,0,0,0,0,0,0,0
google_google-api-java-client,com.google.api.client.googleapis.auth.oauth2,0,0,0,1,1,0,0,2
google_google-api-java-client,com.google.api.client.googleapis.batch,0,0,0,1,1,0,0,2
google_google-api-java-client,com.google.api.client.googleapis.batch.json,0,0,0,0,0,0,0,0
google_google-api-java-client,com.google.api.client.googleapis.compute,0,0,0,0,0,0,0,0
google_google-api-java-client,com.google.api.client.googleapis,0,0,0,0,0,0,0,0
google_google-api-java-client,com.google.api.client.googleapis.javanet,0,0,0,0,0,0,0,0
google_google-api-java-client,com.google.api.client.googleapis.json,0,0,0,0,1,0,0,1
google_google-api-java-client,com.google.api.client.googleapis.media,0,0,0,0,1,0,0,1
google_google-api-java-client,com.google.api.client.googleapis.notifications,0,0,0,0,1,0,0,1
google_google-api-java-client,com.google.api.client.googleapis.notifications.json,0,0,0,0,0,0,0,0
google_google-api-java-client,com.google.api.client.googleapis.services,1,0,0,0,1,0,0,2
google_google-api-java-client,com.google.api.client.googleapis.services.json,1,0,0,0,1,0,0,2
google_google-api-java-client,com.google.api.client.googleapis.util,0,0,0,0,0,0,0,0
google_google-api-java-client,com.google.api.client.googleapis.extensions.android.accounts,0,0,0,0,0,0,0,0
google_google-api-java-client,com.google.api.client.googleapis.extensions.android.gms.auth,0,0,0,0,0,0,0,0
google_google-api-java-client,com.google.api.client.googleapis.extensions.appengine.auth.oauth2,0,0,0,0,0,0,0,0
google_google-api-java-client,com.google.api.client.googleapis.extensions.appengine.notifications,0,0,0,0,0,0,0,0
google_google-api-java-client,com.google.api.client.googleapis.notifications.json.gson,0,0,0,0,0,0,0,0
google_google-api-java-client,com.google.api.client.googleapis.notifications.json.jackson2,0,0,0,0,0,0,0,0
google_google-api-java-client,com.google.api.client.googleapis.extensions.java6.auth.oauth2,0,0,0,0,0,0,0,0
google_google-api-java-client,com.google.api.client.googleapis.services.protobuf,1,0,0,0,1,0,0,2
google_google-api-java-client,com.google.api.client.googleapis.extensions.servlet.notifications,0,0,0,0,0,0,0,0
google_google-api-java-client,com.google.api.client.googleapis.xml.atom,0,0,0,0,1,0,0,1
google_google-auth-library-java,com.google.auth.appengine,0,0,0,0,0,0,0,0
google_google-auth-library-java,com.google.auth,1,1,0,0,1,0,0,3
google_google-auth-library-java,com.google.auth.http,2,1,0,0,0,0,0,3
google_google-auth-library-java,com.google.auth.oauth2,2,0,0,1,1,0,0,4
google_google-http-java-client,com.google.api.client.http,1,0,0,1,0,4,0,6
google_google-http-java-client,com.google.api.client.http.apache,0,0,0,0,1,0,0,1
google_google-http-java-client,com.google.api.client.http.javanet,0,0,0,0,0,1,0,1
google_google-http-java-client,com.google.api.client.http.json,0,1,0,0,0,0,0,1
google_google-http-java-client,com.google.api.client.json,0,0,0,0,1,0,0,1
google_google-http-java-client,com.google.api.client.json.rpc2,0,0,0,0,0,0,0,0
google_google-http-java-client,com.google.api.client.json.webtoken,3,0,0,0,1,0,0,4
google_google-http-java-client,com.google.api.client.util,2,1,0,1,1,2,0,7
google_google-http-java-client,com.google.api.client.util.escape,0,0,0,0,0,1,0,1
google_google-http-java-client,com.google.api.client.util.store,0,0,0,0,0,0,0,0
google_google-http-java-client,com.google.api.client.extensions.android,0,0,0,0,0,0,0,0
google_google-http-java-client,com.google.api.client.extensions.android.http,0,0,0,0,0,0,0,0
google_google-http-java-client,com.google.api.client.extensions.android.json,0,0,0,0,1,0,0,1
google_google-http-java-client,com.google.api.client.http.apache.v2,0,0,0,0,1,0,0,1
google_google-http-java-client,com.google.api.client.extensions.appengine.datastore,0,0,0,0,0,0,0,0
google_google-http-java-client,com.google.api.client.extensions.appengine.http,0,0,0,0,1,0,0,1
google_google-http-java-client,com.google.api.client.findbugs,0,0,0,0,0,0,0,0
google_google-http-java-client,com.google.api.client.json.gson,0,0,0,0,1,0,0,1
google_google-http-java-client,com.google.api.client.json.jackson2,0,0,0,0,1,0,0,1
google_google-http-java-client,com.google.api.client.http.protobuf,0,0,0,0,0,0,0,0
google_google-http-java-client,com.google.api.client.protobuf,0,0,0,0,0,0,0,0
google_google-http-java-client,com.google.api.client.http.xml,0,0,0,0,0,0,0,0
google_google-http-java-client,com.google.api.client.http.xml.atom,0,0,0,0,0,0,0,0
google_google-http-java-client,com.google.api.client.xml.atom,1,1,0,0,0,0,0,2
google_google-http-java-client,com.google.api.client.xml,1,0,0,1,1,0,0,3
google_google-oauth-java-client,com.google.api.client.auth.oauth,0,0,0,0,1,0,0,1
google_google-oauth-java-client,com.google.api.client.auth.oauth2,0,0,0,1,1,0,0,2
google_google-oauth-java-client,com.google.api.client.auth.openidconnect,0,0,0,0,1,0,0,1
google_google-oauth-java-client,com.google.api.client.extensions.appengine.auth,0,0,0,0,0,0,0,0
google_google-oauth-java-client,com.google.api.client.extensions.appengine.auth.oauth2,0,0,0,0,0,0,0,0
google_google-oauth-java-client,com.google.api.client.extensions.java6.auth.oauth2,0,0,0,0,1,0,0,1
google_google-oauth-java-client,com.google.api.client.extensions.jetty.auth.oauth2,0,0,0,0,0,0,0,0
google_google-oauth-java-client,com.google.api.client.extensions.auth.helpers,0,0,0,0,0,0,0,0
google_google-oauth-java-client,com.google.api.client.extensions.auth.helpers.oauth,0,0,0,0,0,0,0,0
google_google-oauth-java-client,com.google.api.client.extensions.servlet.auth,0,0,0,0,0,0,0,0
google_google-oauth-java-client,com.google.api.client.extensions.servlet.auth.oauth2,0,0,0,0,0,0,0,0
google_guice,com.google.inject,15,1,0,2,1,40,1,60
google_guice,com.google.inject.binder,0,0,0,0,1,18,1,20
google_guice,com.google.inject.internal,18,0,0,2,1,16,1,38
google_guice,com.google.inject.internal.util,9,1,0,0,1,2,1,14
google_guice,com.google.inject.matcher,4,0,0,1,0,6,1,12
google_guice,com.google.inject.multibindings,3,1,0,0,1,0,1,6
google_guice,com.google.inject.name,8,1,0,0,1,18,1,29
google_guice,com.google.inject.spi,3,1,0,1,1,23,1,30
google_guice,com.google.inject.util,3,1,0,1,1,10,1,17
google_guice,com.google.inject.example,0,0,0,1,1,0,1,3
google_guice,com.googlecode.guice.bundle,0,0,0,1,1,0,1,3
google_guice,com.googlecode.guice,2,0,0,1,1,0,1,5
google_guice,example.xml,0,0,0,0,0,1,1,2
google_guice,com.google.inject.assistedinject,0,0,0,1,1,4,1,7
google_guice,com.google.inject.daggeradapter,0,0,0,1,1,0,1,3
google_guice,com.google.inject.grapher,0,0,0,1,1,1,1,4
google_guice,com.google.inject.grapher.graphviz,0,0,0,0,1,0,1,2
google_guice,com.google.inject.grapher.demo,0,0,0,0,0,0,1,1
google_guice,com.google.inject.tools.jmx,0,0,0,0,1,1,1,3
google_guice,com.google.inject.jndi,0,0,0,0,0,0,1,1
google_guice,com.google.inject.mini,0,0,0,0,0,0,1,1
google_guice,com.google.inject.persist.finder,0,0,0,0,0,0,1,1
google_guice,com.google.inject.persist.jpa,1,1,0,1,0,0,1,4
google_guice,com.google.inject.persist,1,0,0,0,1,0,1,3
google_guice,com.google.inject.service,0,0,0,0,0,0,1,1
google_guice,com.google.inject.servlet,0,0,0,1,1,1,1,4
google_guice,com.google.inject.spring,0,0,0,0,0,0,1,1
google_guice,com.google.inject.struts2.example,0,0,0,0,1,0,1,2
google_guice,com.google.inject.struts2,0,0,0,0,1,0,1,2
google_guice,com.google.inject.throwingproviders,0,0,0,1,1,3,1,6
google_guice,com.google.inject.jdk8,0,0,0,0,1,0,1,2
google_guice,(default package),0,0,0,0,0,0,1,1
google_identity-toolkit-java-client,com.google.identitytoolkit,0,0,0,0,1,0,0,1
google_jimfs,com.google.common.jimfs,0,0,0,1,1,0,0,2
google_truth,com.google.common.truth,0,0,0,2,1,0,0,3
google_truth,com.google.common.truth.extension,0,0,0,0,1,0,0,1
google_truth,com.google.common.truth.gwt,0,0,0,0,0,0,0,0
google_truth,com.google.common.truth.extensions.proto,0,0,0,2,1,0,0,3
google_truth,com.google.common.truth.extensions.re2j,0,0,0,0,0,0,0,0
google_truth,com.google.common.truth.refactorings,0,0,0,0,1,0,0,1
gosu-lang_gosu-lang,gosu.tools.ant,0,0,0,0,1,0,1,2
gosu-lang_gosu-lang,gosu.tools.ant.util,0,0,0,0,0,0,1,1
gosu-lang_gosu-lang,gosu.tools.ant.gosudoc,0,0,0,0,0,0,1,1
gosu-lang_gosu-lang,gw.internal.gosu.annotations,0,0,0,0,0,0,1,1
gosu-lang_gosu-lang,gw.internal.gosu.coercer,3,1,0,0,0,1,1,6
gosu-lang_gosu-lang,gw.internal.gosu.compiler,6,0,0,1,0,11,1,19
gosu-lang_gosu-lang,gw.internal.gosu.compiler.protocols.gosuclass,0,0,0,0,0,2,1,3
gosu-lang_gosu-lang,gw.internal.gosu,0,0,0,0,0,0,1,1
gosu-lang_gosu-lang,gw.internal.gosu.dynamic,2,0,0,0,0,0,1,3
gosu-lang_gosu-lang,gw.internal.gosu.init,0,0,0,0,0,0,1,1
gosu-lang_gosu-lang,gw.internal.gosu.ir.builders,3,0,0,0,0,0,1,4
gosu-lang_gosu-lang,gw.internal.gosu.ir.compiler.bytecode,12,1,0,0,1,0,1,15
gosu-lang_gosu-lang,gw.internal.gosu.ir.compiler.bytecode.expression,2,0,0,0,1,1,1,5
gosu-lang_gosu-lang,gw.internal.gosu.ir.compiler.bytecode.statement,1,0,0,0,1,0,1,3
gosu-lang_gosu-lang,gw.internal.gosu.ir.compiler.java,0,0,0,0,0,2,1,3
gosu-lang_gosu-lang,gw.internal.gosu.ir.compiler.tree,0,0,0,0,0,2,1,3
gosu-lang_gosu-lang,gw.internal.gosu.ir.compiler.verifier,2,1,0,0,0,2,1,6
gosu-lang_gosu-lang,gw.internal.gosu.ir.nodes,5,1,0,0,0,19,1,26
gosu-lang_gosu-lang,gw.internal.gosu.ir.transform,11,1,0,0,1,12,1,26
gosu-lang_gosu-lang,gw.internal.gosu.ir.transform.expression,11,0,0,1,1,0,1,14
gosu-lang_gosu-lang,gw.internal.gosu.ir.transform.statement,4,0,0,1,1,0,1,7
gosu-lang_gosu-lang,gw.internal.gosu.ir.transform.util,6,1,0,0,0,12,1,20
gosu-lang_gosu-lang,gw.internal.gosu.ir,6,1,0,0,0,0,1,8
gosu-lang_gosu-lang,gw.internal.gosu.javadoc,0,0,0,0,0,1,1,2
gosu-lang_gosu-lang,gw.internal.gosu.loader,0,0,0,0,0,0,1,1
gosu-lang_gosu-lang,gw.internal.gosu.memory,0,0,0,0,0,0,1,1
gosu-lang_gosu-lang,gw.internal.gosu.module,7,0,0,0,0,4,1,12
gosu-lang_gosu-lang,gw.internal.gosu.module.fs,3,0,0,0,0,3,1,7
gosu-lang_gosu-lang,gw.internal.gosu.parser,92,1,0,2,0,124,1,220
gosu-lang_gosu-lang,gw.internal.gosu.parser.expressions,10,1,0,1,1,39,1,53
gosu-lang_gosu-lang,gw.internal.gosu.parser.fragments,4,0,0,0,0,1,1,6
gosu-lang_gosu-lang,gw.internal.gosu.parser.gwPlatform,0,0,0,0,0,2,1,3
gosu-lang_gosu-lang,gw.internal.gosu.parser.java.classinfo,5,1,0,1,1,10,1,19
gosu-lang_gosu-lang,gw.internal.gosu.parser.java.compiler,4,0,0,0,0,1,1,6
gosu-lang_gosu-lang,gw.internal.gosu.parser.optimizer,2,1,0,0,0,0,1,4
gosu-lang_gosu-lang,gw.internal.gosu.parser.statements,5,1,0,1,1,26,1,35
gosu-lang_gosu-lang,gw.internal.gosu.parser.types,3,1,0,0,0,1,1,6
gosu-lang_gosu-lang,gw.internal.gosu.properties,2,0,0,0,0,5,1,8
gosu-lang_gosu-lang,gw.internal.gosu.runtime,3,1,0,0,0,2,1,7
gosu-lang_gosu-lang,gw.internal.gosu.template,4,0,0,0,1,4,1,10
gosu-lang_gosu-lang,gw.internal.gosu.util,0,0,0,0,0,0,1,1
gosu-lang_gosu-lang,gw.lang.parser,27,1,0,1,1,102,1,133
gosu-lang_gosu-lang,gw.lang.parser.statements,0,0,0,1,1,6,1,9
gosu-lang_gosu-lang,gw.config,19,1,0,0,0,32,1,53
gosu-lang_gosu-lang,gw.date,0,0,0,0,0,0,1,1
gosu-lang_gosu-lang,gw.fs,6,1,0,0,1,9,1,18
gosu-lang_gosu-lang,gw.fs.jar,6,1,0,0,0,0,1,8
gosu-lang_gosu-lang,gw.fs.physical,1,0,0,0,1,0,1,3
gosu-lang_gosu-lang,gw.fs.physical.fast,0,0,0,0,0,0,1,1
gosu-lang_gosu-lang,gw.fs.physical.generic,0,0,0,0,0,0,1,1
gosu-lang_gosu-lang,gw.fs.physical.win32,0,0,0,0,0,0,1,1
gosu-lang_gosu-lang,gw.fs.url,1,0,0,0,0,0,1,2
gosu-lang_gosu-lang,gw.fs.watcher,0,0,0,0,0,0,1,1
gosu-lang_gosu-lang,gw.lang.annotation,3,0,0,0,1,1,1,6
gosu-lang_gosu-lang,gw.lang,43,1,0,0,1,11,1,57
gosu-lang_gosu-lang,gw.lang.debugger,0,0,0,0,0,0,1,1
gosu-lang_gosu-lang,gw.lang.enhancements,0,0,0,0,0,0,1,1
gosu-lang_gosu-lang,gw.lang.function,2,0,0,1,0,0,1,4
gosu-lang_gosu-lang,gw.lang.gosuc.cli,0,1,0,0,0,0,1,2
gosu-lang_gosu-lang,gw.lang.gosuc,6,0,0,0,1,5,1,13
gosu-lang_gosu-lang,gw.lang.gosuc.simple,0,0,0,0,1,0,1,2
gosu-lang_gosu-lang,gw.lang.init,4,1,0,0,1,1,1,8
gosu-lang_gosu-lang,gw.lang.ir.builder.expression,1,0,0,0,1,4,1,7
gosu-lang_gosu-lang,gw.lang.ir.builder,4,1,0,0,1,7,1,14
gosu-lang_gosu-lang,gw.lang.ir.builder.statement,1,0,0,0,1,2,1,5
gosu-lang_gosu-lang,gw.lang.ir,7,1,0,0,1,17,1,27
gosu-lang_gosu-lang,gw.lang.ir.expression,1,1,0,0,1,3,1,7
gosu-lang_gosu-lang,gw.lang.ir.statement,1,0,0,0,1,6,1,9
gosu-lang_gosu-lang,gw.lang.javac,1,0,0,0,1,1,1,4
gosu-lang_gosu-lang,gw.lang.javadoc,0,0,0,0,1,4,1,6
gosu-lang_gosu-lang,gw.lang.parser.coercers,6,0,0,1,0,4,1,12
gosu-lang_gosu-lang,gw.lang.parser.exceptions,3,0,0,0,1,10,1,15
gosu-lang_gosu-lang,gw.lang.parser.expressions,0,0,0,1,1,20,1,23
gosu-lang_gosu-lang,gw.lang.parser.resources,3,1,0,0,0,0,1,5
gosu-lang_gosu-lang,gw.lang.parser.template,0,0,0,0,0,1,1,2
gosu-lang_gosu-lang,gw.lang.reflect,101,1,0,1,1,167,1,272
gosu-lang_gosu-lang,gw.lang.reflect.features,2,0,0,1,0,0,1,4
gosu-lang_gosu-lang,gw.lang.reflect.gs,13,1,0,1,1,78,1,95
gosu-lang_gosu-lang,gw.lang.reflect.interval,0,0,0,0,1,1,1,3
gosu-lang_gosu-lang,gw.lang.reflect.java,18,1,0,1,1,93,1,115
gosu-lang_gosu-lang,gw.lang.reflect.java.asm,5,0,0,1,1,1,1,9
gosu-lang_gosu-lang,gw.lang.reflect.json,0,0,0,0,0,0,1,1
gosu-lang_gosu-lang,gw.lang.reflect.module,4,1,0,0,1,16,1,23
gosu-lang_gosu-lang,gw.plugin,0,0,0,0,0,0,1,1
gosu-lang_gosu-lang,gw.util,34,1,0,1,1,12,1,50
gosu-lang_gosu-lang,gw.util.cache,2,1,0,0,0,1,1,5
gosu-lang_gosu-lang,gw.util.concurrent,3,1,0,0,0,10,1,15
gosu-lang_gosu-lang,gw.util.diff.sorted,0,0,0,0,0,0,1,1
gosu-lang_gosu-lang,gw.util.fingerprint,2,0,0,0,0,0,1,3
gosu-lang_gosu-lang,gw.util.io,0,0,0,0,0,0,1,1
gosu-lang_gosu-lang,gw.util.perf.codestats,0,0,0,0,0,0,1,1
gosu-lang_gosu-lang,gw.util.perf,0,0,0,0,0,0,1,1
gosu-lang_gosu-lang,gw.util.perf.objectsize,2,0,0,0,1,0,1,4
gosu-lang_gosu-lang,gw.xml.simple,2,0,0,0,0,0,1,3
gosu-lang_gosu-lang,gw,0,0,0,0,0,0,1,1
gosu-lang_gosu-lang,gw.gosudoc.doc,0,0,0,0,0,0,1,1
gosu-lang_gosu-lang,editor,16,1,0,1,0,24,1,43
gosu-lang_gosu-lang,editor.actions,2,0,0,0,0,0,1,3
gosu-lang_gosu-lang,editor.debugger,6,1,0,0,1,2,1,11
gosu-lang_gosu-lang,editor.plugin.typeloader,0,0,0,0,0,0,1,1
gosu-lang_gosu-lang,editor.plugin.typeloader.java,0,0,0,0,0,0,1,1
gosu-lang_gosu-lang,editor.plugin.typeloader.properties,0,0,0,0,0,0,1,1
gosu-lang_gosu-lang,editor.run,2,0,0,0,1,2,1,6
gosu-lang_gosu-lang,editor.search,2,0,0,0,0,8,1,11
gosu-lang_gosu-lang,editor.settings,2,1,0,0,0,2,1,6
gosu-lang_gosu-lang,editor.shipit,2,0,0,0,1,3,1,7
gosu-lang_gosu-lang,editor.splitpane,2,1,0,0,0,0,1,4
gosu-lang_gosu-lang,editor.tabpane,3,0,0,1,0,4,1,9
gosu-lang_gosu-lang,editor.undo,0,0,0,0,1,1,1,3
gosu-lang_gosu-lang,editor.util,9,1,0,1,1,12,1,25
gosu-lang_gosu-lang,editor.util.transform.java,0,0,0,0,1,0,1,2
gosu-lang_gosu-lang,editor.util.transform.java.visitor,0,0,0,0,0,0,1,1
gosu-lang_gosu-lang,(default package),0,0,0,0,0,0,1,1
gosu-lang_gosu-lang,org.gosulang.plexus.compiler.gosu,0,0,0,0,0,0,1,1
gosu-lang_gosu-lang,org.gosulang.foo,0,0,0,0,0,0,1,1
gosu-lang_gosu-lang,gw.util.process,0,0,0,0,0,0,1,1
gosu-lang_gosu-lang,gw.internal.gosu.regression,0,0,0,1,1,1,1,4
gosu-lang_gosu-lang,gw.specContrib.classes.enhancements.shadowingMore.javaVsGosu.methodsVsMethods,0,0,0,0,0,0,1,1
gosu-lang_gosu-lang,gw.specContrib.classes.optional_params,0,0,0,0,0,0,1,1
gosu-lang_gosu-lang,gw.specContrib.classes.property_Declarations.properties_Covariance,0,0,0,0,1,0,1,2
gosu-lang_gosu-lang,gw.specContrib.classes.property_Declarations,0,0,0,0,1,0,1,2
gosu-lang_gosu-lang,gw.specContrib.structural.JavaInteraction,0,0,0,0,0,0,1,1
gosu-lang_gosu-lang,gw.data,0,0,0,0,1,0,1,2
gosu-lang_gosu-lang,gw.data.pac1,0,0,0,0,0,0,1,1
gosu-lang_gosu-lang,gw.data.pac1.pac1_sub,0,0,0,0,0,0,1,1
gosu-lang_gosu-lang,gw.internal.gosu.compiler.blocks,0,0,0,0,1,0,1,2
gosu-lang_gosu-lang,gw.internal.gosu.compiler.featureliteral,0,0,0,0,0,0,1,1
gosu-lang_gosu-lang,gw.internal.gosu.compiler.generics,0,0,0,0,0,0,1,1
gosu-lang_gosu-lang,gw.internal.gosu.compiler.generics.stuff,0,0,0,0,0,0,1,1
gosu-lang_gosu-lang,gw.internal.gosu.gosuc,0,0,0,0,0,0,1,1
gosu-lang_gosu-lang,gw.internal.gosu.parser.annotation.abc,0,0,0,0,0,0,1,1
gosu-lang_gosu-lang,gw.internal.gosu.parser.annotation,0,0,0,0,1,4,1,6
gosu-lang_gosu-lang,gw.internal.gosu.parser.arrays,0,0,0,0,0,1,1,2
gosu-lang_gosu-lang,gw.internal.gosu.parser.coercion,0,0,0,0,0,1,1,2
gosu-lang_gosu-lang,gw.internal.gosu.parser.generics,0,0,0,0,1,5,1,7
gosu-lang_gosu-lang,gw.internal.gosu.parser.java,0,0,0,0,0,3,1,4
gosu-lang_gosu-lang,gw.internal.gosu.parser.sub,0,0,0,0,0,0,1,1
gosu-lang_gosu-lang,gw.lang.annotations,0,0,0,0,0,0,1,1
gosu-lang_gosu-lang,gw.lang.reflect.subpackage,0,0,0,0,0,0,1,1
gosu-lang_gosu-lang,gw.lang.spec_old.coercions,0,0,0,0,0,0,1,1
gosu-lang_gosu-lang,gw.lang.spec_old.generics,0,0,0,0,0,0,1,1
gosu-lang_gosu-lang,gw.lang.spec_old.programs,0,0,0,0,0,0,1,1
gosu-lang_gosu-lang,gw.spec.core.annotations.instances,0,0,0,0,1,1,1,3
gosu-lang_gosu-lang,gw.spec.core.annotations.java,0,0,0,0,0,3,1,4
gosu-lang_gosu-lang,gw.spec.core.enums,0,0,0,0,0,0,1,1
gosu-lang_gosu-lang,gw.spec.core.expressions.arithmetic,0,0,0,1,0,0,1,2
gosu-lang_gosu-lang,gw.spec.core.expressions.beanmethodcall.generated,0,0,0,0,0,0,1,1
gosu-lang_gosu-lang,gw.spec.core.expressions.memberaccess,0,0,0,0,0,0,1,1
gosu-lang_gosu-lang,gw.spec.core.statements.trycatch,0,0,0,0,0,0,1,1
gosu-lang_gosu-lang,gw.specContrib.annotations,0,0,0,0,0,0,1,1
gosu-lang_gosu-lang,gw.specContrib.classes.abc.def,0,0,0,0,0,0,1,1
gosu-lang_gosu-lang,gw.specContrib.classes.abc,0,0,0,0,0,0,1,1
gosu-lang_gosu-lang,gw.specContrib.classes.enhancements.shadowingMore.javaVsGosu.fieldsVsProperties,0,0,0,0,0,0,1,1
gosu-lang_gosu-lang,gw.specContrib.classes.enhancements.shadowingMore.javaVsGosu.gettersSettersVsProperties,0,0,0,0,0,0,1,1
gosu-lang_gosu-lang,gw.specContrib.classes,0,0,0,0,1,0,1,2
gosu-lang_gosu-lang,gw.specContrib.classes.inner,0,0,0,0,0,0,1,1
gosu-lang_gosu-lang,gw.specContrib.classes.java_Package_Visibility,0,0,0,0,0,0,1,1
gosu-lang_gosu-lang,gw.specContrib.classes.method_Scoring.collections_And_Generics,0,0,0,0,0,0,1,1
gosu-lang_gosu-lang,gw.specContrib.classes.property_Declarations.javaClassGosuEnh,0,0,0,0,1,0,1,2
gosu-lang_gosu-lang,gw.specContrib.classes.property_Declarations.javaClassGosuSubClass,0,0,0,0,1,0,1,2
gosu-lang_gosu-lang,gw.specContrib.classes.property_Declarations.obsoleteGetterSetterMethodCalls,0,0,0,0,0,0,1,1
gosu-lang_gosu-lang,gw.specContrib.delegates,0,0,0,0,0,0,1,1
gosu-lang_gosu-lang,gw.specContrib.expressions,0,0,0,0,0,0,1,1
gosu-lang_gosu-lang,gw.specContrib.featureLiterals.javaMembersBinding,0,0,0,0,0,0,1,1
gosu-lang_gosu-lang,gw.specContrib.generics,0,0,0,1,1,0,1,3
gosu-lang_gosu-lang,gw.specContrib.interfaceMethods.defaultMethods.enhancementDM,0,0,0,0,0,0,1,1
gosu-lang_gosu-lang,gw.specContrib.interfaceMethods.defaultMethods.javaInteraction,0,0,0,0,0,0,1,1
gosu-lang_gosu-lang,gw.specContrib.interfaceMethods.staticMethods.javaInteraction,0,0,0,0,0,0,1,1
gosu-lang_gosu-lang,gw.specContrib.interfaces,0,0,0,0,0,0,1,1
gosu-lang_gosu-lang,gw.specContrib.statements.usesStatement,0,0,0,0,0,0,1,1
gosu-lang_gosu-lang,gw.specContrib.typeinference,0,0,0,0,0,0,1,1
gosu-lang_gosu-lang,gw.specification.interfaces,0,0,0,0,0,0,1,1
gosu-lang_gosu-lang,gw.specification.nameAndReservedNames,0,0,0,0,0,0,1,1
gosu-lang_gosu-lang,gw.specification.structures,0,0,0,0,0,0,1,1
gosu-lang_gosu-lang,gw.specification.temp.generics,0,0,0,0,0,0,1,1
gosu-lang_gosu-lang,gw.specification.temp.generic_signature,0,0,0,0,0,0,1,1
gosu-lang_gosu-lang,gw.specContrib.interop.java,0,0,0,0,0,0,1,1
GrammarViz2_grammarviz2_src,net.seninp.grammarviz.anomaly,1,1,0,0,0,0,0,2
GrammarViz2_grammarviz2_src,net.seninp.grammarviz.cli,0,0,0,0,0,0,0,0
GrammarViz2_grammarviz2_src,net.seninp.grammarviz.controller,0,0,0,0,0,0,0,0
GrammarViz2_grammarviz2_src,net.seninp.grammarviz,1,1,0,0,0,0,0,2
GrammarViz2_grammarviz2_src,net.seninp.grammarviz.logic,0,0,0,0,1,0,0,1
GrammarViz2_grammarviz2_src,net.seninp.grammarviz.model,0,0,0,0,0,0,0,0
GrammarViz2_grammarviz2_src,net.seninp.grammarviz.session,0,0,0,0,0,0,0,0
GrammarViz2_grammarviz2_src,net.seninp.grammarviz.tinker,0,0,0,0,0,0,0,0
GrammarViz2_grammarviz2_src,net.seninp.grammarviz.view,0,0,0,0,1,0,0,1
GrammarViz2_grammarviz2_src,net.seninp.grammarviz.view.table,0,0,0,0,1,0,0,1
GrammarViz2_grammarviz2_src,net.seninp.tinker,0,0,0,0,1,0,0,1
GrammarViz2_grammarviz2_src,net.seninp.util,0,0,0,0,0,0,0,0
graphaware_neo4j-algorithms,com.graphaware.module.algo.generator.api,0,0,0,0,0,0,0,0
graphaware_neo4j-algorithms,com.graphaware.module.algo.generator,0,0,0,0,1,0,0,1
graphaware_neo4j-algorithms,com.graphaware.module.algo.generator.config,0,0,0,0,1,0,0,1
graphaware_neo4j-algorithms,com.graphaware.module.algo.generator.distribution,0,0,0,0,0,0,0,0
graphaware_neo4j-algorithms,com.graphaware.module.algo.generator.node,0,0,0,0,0,0,0,0
graphaware_neo4j-algorithms,com.graphaware.module.algo.generator.relationship,0,0,0,0,1,0,0,1
graphaware_neo4j-algorithms,com.graphaware.module.algo.generator.utils,0,0,0,0,0,0,0,0
graphaware_neo4j-algorithms,com.graphaware.module.algo.path,0,0,0,0,1,0,0,1
graphaware_neo4j-noderank,com.graphaware.module.noderank,0,0,0,0,1,0,0,1
graphaware_neo4j-noderank,com.graphaware.module.noderank.utils,0,0,0,0,1,0,0,1
Graphify_graphify,org.neo4j.nlp.examples.author,0,0,0,0,0,0,0,0
Graphify_graphify,org.neo4j.nlp.examples.sentiment,0,0,0,0,0,0,0,0
Graphify_graphify,org.neo4j.nlp.examples.wikipedia,0,0,0,0,0,0,0,0
Graphify_graphify,org.neo4j.nlp.abstractions,0,0,0,0,0,0,0,0
Graphify_graphify,org.neo4j.nlp.ext,0,0,0,0,0,0,0,0
Graphify_graphify,org.neo4j.nlp.helpers,0,0,0,0,0,0,0,0
Graphify_graphify,org.neo4j.nlp.impl.cache,0,0,0,0,0,0,0,0
Graphify_graphify,org.neo4j.nlp.impl.manager,0,0,0,0,0,0,0,0
Graphify_graphify,org.neo4j.nlp.impl.util,0,0,0,0,1,0,0,1
Graphify_graphify,org.neo4j.nlp.models,0,0,0,0,0,0,0,0
Graphify_graphify,org.neo4j.nlp.impl.traversal,0,0,0,0,0,0,0,0
Graphity_graphity-client,com.atomgraph.client,0,0,0,0,0,0,0,0
Graphity_graphity-client,com.atomgraph.client.exception,0,0,0,0,0,0,0,0
Graphity_graphity-client,com.atomgraph.client.filter,0,0,0,0,0,0,0,0
Graphity_graphity-client,com.atomgraph.client.filter.request,0,0,0,0,0,0,0,0
Graphity_graphity-client,com.atomgraph.client.locator,0,0,0,0,0,0,0,0
Graphity_graphity-client,com.atomgraph.client.mapper,0,0,0,0,0,0,0,0
Graphity_graphity-client,com.atomgraph.client.mapper.jersey,0,0,0,0,0,0,0,0
Graphity_graphity-client,com.atomgraph.client.model.impl,0,0,0,0,0,0,0,0
Graphity_graphity-client,com.atomgraph.client.provider,0,0,0,0,0,0,0,0
Graphity_graphity-client,com.atomgraph.client.query,0,0,0,0,0,0,0,0
Graphity_graphity-client,com.atomgraph.client.reader,0,0,0,0,0,0,0,0
Graphity_graphity-client,com.atomgraph.client.riot,0,0,0,0,0,0,0,0
Graphity_graphity-client,com.atomgraph.client.riot.lang,0,0,0,0,0,0,0,0
Graphity_graphity-client,com.atomgraph.client.update,0,0,0,0,0,0,0,0
Graphity_graphity-client,com.atomgraph.client.util,0,1,0,0,1,0,0,2
Graphity_graphity-client,com.atomgraph.client.util.saxon,0,0,0,0,0,0,0,0
Graphity_graphity-client,com.atomgraph.client.vocabulary,0,0,0,0,0,0,0,0
Graphity_graphity-client,com.atomgraph.client.writer,0,0,0,0,0,0,0,0
gravel-st_gravel,st.gravel.core,0,0,0,0,0,5,1,6
gravel-st_gravel,st.gravel.support.compiler,2,0,0,0,1,2,1,6
gravel-st_gravel,st.gravel.support.compiler.ast,5,1,0,1,0,7,1,15
gravel-st_gravel,st.gravel.support.compiler.jvm,3,0,0,1,0,2,1,7
gravel-st_gravel,st.gravel.support.jvm,6,1,0,1,1,3,1,13
gravel-st_gravel,st.gravel.support.jvm.debugger,0,0,0,0,1,0,1,2
gravel-st_gravel,st.gravel.support.jvm.runtime,5,1,0,0,0,3,1,10
gravel-st_gravel,st.gravel.tools,0,0,0,0,0,0,1,1
gravel-st_gravel,st.gravel.benchmark,0,0,0,0,0,0,1,1
gravel-st_gravel,st.gravel.core,0,0,0,0,0,5,1,6
gravel-st_gravel,st.gravel.support.compiler,2,0,0,0,1,2,1,6
gravel-st_gravel,st.gravel.support.compiler.ast,5,1,0,1,0,7,1,15
gravel-st_gravel,st.gravel.support.compiler.jvm,3,0,0,1,0,2,1,7
gravel-st_gravel,st.gravel.support.jvm,6,1,0,1,1,3,1,13
gravel-st_gravel,st.gravel.support.jvm.debugger,0,0,0,0,1,0,1,2
gravel-st_gravel,st.gravel.support.jvm.runtime,5,1,0,0,0,3,1,10
gravel-st_gravel,st.gravel.tools,0,0,0,0,0,0,1,1
gravel-st_gravel,st.gravel.benchmark,0,0,0,0,0,0,1,1
gridkit_nanocloud,org.gridkit.lab.interceptor,0,0,0,0,1,0,1,2
gridkit_nanocloud,org.gridkit.nanocloud.interceptor,5,0,0,0,0,0,1,6
gridkit_nanocloud,org.gridkit.nanocloud.interceptor.misc,1,0,0,0,0,0,1,2
gridkit_nanocloud,org.gridkit.vicluster.isolate,11,1,0,1,0,0,1,14
gridkit_nanocloud,org.gridkit.nanocloud.agent,0,0,0,0,0,0,1,1
gridkit_nanocloud,org.gridkit.nanocloud,17,1,0,0,0,0,1,19
gridkit_nanocloud,org.gridkit.nanocloud.jmx,1,1,0,0,0,0,1,3
gridkit_nanocloud,org.gridkit.nanocloud.viengine,0,0,0,1,0,0,1,2
gridkit_nanocloud,org.gridkit.internal.com.jcraft.jsch,0,0,0,1,0,0,1,2
gridkit_nanocloud,org.gridkit.internal.com.jcraft.jsch.jce,0,0,0,0,1,0,1,2
gridkit_nanocloud,org.gridkit.internal.com.jcraft.jsch.jcraft,0,0,0,0,1,0,1,2
gridkit_nanocloud,org.gridkit.internal.com.jcraft.jsch.jgss,0,0,0,0,0,0,1,1
gridkit_nanocloud,org.gridkit.lab.util.shell,0,0,0,0,0,0,1,1
gridkit_nanocloud,org.gridkit.nanocloud.telecontrol.ssh,5,0,0,0,0,0,1,6
gridkit_nanocloud,org.gridkit.vicluster.telecontrol.ssh,4,0,0,1,0,1,1,7
gridkit_nanocloud,org.gridkit.nanocloud.tunneller,0,0,0,0,0,0,1,1
gridkit_nanocloud,org.gridkit.vicluster,18,1,0,1,0,2,1,23
gridkit_nanocloud,org.gridkit.nanocloud.instrumentation,0,0,0,0,0,0,1,1
gridkit_nanocloud,org.gridkit.nanocloud.log,0,0,0,0,0,0,1,1
gridkit_nanocloud,org.gridkit.nanocloud.telecontrol,3,0,0,1,0,0,1,5
gridkit_nanocloud,org.gridkit.nanocloud.telecontrol.isolate,2,0,0,0,1,0,1,4
gridkit_nanocloud,org.gridkit.vicluster.telecontrol,8,1,0,1,0,0,1,11
gridkit_nanocloud,org.gridkit.vicluster.telecontrol.bootstraper,0,1,0,1,0,0,1,3
gridkit_nanocloud,org.gridkit.vicluster.telecontrol.isolate,0,0,0,0,0,0,1,1
gridkit_nanocloud,org.gridkit.vicluster.telecontrol.jvm,3,0,0,0,0,0,1,4
gridkit_nanocloud,org.gridkit.util.concurrent.zerormi,2,0,0,0,0,0,1,3
gridkit_nanocloud,org.gridkit.vicluster.isolate.rmi,0,0,0,0,0,0,1,1
gridkit_nanocloud,org.gridkit.util.concurrent,0,0,0,1,0,2,1,4
gridkit_nanocloud,org.gridkit.zeroio,0,0,0,0,0,0,1,1
gridkit_nanocloud,org.gridkit.zerormi,1,0,0,1,0,2,1,5
gridkit_nanocloud,org.gridkit.zerormi.hub,1,1,0,0,1,2,1,6
gridkit_nanocloud,org.gridkit.zerormi.util,0,0,0,0,0,0,1,1
gridkit_nanocloud,org.gridkit.zerormi.zlog,0,0,0,0,1,3,1,5
groupon_DotCi,com.groupon.jenkins.branchhistory,0,0,0,0,0,0,0,0
groupon_DotCi,com.groupon.jenkins.buildsetup,3,0,0,0,1,0,0,4
groupon_DotCi,com.groupon.jenkins.buildtype.dockercompose.buildconfiguration,0,0,0,0,1,0,0,1
groupon_DotCi,com.groupon.jenkins.buildtype.dockercompose,9,0,0,0,1,0,0,10
groupon_DotCi,com.groupon.jenkins.buildtype,0,0,0,0,0,0,0,0
groupon_DotCi,com.groupon.jenkins.buildtype.plugins,0,0,0,0,0,0,0,0
groupon_DotCi,com.groupon.jenkins.buildtype.util.shell,0,0,0,0,0,0,0,0
groupon_DotCi,com.groupon.jenkins,15,1,0,0,0,1,0,17
groupon_DotCi,com.groupon.jenkins.dynamic.build.api,0,0,0,0,1,0,0,1
groupon_DotCi,com.groupon.jenkins.dynamic.build.api.metrics,0,0,0,0,0,0,0,0
groupon_DotCi,com.groupon.jenkins.dynamic.build.api.metrics.charts,0,0,0,0,0,0,0,0
groupon_DotCi,com.groupon.jenkins.dynamic.build,14,1,0,1,1,0,0,17
groupon_DotCi,com.groupon.jenkins.dynamic.build.cause,0,0,0,0,1,0,0,1
groupon_DotCi,com.groupon.jenkins.dynamic.build.commithistory,1,0,0,0,0,0,0,1
groupon_DotCi,com.groupon.jenkins.dynamic.build.execution,5,1,0,0,1,0,0,7
groupon_DotCi,com.groupon.jenkins.dynamic.build.plugins.artifacts,0,0,0,0,0,0,0,0
groupon_DotCi,com.groupon.jenkins.dynamic.build.plugins.downstream,0,0,0,0,0,0,0,0
groupon_DotCi,com.groupon.jenkins.dynamic.build.repository,4,0,0,0,0,0,0,4
groupon_DotCi,com.groupon.jenkins.dynamic.buildtype,4,0,0,0,0,0,0,4
groupon_DotCi,com.groupon.jenkins.dynamic.organizationcontainer,0,0,0,0,1,0,0,1
groupon_DotCi,com.groupon.jenkins.dynamic,0,0,0,0,0,0,0,0
groupon_DotCi,com.groupon.jenkins.extensions,0,0,0,0,1,0,0,1
groupon_DotCi,com.groupon.jenkins.git,0,0,0,0,0,0,0,0
groupon_DotCi,com.groupon.jenkins.github,2,0,0,0,1,0,0,3
groupon_DotCi,com.groupon.jenkins.github.services,4,0,0,0,1,1,0,6
groupon_DotCi,com.groupon.jenkins.mongo,0,0,0,1,1,1,0,3
groupon_DotCi,com.groupon.jenkins.mybuildsview,0,0,0,0,0,0,0,0
groupon_DotCi,com.groupon.jenkins.notifications,0,0,0,0,1,0,0,1
groupon_DotCi,com.groupon.jenkins.util,6,1,0,0,1,0,0,8
groupon_DotCi,com.groupon.jenkins.views,0,0,0,0,0,0,0,0
groupon_DotCi,com.groupon.jenkins.buildtype.dockerfile,0,0,0,0,0,0,0,0
groupon_DotCi,(default package),0,0,0,0,0,0,0,0
groupon_odo,com.groupon.odo.bmp,0,0,0,0,1,0,0,1
groupon_odo,com.groupon.odo.client,0,0,0,0,0,0,0,0
groupon_odo,com.groupon.odo.client.models,0,0,0,0,0,0,0,0
groupon_odo,com.groupon.odo.hostsedit,0,0,0,0,0,0,0,0
groupon_odo,com.groupon.odo.proxylib,1,1,0,0,0,1,0,3
groupon_odo,com.groupon.odo.proxylib.hostsedit,0,0,0,0,0,0,0,0
groupon_odo,com.groupon.odo.proxylib.hostsedit.rmi,0,0,0,0,0,0,0,0
groupon_odo,com.groupon.odo.proxylib.models.backup,0,0,0,0,1,1,0,2
groupon_odo,com.groupon.odo.proxylib.models,1,0,0,0,1,1,0,3
groupon_odo,com.groupon.odo.plugin,0,0,0,0,0,0,0,0
groupon_odo,com.groupon.odo,0,0,0,0,1,0,0,1
groupon_odo,com.groupon.transparentproxy,0,0,0,0,0,0,0,0
groupon_odo,com.groupon.odo.containers,0,1,0,0,0,0,0,1
groupon_odo,com.groupon.odo.controllers,0,0,0,0,1,0,0,1
groupon_odo,com.groupon.odo.controllers.models,0,0,0,0,0,0,0,0
grpc_grpc-java,io.grpc.alts.internal,2,0,0,1,0,0,1,4
grpc_grpc-java,io.grpc.alts,5,1,0,0,0,0,1,7
grpc_grpc-java,io.grpc.android,0,0,0,0,1,0,1,2
grpc_grpc-java,io.grpc,17,1,0,1,0,0,1,20
grpc_grpc-java,io.grpc.auth,2,0,0,0,1,0,1,4
grpc_grpc-java,io.grpc.benchmarks.proto,0,0,0,0,0,0,1,1
grpc_grpc-java,io.grpc.benchmarks,0,1,0,0,1,0,1,3
grpc_grpc-java,io.grpc.benchmarks.netty,0,0,0,0,0,0,1,1
grpc_grpc-java,io.grpc.benchmarks.driver,0,0,0,0,0,0,1,1
grpc_grpc-java,io.grpc.benchmarks.qps,0,0,0,0,0,0,1,1
grpc_grpc-java,io.grpc.internal,20,1,0,2,0,0,1,24
grpc_grpc-java,io.grpc.util,3,0,0,1,0,0,1,5
grpc_grpc-java,io.grpc.inprocess,2,0,0,0,0,0,1,3
grpc_grpc-java,io.grpc.cronet,0,0,0,0,0,0,1,1
grpc_grpc-java,io.grpc.clientcacheexample,0,0,0,0,0,0,1,1
grpc_grpc-java,io.grpc.helloworldexample,0,0,0,0,0,0,1,1
grpc_grpc-java,io.grpc.routeguideexample,0,0,0,0,0,0,1,1
grpc_grpc-java,io.grpc.strictmodehelloworldexample,0,0,0,0,0,0,1,1
grpc_grpc-java,io.grpc.examples.alts,0,0,0,0,0,0,1,1
grpc_grpc-java,io.grpc.examples.googleAuth,0,0,0,0,0,0,1,1
grpc_grpc-java,io.grpc.examples.helloworldtls,0,0,0,0,0,0,1,1
grpc_grpc-java,io.grpc.examples.advanced,0,0,0,0,0,0,1,1
grpc_grpc-java,io.grpc.examples.errorhandling,0,0,0,0,0,0,1,1
grpc_grpc-java,io.grpc.examples.experimental,0,0,0,0,0,0,1,1
grpc_grpc-java,io.grpc.examples.header,0,0,0,0,1,0,1,2
grpc_grpc-java,io.grpc.examples.hedging,0,0,0,0,0,0,1,1
grpc_grpc-java,io.grpc.examples.helloworld,0,0,0,0,0,0,1,1
grpc_grpc-java,io.grpc.examples.manualflowcontrol,0,0,0,0,0,0,1,1
grpc_grpc-java,io.grpc.examples.routeguide,0,0,0,0,0,0,1,1
grpc_grpc-java,io.grpc.lb.v1,5,0,0,0,0,0,1,6
grpc_grpc-java,io.grpc.grpclb,11,0,0,0,0,0,1,12
grpc_grpc-java,io.grpc.stub,14,1,0,1,0,0,1,17
grpc_grpc-java,io.grpc.netty.shaded,0,0,0,0,0,0,1,1
grpc_grpc-java,io.grpc.netty,5,0,0,1,0,0,1,7
grpc_grpc-java,io.grpc.okhttp,2,0,0,1,0,0,1,4
grpc_grpc-java,io.grpc.okhttp.internal,0,0,0,0,0,0,1,1
grpc_grpc-java,io.grpc.okhttp.internal.framed,0,0,0,0,0,0,1,1
grpc_grpc-java,io.grpc.protobuf,3,1,0,0,1,0,1,6
grpc_grpc-java,io.grpc.protobuf.lite,1,0,0,0,0,0,1,2
grpc_grpc-java,io.grpc.channelz.v1,0,0,0,0,0,0,1,1
grpc_grpc-java,io.grpc.health.v1,0,0,0,0,0,0,1,1
grpc_grpc-java,io.grpc.reflection.v1alpha,0,0,0,0,0,0,1,1
grpc_grpc-java,io.grpc.protobuf.services,0,0,0,0,0,0,1,1
grpc_grpc-java,io.grpc.services,0,0,0,1,0,0,1,2
grpc_grpc-java,io.grpc.services.internal,0,0,0,0,0,0,1,1
grpc_grpc-java,com.github.udpa.udpa.service.orca.v1,0,0,0,0,0,0,1,1
grpc_grpc-java,io.envoyproxy.envoy.api.v2,0,0,0,0,0,0,1,1
grpc_grpc-java,io.envoyproxy.envoy.service.discovery.v2,0,0,0,0,0,0,1,1
grpc_grpc-java,io.envoyproxy.envoy.service.load_stats.v2,0,0,0,0,0,0,1,1
grpc_grpc-java,io.grpc.xds,0,0,0,1,0,0,1,2
GumTreeDiff_gumtree,com.github.gumtree.dist,0,0,0,0,1,0,0,1
GumTreeDiff_gumtree,com.github.gumtreediff.client,0,0,0,0,0,0,0,0
GumTreeDiff_gumtree,com.github.gumtreediff.client.diff,0,0,0,0,0,0,0,0
GumTreeDiff_gumtree,com.github.gumtreediff.client.diff.dot,0,0,0,0,0,0,0,0
GumTreeDiff_gumtree,com.github.gumtreediff.client.diff.swing,0,0,0,0,0,0,0,0
GumTreeDiff_gumtree,com.github.gumtreediff.client.diff.web,0,0,0,0,1,0,0,1
GumTreeDiff_gumtree,com.github.gumtreediff.actions,3,1,0,0,0,0,0,4
GumTreeDiff_gumtree,com.github.gumtreediff.actions.model,1,0,0,0,0,0,0,1
GumTreeDiff_gumtree,com.github.gumtreediff.gen,0,0,0,0,1,0,0,1
GumTreeDiff_gumtree,com.github.gumtreediff.io,5,1,0,1,0,0,0,7
GumTreeDiff_gumtree,com.github.gumtreediff.matchers,2,1,0,0,0,0,0,3
GumTreeDiff_gumtree,com.github.gumtreediff.matchers.heuristic.cd,0,0,0,0,1,0,0,1
GumTreeDiff_gumtree,com.github.gumtreediff.matchers.heuristic.gt,0,0,0,0,0,0,0,0
GumTreeDiff_gumtree,com.github.gumtreediff.matchers.heuristic,0,0,0,0,0,0,0,0
GumTreeDiff_gumtree,com.github.gumtreediff.matchers.optimal.rted,0,0,0,0,0,0,0,0
GumTreeDiff_gumtree,com.github.gumtreediff.matchers.optimal.zs,0,0,0,0,0,0,0,0
GumTreeDiff_gumtree,com.github.gumtreediff.matchers.optimizations,0,0,0,0,1,0,0,1
GumTreeDiff_gumtree,com.github.gumtreediff.tree,5,1,0,0,0,0,0,6
GumTreeDiff_gumtree,com.github.gumtreediff.utils,0,0,0,0,0,0,0,0
GumTreeDiff_gumtree,com.github.gumtreediff.gen.antlr3,0,0,0,0,0,0,0,0
GumTreeDiff_gumtree,com.github.gumtreediff.gen.antlr3.antlr,0,0,0,1,0,0,0,1
GumTreeDiff_gumtree,com.github.gumtreediff.gen.antlr3.json,0,0,0,0,0,0,0,0
GumTreeDiff_gumtree,com.github.gumtreediff.gen.antlr3.php,0,0,0,2,0,0,0,2
GumTreeDiff_gumtree,com.github.gumtreediff.gen.antlr3.r,0,0,0,1,0,0,0,1
GumTreeDiff_gumtree,com.github.gumtreediff.gen.antlr3.xml,0,0,0,0,0,0,0,0
GumTreeDiff_gumtree,com.github.gumtreediff.gen.antlr4,0,0,0,0,0,0,0,0
GumTreeDiff_gumtree,com.github.gumtreediff.gen.antlr4.matlab,0,0,0,0,0,0,0,0
GumTreeDiff_gumtree,com.github.gumtreediff.gen.c,0,0,0,0,0,0,0,0
GumTreeDiff_gumtree,com.github.gumtreediff.gen.css,0,0,0,0,0,0,0,0
GumTreeDiff_gumtree,com.github.gumtreediff.gen.javaparser,0,0,0,0,0,0,0,0
GumTreeDiff_gumtree,com.github.gumtreediff.gen.jdt,0,0,0,0,0,0,0,0
GumTreeDiff_gumtree,com.github.gumtreediff.gen.jdt.cd,0,0,0,0,0,0,0,0
GumTreeDiff_gumtree,com.github.gumtreediff.gen.js,0,0,0,0,0,0,0,0
GumTreeDiff_gumtree,com.github.gumtreediff.gen.python,0,0,0,0,0,0,0,0
GumTreeDiff_gumtree,com.github.gumtreediff.gen.ruby,0,0,0,0,0,0,0,0
GumTreeDiff_gumtree,com.github.gumtreediff.gen.srcml,0,0,0,0,0,0,0,0
gwtbootstrap3_gwtbootstrap3,org.gwtbootstrap3.client,0,0,0,0,1,0,0,1
gwtbootstrap3_gwtbootstrap3,org.gwtbootstrap3.client.shared.event,0,0,0,1,1,0,0,2
gwtbootstrap3_gwtbootstrap3,org.gwtbootstrap3.client.shared.js,0,0,0,0,0,0,0,0
gwtbootstrap3_gwtbootstrap3,org.gwtbootstrap3.client.ui,0,0,0,1,1,0,0,2
gwtbootstrap3_gwtbootstrap3,org.gwtbootstrap3.client.ui.base,0,0,0,1,1,0,0,2
gwtbootstrap3_gwtbootstrap3,org.gwtbootstrap3.client.ui.base.button,0,0,0,0,1,0,0,1
gwtbootstrap3_gwtbootstrap3,org.gwtbootstrap3.client.ui.base.form,0,0,0,0,1,0,0,1
gwtbootstrap3_gwtbootstrap3,org.gwtbootstrap3.client.ui.base.helper,0,0,0,0,1,0,0,1
gwtbootstrap3_gwtbootstrap3,org.gwtbootstrap3.client.ui.base.mixin,0,0,0,1,1,0,0,2
gwtbootstrap3_gwtbootstrap3,org.gwtbootstrap3.client.ui.base.modal,0,0,0,0,0,0,0,0
gwtbootstrap3_gwtbootstrap3,org.gwtbootstrap3.client.ui.constants,0,0,0,0,1,0,0,1
gwtbootstrap3_gwtbootstrap3,org.gwtbootstrap3.client.ui.form.error,0,0,0,0,1,0,0,1
gwtbootstrap3_gwtbootstrap3,org.gwtbootstrap3.client.ui.form.validator,0,0,0,1,1,0,0,2
gwtbootstrap3_gwtbootstrap3,org.gwtbootstrap3.client.ui.gwt,0,0,0,0,1,0,0,1
gwtbootstrap3_gwtbootstrap3,org.gwtbootstrap3.client.ui.html,0,0,0,0,1,0,0,1
gwtbootstrap3_gwtbootstrap3,org.gwtbootstrap3.client.ui.impl,0,0,0,0,1,0,0,1
gwtbootstrap3_gwtbootstrap3,com.google.gwt.lang,0,0,0,0,0,0,0,0
gwtbootstrap3_gwtbootstrap3,com.google.gwt.user.client,0,0,0,0,0,0,0,0
gwtbootstrap3_gwtbootstrap3,com.google.gwt.useragent.client,0,0,0,0,0,0,0,0
gwtbootstrap3_gwtbootstrap3-demo,org.gwtbootstrap3.demo.client.application,6,1,0,0,1,0,0,8
gwtbootstrap3_gwtbootstrap3-demo,org.gwtbootstrap3.demo.client.application.components,1,0,0,2,1,0,0,4
gwtbootstrap3_gwtbootstrap3-demo,org.gwtbootstrap3.demo.client.application.css,1,0,0,1,1,0,0,3
gwtbootstrap3_gwtbootstrap3-demo,org.gwtbootstrap3.demo.client.application.css.validation,1,0,0,1,1,0,0,3
gwtbootstrap3_gwtbootstrap3-demo,org.gwtbootstrap3.demo.client.application.extras,1,0,0,2,1,0,0,4
gwtbootstrap3_gwtbootstrap3-demo,org.gwtbootstrap3.demo.client.application.general,1,0,0,1,1,0,0,3
gwtbootstrap3_gwtbootstrap3-demo,org.gwtbootstrap3.demo.client.application.javascript,1,0,0,1,1,0,0,3
gwtbootstrap3_gwtbootstrap3-demo,org.gwtbootstrap3.demo.client.gin,0,0,0,0,0,0,0,0
gwtbootstrap3_gwtbootstrap3-demo,org.gwtbootstrap3.demo.client,0,0,0,0,1,0,0,1
gwtbootstrap3_gwtbootstrap3-demo,org.gwtbootstrap3.demo.client.place,0,0,0,0,0,0,0,0
gwtbootstrap3_gwtbootstrap3-demo,org.gwtbootstrap3.demo.client.pojo,0,0,0,0,0,0,0,0
gwtbootstrap3_gwtbootstrap3-demo,org.gwtbootstrap3.demo.client.ui.constants,0,0,0,0,0,0,0,0
gwtbootstrap3_gwtbootstrap3-demo,org.gwtbootstrap3.demo.client.ui,0,0,0,0,0,0,0,0
gwtbootstrap3_gwtbootstrap3-demo,com.arcbees.analytics.client,1,1,0,0,0,0,0,2
gwtbootstrap3_gwtbootstrap3-demo,com.google.gwt.editor.ui.client.adapters,0,0,0,0,0,0,0,0
gwtbootstrap3_gwtbootstrap3-demo,com.google.gwt.i18n.client.constants,0,0,0,0,0,0,0,0
gwtbootstrap3_gwtbootstrap3-demo,com.google.gwt.i18n.client,0,0,0,0,0,0,0,0
gwtbootstrap3_gwtbootstrap3-demo,com.google.gwt.i18n.client.impl,0,0,0,0,0,0,0,0
gwtbootstrap3_gwtbootstrap3-demo,com.google.gwt.lang,0,0,0,0,0,0,0,0
gwtbootstrap3_gwtbootstrap3-demo,com.google.gwt.place.shared,1,1,0,0,0,0,0,2
gwtbootstrap3_gwtbootstrap3-demo,com.google.gwt.resources.client,0,0,0,0,1,0,0,1
gwtbootstrap3_gwtbootstrap3-demo,com.google.gwt.user.cellview.client,0,0,0,1,1,0,0,2
gwtbootstrap3_gwtbootstrap3-demo,com.google.gwt.user.client,0,0,0,0,0,0,0,0
gwtbootstrap3_gwtbootstrap3-demo,com.google.gwt.user.client.impl,0,0,0,0,1,0,0,1
gwtbootstrap3_gwtbootstrap3-demo,com.google.gwt.user.client.ui,0,0,0,1,1,0,0,2
gwtbootstrap3_gwtbootstrap3-demo,com.google.gwt.user.client.ui.impl,0,0,0,0,0,0,0,0
gwtbootstrap3_gwtbootstrap3-demo,com.google.gwt.useragent.client,0,0,0,0,0,0,0,0
gwtbootstrap3_gwtbootstrap3-demo,com.google.web.bindery.event.shared,1,1,0,0,0,0,0,2
gwtbootstrap3_gwtbootstrap3-demo,com.gwtplatform.common.client,1,1,0,0,0,0,0,2
gwtbootstrap3_gwtbootstrap3-demo,com.gwtplatform.common.shared,1,1,0,0,0,0,0,2
gwtbootstrap3_gwtbootstrap3-demo,com.gwtplatform.mvp.client,7,0,0,0,0,0,0,7
gwtbootstrap3_gwtbootstrap3-demo,com.gwtplatform.mvp.client.proxy,1,1,0,0,0,0,0,2
gwtbootstrap3_gwtbootstrap3-demo,com.gwtplatform.mvp.shared.proxy,1,1,0,0,0,0,0,2
gwtbootstrap3_gwtbootstrap3-demo,org.gwtbootstrap3.client,0,0,0,0,1,0,0,1
gwtbootstrap3_gwtbootstrap3-demo,org.gwtbootstrap3.client.ui.base.form,0,0,0,0,0,0,0,0
gwtbootstrap3_gwtbootstrap3-demo,org.gwtbootstrap3.client.ui.form.validator,0,0,0,0,0,0,0,0
gwtbootstrap3_gwtbootstrap3-demo,org.gwtbootstrap3.client.ui,0,0,0,0,0,0,0,0
gwtbootstrap3_gwtbootstrap3-demo,org.gwtbootstrap3.extras.bootbox.client,0,0,0,0,1,0,0,1
gwtbootstrap3_gwtbootstrap3-demo,org.gwtbootstrap3.extras.datepicker.client,0,0,0,1,1,0,0,2
gwtbootstrap3_gwtbootstrap3-demo,org.gwtbootstrap3.extras.datetimepicker.client,0,0,0,1,1,0,0,2
gwtbootstrap3_gwtbootstrap3-demo,org.gwtbootstrap3.extras.fullcalendar.client,0,0,0,1,1,0,0,2
gwtbootstrap3_gwtbootstrap3-demo,org.gwtbootstrap3.extras.notify.client,0,0,0,0,1,0,0,1
gwtbootstrap3_gwtbootstrap3-demo,org.gwtbootstrap3.extras.respond.client,0,0,0,0,1,0,0,1
gwtbootstrap3_gwtbootstrap3-demo,org.gwtbootstrap3.extras.select.client,0,0,0,1,1,0,0,2
gwtbootstrap3_gwtbootstrap3-demo,org.gwtbootstrap3.extras.slider.client,0,0,0,0,1,0,0,1
gwtbootstrap3_gwtbootstrap3-demo,org.gwtbootstrap3.extras.summernote.client,0,0,0,1,1,0,0,2
gwtbootstrap3_gwtbootstrap3-demo,org.gwtbootstrap3.extras.tagsinput.client,0,0,0,0,1,0,0,1
gwtbootstrap3_gwtbootstrap3-demo,org.gwtbootstrap3.extras.toggleswitch.client,0,0,0,0,1,0,0,1
gwtbootstrap3_gwtbootstrap3-demo,org.gwtbootstrap3.extras.typeahead.client,0,0,0,0,1,0,0,1
gwtbootstrap3_gwtbootstrap3-demo,org.hibernate.validator,0,0,0,0,0,0,0,0
gwtbootstrap3_gwtbootstrap3-extras,org.gwtbootstrap3.extras.animate.client.ui,0,0,0,0,0,0,0,0
gwtbootstrap3_gwtbootstrap3-extras,org.gwtbootstrap3.extras.bootbox.client,0,0,0,0,1,0,0,1
gwtbootstrap3_gwtbootstrap3-extras,org.gwtbootstrap3.extras.bootbox.client.callback,0,0,0,0,1,0,0,1
gwtbootstrap3_gwtbootstrap3-extras,org.gwtbootstrap3.extras.bootbox.client.options,0,0,0,0,0,0,0,0
gwtbootstrap3_gwtbootstrap3-extras,org.gwtbootstrap3.extras.cachemanifest,0,0,0,0,0,0,0,0
gwtbootstrap3_gwtbootstrap3-extras,org.gwtbootstrap3.extras.card.client.ui,0,0,0,0,1,0,0,1
gwtbootstrap3_gwtbootstrap3-extras,org.gwtbootstrap3.extras.datepicker.client,0,0,0,1,0,0,0,1
gwtbootstrap3_gwtbootstrap3-extras,org.gwtbootstrap3.extras.datepicker.client.ui.base.constants,0,0,0,1,1,0,0,2
gwtbootstrap3_gwtbootstrap3-extras,org.gwtbootstrap3.extras.datepicker.client.ui.base,0,0,0,0,0,0,0,0
gwtbootstrap3_gwtbootstrap3-extras,org.gwtbootstrap3.extras.datepicker.client.ui.base.events,0,0,0,0,1,0,0,1
gwtbootstrap3_gwtbootstrap3-extras,org.gwtbootstrap3.extras.datepicker.client.ui,0,0,0,0,0,0,0,0
gwtbootstrap3_gwtbootstrap3-extras,org.gwtbootstrap3.extras.datetimepicker.client,0,0,0,1,0,0,0,1
gwtbootstrap3_gwtbootstrap3-extras,org.gwtbootstrap3.extras.datetimepicker.client.ui.base.constants,0,0,0,1,1,0,0,2
gwtbootstrap3_gwtbootstrap3-extras,org.gwtbootstrap3.extras.datetimepicker.client.ui.base,0,0,0,0,0,0,0,0
gwtbootstrap3_gwtbootstrap3-extras,org.gwtbootstrap3.extras.datetimepicker.client.ui.base.events,0,0,0,0,1,0,0,1
gwtbootstrap3_gwtbootstrap3-extras,org.gwtbootstrap3.extras.datetimepicker.client.ui,0,0,0,0,0,0,0,0
gwtbootstrap3_gwtbootstrap3-extras,org.gwtbootstrap3.extras.fullcalendar.client,0,0,0,1,0,0,0,1
gwtbootstrap3_gwtbootstrap3-extras,org.gwtbootstrap3.extras.fullcalendar.client.ui,0,0,0,1,1,0,0,2
gwtbootstrap3_gwtbootstrap3-extras,org.gwtbootstrap3.extras.gallery.client.events,0,0,0,0,1,0,0,1
gwtbootstrap3_gwtbootstrap3-extras,org.gwtbootstrap3.extras.gallery.client,0,0,0,0,0,0,0,0
gwtbootstrap3_gwtbootstrap3-extras,org.gwtbootstrap3.extras.gallery.client.ui,0,0,0,0,0,0,0,0
gwtbootstrap3_gwtbootstrap3-extras,org.gwtbootstrap3.extras.notify.client.event,0,0,0,0,1,0,0,1
gwtbootstrap3_gwtbootstrap3-extras,org.gwtbootstrap3.extras.notify.client,0,0,0,0,1,0,0,1
gwtbootstrap3_gwtbootstrap3-extras,org.gwtbootstrap3.extras.notify.client.ui,0,0,0,0,0,0,0,0
gwtbootstrap3_gwtbootstrap3-extras,org.gwtbootstrap3.extras.respond.client,0,0,0,0,1,0,0,1
gwtbootstrap3_gwtbootstrap3-extras,org.gwtbootstrap3.extras.select.client,0,0,0,1,0,0,0,1
gwtbootstrap3_gwtbootstrap3-extras,org.gwtbootstrap3.extras.select.client.ui.constants,0,0,0,0,0,0,0,0
gwtbootstrap3_gwtbootstrap3-extras,org.gwtbootstrap3.extras.select.client.ui,0,0,0,0,1,0,0,1
gwtbootstrap3_gwtbootstrap3-extras,org.gwtbootstrap3.extras.select.client.ui.event,0,0,0,1,1,0,0,2
gwtbootstrap3_gwtbootstrap3-extras,org.gwtbootstrap3.extras.slider.client,0,0,0,0,1,0,0,1
gwtbootstrap3_gwtbootstrap3-extras,org.gwtbootstrap3.extras.slider.client.ui.base.event,0,0,0,1,1,0,0,2
gwtbootstrap3_gwtbootstrap3-extras,org.gwtbootstrap3.extras.slider.client.ui.base,0,0,0,0,1,0,0,1
gwtbootstrap3_gwtbootstrap3-extras,org.gwtbootstrap3.extras.slider.client.ui,0,0,0,0,1,0,0,1
gwtbootstrap3_gwtbootstrap3-extras,org.gwtbootstrap3.extras.summernote.client.event,0,0,0,1,1,0,0,2
gwtbootstrap3_gwtbootstrap3-extras,org.gwtbootstrap3.extras.summernote.client,0,0,0,1,0,0,0,1
gwtbootstrap3_gwtbootstrap3-extras,org.gwtbootstrap3.extras.summernote.client.ui.base,0,0,0,0,1,0,0,1
gwtbootstrap3_gwtbootstrap3-extras,org.gwtbootstrap3.extras.summernote.client.ui,0,0,0,0,0,0,0,0
gwtbootstrap3_gwtbootstrap3-extras,org.gwtbootstrap3.extras.tagsinput.client.callback,0,0,0,0,1,0,0,1
gwtbootstrap3_gwtbootstrap3-extras,org.gwtbootstrap3.extras.tagsinput.client.event,0,0,0,0,1,0,0,1
gwtbootstrap3_gwtbootstrap3-extras,org.gwtbootstrap3.extras.tagsinput.client,0,0,0,0,1,0,0,1
gwtbootstrap3_gwtbootstrap3-extras,org.gwtbootstrap3.extras.tagsinput.client.ui.base,0,0,0,0,1,0,0,1
gwtbootstrap3_gwtbootstrap3-extras,org.gwtbootstrap3.extras.tagsinput.client.ui,0,0,0,0,0,0,0,0
gwtbootstrap3_gwtbootstrap3-extras,org.gwtbootstrap3.extras.toggleswitch.client,0,0,0,0,1,0,0,1
gwtbootstrap3_gwtbootstrap3-extras,org.gwtbootstrap3.extras.toggleswitch.client.ui.base,0,0,0,0,0,0,0,0
gwtbootstrap3_gwtbootstrap3-extras,org.gwtbootstrap3.extras.toggleswitch.client.ui,0,0,0,0,0,0,0,0
gwtbootstrap3_gwtbootstrap3-extras,org.gwtbootstrap3.extras.typeahead.client.base,0,0,0,0,1,0,0,1
gwtbootstrap3_gwtbootstrap3-extras,org.gwtbootstrap3.extras.typeahead.client.events,0,0,0,0,1,0,0,1
gwtbootstrap3_gwtbootstrap3-extras,org.gwtbootstrap3.extras.typeahead.client,0,0,0,0,1,0,0,1
gwtbootstrap3_gwtbootstrap3-extras,org.gwtbootstrap3.extras.typeahead.client.ui,0,0,0,0,0,0,0,0
gwtbootstrap3_gwtbootstrap3-extras,com.google.gwt.i18n.client.constants,0,0,0,0,0,0,0,0
gwtbootstrap3_gwtbootstrap3-extras,com.google.gwt.i18n.client.impl,0,0,0,0,0,0,0,0
gwtbootstrap3_gwtbootstrap3-extras,com.google.gwt.lang,0,0,0,0,1,0,0,1
gwtbootstrap3_gwtbootstrap3-extras,com.google.gwt.user.client,0,0,0,0,0,0,0,0
gwtbootstrap3_gwtbootstrap3-extras,com.google.gwt.useragent.client,0,0,0,0,0,0,0,0
h2oai_h2o,hex,14,1,0,1,1,29,1,47
h2oai_h2o,cookbook,0,0,0,0,1,2,1,4
h2oai_h2o,cookbook.groupedaverage,0,0,0,0,1,0,1,2
h2oai_h2o,water.api.dsl,0,0,0,0,0,1,1,2
h2oai_h2o,water.api.dsl.util,0,0,0,0,0,0,1,1
h2oai_h2o,water.zookeeper,0,0,0,0,1,0,1,2
h2oai_h2o,water.zookeeper.nodes,0,0,0,0,0,0,1,1
h2oai_h2o,water.hadoop,0,0,0,0,0,1,1,2
h2oai_h2o,(default package),0,0,0,0,0,0,1,1
h2oai_h2o,h2o_proof,0,0,0,0,0,0,1,1
h2oai_h2o,embedded,0,0,0,0,0,0,1,1
h2oai_h2o,hex.anomaly,0,0,0,0,0,0,1,1
h2oai_h2o,hex.deepfeatures,0,0,0,0,0,0,1,1
h2oai_h2o,hex.deeplearning,3,0,0,0,0,6,1,10
h2oai_h2o,hex.drf,3,0,0,0,0,6,1,10
h2oai_h2o,hex.gapstat,0,0,0,0,0,0,1,1
h2oai_h2o,hex.gbm,3,0,0,1,0,6,1,11
h2oai_h2o,hex.glm,4,0,0,1,0,12,1,18
h2oai_h2o,hex.gram,3,1,0,0,0,6,1,11
h2oai_h2o,hex.la,2,0,0,0,1,2,1,6
h2oai_h2o,hex.nb,4,0,0,0,1,0,1,6
h2oai_h2o,hex.pca,3,0,0,0,1,4,1,9
h2oai_h2o,hex.rng,0,0,0,0,0,0,1,1
h2oai_h2o,hex.singlenoderf,3,0,0,1,0,7,1,12
h2oai_h2o,jsr166y,0,0,0,0,0,25,1,26
h2oai_h2o,water,35,1,0,1,0,80,1,118
h2oai_h2o,water.api,33,1,0,1,0,22,1,58
h2oai_h2o,water.api.handlers,0,0,0,0,0,0,1,1
h2oai_h2o,water.deploy,3,1,0,0,0,3,1,8
h2oai_h2o,water.exec,2,1,0,1,1,5,1,11
h2oai_h2o,water.fvec,4,1,0,1,0,47,1,54
h2oai_h2o,water.ga,2,0,0,0,1,0,1,4
h2oai_h2o,water.ga.internal,0,0,0,0,0,0,1,1
h2oai_h2o,water.genmodel,0,0,0,0,0,0,1,1
h2oai_h2o,water.license,0,0,0,0,0,0,1,1
h2oai_h2o,water.nbhm,2,1,0,0,0,7,1,11
h2oai_h2o,water.parser,6,1,0,1,0,6,1,15
h2oai_h2o,water.persist,2,0,0,0,1,2,1,6
h2oai_h2o,water.schemas,2,0,0,0,0,0,1,3
h2oai_h2o,water.score,3,0,0,0,1,0,1,5
h2oai_h2o,water.serial,0,0,0,0,0,0,1,1
h2oai_h2o,water.util,32,1,0,1,1,23,1,59
h2oai_h2o,hex.purelogic,0,0,0,0,0,0,1,1
h2oai_h2o,hex.trees,0,0,0,0,0,0,1,1
h2oai_h2o,water.suites,0,0,0,0,0,0,1,1
h3xstream_http-script-generator,burp,0,0,0,1,1,0,0,2
h3xstream_http-script-generator,com.h3xstream.scriptgen.gui,2,0,0,0,1,0,0,3
h3xstream_http-script-generator,com.h3xstream.scriptgen,2,1,0,0,0,0,0,3
h3xstream_http-script-generator,com.h3xstream.scriptgen.model,0,0,0,0,0,0,0,0
h3xstream_http-script-generator,com.h3xstream.scriptgen.template,1,0,0,0,0,0,0,1
h3xstream_http-script-generator,org.zaproxy.zap.extension.scriptgen,0,0,0,0,0,0,0,0
HadoopGenomics_Hadoop-BAM,org.seqdoop.hadoop_bam.examples,0,0,0,0,1,0,0,1
HadoopGenomics_Hadoop-BAM,htsjdk.samtools,0,0,0,0,0,0,0,0
HadoopGenomics_Hadoop-BAM,org.seqdoop.hadoop_bam,1,0,0,1,1,0,0,3
HadoopGenomics_Hadoop-BAM,org.seqdoop.hadoop_bam.util,1,1,0,0,1,0,0,3
hal_circuit,org.jboss.gwt.circuit,1,1,0,1,1,1,0,5
hal_circuit,org.jboss.gwt.circuit.dag,1,1,0,0,1,1,0,4
hal_circuit,org.jgrapht.alg,0,0,0,1,1,2,0,4
hal_circuit,org.jgrapht,1,1,0,0,1,1,0,4
hal_circuit,org.jgrapht.event,0,0,0,0,1,1,0,2
hal_circuit,org.jgrapht.graph,1,0,0,1,0,0,0,2
hal_circuit,org.jgrapht.traverse,0,0,0,0,1,0,0,1
hal_circuit,org.jgrapht.util,0,0,0,0,1,0,0,1
hal_circuit,org.jgrapht.alg.interfaces,0,0,0,0,0,0,0,0
hal_circuit,org.jgrapht.alg.util,0,0,0,0,0,0,0,0
hal_circuit,org.jgrapht.experimental.alg,0,0,0,0,0,0,0,0
hal_circuit,org.jgrapht.experimental.equivalence,0,0,0,0,0,0,0,0
hal_circuit,org.jgrapht.experimental,0,0,0,0,0,0,0,0
hal_circuit,org.jgrapht.experimental.isomorphism,0,0,0,0,0,0,0,0
hal_circuit,org.jgrapht.experimental.permutation,0,0,0,0,0,0,0,0
hal_circuit,org.jgrapht.generate,0,0,0,0,0,0,0,0
hal_circuit,org.jboss.gwt.circuit.processor,0,0,0,0,0,0,0,0
hankcs_HanLP,com.hankcs.hanlp.algorithm.ahocorasick.interval,0,0,0,0,1,0,1,2
hankcs_HanLP,com.hankcs.hanlp.algorithm.ahocorasick.trie,1,0,0,0,0,0,1,2
hankcs_HanLP,com.hankcs.hanlp.algorithm,1,1,0,0,1,1,1,5
hankcs_HanLP,com.hankcs.hanlp.classification.classifiers,0,0,0,0,0,1,1,2
hankcs_HanLP,com.hankcs.hanlp.classification.collections,0,0,0,0,0,0,1,1
hankcs_HanLP,com.hankcs.hanlp.classification.corpus,0,0,0,0,0,1,1,2
hankcs_HanLP,com.hankcs.hanlp.classification.features,0,0,0,0,1,0,1,2
hankcs_HanLP,com.hankcs.hanlp.classification.models,0,0,0,0,0,0,1,1
hankcs_HanLP,com.hankcs.hanlp.classification.statistics,0,0,0,0,0,0,1,1
hankcs_HanLP,com.hankcs.hanlp.classification.statistics.evaluations,0,1,0,0,0,1,1,3
hankcs_HanLP,com.hankcs.hanlp.classification.tokenizers,0,0,0,0,0,0,1,1
hankcs_HanLP,com.hankcs.hanlp.classification.utilities,0,0,0,0,0,0,1,1
hankcs_HanLP,com.hankcs.hanlp.classification.utilities.io,0,0,0,0,0,0,1,1
hankcs_HanLP,com.hankcs.hanlp.collection.AhoCorasick,7,1,0,0,1,0,1,10
hankcs_HanLP,com.hankcs.hanlp.collection.dartsclone,2,0,0,0,0,0,1,3
hankcs_HanLP,com.hankcs.hanlp.collection.dartsclone.details,0,0,0,0,1,0,1,2
hankcs_HanLP,com.hankcs.hanlp.collection.MDAG,3,0,0,0,1,0,1,5
hankcs_HanLP,com.hankcs.hanlp.collection.sequence,0,0,0,0,0,0,1,1
hankcs_HanLP,com.hankcs.hanlp.collection.set,0,0,0,0,0,0,1,1
hankcs_HanLP,com.hankcs.hanlp.collection.trie.bintrie,5,0,0,0,0,3,1,9
hankcs_HanLP,com.hankcs.hanlp.collection.trie.bintrie.util,0,0,0,0,0,0,1,1
hankcs_HanLP,com.hankcs.hanlp.collection.trie.datrie,1,0,0,0,1,0,1,3
hankcs_HanLP,com.hankcs.hanlp.collection.trie,6,0,0,0,0,2,1,9
hankcs_HanLP,com.hankcs.hanlp.corpus.dependency.CoNll,2,0,0,0,1,1,1,5
hankcs_HanLP,com.hankcs.hanlp.corpus.dependency.model,0,0,0,0,0,0,1,1
hankcs_HanLP,com.hankcs.hanlp.corpus.dictionary,5,0,0,0,1,4,1,11
hankcs_HanLP,com.hankcs.hanlp.corpus.dictionary.item,0,0,0,0,0,2,1,3
hankcs_HanLP,com.hankcs.hanlp.corpus.document,4,1,0,0,1,2,1,9
hankcs_HanLP,com.hankcs.hanlp.corpus.document.sentence,12,1,0,0,0,4,1,18
hankcs_HanLP,com.hankcs.hanlp.corpus.document.sentence.word,0,0,0,0,0,6,1,7
hankcs_HanLP,com.hankcs.hanlp.corpus.io,59,1,0,0,1,2,1,64
hankcs_HanLP,com.hankcs.hanlp.corpus.occurrence,2,0,0,0,0,1,1,4
hankcs_HanLP,com.hankcs.hanlp.corpus.synonym,0,0,0,0,0,0,1,1
hankcs_HanLP,com.hankcs.hanlp.corpus.tag,0,0,0,0,0,2,1,3
hankcs_HanLP,com.hankcs.hanlp.corpus.util,1,0,0,0,0,2,1,4
hankcs_HanLP,com.hankcs.hanlp.dependency,0,0,0,0,1,0,1,2
hankcs_HanLP,com.hankcs.hanlp.dependency.common,0,0,0,0,0,0,1,1
hankcs_HanLP,com.hankcs.hanlp.dependency.nnparser.action,0,0,0,0,0,0,1,1
hankcs_HanLP,com.hankcs.hanlp.dependency.nnparser,0,0,0,0,1,0,1,2
hankcs_HanLP,com.hankcs.hanlp.dependency.nnparser.option,0,0,0,0,1,0,1,2
hankcs_HanLP,com.hankcs.hanlp.dependency.nnparser.util,0,0,0,0,0,0,1,1
hankcs_HanLP,com.hankcs.hanlp.dependency.perceptron.accessories,2,0,0,0,0,1,1,4
hankcs_HanLP,com.hankcs.hanlp.dependency.perceptron.learning,0,0,0,0,0,2,1,3
hankcs_HanLP,com.hankcs.hanlp.dependency.perceptron.parser,0,0,0,0,0,0,1,1
hankcs_HanLP,com.hankcs.hanlp.dependency.perceptron.structures,0,0,0,0,0,2,1,3
hankcs_HanLP,com.hankcs.hanlp.dependency.perceptron.transition.configuration,3,1,0,0,0,4,1,9
hankcs_HanLP,com.hankcs.hanlp.dependency.perceptron.transition.features,0,0,0,0,0,3,1,4
hankcs_HanLP,com.hankcs.hanlp.dependency.perceptron.transition.parser,2,0,0,0,1,3,1,7
hankcs_HanLP,com.hankcs.hanlp.dependency.perceptron.transition.trainer,0,0,0,0,0,1,1,2
hankcs_HanLP,com.hankcs.hanlp.dictionary,43,1,0,0,1,6,1,52
hankcs_HanLP,com.hankcs.hanlp.dictionary.common,11,0,0,0,1,1,1,14
hankcs_HanLP,com.hankcs.hanlp.dictionary.nr,2,0,0,0,1,0,1,4
hankcs_HanLP,com.hankcs.hanlp.dictionary.ns,2,0,0,0,0,0,1,3
hankcs_HanLP,com.hankcs.hanlp.dictionary.nt,2,0,0,0,0,0,1,3
hankcs_HanLP,com.hankcs.hanlp.dictionary.other,8,0,0,0,1,1,1,11
hankcs_HanLP,com.hankcs.hanlp.dictionary.py,6,0,0,0,0,0,1,7
hankcs_HanLP,com.hankcs.hanlp.dictionary.stopword,11,1,0,0,0,1,1,14
hankcs_HanLP,com.hankcs.hanlp.dictionary.ts,6,0,0,0,0,0,1,7
hankcs_HanLP,com.hankcs.hanlp,70,1,0,0,0,3,1,75
hankcs_HanLP,com.hankcs.hanlp.mining.cluster,1,1,0,0,0,0,1,3
hankcs_HanLP,com.hankcs.hanlp.mining.phrase,3,1,0,0,0,0,1,5
hankcs_HanLP,com.hankcs.hanlp.mining.word,5,0,0,0,1,0,1,7
hankcs_HanLP,com.hankcs.hanlp.mining.word2vec,0,0,0,0,0,0,1,1
hankcs_HanLP,com.hankcs.hanlp.model.bigram,0,0,0,0,0,0,1,1
hankcs_HanLP,com.hankcs.hanlp.model.crf,17,1,0,0,0,0,1,19
hankcs_HanLP,com.hankcs.hanlp.model.crf.crfpp,3,0,0,0,0,0,1,4
hankcs_HanLP,com.hankcs.hanlp.model,0,1,0,0,0,0,1,2
hankcs_HanLP,com.hankcs.hanlp.model.hmm,6,0,0,0,0,0,1,7
hankcs_HanLP,com.hankcs.hanlp.model.maxent,0,0,0,0,0,0,1,1
hankcs_HanLP,com.hankcs.hanlp.model.perceptron.cli,0,0,0,0,0,0,1,1
hankcs_HanLP,com.hankcs.hanlp.model.perceptron.common,0,0,0,0,0,0,1,1
hankcs_HanLP,com.hankcs.hanlp.model.perceptron,9,1,0,1,0,6,1,18
hankcs_HanLP,com.hankcs.hanlp.model.perceptron.feature,5,0,0,0,1,2,1,9
hankcs_HanLP,com.hankcs.hanlp.model.perceptron.instance,5,1,0,0,0,2,1,9
hankcs_HanLP,com.hankcs.hanlp.model.perceptron.model,5,1,0,0,0,3,1,10
hankcs_HanLP,com.hankcs.hanlp.model.perceptron.tagset,0,0,0,0,0,1,1,2
hankcs_HanLP,com.hankcs.hanlp.model.perceptron.utility,15,1,0,0,0,2,1,19
hankcs_HanLP,com.hankcs.hanlp.model.trigram,0,0,0,0,0,0,1,1
hankcs_HanLP,com.hankcs.hanlp.model.trigram.frequency,0,0,0,0,0,0,1,1
hankcs_HanLP,com.hankcs.hanlp.recognition.nr,3,1,0,0,0,0,1,5
hankcs_HanLP,com.hankcs.hanlp.recognition.ns,4,1,0,0,0,0,1,6
hankcs_HanLP,com.hankcs.hanlp.recognition.nt,3,1,0,0,0,0,1,5
hankcs_HanLP,com.hankcs.hanlp.seg,10,1,0,0,1,8,1,21
hankcs_HanLP,com.hankcs.hanlp.seg.common,12,1,0,0,1,1,1,16
hankcs_HanLP,com.hankcs.hanlp.seg.common.wrapper,0,0,0,0,0,0,1,1
hankcs_HanLP,com.hankcs.hanlp.seg.CRF,0,0,0,0,0,0,1,1
hankcs_HanLP,com.hankcs.hanlp.seg.Dijkstra,2,0,0,0,0,0,1,3
hankcs_HanLP,com.hankcs.hanlp.seg.Dijkstra.Path,0,0,0,0,0,0,1,1
hankcs_HanLP,com.hankcs.hanlp.seg.HMM,0,0,0,0,0,0,1,1
hankcs_HanLP,com.hankcs.hanlp.seg.NShort,6,0,0,0,0,0,1,7
hankcs_HanLP,com.hankcs.hanlp.seg.NShort.Path,2,0,0,0,0,0,1,3
hankcs_HanLP,com.hankcs.hanlp.seg.Other,6,0,0,0,1,0,1,8
hankcs_HanLP,com.hankcs.hanlp.seg.Viterbi.Path,0,0,0,0,0,0,1,1
hankcs_HanLP,com.hankcs.hanlp.seg.Viterbi,13,0,0,0,0,0,1,14
hankcs_HanLP,com.hankcs.hanlp.suggest,0,1,0,0,0,0,1,2
hankcs_HanLP,com.hankcs.hanlp.suggest.scorer,0,0,0,0,0,0,1,1
hankcs_HanLP,com.hankcs.hanlp.suggest.scorer.editdistance,0,0,0,0,0,0,1,1
hankcs_HanLP,com.hankcs.hanlp.suggest.scorer.lexeme,0,0,0,0,0,0,1,1
hankcs_HanLP,com.hankcs.hanlp.suggest.scorer.pinyin,0,1,0,0,0,0,1,2
hankcs_HanLP,com.hankcs.hanlp.summary,3,0,0,0,0,0,1,4
hankcs_HanLP,com.hankcs.hanlp.tokenizer,4,1,0,0,1,2,1,9
hankcs_HanLP,com.hankcs.hanlp.tokenizer.lexical,4,0,0,0,1,2,1,8
hankcs_HanLP,com.hankcs.hanlp.tokenizer.pipe,2,1,0,0,0,0,1,4
hankcs_HanLP,com.hankcs.hanlp.utility,24,1,0,0,1,0,1,27
hankcs_HanLP,com.hankcs.demo,1,0,0,1,1,3,1,7
hankcs_HanLP,com.hankcs.hanlp.corpus,3,1,0,0,1,1,1,7
hankcs_HanLP,com.hankcs.hanlp.model.perceptron.corpus,0,0,0,0,0,0,1,1
hansenji_pocketknife,pocketknife,0,0,0,0,0,0,0,0
hansenji_pocketknife,pocketknife.internal,0,0,0,0,0,0,0,0
hansenji_pocketknife,pocketknife.internal.codegen,0,0,0,0,1,0,0,1
hansenji_pocketknife,pocketknife.internal.codegen.binding,0,0,0,0,0,0,0,0
hansenji_pocketknife,pocketknife.internal.codegen.builder,0,0,0,0,0,0,0,0
hansenji_pocketknife,com.example.pocketknife,0,0,0,1,1,0,0,2
harishreedharan_usingflumecode,usingflume.ch03,0,0,0,0,1,0,0,1
harishreedharan_usingflumecode,usingflume.ch05,0,0,0,0,1,0,0,1
harishreedharan_usingflumecode,usingflume.ch06,0,0,0,0,0,0,0,0
harishreedharan_usingflumecode,usingflume.ch07,0,0,0,0,1,0,0,1
hcoles_QuickBuilder,com.example.beans,0,1,0,0,1,0,0,2
hcoles_QuickBuilder,com.example.beans.generics,0,1,0,0,0,0,0,1
hcoles_QuickBuilder,com.example.beans.misuse,0,0,0,0,0,0,0,0
hcoles_QuickBuilder,com.example.beans.primitives,0,0,0,0,1,0,0,1
hcoles_QuickBuilder,com.example.example,1,1,0,0,0,0,0,2
hcoles_QuickBuilder,com.example.immutable,0,0,0,0,1,0,0,1
HdrHistogram_HdrHistogram,bench,0,0,0,0,0,0,0,0
HdrHistogram_HdrHistogram,org.HdrHistogram,0,0,0,1,0,0,0,1
HdrHistogram_HdrHistogram,(default package),0,0,0,0,0,0,0,0
headissue_cache2k,org.cache2k.extra.allTransition,0,0,0,0,0,0,0,0
headissue_cache2k,(default package),0,0,0,0,0,0,0,0
headissue_cache2k,org.cache2k,0,1,0,0,1,6,0,8
headissue_cache2k,org.cache2k.configuration,0,0,0,0,0,5,0,5
headissue_cache2k,org.cache2k.event,0,0,0,0,1,1,0,2
headissue_cache2k,org.cache2k.expiry,0,0,0,0,0,0,0,0
headissue_cache2k,org.cache2k.integration,0,0,0,0,1,1,0,2
headissue_cache2k,org.cache2k.jcache,0,0,0,0,0,0,0,0
headissue_cache2k,org.cache2k.jmx,0,0,0,0,0,0,0,0
headissue_cache2k,org.cache2k.processor,0,0,1,0,0,0,0,1
headissue_cache2k,org.cache2k.spi,0,0,0,0,1,1,0,2
headissue_cache2k,org.cache2k.core,6,0,0,1,0,3,0,10
headissue_cache2k,org.cache2k.core.concurrency,0,0,0,0,1,0,0,1
headissue_cache2k,org.cache2k.core.event,0,0,0,0,0,1,0,1
headissue_cache2k,org.cache2k.core.experimentalApi,0,0,0,0,0,0,0,0
headissue_cache2k,org.cache2k.core.operation,1,1,0,0,1,0,0,3
headissue_cache2k,org.cache2k.core.spi,0,0,0,0,0,0,0,0
headissue_cache2k,org.cache2k.core.storageApi,1,1,0,0,1,0,0,3
headissue_cache2k,org.cache2k.core.util,3,1,0,0,1,1,0,6
headissue_cache2k,org.cache2k.impl.serverSide,0,0,0,0,1,2,0,3
headissue_cache2k,org.cache2k.impl.xmlConfiguration,0,0,0,0,1,2,0,3
headissue_cache2k,org.cache2k.impl.xmlConfiguration.generic,0,0,0,1,0,1,0,2
headissue_cache2k,org.cache2k.jcache.provider.event,0,0,0,0,1,0,0,1
headissue_cache2k,org.cache2k.jcache.provider.generic.storeByValueSimulation,0,0,0,0,1,0,0,1
headissue_cache2k,org.cache2k.jcache.provider,0,0,0,0,1,0,0,1
headissue_cache2k,org.cache2k.jcache.provider.tckGlue,0,0,0,0,0,0,0,0
headissue_cache2k,domain,0,0,0,0,1,0,0,1
headissue_cache2k,manager,0,0,0,0,0,0,0,0
headissue_cache2k,org.jsr107.tck,0,0,0,0,1,0,0,1
headissue_cache2k,org.jsr107.tck.event,0,0,0,0,0,0,0,0
headissue_cache2k,org.jsr107.tck.expiry,0,0,0,0,0,0,0,0
headissue_cache2k,org.jsr107.tck.integration,0,0,0,1,0,0,0,1
headissue_cache2k,org.jsr107.tck.management,0,0,0,0,0,0,0,0
headissue_cache2k,org.jsr107.tck.processor,0,0,0,0,1,0,0,1
headissue_cache2k,org.jsr107.tck.spi,0,0,0,0,0,0,0,0
headissue_cache2k,org.jsr107.tck.support,0,0,0,0,0,0,0,0
headissue_cache2k,org.cache2k.schema,0,0,0,0,0,0,0,0
headissue_cache2k,org.cache2k.extra.spring,0,0,0,0,1,1,0,2
HearthStats_HearthStats.net-Uploader,net.hearthstats.game.imageanalysis,0,0,0,0,1,0,0,1
HearthStats_HearthStats.net-Uploader,net.hearthstats.game.ocr,0,0,0,0,1,0,0,1
HearthStats_HearthStats.net-Uploader,net.hearthstats.ui,0,0,0,0,0,0,0,0
HearthStats_HearthStats.net-Uploader,net.hearthstats.ui.notification,0,0,0,0,0,0,0,0
HearthStats_HearthStats.net-Uploader,net.sourceforge.tess4j,0,0,0,0,1,0,0,1
HearthStats_HearthStats.net-Uploader,net.sourceforge.vietocr,0,0,0,0,0,0,0,0
HearthStats_HearthStats.net-Uploader,net.hearthstats.osx.jna,0,0,0,0,1,0,0,1
HearthStats_HearthStats.net-Uploader,net.hearthstats.osx,0,0,0,0,0,0,0,0
HearthStats_HearthStats.net-Uploader,net.hearthstats.win.jna.extra,0,0,0,0,0,0,0,0
HearthStats_HearthStats.net-Uploader,net.hearthstats.win.jna,0,0,0,0,0,0,0,0
HearthStats_HearthStats.net-Uploader,net.hearthstats.win,0,0,0,0,0,0,0,0
HearthStats_HearthStats.net-Uploader,net.hearthstats.updater.api,0,0,0,0,0,1,0,1
HearthStats_HearthStats.net-Uploader,net.hearthstats.updater.api.model,0,0,0,0,0,1,0,1
HearthStats_HearthStats.net-Uploader,net.hearthstats.updater.application,0,0,0,0,0,0,0,0
HearthStats_HearthStats.net-Uploader,net.hearthstats.updater.exception,0,0,0,0,0,0,0,0
HearthStats_HearthStats.net-Uploader,net.hearthstats.updater,0,0,0,0,0,1,0,1
hekonsek_fuse-pocs,fuse.pocs.camel.amqp,0,0,0,0,0,0,0,0
hekonsek_fuse-pocs,camelpoc,0,0,0,0,1,0,0,1
hekonsek_fuse-pocs,(default package),0,0,0,0,0,0,0,0
hekonsek_fuse-pocs,fuse.pocs.blueprint.beanvalidator,0,0,0,0,0,0,0,0
hekonsek_fuse-pocs,fuse.pocs.blueprint.beanvalidator.event,0,0,0,0,0,0,0,0
hekonsek_fuse-pocs,fuse.pocs.blueprint.eclipselink.adapter,0,0,0,0,0,0,0,0
hekonsek_fuse-pocs,fuse.pocs.blueprint.eclipselink,0,0,0,0,0,0,0,0
hekonsek_fuse-pocs,fuse.poc.blueprint.eclipselink,0,0,0,0,0,0,0,0
hekonsek_fuse-pocs,fuse.pocs.blueprint.eclipselink.bundle1,0,0,0,0,0,0,0,0
hekonsek_fuse-pocs,fuse.pocs.blueprint.eclipselink.bundle2,0,0,0,0,0,0,0,0
hekonsek_fuse-pocs,fuse.pocs.blueprint.eclipselink.composedbundle,0,0,0,0,0,0,0,0
hekonsek_fuse-pocs,fuse.pocs.blueprint.hibernate.raw,0,0,0,0,0,0,0,0
hekonsek_fuse-pocs,fuse.pocs.blueprint.openjpa,0,0,0,0,1,0,0,1
hekonsek_fuse-pocs,fuse.poc.blueprint.openjpa,0,0,0,0,0,0,0,0
hekonsek_fuse-pocs,fuse.pocs.blueprint.openjpa.springdata,0,0,0,0,1,0,0,1
hekonsek_fuse-pocs,fuse.poc.blueprint.openjpa.springdata,0,0,0,0,0,0,0,0
hekonsek_fuse-pocs,fuse.pocs.camel.correlate.response,0,0,0,0,0,0,0,0
hekonsek_fuse-pocs,fuse.pocs.camel.ebcdic,0,0,0,0,0,0,0,0
hekonsek_fuse-pocs,fuse.pocs.camel.xml.normalizer,0,0,0,0,0,0,0,0
hekonsek_fuse-pocs,fuse.pocs.camel.netty.http.params,0,0,0,0,0,0,0,0
hekonsek_fuse-pocs,fuse.pocs.camel.spring.cxf.async,0,0,0,0,0,0,0,0
hekonsek_fuse-pocs,fuse.pocs.camel.spring.properties,0,0,0,0,0,0,0,0
hekonsek_fuse-pocs,fuse.pocs.cxf.soapoverjms,0,0,0,0,0,0,0,0
hekonsek_fuse-pocs,fuse.pocs.fabric,0,0,0,0,0,0,0,0
heroku_heroku-maven-plugin,(default package),0,0,0,0,1,0,0,1
heroku_heroku-maven-plugin,com.heroku.sdk.deploy,0,1,0,0,1,0,0,2
heroku_heroku-maven-plugin,com.heroku.sdk.deploy.endpoints,0,0,0,0,0,0,0,0
heroku_heroku-maven-plugin,com.heroku.sdk.deploy.utils,0,0,0,0,1,0,0,1
heroku_heroku-maven-plugin,com.heroku.sdk.maven,0,0,0,0,1,0,0,1
heroku_heroku-maven-plugin,com.heroku.sdk.maven.executor,0,1,0,0,0,0,0,1
heroku_heroku-maven-plugin,org.apache.maven.plugins.dependency,0,0,0,0,1,0,0,1
heroku_heroku-maven-plugin,org.apache.maven.plugins.dependency.analyze,0,0,0,0,1,0,0,1
heroku_heroku-maven-plugin,org.apache.maven.plugins.dependency.fromConfiguration,3,1,0,0,0,0,0,4
heroku_heroku-maven-plugin,org.apache.maven.plugins.dependency.fromDependencies,0,0,0,0,0,0,0,0
heroku_heroku-maven-plugin,org.apache.maven.plugins.dependency.resolvers,0,0,0,0,1,0,0,1
heroku_heroku-maven-plugin,org.apache.maven.plugins.dependency.tree,0,0,0,0,0,0,0,0
heroku_heroku-maven-plugin,org.apache.maven.plugins.dependency.utils,0,0,0,0,0,0,0,0
heroku_heroku-maven-plugin,org.apache.maven.plugins.dependency.utils.filters,2,0,0,0,0,0,0,2
heroku_heroku-maven-plugin,org.apache.maven.plugins.dependency.utils.markers,2,1,0,0,0,0,0,3
heroku_heroku-maven-plugin,org.apache.maven.plugins.dependency.utils.translators,0,0,0,0,0,0,0,0
heroku_heroku-maven-plugin,org.apache.maven.reporting,0,0,0,0,0,0,0,0
hevs-isi_gdx2d,ch.hevs.gdx2d.hello,0,0,0,0,0,0,0,0
hevs-isi_gdx2d,ch.hevs.gdx2d.components.audio,0,0,0,0,0,0,0,0
hevs-isi_gdx2d,ch.hevs.gdx2d.components.bitmaps,0,0,0,0,0,0,0,0
hevs-isi_gdx2d,ch.hevs.gdx2d.components.colors,0,0,0,0,0,0,0,0
hevs-isi_gdx2d,ch.hevs.gdx2d.components.geometry,0,0,0,0,0,0,0,0
hevs-isi_gdx2d,ch.hevs.gdx2d.components.graphics,0,0,0,0,0,0,0,0
hevs-isi_gdx2d,ch.hevs.gdx2d.components.physics,0,0,0,0,0,0,0,0
hevs-isi_gdx2d,ch.hevs.gdx2d.components.physics.primitives,0,0,0,0,1,0,0,1
hevs-isi_gdx2d,ch.hevs.gdx2d.components.physics.utils,0,0,0,0,0,0,0,0
hevs-isi_gdx2d,ch.hevs.gdx2d.components.screen_management,0,0,0,0,0,0,0,0
hevs-isi_gdx2d,ch.hevs.gdx2d.components.screen_management.transitions,0,0,0,0,0,0,0,0
hevs-isi_gdx2d,ch.hevs.gdx2d.lib,0,0,0,0,0,0,0,0
hevs-isi_gdx2d,ch.hevs.gdx2d.lib.interfaces,0,0,0,0,1,0,0,1
hevs-isi_gdx2d,ch.hevs.gdx2d.lib.physics,0,0,0,0,0,0,0,0
hevs-isi_gdx2d,ch.hevs.gdx2d.lib.renderers,0,0,0,0,0,0,0,0
hevs-isi_gdx2d,ch.hevs.gdx2d.lib.utils.catmull,0,0,0,0,0,0,0,0
hevs-isi_gdx2d,ch.hevs.gdx2d.lib.utils,0,1,0,0,0,0,0,1
hevs-isi_gdx2d,ch.hevs.gdx2d.desktop,0,0,0,0,1,0,0,1
hevs-isi_gdx2d,ch.hevs.gdx2d.desktop.physics,0,0,0,0,0,0,0,0
hgoebl_DavidWebb,com.goebl.david,0,0,0,0,0,0,0,0
highsource_jaxb2-basics,org.jvnet.jaxb2_commons.xjc,0,0,0,0,0,0,0,0
highsource_jaxb2-basics,org.jvnet.jaxb2_commons.plugin.autoinheritance,0,0,0,0,0,0,0,0
highsource_jaxb2-basics,org.jvnet.jaxb2_commons.plugin.codegenerator,0,0,0,0,1,0,0,1
highsource_jaxb2-basics,org.jvnet.jaxb2_commons.plugin.copyable,0,0,0,0,0,0,0,0
highsource_jaxb2-basics,org.jvnet.jaxb2_commons.plugin.customizations,0,0,0,0,0,0,0,0
highsource_jaxb2-basics,org.jvnet.jaxb2_commons.plugin,0,0,0,0,1,0,0,1
highsource_jaxb2-basics,org.jvnet.jaxb2_commons.plugin.elementwrapper,0,0,0,0,0,0,0,0
highsource_jaxb2-basics,org.jvnet.jaxb2_commons.plugin.enumvalue,0,0,0,0,0,0,0,0
highsource_jaxb2-basics,org.jvnet.jaxb2_commons.plugin.equals,0,0,0,0,0,0,0,0
highsource_jaxb2-basics,org.jvnet.jaxb2_commons.plugin.fixjaxb1058,0,0,0,0,0,0,0,0
highsource_jaxb2-basics,org.jvnet.jaxb2_commons.plugin.hashcode,0,0,0,0,0,0,0,0
highsource_jaxb2-basics,org.jvnet.jaxb2_commons.plugin.inheritance,0,0,0,0,1,0,0,1
highsource_jaxb2-basics,org.jvnet.jaxb2_commons.plugin.inheritance.util,0,0,0,0,0,0,0,0
highsource_jaxb2-basics,org.jvnet.jaxb2_commons.plugin.jaxbindex,0,0,0,0,0,0,0,0
highsource_jaxb2-basics,org.jvnet.jaxb2_commons.plugin.mergeable,0,0,0,0,0,0,0,0
highsource_jaxb2-basics,org.jvnet.jaxb2_commons.plugin.model,0,0,0,0,0,0,0,0
highsource_jaxb2-basics,org.jvnet.jaxb2_commons.plugin.setters,0,0,0,0,0,0,0,0
highsource_jaxb2-basics,org.jvnet.jaxb2_commons.plugin.simpleequals,0,0,0,0,0,0,0,0
highsource_jaxb2-basics,org.jvnet.jaxb2_commons.plugin.simplehashcode,0,0,0,0,0,0,0,0
highsource_jaxb2-basics,org.jvnet.jaxb2_commons.plugin.simpletostring,0,0,0,0,0,0,0,0
highsource_jaxb2-basics,org.jvnet.jaxb2_commons.plugin.simplify,0,0,0,0,0,0,0,0
highsource_jaxb2-basics,org.jvnet.jaxb2_commons.plugin.tostring,0,0,0,0,0,0,0,0
highsource_jaxb2-basics,org.jvnet.jaxb2_commons.plugin.util,0,0,0,0,0,0,0,0
highsource_jaxb2-basics,org.jvnet.jaxb2_commons.plugin.wildcard,0,0,0,0,0,0,0,0
highsource_jaxb2-basics,org.jvnet.jaxb2_commons.i18n,0,0,0,0,0,0,0,0
highsource_jaxb2-basics,org.jvnet.jaxb2_commons.lang,0,0,0,1,1,0,0,2
highsource_jaxb2-basics,org.jvnet.jaxb2_commons.locator,0,0,0,0,0,0,0,0
highsource_jaxb2-basics,org.jvnet.jaxb2_commons.locator.util,0,0,0,0,0,0,0,0
highsource_jaxb2-basics,org.jvnet.jaxb2_commons.xml.bind,0,0,0,0,0,0,0,0
highsource_jaxb2-basics,org.jvnet.jaxb2_commons.xml.bind.annotation.adapters,0,0,0,0,0,0,0,0
highsource_jaxb2-basics,org.jvnet.jaxb2_commons.xml.bind.model.concrete,0,0,0,0,1,0,0,1
highsource_jaxb2-basics,org.jvnet.jaxb2_commons.xml.bind.model.concrete.origin,0,0,0,0,1,0,0,1
highsource_jaxb2-basics,org.jvnet.jaxb2_commons.xml.bind.model,0,0,0,1,1,0,0,2
highsource_jaxb2-basics,org.jvnet.jaxb2_commons.xml.bind.model.origin,0,0,0,0,1,0,0,1
highsource_jaxb2-basics,org.jvnet.jaxb2_commons.xml.bind.model.util,0,0,0,0,1,0,0,1
highsource_jaxb2-basics,org.jvnet.jaxb2_commons.xml.namespace.util,0,0,0,0,0,0,0,0
highsource_jaxb2-basics,org.jvnet.jaxb2_commons.xmlschema,0,0,0,0,0,0,0,0
highsource_jaxb2-basics,org.hisrc.xml.xsom,0,0,0,0,0,0,0,0
highsource_jaxb2-basics,org.jvnet.jaxb2_commons.codemodel,0,0,0,0,1,0,0,1
highsource_jaxb2-basics,org.jvnet.jaxb2_commons.plugin.spring,0,0,0,0,0,0,0,0
highsource_jaxb2-basics,org.jvnet.jaxb2_commons.reflection.util,0,0,0,0,0,0,0,0
highsource_jaxb2-basics,org.jvnet.jaxb2_commons.strategy,0,0,0,0,0,0,0,0
highsource_jaxb2-basics,org.jvnet.jaxb2_commons.strategy.impl,0,0,0,0,0,0,0,0
highsource_jaxb2-basics,org.jvnet.jaxb2_commons.util,0,0,0,0,1,0,0,1
highsource_jaxb2-basics,org.jvnet.jaxb2_commons.xjc.generator.artificial,0,0,0,0,0,0,0,0
highsource_jaxb2-basics,org.jvnet.jaxb2_commons.xjc.generator.concrete,0,0,0,0,1,0,0,1
highsource_jaxb2-basics,org.jvnet.jaxb2_commons.xjc.generator,0,0,0,0,1,0,0,1
highsource_jaxb2-basics,org.jvnet.jaxb2_commons.xjc.model.concrete.origin,0,0,0,0,1,0,0,1
highsource_jaxb2-basics,org.jvnet.jaxb2_commons.xjc.model.concrete,0,0,0,0,0,0,0,0
highsource_jaxb2-basics,org.jvnet.jaxb2_commons.xjc.outline.artificial,0,0,0,0,1,0,0,1
highsource_jaxb2-basics,org.jvnet.jaxb2_commons.xjc.outline.concrete,0,0,0,0,1,0,0,1
highsource_jaxb2-basics,org.jvnet.jaxb2_commons.xjc.outline,0,0,0,0,1,0,0,1
highsource_jsonix-schema-compiler,org.hisrc.jsonix.analysis,0,0,0,0,1,0,0,1
highsource_jsonix-schema-compiler,org.hisrc.jsonix.args4j,0,0,0,0,0,0,0,0
highsource_jsonix-schema-compiler,org.hisrc.jsonix.compilation.jsonschema,0,0,0,0,1,0,0,1
highsource_jsonix-schema-compiler,org.hisrc.jsonix.compilation.jsonschema.typeinfo.builtin,0,0,0,0,1,0,0,1
highsource_jsonix-schema-compiler,org.hisrc.jsonix.compilation.jsonschema.typeinfo,0,0,0,0,1,0,0,1
highsource_jsonix-schema-compiler,org.hisrc.jsonix.compilation.mapping,0,0,0,0,1,0,0,1
highsource_jsonix-schema-compiler,org.hisrc.jsonix.compilation.mapping.typeinfo.builtin,0,0,0,0,1,0,0,1
highsource_jsonix-schema-compiler,org.hisrc.jsonix.compilation.mapping.typeinfo,0,0,0,0,1,0,0,1
highsource_jsonix-schema-compiler,org.hisrc.jsonix.configuration,0,0,0,0,0,0,0,0
highsource_jsonix-schema-compiler,org.hisrc.jsonix.configuration.exception,0,0,0,0,0,0,0,0
highsource_jsonix-schema-compiler,org.hisrc.jsonix.context,0,0,0,0,0,0,0,0
highsource_jsonix-schema-compiler,org.hisrc.jsonix.definition,0,0,0,0,1,0,0,1
highsource_jsonix-schema-compiler,org.hisrc.jsonix.execution,0,0,0,0,0,0,0,0
highsource_jsonix-schema-compiler,org.hisrc.jsonix.json.util,0,0,0,0,0,0,0,0
highsource_jsonix-schema-compiler,org.hisrc.jsonix,0,0,0,0,0,0,0,0
highsource_jsonix-schema-compiler,org.hisrc.jsonix.jsonschema,0,0,0,0,0,0,0,0
highsource_jsonix-schema-compiler,org.hisrc.jsonix.naming,0,0,0,0,0,0,0,0
highsource_jsonix-schema-compiler,org.hisrc.jsonix.settings,0,0,0,0,0,0,0,0
highsource_jsonix-schema-compiler,org.hisrc.jsonix.slf4j,0,0,0,0,0,0,0,0
highsource_jsonix-schema-compiler,org.hisrc.jsonix.xjc.plugin,0,0,0,0,0,0,0,0
highsource_jsonix-schema-compiler,org.hisrc.jsonix.xml.bind.model,0,0,0,0,0,0,0,0
highsource_jsonix-schema-compiler,org.hisrc.jsonix.xml.sax,0,0,0,0,0,0,0,0
highsource_jsonix-schema-compiler,org.hisrc.jsonix.xml.xsom,0,0,0,0,0,0,0,0
highsource_jsonix-schema-compiler,org.hisrc.xml.bind.model.util,0,0,0,0,0,0,0,0
hmsonline_storm-cassandra-cql,com.hmsonline.trident.cql,0,0,0,0,1,0,0,1
hmsonline_storm-cassandra-cql,com.hmsonline.trident.cql.incremental,0,0,0,0,1,0,0,1
hmsonline_storm-cassandra-cql,com.hmsonline.trident.cql.mappers,0,0,0,0,0,0,0,0
hmsonline_storm-cassandra-cql,com.hmsonline.trident.cql.example.sales,0,0,0,0,0,0,0,0
hmsonline_storm-cassandra-cql,com.hmsonline.trident.cql.example.simpleupdate,0,0,0,0,0,0,0,0
hmsonline_storm-cassandra-cql,com.hmsonline.trident.cql.example.wordcount,0,0,0,0,0,0,0,0
holgerbrandl_r4intellij,com.r4intellij.parsing,0,0,0,0,0,0,1,1
holgerbrandl_r4intellij,com.r4intellij.psi.api,0,0,0,1,0,0,1,2
holgerbrandl_r4intellij,com.r4intellij.psi,5,1,0,1,1,0,1,9
holgerbrandl_r4intellij,com.r4intellij.actions,0,0,0,0,1,0,1,2
holgerbrandl_r4intellij,com.r4intellij.apiplayground,0,0,0,0,0,0,1,1
holgerbrandl_r4intellij,com.r4intellij.console,0,0,0,0,0,0,1,1
holgerbrandl_r4intellij,com.r4intellij.debugger.data,0,0,0,0,1,0,1,2
holgerbrandl_r4intellij,com.r4intellij.debugger.evaluator,8,0,0,0,0,0,1,9
holgerbrandl_r4intellij,com.r4intellij.debugger.exception,0,0,0,0,0,0,1,1
holgerbrandl_r4intellij,com.r4intellij.debugger.executor,10,1,0,0,0,0,1,12
holgerbrandl_r4intellij,com.r4intellij.debugger.frame,5,0,0,0,0,0,1,6
holgerbrandl_r4intellij,com.r4intellij.debugger.function,4,1,0,1,0,0,1,7
holgerbrandl_r4intellij,com.r4intellij.debugger,13,1,0,1,0,0,1,16
holgerbrandl_r4intellij,com.r4intellij.documentation,3,1,0,0,0,0,1,5
holgerbrandl_r4intellij,com.r4intellij.editor.formatting,0,0,0,0,1,0,1,2
holgerbrandl_r4intellij,com.r4intellij.editor,0,0,0,0,1,0,1,2
holgerbrandl_r4intellij,com.r4intellij.highlighting,0,0,0,0,1,0,1,2
holgerbrandl_r4intellij,com.r4intellij.inspections,0,0,0,0,1,0,1,2
holgerbrandl_r4intellij,com.r4intellij.intentions,0,0,0,0,1,0,1,2
holgerbrandl_r4intellij,com.r4intellij.interpreter,2,0,0,0,1,0,1,4
holgerbrandl_r4intellij,com.r4intellij.lexer,0,0,0,0,0,0,1,1
holgerbrandl_r4intellij,com.r4intellij.packages,9,1,0,0,1,0,1,12
holgerbrandl_r4intellij,com.r4intellij.packages.remote,0,0,0,0,0,0,1,1
holgerbrandl_r4intellij,com.r4intellij.packages.remote.ui,0,0,0,0,0,0,1,1
holgerbrandl_r4intellij,com.r4intellij.psi.references.externalres,0,0,0,0,0,0,1,1
holgerbrandl_r4intellij,com.r4intellij.psi.references,6,1,0,0,1,0,1,9
holgerbrandl_r4intellij,com.r4intellij.psi.stubs,3,0,0,0,0,0,1,4
holgerbrandl_r4intellij,com.r4intellij,19,1,0,0,1,0,1,22
holgerbrandl_r4intellij,com.r4intellij.refactoring,0,0,0,0,1,0,1,2
holgerbrandl_r4intellij,com.r4intellij.run.configuration,3,1,0,0,0,0,1,5
holgerbrandl_r4intellij,com.r4intellij.run.debug,4,0,0,0,0,0,1,5
holgerbrandl_r4intellij,com.r4intellij.run.debug.resolve,0,0,0,0,0,0,1,1
holgerbrandl_r4intellij,com.r4intellij.run.debug.stack,0,0,0,0,0,0,1,1
holgerbrandl_r4intellij,com.r4intellij.run.graphics,0,0,0,0,0,0,1,1
holgerbrandl_r4intellij,com.r4intellij.run,2,0,0,0,1,0,1,4
holgerbrandl_r4intellij,com.r4intellij.run.run,0,0,0,0,1,0,1,2
holgerbrandl_r4intellij,com.r4intellij.settings,3,1,0,0,0,0,1,5
holgerbrandl_r4intellij,com.r4intellij.typing,9,0,0,0,1,0,1,11
holgerbrandl_r4intellij,com.r4intellij.typing.types,4,1,0,0,0,0,1,6
holgerbrandl_r4intellij,com.r4intellij.debugger.mock,6,1,0,0,1,0,1,9
holgerbrandl_r4intellij,com.r4intellij.misc,0,0,0,0,0,0,1,1
holgerbrandl_r4intellij,com.r4intellij.parser,0,0,0,0,0,0,1,1
holgerbrandl_r4intellij,com.r4intellij.rename,0,0,0,0,0,0,1,1
holgerbrandl_r4intellij,com.r4intellij.run.debug.mock,0,0,0,0,1,0,1,2
holgerbrandl_themoviedbapi,info.movito.themoviedbapi,2,0,0,1,0,4,0,7
holgerbrandl_themoviedbapi,info.movito.themoviedbapi.model,1,1,0,1,1,1,0,5
holgerbrandl_themoviedbapi,info.movito.themoviedbapi.model.changes,0,0,0,0,0,0,0,0
holgerbrandl_themoviedbapi,info.movito.themoviedbapi.model.config,0,0,0,0,1,1,0,2
holgerbrandl_themoviedbapi,info.movito.themoviedbapi.model.core,0,0,0,0,1,4,0,5
holgerbrandl_themoviedbapi,info.movito.themoviedbapi.model.keywords,0,0,0,0,0,0,0,0
holgerbrandl_themoviedbapi,info.movito.themoviedbapi.model.people,0,0,0,0,1,1,0,2
holgerbrandl_themoviedbapi,info.movito.themoviedbapi.model.tv,0,0,0,0,0,1,0,1
holgerbrandl_themoviedbapi,info.movito.themoviedbapi.tools,1,1,0,0,1,0,0,3
HolmesNL_kafka-spout,nl.minvenj.nfi.storm.kafka.fail,0,0,0,0,1,0,0,1
HolmesNL_kafka-spout,nl.minvenj.nfi.storm.kafka,0,0,0,0,0,0,0,0
HolmesNL_kafka-spout,nl.minvenj.nfi.storm.kafka.util,0,0,0,0,1,0,0,1
holodeck-b2b_Holodeck-B2B,org.holodeckb2b.common.axis2,0,0,0,0,1,0,1,2
holodeck-b2b_Holodeck-B2B,org.holodeckb2b.common.config,0,0,0,0,0,0,1,1
holodeck-b2b_Holodeck-B2B,org.holodeckb2b.common.events,0,0,0,0,1,0,1,2
holodeck-b2b_Holodeck-B2B,org.holodeckb2b.common.exceptions,0,0,0,0,0,0,1,1
holodeck-b2b_Holodeck-B2B,org.holodeckb2b.common.handler,0,0,0,0,1,0,1,2
holodeck-b2b_Holodeck-B2B,org.holodeckb2b.common.messagemodel,1,0,0,0,0,2,1,4
holodeck-b2b_Holodeck-B2B,org.holodeckb2b.common.messagemodel.util,0,0,0,0,1,1,1,3
holodeck-b2b_Holodeck-B2B,org.holodeckb2b.common.mmd.xml,2,0,0,0,0,1,1,4
holodeck-b2b_Holodeck-B2B,org.holodeckb2b.common.util,3,1,0,0,0,1,1,6
holodeck-b2b_Holodeck-B2B,org.holodeckb2b.common.workerpool,0,0,0,0,1,1,1,3
holodeck-b2b_Holodeck-B2B,org.holodeckb2b.common.workerpool.xml,0,0,0,0,0,1,1,2
holodeck-b2b_Holodeck-B2B,org.holodeckb2b.common.workers,0,0,0,0,1,0,1,2
holodeck-b2b_Holodeck-B2B,org.holodeckb2b.common.constants,0,0,0,0,0,0,1,1
holodeck-b2b_Holodeck-B2B,org.holodeckb2b.as4.compression,0,0,0,0,1,0,1,2
holodeck-b2b_Holodeck-B2B,org.holodeckb2b.as4.handlers.inflow,0,0,0,0,0,0,1,1
holodeck-b2b_Holodeck-B2B,org.holodeckb2b.as4.receptionawareness,0,0,0,0,1,0,1,2
holodeck-b2b_Holodeck-B2B,org.holodeckb2b.core.validation,0,0,0,0,0,0,1,1
holodeck-b2b_Holodeck-B2B,org.holodeckb2b.core.validation.header,1,0,0,0,1,0,1,3
holodeck-b2b_Holodeck-B2B,org.holodeckb2b.deliverymethod.file,0,0,0,0,0,0,1,1
holodeck-b2b_Holodeck-B2B,org.holodeckb2b.ebms3.axis2,0,0,0,0,0,0,1,1
holodeck-b2b_Holodeck-B2B,org.holodeckb2b.ebms3.errors,0,0,0,0,1,0,1,2
holodeck-b2b_Holodeck-B2B,org.holodeckb2b.ebms3.handlers.inflow,0,0,0,1,1,0,1,3
holodeck-b2b_Holodeck-B2B,org.holodeckb2b.ebms3.handlers.outflow,0,0,0,0,1,0,1,2
holodeck-b2b_Holodeck-B2B,org.holodeckb2b.ebms3.packaging,0,0,0,1,0,0,1,2
holodeck-b2b_Holodeck-B2B,org.holodeckb2b.ebms3.pulling,0,0,0,0,1,0,1,2
holodeck-b2b_Holodeck-B2B,org.holodeckb2b.ebms3.submit.core,0,0,0,0,0,3,1,4
holodeck-b2b_Holodeck-B2B,org.holodeckb2b.ebms3.util,0,0,0,0,0,0,1,1
holodeck-b2b_Holodeck-B2B,org.holodeckb2b.ebms3.validation.header,1,1,0,0,1,1,1,5
holodeck-b2b_Holodeck-B2B,org.holodeckb2b.ebms3.workers,0,0,0,0,0,0,1,1
holodeck-b2b_Holodeck-B2B,org.holodeckb2b.events,0,0,0,0,0,0,1,1
holodeck-b2b_Holodeck-B2B,org.holodeckb2b.events.security,0,0,0,0,1,0,1,2
holodeck-b2b_Holodeck-B2B,org.holodeckb2b.module,0,1,0,0,0,0,1,2
holodeck-b2b_Holodeck-B2B,org.holodeckb2b.multihop,0,0,0,0,0,0,1,1
holodeck-b2b_Holodeck-B2B,org.holodeckb2b.persistency.dao,0,0,0,0,0,0,1,1
holodeck-b2b_Holodeck-B2B,org.holodeckb2b.pmode,0,0,0,0,0,4,1,5
holodeck-b2b_Holodeck-B2B,org.holodeckb2b.pmode.xml,0,1,0,1,1,0,1,4
holodeck-b2b_Holodeck-B2B,org.holodeckb2b.security.util,3,1,0,0,1,0,1,6
holodeck-b2b_Holodeck-B2B,org.holodeckb2b.customvalidation,0,0,0,0,0,0,1,1
holodeck-b2b_Holodeck-B2B,org.holodeckb2b.customvalidation.helpers,0,0,0,0,0,0,1,1
holodeck-b2b_Holodeck-B2B,org.holodeckb2b.pmode.xml.events,0,0,0,0,0,0,1,1
holodeck-b2b_Holodeck-B2B,org.holodeckb2b.interfaces.as4.pmode,0,0,0,0,0,0,1,1
holodeck-b2b_Holodeck-B2B,org.holodeckb2b.interfaces.config,0,0,0,0,0,1,1,2
holodeck-b2b_Holodeck-B2B,org.holodeckb2b.interfaces.core,0,0,0,0,0,4,1,5
holodeck-b2b_Holodeck-B2B,org.holodeckb2b.interfaces.customvalidation,0,0,0,0,1,0,1,2
holodeck-b2b_Holodeck-B2B,org.holodeckb2b.interfaces.delivery,0,0,0,0,0,0,1,1
holodeck-b2b_Holodeck-B2B,org.holodeckb2b.interfaces.eventprocessing,0,0,0,0,1,1,1,3
holodeck-b2b_Holodeck-B2B,org.holodeckb2b.interfaces.events,0,0,0,0,1,0,1,2
holodeck-b2b_Holodeck-B2B,org.holodeckb2b.interfaces.events.security,0,0,0,0,1,0,1,2
holodeck-b2b_Holodeck-B2B,org.holodeckb2b.interfaces.general,0,0,0,0,1,4,1,6
holodeck-b2b_Holodeck-B2B,org.holodeckb2b.interfaces.messagemodel,0,0,0,0,1,4,1,6
holodeck-b2b_Holodeck-B2B,org.holodeckb2b.interfaces.persistency.dao,0,0,0,0,0,0,1,1
holodeck-b2b_Holodeck-B2B,org.holodeckb2b.interfaces.persistency.entities,0,0,1,0,1,0,1,3
holodeck-b2b_Holodeck-B2B,org.holodeckb2b.interfaces.persistency,0,0,0,0,0,0,1,1
holodeck-b2b_Holodeck-B2B,org.holodeckb2b.interfaces.pmode,0,0,0,0,1,5,1,7
holodeck-b2b_Holodeck-B2B,org.holodeckb2b.interfaces.pmode.validation,0,0,0,0,0,1,1,2
holodeck-b2b_Holodeck-B2B,org.holodeckb2b.interfaces.processingmodel,0,0,0,0,0,0,1,1
holodeck-b2b_Holodeck-B2B,org.holodeckb2b.interfaces.security,0,0,0,0,1,2,1,4
holodeck-b2b_Holodeck-B2B,org.holodeckb2b.interfaces.submit,0,0,0,0,0,0,1,1
holodeck-b2b_Holodeck-B2B,org.holodeckb2b.interfaces.workerpool,0,0,0,0,0,1,1,2
holodeck-b2b_Holodeck-B2B,org.holodeckb2b.persistency,0,1,0,0,0,0,1,2
holodeck-b2b_Holodeck-B2B,org.holodeckb2b.persistency.entities,0,0,0,0,1,0,1,2
holodeck-b2b_Holodeck-B2B,org.holodeckb2b.persistency.jpa,1,0,0,0,1,0,1,3
holodeck-b2b_Holodeck-B2B,org.holodeckb2b.persistency.managers,0,0,0,0,1,0,1,2
holodeck-b2b_Holodeck-B2B,org.holodeckb2b.persistency.util,0,1,0,0,0,0,1,2
holodeck-b2b_Holodeck-B2B,org.holodeckb2b.security,2,1,0,0,1,0,1,5
holodeck-b2b_Holodeck-B2B,org.holodeckb2b.security.callbackhandlers,0,0,0,0,0,0,1,1
holodeck-b2b_Holodeck-B2B,org.holodeckb2b.security.results,2,0,0,0,1,0,1,4
holodeck-b2b_Holodeck-B2B,org.holodeckb2b.security.config,0,0,0,0,0,0,1,1
HotswapProjects_HotswapAgent,org.hotswap.agent.distribution.markdown,1,1,0,0,0,0,0,2
HotswapProjects_HotswapAgent,org.hotswap.agent.distribution,1,0,0,0,0,0,0,1
HotswapProjects_HotswapAgent,org.hotswap.agent.annotation.handler,5,1,0,0,0,0,0,6
HotswapProjects_HotswapAgent,org.hotswap.agent.command,4,1,0,0,0,3,0,8
HotswapProjects_HotswapAgent,org.hotswap.agent.command.impl,1,0,0,0,0,0,0,1
HotswapProjects_HotswapAgent,org.hotswap.agent.config,12,1,0,0,1,1,0,15
HotswapProjects_HotswapAgent,org.hotswap.agent,3,0,0,0,0,0,0,3
HotswapProjects_HotswapAgent,org.hotswap.agent.javassist,14,1,0,1,0,30,0,46
HotswapProjects_HotswapAgent,org.hotswap.agent.javassist.bytecode,12,1,0,1,0,13,0,27
HotswapProjects_HotswapAgent,org.hotswap.agent.javassist.bytecode.analysis,3,0,0,0,0,1,0,4
HotswapProjects_HotswapAgent,org.hotswap.agent.javassist.bytecode.annotation,6,0,0,0,0,2,0,8
HotswapProjects_HotswapAgent,org.hotswap.agent.javassist.bytecode.stackmap,2,0,0,0,0,0,0,2
HotswapProjects_HotswapAgent,org.hotswap.agent.javassist.compiler,4,0,0,0,0,7,0,11
HotswapProjects_HotswapAgent,org.hotswap.agent.javassist.compiler.ast,1,1,0,0,0,4,0,6
HotswapProjects_HotswapAgent,org.hotswap.agent.javassist.convert,4,0,0,0,0,1,0,5
HotswapProjects_HotswapAgent,org.hotswap.agent.javassist.expr,0,0,0,0,0,5,0,5
HotswapProjects_HotswapAgent,org.hotswap.agent.javassist.runtime,0,0,0,0,0,0,0,0
HotswapProjects_HotswapAgent,org.hotswap.agent.javassist.scopedpool,0,0,0,0,1,0,0,1
HotswapProjects_HotswapAgent,org.hotswap.agent.javassist.tools,0,0,0,0,0,0,0,0
HotswapProjects_HotswapAgent,org.hotswap.agent.javassist.tools.reflect,0,0,0,0,0,0,0,0
HotswapProjects_HotswapAgent,org.hotswap.agent.javassist.tools.rmi,0,0,0,0,0,0,0,0
HotswapProjects_HotswapAgent,org.hotswap.agent.javassist.tools.web,0,0,0,0,0,0,0,0
HotswapProjects_HotswapAgent,org.hotswap.agent.javassist.util,0,0,0,0,0,0,0,0
HotswapProjects_HotswapAgent,org.hotswap.agent.javassist.util.proxy,3,0,0,0,0,0,0,3
HotswapProjects_HotswapAgent,org.hotswap.agent.logging,0,0,0,0,0,3,0,3
HotswapProjects_HotswapAgent,org.hotswap.agent.plugin.hotswapper,0,0,0,0,0,0,0,0
HotswapProjects_HotswapAgent,org.hotswap.agent.plugin.jdk,0,0,0,0,1,0,0,1
HotswapProjects_HotswapAgent,org.hotswap.agent.plugin.jvm,2,0,0,0,0,1,0,3
HotswapProjects_HotswapAgent,org.hotswap.agent.plugin.watchResources,0,0,0,0,0,0,0,0
HotswapProjects_HotswapAgent,org.hotswap.agent.util,12,1,0,0,1,14,0,28
HotswapProjects_HotswapAgent,org.hotswap.agent.util.classloader,4,1,0,0,1,1,0,7
HotswapProjects_HotswapAgent,org.hotswap.agent.util.scanner,0,0,0,0,0,0,0,0
HotswapProjects_HotswapAgent,org.hotswap.agent.util.signature,0,1,0,0,0,0,0,1
HotswapProjects_HotswapAgent,org.hotswap.agent.util.spring.collections,0,0,0,0,0,0,0,0
HotswapProjects_HotswapAgent,org.hotswap.agent.util.spring.io.loader,0,0,0,0,0,0,0,0
HotswapProjects_HotswapAgent,org.hotswap.agent.util.spring.io.resource,0,0,0,0,0,2,0,2
HotswapProjects_HotswapAgent,org.hotswap.agent.util.spring.path,3,0,0,0,0,1,0,4
HotswapProjects_HotswapAgent,org.hotswap.agent.util.spring.util,0,0,0,0,0,0,0,0
HotswapProjects_HotswapAgent,org.hotswap.agent.versions,3,1,0,0,0,1,0,5
HotswapProjects_HotswapAgent,org.hotswap.agent.versions.matcher,1,0,0,0,1,0,0,2
HotswapProjects_HotswapAgent,org.hotswap.agent.watch.nio,0,0,0,0,1,0,0,1
HotswapProjects_HotswapAgent,org.hotswap.agent.watch,0,0,0,0,0,4,0,4
HotswapProjects_HotswapAgent,org.hotswap.agent.plugin.jvm.anonymous,0,0,0,0,1,0,0,1
HotswapProjects_HotswapAgent,org.hotswap.agent.plugin.jvm.classinit,0,0,0,0,0,0,0,0
HotswapProjects_HotswapAgent,org.hotswap.agent.plugin.cdi,0,1,0,0,0,0,0,1
HotswapProjects_HotswapAgent,org.hotswap.agent.plugin.cxf.jaxrs,0,0,0,0,1,1,0,2
HotswapProjects_HotswapAgent,org.hotswap.agent.plugin.deltaspike.command,1,1,0,0,0,0,0,2
HotswapProjects_HotswapAgent,org.hotswap.agent.plugin.deltaspike,1,0,0,0,1,0,0,2
HotswapProjects_HotswapAgent,org.hotswap.agent.plugin.deltaspike.jsf,0,0,0,0,0,0,0,0
HotswapProjects_HotswapAgent,org.hotswap.agent.plugin.deltaspike.transformer,0,0,0,0,1,2,0,3
HotswapProjects_HotswapAgent,org.hotswap.agent.plugin.elresolver,0,0,0,0,0,1,0,1
HotswapProjects_HotswapAgent,org.hotswap.agent.plugin.freemarker,0,0,0,0,0,0,0,0
HotswapProjects_HotswapAgent,org.hotswap.agent.plugin.glassfish,0,0,0,0,0,0,0,0
HotswapProjects_HotswapAgent,org.hotswap.agent.plugin.hibernate,0,0,0,0,1,1,0,2
HotswapProjects_HotswapAgent,org.hotswap.agent.plugin.hibernate.proxy,0,0,0,0,0,0,0,0
HotswapProjects_HotswapAgent,org.hotswap.agent.plugin.hibernate3.jpa,0,0,0,0,0,1,0,1
HotswapProjects_HotswapAgent,org.hotswap.agent.plugin.hibernate3.jpa.proxy,0,0,0,0,0,0,0,0
HotswapProjects_HotswapAgent,org.hotswap.agent.plugin.hibernate3.session,0,0,0,0,0,1,0,1
HotswapProjects_HotswapAgent,org.hotswap.agent.plugin.hibernate3.session.proxy,0,1,0,0,0,0,0,1
HotswapProjects_HotswapAgent,org.hotswap.agent.plugin.hibernate3.session.util,0,0,0,0,0,0,0,0
HotswapProjects_HotswapAgent,org.hotswap.agent.plugin.hibernate3.en,0,0,0,0,0,0,0,0
HotswapProjects_HotswapAgent,org.hotswap.agent.plugin.hibernate3,0,0,0,0,0,0,0,0
HotswapProjects_HotswapAgent,org.hotswap.agent.plugin.hibernate3.proxy,0,0,0,0,0,0,0,0
HotswapProjects_HotswapAgent,org.hotswap.agent.plugin.jbossmodules,0,0,0,0,0,0,0,0
HotswapProjects_HotswapAgent,org.hotswap.agent.plugin.jersey1,0,0,0,0,0,0,0,0
HotswapProjects_HotswapAgent,org.hotswap.agent.plugin.jersey2,0,0,0,0,0,0,0,0
HotswapProjects_HotswapAgent,org.hotswap.agent.plugin.jetty,0,0,0,0,0,1,0,1
HotswapProjects_HotswapAgent,org.hotswap.agent.plugin.log4j2,0,0,0,0,0,0,0,0
HotswapProjects_HotswapAgent,org.hotswap.agent.plugin.logback,0,0,0,0,0,0,0,0
HotswapProjects_HotswapAgent,org.hotswap.agent.plugin.mojarra,0,0,0,0,0,1,0,1
HotswapProjects_HotswapAgent,org.hotswap.agent.plugin.mybatis,0,0,0,0,1,0,0,1
HotswapProjects_HotswapAgent,org.hotswap.agent.plugin.mybatis.proxy,0,0,0,0,0,0,0,0
HotswapProjects_HotswapAgent,org.hotswap.agent.plugin.mybatis.transformers,0,0,0,0,0,1,0,1
HotswapProjects_HotswapAgent,org.hotswap.agent.plugin.myfaces,0,0,0,0,0,0,0,0
HotswapProjects_HotswapAgent,org.hotswap.agent.plugin.omnifaces,0,0,0,0,0,0,0,0
HotswapProjects_HotswapAgent,org.hotswap.agent.plugin.osgiequinox,0,0,0,0,0,1,0,1
HotswapProjects_HotswapAgent,org.hotswap.agent.plugin.owb,1,0,0,0,1,1,0,3
HotswapProjects_HotswapAgent,org.hotswap.agent.plugin.owb.beans,0,0,0,0,0,0,0,0
HotswapProjects_HotswapAgent,org.hotswap.agent.plugin.owb.command,1,1,0,0,0,0,0,2
HotswapProjects_HotswapAgent,org.hotswap.agent.plugin.owb.transformer,0,0,0,0,0,0,0,0
HotswapProjects_HotswapAgent,org.hotswap.agent.plugin.proxy,1,0,0,0,1,0,0,2
HotswapProjects_HotswapAgent,org.hotswap.agent.plugin.proxy.hscglib,0,0,0,0,0,1,0,1
HotswapProjects_HotswapAgent,org.hotswap.agent.plugin.proxy.java,1,1,0,0,1,0,0,3
HotswapProjects_HotswapAgent,org.hotswap.agent.plugin.resteasy,0,0,0,0,0,2,0,2
HotswapProjects_HotswapAgent,org.hotswap.agent.plugin.spring.getbean,1,1,0,0,1,0,0,3
HotswapProjects_HotswapAgent,org.hotswap.agent.plugin.spring,2,0,0,0,1,1,0,4
HotswapProjects_HotswapAgent,org.hotswap.agent.plugin.spring.scanner,2,1,0,0,1,0,0,4
HotswapProjects_HotswapAgent,org.hotswap.agent.plugin.spring.signature,0,0,0,0,0,0,0,0
HotswapProjects_HotswapAgent,org.hotswap.agent.plugin.spring.aop,0,0,0,0,0,0,0,0
HotswapProjects_HotswapAgent,org.hotswap.agent.plugin.tomcat,0,0,0,0,0,1,0,1
HotswapProjects_HotswapAgent,org.hotswap.agent.tutorial.framework,1,1,0,0,0,0,0,2
HotswapProjects_HotswapAgent,org.hotswap.agent.tutorial.plugin,1,0,0,0,0,0,0,1
HotswapProjects_HotswapAgent,org.hotswap.agent.tutorial.printSources,0,0,0,0,0,0,0,0
HotswapProjects_HotswapAgent,org.hotswap.agent.tutorial,0,0,0,0,0,0,0,0
HotswapProjects_HotswapAgent,org.hotswap.agent.plugin.undertow,0,0,0,0,0,0,0,0
HotswapProjects_HotswapAgent,org.hotswap.agent.plugin.vaadin,0,0,0,0,0,1,0,1
HotswapProjects_HotswapAgent,org.hotswap.agent.plugin.webobjects,0,0,0,0,0,0,0,0
HotswapProjects_HotswapAgent,org.hotswap.agent.plugin.weld,1,0,0,0,0,1,0,2
HotswapProjects_HotswapAgent,org.hotswap.agent.plugin.weld.beans,0,0,0,0,0,0,0,0
HotswapProjects_HotswapAgent,org.hotswap.agent.plugin.weld.command,1,1,0,0,0,0,0,2
HotswapProjects_HotswapAgent,org.hotswap.agent.plugin.weld.transformer,0,0,0,0,0,2,0,2
HotswapProjects_HotswapAgent,org.hotswap.agent.plugin.wicket,0,0,0,0,0,0,0,0
HotswapProjects_HotswapAgent,org.hotswap.agent.plugin.wildfly.el,0,0,0,0,0,1,0,1
HotswapProjects_HotswapAgent,org.hotswap.agent.plugin.zk,0,0,0,0,0,0,0,0
HPI-Information-Systems_Metanome,de.metanome.algorithm_helper.data_structures,0,0,0,0,1,1,1,3
HPI-Information-Systems_Metanome,de.metanome.algorithm_integration,0,0,0,0,1,5,1,7
HPI-Information-Systems_Metanome,de.metanome.algorithm_integration.algorithm_execution,0,0,0,0,0,0,1,1
HPI-Information-Systems_Metanome,de.metanome.algorithm_integration.algorithm_types,0,0,0,0,1,0,1,2
HPI-Information-Systems_Metanome,de.metanome.algorithm_integration.configuration,0,0,0,1,1,2,1,5
HPI-Information-Systems_Metanome,de.metanome.algorithm_integration.input,0,0,0,0,1,1,1,3
HPI-Information-Systems_Metanome,de.metanome.algorithm_integration.results,0,0,0,0,1,2,1,4
HPI-Information-Systems_Metanome,de.metanome.algorithm_integration.results.basic_statistic_values,0,0,0,0,0,0,1,1
HPI-Information-Systems_Metanome,de.metanome.algorithm_integration.result_receiver,0,0,0,0,1,0,1,2
HPI-Information-Systems_Metanome,de.metanome.algorithms.algorithm_template,0,0,0,0,0,0,1,1
HPI-Information-Systems_Metanome,de.metanome.backend.algorithm_execution,1,0,0,0,1,0,1,3
HPI-Information-Systems_Metanome,de.metanome.backend.algorithm_loading,0,1,0,0,1,0,1,3
HPI-Information-Systems_Metanome,de.metanome.backend.api,0,0,0,0,0,0,1,1
HPI-Information-Systems_Metanome,de.metanome.backend.configuration,1,0,0,0,0,0,1,2
HPI-Information-Systems_Metanome,de.metanome.backend.constants,0,0,0,0,0,0,1,1
HPI-Information-Systems_Metanome,de.metanome.backend.helper,0,0,0,0,1,1,1,3
HPI-Information-Systems_Metanome,de.metanome.backend.initializer,0,0,0,0,0,0,1,1
HPI-Information-Systems_Metanome,de.metanome.backend.input.database,0,0,0,0,1,0,1,2
HPI-Information-Systems_Metanome,de.metanome.backend.input,1,1,0,0,0,0,1,3
HPI-Information-Systems_Metanome,de.metanome.backend.input.file,0,0,0,0,0,0,1,1
HPI-Information-Systems_Metanome,de.metanome.backend.resources,4,0,0,0,1,0,1,6
HPI-Information-Systems_Metanome,de.metanome.backend.results_db,4,1,0,0,0,2,1,8
HPI-Information-Systems_Metanome,de.metanome.backend.result_postprocessing.helper,2,1,0,0,1,5,1,10
HPI-Information-Systems_Metanome,de.metanome.backend.result_postprocessing,1,1,0,0,0,0,1,3
HPI-Information-Systems_Metanome,de.metanome.backend.result_postprocessing.results,1,0,0,0,1,6,1,9
HPI-Information-Systems_Metanome,de.metanome.backend.result_postprocessing.result_analyzer,2,0,0,0,0,1,1,4
HPI-Information-Systems_Metanome,de.metanome.backend.result_postprocessing.result_comparator,0,0,0,0,0,2,1,3
HPI-Information-Systems_Metanome,de.metanome.backend.result_postprocessing.result_ranking,1,1,0,0,0,4,1,7
HPI-Information-Systems_Metanome,de.metanome.backend.result_postprocessing.result_store,1,0,0,0,0,0,1,2
HPI-Information-Systems_Metanome,de.metanome.backend.result_postprocessing.visualization.FunctionalDependency,0,0,0,0,0,0,1,1
HPI-Information-Systems_Metanome,de.metanome.backend.result_postprocessing.visualization,0,0,0,0,0,0,1,1
HPI-Information-Systems_Metanome,de.metanome.backend.result_postprocessing.visualization.UniqueColumnCombination,0,0,0,0,0,0,1,1
HPI-Information-Systems_Metanome,de.metanome.backend.result_receiver,0,0,0,0,0,1,1,2
HPI-Information-Systems_Metanome,de.metanome.backend.file_uploads,0,0,0,0,0,0,1,1
HPI-Information-Systems_Metanome,de.metanome.backend.result_postprocessing.file_fixture,0,1,0,0,1,0,1,3
hypereddie_HippyJava,com.ep.hippyjava.bot,0,0,0,0,0,0,0,0
hypereddie_HippyJava,com.ep.hippyjava.eventsystem,0,0,0,0,1,0,0,1
hypereddie_HippyJava,com.ep.hippyjava.eventsystem.events.model,0,0,0,0,0,0,0,0
hypereddie_HippyJava,com.ep.hippyjava.eventsystem.events,0,0,0,0,0,0,0,0
hypereddie_HippyJava,com.ep.hippyjava,3,1,0,0,0,0,0,4
hypereddie_HippyJava,com.ep.hippyjava.model,2,0,0,0,0,0,0,2
hypereddie_HippyJava,com.ep.hippyjava.networking,2,0,0,0,0,0,0,2
hypereddie_HippyJava,com.ep.hippyjava.networking.exceptions,0,0,0,0,0,0,0,0
hypereddie_HippyJava,com.ep.hippyjava.utils,0,0,0,0,0,0,0,0
hyperic_hq,org.hyperic.hq.agent,0,1,0,0,1,0,1,3
hyperic_hq,org.hyperic.hq.agent.db,0,0,0,0,0,0,1,1
hyperic_hq,org.hyperic.hq.agent.diagnostics,0,0,0,0,0,0,1,1
hyperic_hq,org.hyperic.hq.agent.server,6,1,0,0,1,0,1,9
hyperic_hq,org.hyperic.hq.agent.server.monitor,0,0,0,0,0,0,1,1
hyperic_hq,org.hyperic.hq.agent.stats,0,0,0,0,0,0,1,1
hyperic_hq,org.hyperic.hq.bizapp.agent.client,3,0,0,0,1,0,1,5
hyperic_hq,org.hyperic.hq.bizapp.agent.commands,1,0,0,0,1,0,1,3
hyperic_hq,org.hyperic.hq.bizapp.agent,4,1,0,0,1,0,1,7
hyperic_hq,org.hyperic.hq.bizapp.client,2,0,0,0,0,0,1,3
hyperic_hq,org.hyperic.hq.measurement.agent,1,0,0,0,0,0,1,2
hyperic_hq,org.hyperic.hq.measurement,21,1,0,0,1,0,1,24
hyperic_hq,org.hyperic.hq.transport,2,1,0,0,1,0,1,5
hyperic_hq,org.hyperic.hq.autoinventory.agent.server,0,0,0,0,0,0,1,1
hyperic_hq,org.hyperic.hq.bizapp.agent.server,0,0,0,0,0,0,1,1
hyperic_hq,org.hyperic.hq.control.agent.server,0,0,0,0,0,0,1,1
hyperic_hq,org.hyperic.hq.livedata.agent.server,0,0,0,0,0,0,1,1
hyperic_hq,org.hyperic.hq.measurement.agent.server,0,0,0,0,0,0,1,1
hyperic_hq,org.hyperic.hq.api,0,0,0,0,0,0,1,1
hyperic_hq,org.hyperic.hq.api.common,2,1,0,0,0,0,1,4
hyperic_hq,org.hyperic.hq.api.model,9,1,0,0,0,0,1,11
hyperic_hq,org.hyperic.hq.api.model.cloud,0,0,0,0,1,0,1,2
hyperic_hq,org.hyperic.hq.api.model.common,3,1,0,0,1,0,1,6
hyperic_hq,org.hyperic.hq.api.model.measurements,6,1,0,0,1,0,1,9
hyperic_hq,org.hyperic.hq.api.model.resources,7,1,0,0,1,0,1,10
hyperic_hq,org.hyperic.hq.api.security,0,0,0,0,0,0,1,1
hyperic_hq,org.hyperic.hq.api.services,0,0,0,0,1,0,1,2
hyperic_hq,org.hyperic.hq.api.services.impl,5,1,0,0,1,0,1,8
hyperic_hq,org.hyperic.hq.api.transfer,8,1,0,0,1,0,1,11
hyperic_hq,org.hyperic.hq.api.transfer.impl,4,0,0,0,0,0,1,5
hyperic_hq,org.hyperic.hq.api.transfer.mapping,14,0,0,0,1,0,1,16
hyperic_hq,org.hyperic.bootstrap,0,0,0,0,0,0,1,1
hyperic_hq,org.hyperic.hibernate,4,1,0,0,1,0,1,7
hyperic_hq,org.hyperic.hibernate.dialect,2,1,0,0,0,0,1,4
hyperic_hq,org.hyperic.hibernate.id,0,0,0,0,0,0,1,1
hyperic_hq,org.hyperic.hibernate.usertypes,0,0,0,0,1,0,1,2
hyperic_hq,org.hyperic.hq.agent.client,6,0,0,0,0,0,1,7
hyperic_hq,org.hyperic.hq.agent.commands,0,0,0,0,1,0,1,2
hyperic_hq,org.hyperic.hq.appdef.shared,73,1,0,1,1,0,1,77
hyperic_hq,org.hyperic.hq.authz.shared,34,1,0,0,1,0,1,37
hyperic_hq,org.hyperic.hq.common,6,0,0,0,1,0,1,8
hyperic_hq,org.hyperic.hq.common.shared,9,1,0,0,1,0,1,12
hyperic_hq,org.hyperic.hq.common.utils,0,0,0,0,0,0,1,1
hyperic_hq,org.hyperic.hq.context,0,0,0,0,0,0,1,1
hyperic_hq,org.hyperic.hq.control.agent.client,0,0,0,0,0,0,1,1
hyperic_hq,org.hyperic.hq.control.agent.commands,0,0,0,0,1,1,1,3
hyperic_hq,org.hyperic.hq.control.agent,0,0,0,0,0,0,1,1
hyperic_hq,org.hyperic.hq.events,14,1,0,1,1,0,1,18
hyperic_hq,org.hyperic.hq.livedata.agent.client,0,0,0,0,0,0,1,1
hyperic_hq,org.hyperic.hq.livedata.agent.commands,0,0,0,0,0,1,1,2
hyperic_hq,org.hyperic.hq.livedata.agent,0,0,0,0,0,0,1,1
hyperic_hq,org.hyperic.hq.livedata.shared,3,0,0,0,0,0,1,4
hyperic_hq,org.hyperic.hq.measurement.agent.client,5,0,0,0,0,0,1,6
hyperic_hq,org.hyperic.hq.measurement.agent.commands,2,1,0,0,1,1,1,6
hyperic_hq,org.hyperic.hq.measurement.server.session,38,1,0,1,0,0,1,41
hyperic_hq,org.hyperic.hq.measurement.shared,10,1,0,0,1,0,1,13
hyperic_hq,org.hyperic.hq.plugin.system,3,0,0,1,0,0,1,5
hyperic_hq,org.hyperic.hq.product,24,1,0,1,0,0,1,27
hyperic_hq,org.hyperic.hq.stats,6,1,0,0,0,0,1,8
hyperic_hq,org.hyperic.hq.transport.unidirectional,0,0,0,0,0,0,1,1
hyperic_hq,org.hyperic.hq.transport.util,0,0,0,0,1,0,1,2
hyperic_hq,org.hyperic.tools.db,0,0,0,0,0,1,1,2
hyperic_hq,org.hyperic.tools.db.plan,0,0,0,0,0,0,1,1
hyperic_hq,org.hyperic.tools.db.priv,0,0,0,0,0,0,1,1
hyperic_hq,org.hyperic.hq.install,0,0,0,0,0,0,1,1
hyperic_hq,org.hyperic.tools.ant,1,0,0,1,1,0,1,4
hyperic_hq,org.hyperic.tools.ant.dbupgrade,0,0,0,1,0,0,1,2
hyperic_hq,org.hyperic.tools.ant.installer,1,1,0,0,0,0,1,3
hyperic_hq,org.hyperic.tools.ant.utils,0,0,0,0,1,0,1,2
hyperic_hq,org.hyperic.tools.dbmigrate,0,0,0,1,0,0,1,2
hyperic_hq,org.hyperic.hq.api.resources,0,0,0,0,0,0,1,1
hyperic_hq,org.hyperic.hq.api.rest,0,0,0,0,1,0,1,2
hyperic_hq,org.hyperic.hq.api.rest.cxf,0,0,0,0,0,0,1,1
hyperic_hq,org.hyperic.hq.appdef.server.session,71,1,0,1,0,0,1,74
hyperic_hq,org.hyperic.hq.authz.server.session,79,1,0,1,0,0,1,82
hyperic_hq,org.hyperic.hq.autoinventory.server.session,0,0,0,0,1,0,1,2
hyperic_hq,org.hyperic.hq.bizapp.server.session,13,0,0,1,1,1,1,17
hyperic_hq,org.hyperic.hq.control.server.session,0,0,0,0,1,0,1,2
hyperic_hq,org.hyperic.hq.escalation.shared,4,0,0,0,0,0,1,5
hyperic_hq,org.hyperic.hq.events.server.session,17,1,0,1,0,0,1,20
hyperic_hq,org.hyperic.hq.galerts.server.session,18,1,0,0,0,0,1,20
hyperic_hq,org.hyperic.hq.livedata.server.session,0,0,0,0,0,0,1,1
hyperic_hq,org.hyperic.hq.monitor.aop,0,0,0,0,0,0,1,1
hyperic_hq,org.hyperic.hq.monitor,0,0,0,0,0,0,1,1
hyperic_hq,org.hyperic.lather.client,0,0,0,0,0,0,1,1
hyperic_hq,org.hyperic.lather,0,0,0,0,1,0,1,2
hyperic_hq,org.hyperic.lather.xcode,0,0,0,0,0,0,1,1
hyperic_hq,org.hyperic.hq.maven.HQplugins,0,0,0,0,0,0,1,1
hyperic_hq,org.hyperic.hq.autoinventory.agent,0,0,0,0,0,0,1,1
hyperic_hq,org.hyperic.hq.autoinventory.agent.client,0,1,0,0,0,0,1,2
hyperic_hq,org.hyperic.hq.autoinventory,7,1,0,0,1,0,1,10
hyperic_hq,org.hyperic.hq.autoinventory.scanimpl,0,0,0,0,0,0,1,1
hyperic_hq,org.hyperic.hq.bizapp.shared.lather,16,0,0,1,1,0,1,19
hyperic_hq,org.hyperic.hq.measurement.data,4,1,0,0,1,0,1,7
hyperic_hq,org.hyperic.hq.product.jmx,0,0,0,0,0,0,1,1
hyperic_hq,org.hyperic.hq.product.logparse,1,0,0,0,0,0,1,2
hyperic_hq,org.hyperic.hq.product.pluginxml,3,0,0,1,0,0,1,5
hyperic_hq,org.hyperic.hq.product.util,0,0,0,0,0,0,1,1
hyperic_hq,org.hyperic.hq.product.validation,0,0,0,0,0,0,1,1
hyperic_hq,org.hyperic.snmp,0,0,0,0,0,0,1,1
hyperic_hq,org.novadeck.jxla.config,0,0,0,0,0,0,1,1
hyperic_hq,org.novadeck.jxla,0,0,0,0,0,0,1,1
hyperic_hq,org.novadeck.jxla.data,0,0,0,0,0,0,1,1
hyperic_hq,org.novadeck.jxla.tools,0,0,0,0,0,0,1,1
hyperic_hq,org.novadeck.jxla.xml,0,0,0,0,0,0,1,1
hyperic_hq,org.hyperic.hq.plugin.activemq,0,0,0,0,0,0,1,1
hyperic_hq,org.hyperic.hq.plugin.alfresco,0,0,0,0,0,0,1,1
hyperic_hq,org.hyperic.hq.plugin.apache,0,0,0,0,1,0,1,2
hyperic_hq,org.hyperic.hq.plugin.appha,0,0,0,0,1,0,1,2
hyperic_hq,org.hyperic.hq.plugin.bind,0,0,0,0,0,0,1,1
hyperic_hq,org.hyperic.hq.plugin.cloudfoundry.collector,0,0,0,0,0,0,1,1
hyperic_hq,org.hyperic.hq.plugin.cloudfoundry.control,0,0,0,0,0,0,1,1
hyperic_hq,org.hyperic.hq.plugin.cloudfoundry.events,0,0,0,0,0,0,1,1
hyperic_hq,org.hyperic.hq.plugin.cloudfoundry.inventory,0,0,0,0,0,0,1,1
hyperic_hq,org.hyperic.hq.plugin.cloudfoundry.measurement,0,0,0,0,0,0,1,1
hyperic_hq,org.hyperic.hq.plugin.cloudfoundry.product,0,0,0,0,0,0,1,1
hyperic_hq,org.hyperic.hq.plugin.cloudfoundry.util,0,0,0,0,0,0,1,1
hyperic_hq,org.hyperic.hq.plugin.coldfusion,0,0,0,0,0,0,1,1
hyperic_hq,org.hyperic.hq.plugin.db2,0,0,0,0,0,0,1,1
hyperic_hq,org.hyperic.hq.plugin.db2jdbc,0,0,0,0,0,0,1,1
hyperic_hq,org.hyperic.hq.plugin.dotnet,0,0,0,0,0,0,1,1
hyperic_hq,org.hyperic.hq.plugin.exchange,0,0,0,0,1,0,1,2
hyperic_hq,org.hyperic.hq.plugin.exchange.v2,0,0,0,0,0,0,1,1
hyperic_hq,org.hyperic.hq.plugin.mssql,1,0,0,0,1,0,1,3
hyperic_hq,com.vmware.springsource.hyperic.plugin.gemfire,2,1,0,0,0,0,1,4
hyperic_hq,com.vmware.springsource.hyperic.plugin.gemfire.collectors,2,1,0,0,1,0,1,5
hyperic_hq,com.vmware.springsource.hyperic.plugin.gemfire.detectors,1,0,0,0,1,0,1,3
hyperic_hq,org.hyperic.hq.plugin.groovy,0,0,0,0,0,0,1,1
hyperic_hq,org.hyperic.hq.plugin.hqagent,0,0,0,0,0,0,1,1
hyperic_hq,org.hyperic.hq.plugin.hyper_v,0,0,0,0,0,0,1,1
hyperic_hq,org.hyperic.hq.plugin.iis,0,0,0,0,0,0,1,1
hyperic_hq,org.hyperic.hq.plugin.informix,0,0,0,0,0,0,1,1
hyperic_hq,org.hyperic.hq.plugin.iplanet,0,0,0,0,1,0,1,2
hyperic_hq,org.hyperic.hq.plugin.jboss,1,0,0,0,0,0,1,2
hyperic_hq,org.hyperic.hq.plugin.jboss.jmx,1,1,0,0,0,0,1,3
hyperic_hq,org.hyperic.hq.plugin.jboss7,0,0,0,0,0,0,1,1
hyperic_hq,org.hyperic.hq.plugin.jboss7.objects,0,0,0,0,1,0,1,2
hyperic_hq,org.hyperic.hq.plugin.memcached,0,0,0,0,0,0,1,1
hyperic_hq,org.hyperic.hq.plugin.multilogtrack,0,0,0,0,1,0,1,2
hyperic_hq,org.hyperic.hq.plugin.mysql,0,0,0,0,0,0,1,1
hyperic_hq,org.hyperic.hq.plugin.mysql_stats,0,0,0,0,0,0,1,1
hyperic_hq,org.hyperic.hq.plugin.nagios,0,0,0,0,1,0,1,2
hyperic_hq,org.hyperic.hq.plugin.nagios.parser,0,0,0,0,0,0,1,1
hyperic_hq,org.hyperic.hq.plugin.netapp,0,0,0,0,0,0,1,1
hyperic_hq,org.hyperic.hq.plugin.netdevice,0,0,0,0,1,0,1,2
hyperic_hq,org.hyperic.hq.plugin.netservices,0,0,0,0,1,0,1,2
hyperic_hq,org.hyperic.hq.plugin.ntds,0,0,0,0,0,0,1,1
hyperic_hq,org.hyperic.hq.plugin.ntp,0,0,0,0,0,0,1,1
hyperic_hq,org.hyperic.hq.plugin.oc4j,0,0,0,0,0,0,1,1
hyperic_hq,org.hyperic.hq.plugin.openldap,0,0,0,0,0,0,1,1
hyperic_hq,org.hyperic.plugin.openstack,0,0,0,0,1,0,1,2
hyperic_hq,org.hyperic.hq.plugin.oracle,0,0,0,0,0,0,1,1
hyperic_hq,org.hyperic.hq.plugin.perlbal,0,0,0,0,0,0,1,1
hyperic_hq,org.hyperic.hq.plugin.postfix,0,0,0,0,0,0,1,1
hyperic_hq,org.hyperic.hq.plugin.postgresql,0,0,0,0,0,0,1,1
hyperic_hq,org.hyperic.hq.plugin.rabbitmq.collect,1,0,0,0,1,0,1,3
hyperic_hq,org.hyperic.hq.plugin.rabbitmq.core,1,1,0,0,1,0,1,4
hyperic_hq,org.hyperic.hq.plugin.rabbitmq.detect,0,0,0,0,0,0,1,1
hyperic_hq,org.hyperic.hq.plugin.rabbitmq.manage,0,0,0,0,0,0,1,1
hyperic_hq,org.hyperic.hq.plugin.rabbitmq.product,0,0,0,0,0,0,1,1
hyperic_hq,org.hyperic.hq.plugin.samba,0,0,0,0,0,0,1,1
hyperic_hq,org.hyperic.hq.plugin.sharepoint,0,0,0,0,0,0,1,1
hyperic_hq,org.hyperic.hq.plugin.spring,0,0,0,0,0,0,1,1
hyperic_hq,org.hyperic.hq.plugin.sqlquery,0,0,0,0,0,0,1,1
hyperic_hq,org.hyperic.hq.plugin.sybase,0,0,0,0,1,0,1,2
hyperic_hq,org.hyperic.hq.plugin.tomcat,0,0,0,0,1,0,1,2
hyperic_hq,org.hyperic.hq.plugin.vim,0,0,0,0,0,0,1,1
hyperic_hq,org.hyperic.hq.plugin.vmware,0,0,0,0,0,0,1,1
hyperic_hq,org.hyperic.plugin.vrealize.automation,0,0,0,0,1,0,1,2
hyperic_hq,org.hyperic.plugin.vrealize.automation.model.cluster.config,0,0,0,0,0,0,1,1
hyperic_hq,org.hyperic.plugin.vrealize.automation.model.components,0,0,0,0,1,0,1,2
hyperic_hq,org.hyperic.hq.plugin.vsphere,0,0,0,0,0,0,1,1
hyperic_hq,org.hyperic.hq.plugin.weblogic.config,1,0,0,0,0,0,1,2
hyperic_hq,org.hyperic.hq.plugin.weblogic,2,1,0,1,0,0,1,5
hyperic_hq,org.hyperic.hq.plugin.weblogic.jmx,1,0,0,0,0,0,1,2
hyperic_hq,org.hyperic.hq.plugin.websphere,1,1,0,0,0,0,1,3
hyperic_hq,org.hyperic.hq.plugin.websphere.jmx,1,0,0,0,0,0,1,2
hyperic_hq,com.xensource.xenapi,0,0,0,2,0,0,1,3
hyperic_hq,org.hyperic.hq.plugin.xen,0,0,0,0,0,0,1,1
hyperic_hq,org.hyperic.hq.plugin.zimbra.five,0,0,0,0,1,0,1,2
hyperic_hq,org.hyperic.hq.plugin.zimbra,0,0,0,0,0,0,1,1
hyperic_hq,org.hyperic.hq.hqu.rendit,0,0,0,0,0,0,1,1
hyperic_hq,org.hyperic.hq.agent.server.session,4,0,0,0,0,0,1,5
hyperic_hq,org.hyperic.hq.alerts,2,0,0,0,0,0,1,3
hyperic_hq,org.hyperic.hq.appdef,13,1,0,0,1,0,1,16
hyperic_hq,org.hyperic.hq.appdef.galerts,3,0,0,0,0,0,1,4
hyperic_hq,org.hyperic.hq.appdef.shared.pager,2,0,0,0,0,0,1,3
hyperic_hq,org.hyperic.hq.appdef.shared.resourceTree,4,0,0,0,0,0,1,5
hyperic_hq,org.hyperic.hq.application,0,0,0,0,1,0,1,2
hyperic_hq,org.hyperic.hq.auth,0,0,0,0,0,0,1,1
hyperic_hq,org.hyperic.hq.auth.server.session,4,0,0,0,1,0,1,6
hyperic_hq,org.hyperic.hq.auth.shared,2,1,0,0,1,0,1,5
hyperic_hq,org.hyperic.hq.authz,0,0,0,0,0,0,1,1
hyperic_hq,org.hyperic.hq.authz.server.session.events.group,2,0,0,0,1,0,1,4
hyperic_hq,org.hyperic.hq.authz.server.session.events.role,0,0,0,0,0,0,1,1
hyperic_hq,org.hyperic.hq.authz.server.session.events.subject,0,0,0,0,0,0,1,1
hyperic_hq,org.hyperic.hq.authz.server.shared,2,0,0,0,0,0,1,3
hyperic_hq,org.hyperic.hq.authz.values,2,0,0,0,0,0,1,3
hyperic_hq,org.hyperic.hq.autoinventory.shared,4,0,0,0,0,0,1,5
hyperic_hq,org.hyperic.hq.bizapp.server.action.email,5,0,0,0,0,0,1,6
hyperic_hq,org.hyperic.hq.bizapp.server.action.integrate,0,0,0,0,0,0,1,1
hyperic_hq,org.hyperic.hq.bizapp.server.action.log,0,0,0,0,0,0,1,1
hyperic_hq,org.hyperic.hq.bizapp.server.mdb,0,0,0,0,0,0,1,1
hyperic_hq,org.hyperic.hq.bizapp.server.shared,0,0,0,0,0,0,1,1
hyperic_hq,org.hyperic.hq.bizapp.server.trigger.conditional,5,0,0,0,0,0,1,6
hyperic_hq,org.hyperic.hq.bizapp.shared.action,0,0,0,0,0,0,1,1
hyperic_hq,org.hyperic.hq.bizapp.shared,15,1,0,0,1,0,1,18
hyperic_hq,org.hyperic.hq.bizapp.shared.resourceImport,0,0,0,1,0,0,1,2
hyperic_hq,org.hyperic.hq.bizapp.shared.uibeans,3,1,0,0,1,0,1,6
hyperic_hq,org.hyperic.hq.common.server.session,18,1,0,0,0,0,1,20
hyperic_hq,org.hyperic.hq.common.util,2,1,0,0,0,0,1,4
hyperic_hq,org.hyperic.hq.control,1,0,0,0,0,0,1,2
hyperic_hq,org.hyperic.hq.control.shared,2,1,0,0,1,0,1,5
hyperic_hq,org.hyperic.hq.dao,5,0,0,0,0,0,1,6
hyperic_hq,org.hyperic.hq.escalation,0,0,0,0,0,0,1,1
hyperic_hq,org.hyperic.hq.escalation.server.session,3,1,0,0,0,0,1,5
hyperic_hq,org.hyperic.hq.events.ext,2,1,0,0,0,0,1,4
hyperic_hq,org.hyperic.hq.events.server.mbean,0,0,0,0,0,0,1,1
hyperic_hq,org.hyperic.hq.events.shared,9,1,0,0,1,0,1,12
hyperic_hq,org.hyperic.hq.galerts.processor,1,0,0,0,0,0,1,2
hyperic_hq,org.hyperic.hq.galerts.shared,6,1,0,0,0,0,1,8
hyperic_hq,org.hyperic.hq.galerts.strategies,0,0,0,0,0,0,1,1
hyperic_hq,org.hyperic.hq.grouping,0,0,0,0,0,0,1,1
hyperic_hq,org.hyperic.hq.grouping.server.session,4,0,0,0,0,0,1,5
hyperic_hq,org.hyperic.hq.grouping.shared,3,0,0,0,0,0,1,4
hyperic_hq,org.hyperic.hq.ha,1,0,0,0,0,0,1,2
hyperic_hq,org.hyperic.hq.ha.server.session,0,0,0,0,0,0,1,1
hyperic_hq,org.hyperic.hq.hibernate,0,0,0,0,0,0,1,1
hyperic_hq,org.hyperic.hq.hqu,4,1,0,0,1,0,1,7
hyperic_hq,org.hyperic.hq.hqu.server.session,6,0,0,0,0,0,1,7
hyperic_hq,org.hyperic.hq.hqu.shared,3,0,0,0,0,0,1,4
hyperic_hq,org.hyperic.hq.livedata.formatters,0,0,0,0,1,0,1,2
hyperic_hq,org.hyperic.hq.livedata,1,1,0,0,0,0,1,3
hyperic_hq,org.hyperic.hq.management.server.session,0,0,0,0,0,0,1,1
hyperic_hq,org.hyperic.hq.management.shared,2,0,0,0,1,0,1,4
hyperic_hq,org.hyperic.hq.measurement.action,0,0,0,0,0,0,1,1
hyperic_hq,org.hyperic.hq.measurement.ext,4,1,0,0,1,0,1,7
hyperic_hq,org.hyperic.hq.measurement.galerts,5,0,0,0,0,0,1,6
hyperic_hq,org.hyperic.hq.measurement.monitor,0,0,0,0,0,0,1,1
hyperic_hq,org.hyperic.hq.measurement.server.mbean,0,0,0,0,0,0,1,1
hyperic_hq,org.hyperic.hq.monitor.aop.aspects,0,0,0,0,0,0,1,1
hyperic_hq,org.hyperic.hq.notifications,1,0,0,0,1,0,1,3
hyperic_hq,org.hyperic.hq.notifications.filtering,1,1,0,0,1,0,1,4
hyperic_hq,org.hyperic.hq.notifications.model,0,1,0,0,0,0,1,2
hyperic_hq,org.hyperic.hq.product.server.session,5,1,0,0,1,0,1,8
hyperic_hq,org.hyperic.hq.product.shared,4,0,0,0,0,0,1,5
hyperic_hq,org.hyperic.hq.rt,0,0,0,0,0,0,1,1
hyperic_hq,org.hyperic.hq.scheduler,0,0,0,0,1,0,1,2
hyperic_hq,org.hyperic.hq.scheduler.server.session,0,0,0,0,0,0,1,1
hyperic_hq,org.hyperic.hq.security,2,1,0,0,1,0,1,5
hyperic_hq,org.hyperic.hq.security.server.session,0,0,0,0,1,0,1,2
hyperic_hq,org.hyperic.hq.topn,0,0,0,0,0,0,1,1
hyperic_hq,org.hyperic.hq.types,0,0,0,0,1,0,1,2
hyperic_hq,org.hyperic.hq.ui.server.session,3,1,0,0,1,0,1,6
hyperic_hq,org.hyperic.hq.vm,3,0,0,0,0,0,1,4
hyperic_hq,org.hyperic.hq.zevents,3,1,0,0,0,0,1,5
hyperic_hq,org.hyperic.util.json,0,0,0,0,0,0,1,1
hyperic_hq,org.hyperic.hq.db,0,0,0,0,0,0,1,1
hyperic_hq,org.hyperic.hq.util.properties,0,0,0,0,0,0,1,1
hyperic_hq,org.hyperic.hq.util,0,0,0,0,0,1,1,2
hyperic_hq,org.hyperic.util,5,1,0,1,1,1,1,10
hyperic_hq,org.hyperic.util.collection,0,0,0,0,1,0,1,2
hyperic_hq,org.hyperic.util.config,1,1,0,1,0,4,1,8
hyperic_hq,org.hyperic.util.data,0,0,0,0,1,0,1,2
hyperic_hq,org.hyperic.util.encoding,0,0,0,0,0,3,1,4
hyperic_hq,org.hyperic.util.exec,0,0,0,0,0,0,1,1
hyperic_hq,org.hyperic.util.file,2,0,0,0,1,0,1,4
hyperic_hq,org.hyperic.util.file.match,0,0,0,0,1,0,1,2
hyperic_hq,org.hyperic.util.filter,0,0,0,0,0,0,1,1
hyperic_hq,org.hyperic.util.http,0,0,0,0,0,0,1,1
hyperic_hq,org.hyperic.util.i18n,0,0,0,0,0,0,1,1
hyperic_hq,org.hyperic.util.jdbc,0,0,0,0,1,1,1,3
hyperic_hq,org.hyperic.util.math,0,0,0,0,0,0,1,1
hyperic_hq,org.hyperic.util.ntp,0,0,0,0,0,0,1,1
hyperic_hq,org.hyperic.util.pager,0,0,0,0,1,2,1,4
hyperic_hq,org.hyperic.util.paramParser,0,0,0,0,0,0,1,1
hyperic_hq,org.hyperic.util.schedule,0,0,0,0,1,0,1,2
hyperic_hq,org.hyperic.util.security,1,0,0,0,1,0,1,3
hyperic_hq,org.hyperic.util.shell,0,0,0,0,0,0,1,1
hyperic_hq,org.hyperic.util.ssh,0,0,0,0,1,0,1,2
hyperic_hq,org.hyperic.util.stats,0,0,0,0,1,0,1,2
hyperic_hq,org.hyperic.util.thread,0,0,0,0,1,0,1,2
hyperic_hq,org.hyperic.util.timer,0,0,0,0,1,0,1,2
hyperic_hq,org.hyperic.util.units,1,0,0,0,0,0,1,2
hyperic_hq,org.hyperic.util.validator.common,0,0,0,0,0,0,1,1
hyperic_hq,org.hyperic.util.validator,1,0,0,0,0,0,1,2
hyperic_hq,org.hyperic.util.xmlparser,0,1,0,0,1,0,1,3
hyperic_hq,org.hyperic.hq.ui.action.admin.config,0,0,0,0,1,0,1,2
hyperic_hq,org.hyperic.hq.ui.action.admin.home,0,0,0,0,0,0,1,1
hyperic_hq,org.hyperic.hq.ui.action.admin.plugins,0,0,0,0,0,0,1,1
hyperic_hq,org.hyperic.hq.ui.action.admin.user,0,0,0,0,1,0,1,2
hyperic_hq,org.hyperic.hq.ui.action.attach,0,0,0,0,0,0,1,1
hyperic_hq,org.hyperic.hq.ui.action,0,1,0,0,0,0,1,2
hyperic_hq,org.hyperic.hq.ui.action.management,0,0,0,0,0,0,1,1
hyperic_hq,org.hyperic.hq.ui.action.portlet.addcontent,0,0,0,0,0,0,1,1
hyperic_hq,org.hyperic.hq.ui.action.portlet.addresource,0,0,0,0,0,0,1,1
hyperic_hq,org.hyperic.hq.ui.action.portlet.autoDisc,0,0,0,0,1,1,1,3
hyperic_hq,org.hyperic.hq.ui.action.portlet.availsummary,0,0,0,0,1,0,1,2
hyperic_hq,org.hyperic.hq.ui.action.portlet,0,0,0,0,1,0,1,2
hyperic_hq,org.hyperic.hq.ui.action.portlet.controlactions,0,0,0,0,0,0,1,1
hyperic_hq,org.hyperic.hq.ui.action.portlet.criticalalerts,0,0,0,0,1,0,1,2
hyperic_hq,org.hyperic.hq.ui.action.portlet.metricviewer,0,0,0,0,0,0,1,1
hyperic_hq,org.hyperic.hq.ui.action.portlet.recentlyApproved,0,0,0,0,0,0,1,1
hyperic_hq,org.hyperic.hq.ui.action.portlet.resourcehealth,0,0,0,0,1,0,1,2
hyperic_hq,org.hyperic.hq.ui.action.portlet.savedqueries,0,0,0,0,0,0,1,1
hyperic_hq,org.hyperic.hq.ui.action.portlet.search,0,0,0,0,0,0,1,1
hyperic_hq,org.hyperic.hq.ui.action.portlet.summaryCounts,0,0,0,0,0,0,1,1
hyperic_hq,org.hyperic.hq.ui.action.resource.application,0,0,0,0,0,0,1,1
hyperic_hq,org.hyperic.hq.ui.action.resource.application.inventory,0,0,0,0,1,0,1,2
hyperic_hq,org.hyperic.hq.ui.action.resource.application.monitor.visibility,0,0,0,0,0,0,1,1
hyperic_hq,org.hyperic.hq.ui.action.resource.application.monitor,0,0,0,0,0,0,1,1
hyperic_hq,org.hyperic.hq.ui.action.resource.autogroup.monitor.visibility,0,0,0,0,0,0,1,1
hyperic_hq,org.hyperic.hq.ui.action.resource.autogroup.monitor,0,0,0,0,0,0,1,1
hyperic_hq,org.hyperic.hq.ui.action.resource.common.control,0,0,0,0,1,0,1,2
hyperic_hq,org.hyperic.hq.ui.action.resource.common.inventory,0,0,0,0,1,0,1,2
hyperic_hq,org.hyperic.hq.ui.action.resource.common,0,0,0,0,0,0,1,1
hyperic_hq,org.hyperic.hq.ui.action.resource.common.monitor.alerts,1,1,0,0,1,0,1,4
hyperic_hq,org.hyperic.hq.ui.action.resource.common.monitor.alerts.config,1,0,0,1,0,0,1,3
hyperic_hq,org.hyperic.hq.ui.action.resource.common.monitor.config,0,0,0,0,0,0,1,1
hyperic_hq,org.hyperic.hq.ui.action.resource.common.monitor.visibility,4,0,0,1,1,0,1,7
hyperic_hq,org.hyperic.hq.ui.action.resource.common.monitor,0,0,0,0,0,0,1,1
hyperic_hq,org.hyperic.hq.ui.action.resource,0,1,0,0,1,0,1,3
hyperic_hq,org.hyperic.hq.ui.action.resource.group.control,0,0,0,0,1,0,1,2
hyperic_hq,org.hyperic.hq.ui.action.resource.group.inventory,0,0,0,0,1,0,1,2
hyperic_hq,org.hyperic.hq.ui.action.resource.group.monitor.visibility,0,0,0,0,0,0,1,1
hyperic_hq,org.hyperic.hq.ui.action.resource.group.monitor,0,0,0,0,0,0,1,1
hyperic_hq,org.hyperic.hq.ui.action.resource.hub,1,0,0,0,0,0,1,2
hyperic_hq,org.hyperic.hq.ui.action.resource.platform.autodiscovery,0,0,0,0,1,0,1,2
hyperic_hq,org.hyperic.hq.ui.action.resource.platform.control,0,0,0,0,0,0,1,1
hyperic_hq,org.hyperic.hq.ui.action.resource.platform.inventory,0,0,0,0,1,0,1,2
hyperic_hq,org.hyperic.hq.ui.action.resource.platform.monitor,0,0,0,0,0,0,1,1
hyperic_hq,org.hyperic.hq.ui.action.resource.platform.monitor.visibility,0,0,0,0,0,0,1,1
hyperic_hq,org.hyperic.hq.ui.action.resource.platform,0,0,0,0,0,0,1,1
hyperic_hq,org.hyperic.hq.ui.action.resource.platform.topn,0,0,0,0,0,0,1,1
hyperic_hq,org.hyperic.hq.ui.action.resource.server.control,0,0,0,0,0,0,1,1
hyperic_hq,org.hyperic.hq.ui.action.resource.server.inventory,0,0,0,0,1,0,1,2
hyperic_hq,org.hyperic.hq.ui.action.resource.server.monitor,0,0,0,0,0,0,1,1
hyperic_hq,org.hyperic.hq.ui.action.resource.server.monitor.visibility,0,0,0,0,0,0,1,1
hyperic_hq,org.hyperic.hq.ui.action.resource.service.control,0,0,0,0,0,0,1,1
hyperic_hq,org.hyperic.hq.ui.action.resource.service.inventory,0,0,0,0,1,0,1,2
hyperic_hq,org.hyperic.hq.ui.action.resource.service.monitor,0,0,0,0,0,0,1,1
hyperic_hq,org.hyperic.hq.ui.action.resource.service.monitor.visibility,0,0,0,0,0,0,1,1
hyperic_hq,org.hyperic.hq.ui,8,1,0,0,1,0,1,11
hyperic_hq,org.hyperic.hq.ui.beans,0,1,0,0,1,0,1,3
hyperic_hq,org.hyperic.hq.ui.exception,0,0,0,0,0,0,1,1
hyperic_hq,org.hyperic.hq.ui.json.action.escalation.crud,0,0,0,0,1,0,1,2
hyperic_hq,org.hyperic.hq.ui.json.action.escalation.finder,0,0,0,0,0,0,1,1
hyperic_hq,org.hyperic.hq.ui.json.action,1,1,0,0,0,0,1,3
hyperic_hq,org.hyperic.hq.ui.json,0,0,0,0,0,0,1,1
hyperic_hq,org.hyperic.hq.ui.security,0,0,0,0,1,0,1,2
hyperic_hq,org.hyperic.hq.ui.servlet,3,0,0,0,1,0,1,5
hyperic_hq,org.hyperic.hq.ui.shared,3,1,0,0,0,0,1,5
hyperic_hq,org.hyperic.hq.ui.taglib,2,0,0,1,1,0,1,5
hyperic_hq,org.hyperic.hq.ui.taglib.display,2,1,0,1,0,0,1,5
hyperic_hq,org.hyperic.hq.ui.util,9,1,0,0,1,0,1,12
hyperic_hq,org.hyperic.hq.ui.util.minitab,0,0,0,0,0,0,1,1
hyperic_hq,org.hyperic.hq.ui.validator,0,0,0,0,0,0,1,1
hyperic_hq,org.hyperic.hq.web.admin.managers,0,0,0,0,0,0,1,1
hyperic_hq,org.hyperic.hq.web,0,0,0,0,0,0,1,1
hyperic_hq,org.hyperic.hq.web.dashboard,0,0,0,0,0,0,1,1
hyperic_hq,org.hyperic.hq.web.fileupload,0,0,0,0,0,0,1,1
hyperic_hq,org.hyperic.hq.web.filter,0,0,0,0,0,0,1,1
hyperic_hq,org.hyperic.hq.web.filters,0,0,0,0,0,0,1,1
hyperic_hq,org.hyperic.hq.web.login,0,0,0,0,0,0,1,1
hyperic_hq,org.hyperic.hq.web.resource.association,0,0,0,0,0,0,1,1
hyperic_hq,org.hyperic.hq.web.search,0,0,0,0,0,0,1,1
hyperic_hq,org.hyperic.image.chart,0,0,0,0,0,0,1,1
hyperic_hq,org.hyperic.image,0,0,0,0,0,0,1,1
hyperic_hq,org.hyperic.image.widget,0,0,0,0,0,0,1,1
hyperic_hq,org.hyperic.lather.server,0,0,0,0,0,0,1,1
hyperic_hq,org.hyperic.lather.util,0,0,0,0,0,0,1,1
hyperic_hq,org.hyperic.hq.rest.api,0,0,0,0,0,0,1,1
hyperic_hq,(default package),0,0,0,0,0,0,1,1
ic3fox_jawr,net.jawr.resource.generator,0,0,0,0,1,0,1,2
ic3fox_jawr,net.jawr.resource.postprocessor,0,0,0,0,1,0,1,2
ic3fox_jawr,net.jawr.web,0,0,0,0,0,0,1,1
ic3fox_jawr,net.jawr.web.cache,5,0,0,0,0,0,1,6
ic3fox_jawr,net.jawr.web.config,8,1,0,0,0,7,1,17
ic3fox_jawr,net.jawr.web.config.jmx,8,0,0,0,0,0,1,9
ic3fox_jawr,net.jawr.web.context,0,0,0,0,0,0,1,1
ic3fox_jawr,net.jawr.web.exception,0,0,0,0,1,0,1,2
ic3fox_jawr,net.jawr.web.minification,2,0,0,0,1,1,1,5
ic3fox_jawr,net.jawr.web.resource,3,1,0,0,0,0,1,5
ic3fox_jawr,net.jawr.web.resource.bundle,46,1,0,0,1,2,1,51
ic3fox_jawr,net.jawr.web.resource.bundle.css,3,0,0,0,0,0,1,4
ic3fox_jawr,net.jawr.web.resource.bundle.factory,35,1,0,0,0,2,1,39
ic3fox_jawr,net.jawr.web.resource.bundle.factory.global.postprocessor,2,1,0,0,0,1,1,5
ic3fox_jawr,net.jawr.web.resource.bundle.factory.global.preprocessor,2,0,0,0,0,0,1,3
ic3fox_jawr,net.jawr.web.resource.bundle.factory.mapper,2,0,0,0,0,0,1,3
ic3fox_jawr,net.jawr.web.resource.bundle.factory.postprocessor,8,0,0,0,0,1,1,10
ic3fox_jawr,net.jawr.web.resource.bundle.factory.util,52,1,0,0,1,2,1,57
ic3fox_jawr,net.jawr.web.resource.bundle.generator,39,1,0,0,0,2,1,43
ic3fox_jawr,net.jawr.web.resource.bundle.generator.classpath,0,0,0,0,0,0,1,1
ic3fox_jawr,net.jawr.web.resource.bundle.generator.classpath.webjars,0,0,0,0,1,0,1,2
ic3fox_jawr,net.jawr.web.resource.bundle.generator.css.less,4,0,0,0,0,0,1,5
ic3fox_jawr,net.jawr.web.resource.bundle.generator.css.sass,0,0,0,0,0,0,1,1
ic3fox_jawr,net.jawr.web.resource.bundle.generator.css.sass.ruby,4,0,0,0,0,0,1,5
ic3fox_jawr,net.jawr.web.resource.bundle.generator.css.sass.vaadin,4,0,0,0,0,0,1,5
ic3fox_jawr,net.jawr.web.resource.bundle.generator.img,4,0,0,0,0,0,1,5
ic3fox_jawr,net.jawr.web.resource.bundle.generator.js.coffee,3,0,0,0,0,0,1,4
ic3fox_jawr,net.jawr.web.resource.bundle.generator.resolver,13,1,0,0,0,1,1,16
ic3fox_jawr,net.jawr.web.resource.bundle.generator.validator,3,1,0,0,0,0,1,5
ic3fox_jawr,net.jawr.web.resource.bundle.generator.variant.css,3,0,0,0,0,4,1,8
ic3fox_jawr,net.jawr.web.resource.bundle.generator.variant,0,0,0,0,0,0,1,1
ic3fox_jawr,net.jawr.web.resource.bundle.global.postprocessor.google.closure,2,0,0,0,0,2,1,5
ic3fox_jawr,net.jawr.web.resource.bundle.global.preprocessor.css.smartsprites,3,0,0,0,0,0,1,4
ic3fox_jawr,net.jawr.web.resource.bundle.global.processor,0,0,0,0,1,2,1,4
ic3fox_jawr,net.jawr.web.resource.bundle.handler,12,0,0,0,1,1,1,15
ic3fox_jawr,net.jawr.web.resource.bundle.hashcode,0,0,0,0,0,0,1,1
ic3fox_jawr,net.jawr.web.resource.bundle.iexplore,0,0,0,0,0,0,1,1
ic3fox_jawr,net.jawr.web.resource.bundle.iterator,2,0,0,0,1,0,1,4
ic3fox_jawr,net.jawr.web.resource.bundle.lifecycle,0,0,0,0,0,0,1,1
ic3fox_jawr,net.jawr.web.resource.bundle.locale,7,0,0,0,1,0,1,9
ic3fox_jawr,net.jawr.web.resource.bundle.locale.message,2,0,0,0,0,0,1,3
ic3fox_jawr,net.jawr.web.resource.bundle.mappings,7,1,0,0,0,0,1,9
ic3fox_jawr,net.jawr.web.resource.bundle.postprocess,1,1,0,0,0,1,1,4
ic3fox_jawr,net.jawr.web.resource.bundle.postprocess.impl,3,0,0,0,1,1,1,6
ic3fox_jawr,net.jawr.web.resource.bundle.postprocess.impl.css.base64,2,0,0,0,0,0,1,3
ic3fox_jawr,net.jawr.web.resource.bundle.postprocess.impl.js.uglify,2,0,0,0,0,0,1,3
ic3fox_jawr,net.jawr.web.resource.bundle.postprocess.impl.yui,0,0,0,0,0,0,1,1
ic3fox_jawr,net.jawr.web.resource.bundle.renderer,7,1,0,0,1,1,1,11
ic3fox_jawr,net.jawr.web.resource.bundle.renderer.image,0,0,0,0,0,0,1,1
ic3fox_jawr,net.jawr.web.resource.bundle.sorting,2,0,0,0,0,0,1,3
ic3fox_jawr,net.jawr.web.resource.bundle.variant.resolver,0,0,0,0,0,0,1,1
ic3fox_jawr,net.jawr.web.resource.bundle.variant,6,0,0,0,0,1,1,8
ic3fox_jawr,net.jawr.web.resource.handler.bundle,0,0,0,0,0,1,1,2
ic3fox_jawr,net.jawr.web.resource.handler.reader,0,0,0,0,1,3,1,5
ic3fox_jawr,net.jawr.web.resource.watcher,0,0,0,0,0,0,1,1
ic3fox_jawr,net.jawr.web.servlet,13,1,0,0,1,0,1,16
ic3fox_jawr,net.jawr.web.servlet.util,3,0,0,0,0,0,1,4
ic3fox_jawr,net.jawr.web.taglib,0,0,0,0,1,0,1,2
ic3fox_jawr,net.jawr.web.taglib.el,0,0,0,0,1,0,1,2
ic3fox_jawr,net.jawr.web.taglib.jsf,0,0,0,0,1,0,1,2
ic3fox_jawr,net.jawr.web.util,26,1,0,0,1,0,1,29
ic3fox_jawr,net.jawr.web.util.bom,0,0,0,0,0,0,1,1
ic3fox_jawr,net.jawr.web.util.io,0,0,0,0,0,0,1,1
ic3fox_jawr,net.jawr.web.util.js,0,0,0,0,0,0,1,1
ic3fox_jawr,net.jawr.web.util.js.rhino,0,0,0,0,1,0,1,2
ic3fox_jawr,net.jawr.web.util.js.rhino.util,0,0,0,0,0,0,1,1
ic3fox_jawr,org.j2free.jawr,0,0,0,0,0,0,1,1
ic3fox_jawr,net.jawr.resource.preprocessor,0,0,0,0,0,0,1,1
ic3fox_jawr-main-repo,net.jawr.resource.generator,0,0,0,0,1,0,1,2
ic3fox_jawr-main-repo,net.jawr.resource.postprocessor,0,0,0,0,1,0,1,2
ic3fox_jawr-main-repo,net.jawr.web,0,0,0,0,0,0,1,1
ic3fox_jawr-main-repo,net.jawr.web.cache,5,0,0,0,0,0,1,6
ic3fox_jawr-main-repo,net.jawr.web.config,8,1,0,0,0,8,1,18
ic3fox_jawr-main-repo,net.jawr.web.config.jmx,8,0,0,0,0,0,1,9
ic3fox_jawr-main-repo,net.jawr.web.context,0,0,0,0,0,0,1,1
ic3fox_jawr-main-repo,net.jawr.web.exception,0,0,0,0,1,0,1,2
ic3fox_jawr-main-repo,net.jawr.web.minification,2,0,0,0,1,1,1,5
ic3fox_jawr-main-repo,net.jawr.web.resource,3,1,0,0,0,0,1,5
ic3fox_jawr-main-repo,net.jawr.web.resource.bundle,46,1,0,0,1,2,1,51
ic3fox_jawr-main-repo,net.jawr.web.resource.bundle.css,3,0,0,0,0,0,1,4
ic3fox_jawr-main-repo,net.jawr.web.resource.bundle.factory,35,1,0,0,0,2,1,39
ic3fox_jawr-main-repo,net.jawr.web.resource.bundle.factory.global.postprocessor,2,1,0,0,0,1,1,5
ic3fox_jawr-main-repo,net.jawr.web.resource.bundle.factory.global.preprocessor,2,0,0,0,0,0,1,3
ic3fox_jawr-main-repo,net.jawr.web.resource.bundle.factory.mapper,2,0,0,0,0,0,1,3
ic3fox_jawr-main-repo,net.jawr.web.resource.bundle.factory.postprocessor,8,0,0,0,0,1,1,10
ic3fox_jawr-main-repo,net.jawr.web.resource.bundle.factory.util,52,1,0,0,1,3,1,58
ic3fox_jawr-main-repo,net.jawr.web.resource.bundle.generator,39,1,0,0,0,2,1,43
ic3fox_jawr-main-repo,net.jawr.web.resource.bundle.generator.classpath,0,0,0,0,0,0,1,1
ic3fox_jawr-main-repo,net.jawr.web.resource.bundle.generator.classpath.webjars,0,0,0,0,1,0,1,2
ic3fox_jawr-main-repo,net.jawr.web.resource.bundle.generator.css.less,4,0,0,0,0,0,1,5
ic3fox_jawr-main-repo,net.jawr.web.resource.bundle.generator.css.sass,0,0,0,0,0,0,1,1
ic3fox_jawr-main-repo,net.jawr.web.resource.bundle.generator.css.sass.ruby,4,0,0,0,0,0,1,5
ic3fox_jawr-main-repo,net.jawr.web.resource.bundle.generator.css.sass.vaadin,4,0,0,0,0,0,1,5
ic3fox_jawr-main-repo,net.jawr.web.resource.bundle.generator.img,4,0,0,0,0,0,1,5
ic3fox_jawr-main-repo,net.jawr.web.resource.bundle.generator.js.coffee,3,0,0,0,0,0,1,4
ic3fox_jawr-main-repo,net.jawr.web.resource.bundle.generator.resolver,13,1,0,0,0,1,1,16
ic3fox_jawr-main-repo,net.jawr.web.resource.bundle.generator.validator,3,1,0,0,0,0,1,5
ic3fox_jawr-main-repo,net.jawr.web.resource.bundle.generator.variant.css,3,0,0,0,0,4,1,8
ic3fox_jawr-main-repo,net.jawr.web.resource.bundle.generator.variant,0,0,0,0,0,0,1,1
ic3fox_jawr-main-repo,net.jawr.web.resource.bundle.global.postprocessor.google.closure,2,0,0,0,0,2,1,5
ic3fox_jawr-main-repo,net.jawr.web.resource.bundle.global.preprocessor.css.smartsprites,3,0,0,0,0,0,1,4
ic3fox_jawr-main-repo,net.jawr.web.resource.bundle.global.processor,0,0,0,0,1,2,1,4
ic3fox_jawr-main-repo,net.jawr.web.resource.bundle.handler,12,0,0,0,1,2,1,16
ic3fox_jawr-main-repo,net.jawr.web.resource.bundle.hashcode,0,0,0,0,0,0,1,1
ic3fox_jawr-main-repo,net.jawr.web.resource.bundle.iexplore,0,0,0,0,0,0,1,1
ic3fox_jawr-main-repo,net.jawr.web.resource.bundle.iterator,2,0,0,0,1,0,1,4
ic3fox_jawr-main-repo,net.jawr.web.resource.bundle.lifecycle,0,0,0,0,0,0,1,1
ic3fox_jawr-main-repo,net.jawr.web.resource.bundle.locale,7,0,0,0,1,0,1,9
ic3fox_jawr-main-repo,net.jawr.web.resource.bundle.locale.message,2,0,0,0,0,0,1,3
ic3fox_jawr-main-repo,net.jawr.web.resource.bundle.mappings,7,1,0,0,0,0,1,9
ic3fox_jawr-main-repo,net.jawr.web.resource.bundle.postprocess,1,1,0,0,0,1,1,4
ic3fox_jawr-main-repo,net.jawr.web.resource.bundle.postprocess.impl,3,0,0,0,1,1,1,6
ic3fox_jawr-main-repo,net.jawr.web.resource.bundle.postprocess.impl.css.base64,2,0,0,0,0,0,1,3
ic3fox_jawr-main-repo,net.jawr.web.resource.bundle.postprocess.impl.js.uglify,2,0,0,0,0,0,1,3
ic3fox_jawr-main-repo,net.jawr.web.resource.bundle.postprocess.impl.yui,0,0,0,0,0,0,1,1
ic3fox_jawr-main-repo,net.jawr.web.resource.bundle.renderer,7,1,0,0,1,2,1,12
ic3fox_jawr-main-repo,net.jawr.web.resource.bundle.renderer.image,0,0,0,0,0,0,1,1
ic3fox_jawr-main-repo,net.jawr.web.resource.bundle.sorting,2,0,0,0,0,0,1,3
ic3fox_jawr-main-repo,net.jawr.web.resource.bundle.variant.resolver,0,0,0,0,0,0,1,1
ic3fox_jawr-main-repo,net.jawr.web.resource.bundle.variant,6,0,0,0,0,1,1,8
ic3fox_jawr-main-repo,net.jawr.web.resource.handler.bundle,0,0,0,0,0,1,1,2
ic3fox_jawr-main-repo,net.jawr.web.resource.handler.reader,0,0,0,0,1,3,1,5
ic3fox_jawr-main-repo,net.jawr.web.resource.watcher,0,0,0,0,0,0,1,1
ic3fox_jawr-main-repo,net.jawr.web.servlet,13,1,0,0,1,0,1,16
ic3fox_jawr-main-repo,net.jawr.web.servlet.util,3,0,0,0,0,0,1,4
ic3fox_jawr-main-repo,net.jawr.web.taglib,0,0,0,0,1,0,1,2
ic3fox_jawr-main-repo,net.jawr.web.taglib.el,0,0,0,0,1,0,1,2
ic3fox_jawr-main-repo,net.jawr.web.taglib.jsf,0,0,0,0,1,0,1,2
ic3fox_jawr-main-repo,net.jawr.web.util,26,1,0,0,1,0,1,29
ic3fox_jawr-main-repo,net.jawr.web.util.bom,0,0,0,0,0,0,1,1
ic3fox_jawr-main-repo,net.jawr.web.util.io,0,0,0,0,0,0,1,1
ic3fox_jawr-main-repo,net.jawr.web.util.js,0,0,0,0,0,0,1,1
ic3fox_jawr-main-repo,net.jawr.web.util.js.rhino,0,0,0,0,1,0,1,2
ic3fox_jawr-main-repo,net.jawr.web.util.js.rhino.util,0,0,0,0,0,0,1,1
ic3fox_jawr-main-repo,org.j2free.jawr,0,0,0,0,0,0,1,1
ic3fox_jawr-main-repo,net.jawr.resource.preprocessor,0,0,0,0,0,0,1,1
ic3fox_jawr-main-repo,net.jawr.web.resource.bundle.generator.dwr,0,0,0,0,0,0,1,1
ic3fox_jawr-main-repo,net.jawr.dwr.demo,0,0,0,0,0,0,1,1
ic3fox_jawr-main-repo,net.jawr.dwr.resource.generator,0,0,0,0,1,0,1,2
ic3fox_jawr-main-repo,net.jawr.dwr.resource.postprocessor,0,0,0,0,0,0,1,1
ic3fox_jawr-main-repo,org.getahead.dwrdemo.address,0,0,0,0,0,0,1,1
ic3fox_jawr-main-repo,org.getahead.dwrdemo.asmg,0,0,0,0,0,0,1,1
ic3fox_jawr-main-repo,org.getahead.dwrdemo.chat,0,0,0,0,1,0,1,2
ic3fox_jawr-main-repo,org.getahead.dwrdemo.cli,0,0,0,0,0,0,1,1
ic3fox_jawr-main-repo,org.getahead.dwrdemo.clock,0,0,0,0,0,0,1,1
ic3fox_jawr-main-repo,org.getahead.dwrdemo.filter,0,0,0,0,1,0,1,2
ic3fox_jawr-main-repo,org.getahead.dwrdemo.gidemo,0,0,0,0,1,0,1,2
ic3fox_jawr-main-repo,org.getahead.dwrdemo.intro,0,0,0,0,0,0,1,1
ic3fox_jawr-main-repo,org.getahead.dwrdemo.livehelp,0,0,0,0,0,0,1,1
ic3fox_jawr-main-repo,org.getahead.dwrdemo.people,0,0,0,0,0,0,1,1
ic3fox_jawr-main-repo,org.getahead.dwrdemo.simpletext,0,0,0,0,0,0,1,1
ic3fox_jawr-main-repo,net.jawr.web.resource.bundle.locale.message.grails,0,0,0,0,0,0,1,1
ic3fox_jawr-main-repo,net.jawr.web.resource.handler.reader.grails,0,0,0,0,0,0,1,1
ic3fox_jawr-main-repo,net.jawr.application,0,0,0,0,0,0,1,1
ic3fox_jawr-main-repo,net.jawr.application.controller.hello,0,0,0,0,0,0,1,1
ic3fox_jawr-main-repo,net.jawr.web.autoconfigure,0,0,0,0,1,0,1,2
ic3fox_jawr-main-repo,net.jawr.spring.resource.generator,0,0,0,0,1,0,1,2
ic3fox_jawr-main-repo,net.jawr.spring.resource.postprocessor,0,0,0,0,0,0,1,1
ic3fox_jawr-main-repo,net.jawr.ant,0,0,0,0,0,0,1,1
ic3fox_jawr-main-repo,net.jawr.web.bundle.processor,0,0,0,0,0,0,1,1
ic3fox_jawr-main-repo,net.jawr.web.bundle.processor.renderer,0,0,0,0,0,0,1,1
ic3fox_jawr-main-repo,net.jawr.web.bundle.processor.spring,0,0,0,0,0,0,1,1
ic3fox_jawr-main-repo,net.jawr.web.servlet.mock,0,0,0,0,0,0,1,1
ic3fox_jawr-main-repo,net.jawr.web.servlet.mock.spring,0,0,0,0,0,0,1,1
ic3fox_jawr-main-repo,net.jawr.web.bundle,0,0,0,0,0,0,1,1
ic3fox_jawr-main-repo,net.jawr.web.resource.generator,0,0,0,0,0,0,1,1
ic3fox_jawr-main-repo,net.jawr.web.resource.postprocessor,0,0,0,0,0,0,1,1
ic3fox_jawr-main-repo,net.jawr.maven,0,0,0,0,0,0,1,1
ic3fox_jawr-main-repo,net.jawr.web.wicket,0,1,0,0,1,0,1,3
ic3fox_jawr-main-repo,net.jawr.wicket.resource.generator,0,0,0,0,1,0,1,2
ic3fox_jawr-main-repo,net.jawr.wicket.resource,0,0,0,0,0,0,1,1
ic3fox_jawr-main-repo,net.jawr.wicket.resource.postprocessor,0,0,0,0,0,0,1,1
icode_ameba,ameba,6,1,0,0,0,0,0,7
icode_ameba,ameba.container,2,0,0,0,0,0,0,2
icode_ameba,ameba.container.event,0,0,0,0,0,0,0,0
icode_ameba,ameba.container.internal,0,0,0,0,0,0,0,0
icode_ameba,ameba.container.server,0,0,0,0,0,0,0,0
icode_ameba,ameba.core,4,1,0,0,1,0,0,6
icode_ameba,ameba.core.event,0,0,0,0,0,0,0,0
icode_ameba,ameba.core.ws.rs,0,0,0,0,1,0,0,1
icode_ameba,ameba.db,1,0,0,0,0,0,0,1
icode_ameba,ameba.db.dsl,2,0,0,0,1,0,0,3
icode_ameba,ameba.db.ebean,3,0,0,0,1,0,0,4
icode_ameba,ameba.db.ebean.filter,1,0,0,0,1,0,0,2
icode_ameba,ameba.db.ebean.internal,2,1,0,0,0,0,0,3
icode_ameba,ameba.db.ebean.jackson,1,1,0,0,1,0,0,3
icode_ameba,ameba.db.ebean.migration,0,0,0,0,0,0,0,0
icode_ameba,ameba.db.ebean.support,0,0,0,0,0,0,0,0
icode_ameba,ameba.db.migration.flyway,0,0,0,0,0,0,0,0
icode_ameba,ameba.db.migration,1,1,0,0,0,0,0,2
icode_ameba,ameba.db.migration.models,0,0,0,0,0,0,0,0
icode_ameba,ameba.db.migration.resources,1,0,0,0,0,0,0,1
icode_ameba,ameba.db.model,1,1,0,0,1,0,0,3
icode_ameba,ameba.event,0,0,0,0,1,0,0,1
icode_ameba,ameba.exception,0,0,0,0,1,0,0,1
icode_ameba,ameba.feature,0,0,0,0,0,0,0,0
icode_ameba,ameba.feature.datasource,0,0,0,0,0,0,0,0
icode_ameba,ameba.feature.internal,0,0,0,0,0,0,0,0
icode_ameba,ameba.i18n,7,1,0,0,0,0,0,8
icode_ameba,ameba.inject,0,0,0,0,0,0,0,0
icode_ameba,ameba.inject.generator,0,0,0,0,0,0,0,0
icode_ameba,ameba.lib.el,0,0,0,0,0,0,0,0
icode_ameba,ameba.lib,0,0,0,0,0,0,0,0
icode_ameba,ameba.message,0,0,0,0,0,0,0,0
icode_ameba,ameba.message.error,0,0,0,0,0,0,0,0
icode_ameba,ameba.message.filtering,0,0,0,0,1,0,0,1
icode_ameba,ameba.message.internal,0,1,0,0,0,0,0,1
icode_ameba,ameba.message.internal.streaming,0,0,0,0,1,0,0,1
icode_ameba,ameba.message.jackson.internal,0,0,0,0,1,0,0,1
icode_ameba,ameba.message.jackson,0,0,0,0,0,0,0,0
icode_ameba,ameba.mvc.assets,0,0,0,0,0,0,0,0
icode_ameba,ameba.mvc,0,0,0,0,0,0,0,0
icode_ameba,ameba.mvc.route,0,0,0,0,0,0,0,0
icode_ameba,ameba.mvc.template.internal,0,0,0,0,0,0,0,0
icode_ameba,ameba.mvc.template,0,0,0,0,0,0,0,0
icode_ameba,ameba.scanner,0,0,0,0,0,0,0,0
icode_ameba,ameba.util,0,0,0,0,0,0,0,0
icode_ameba,ameba.validation,0,0,0,0,0,0,0,0
icode_ameba,ameba.websocket,0,0,0,0,1,0,0,1
icode_ameba,ameba.websocket.adapter,0,0,0,0,0,0,0,0
icode_ameba,ameba.websocket.adapter.standard,0,0,0,0,0,0,0,0
icode_ameba,ameba.websocket.codec,0,0,0,0,1,0,0,1
icode_ameba,ameba.websocket.internal,0,0,0,0,1,0,0,1
icode_ameba,ameba.websocket.sockjs.frame,0,0,0,0,0,0,0,0
icode_ameba,ameba.websocket.sockjs.transport,0,0,0,0,1,0,0,1
igniterealtime_jxmpp,org.jxmpp,1,1,0,0,0,0,0,2
igniterealtime_jxmpp,org.jxmpp.stringprep,1,0,0,0,0,0,0,1
igniterealtime_jxmpp,org.jxmpp.stringprep.simple,0,0,0,0,0,0,0,0
igniterealtime_jxmpp,org.jxmpp.util,0,0,0,0,1,0,0,1
igniterealtime_jxmpp,org.jxmpp.xml.splitter,0,0,0,0,0,0,0,0
igniterealtime_jxmpp,org.jxmpp.jid,1,1,0,0,0,0,0,2
igniterealtime_jxmpp,org.jxmpp.jid.impl,1,0,0,0,0,0,0,1
igniterealtime_jxmpp,org.jxmpp.jid.parts,0,0,0,0,0,0,0,0
igniterealtime_jxmpp,org.jxmpp.jid.util,0,0,0,0,0,0,0,0
igniterealtime_jxmpp,org.jxmpp.repl,0,0,0,0,0,0,0,0
igniterealtime_jxmpp,org.jxmpp.stringprep.icu4j,0,0,0,0,0,0,0,0
igniterealtime_jxmpp,org.jxmpp.stringprep.libidn,0,0,0,0,0,0,0,0
igniterealtime_jxmpp,org.jxmpp.stringprep.rocksxmppprecis,0,0,0,0,0,0,0,0
igniterealtime_jxmpp,org.jxmpp.util.cache,0,0,0,0,0,0,0,0
igniterealtime_Openfire,org.jivesoftware.openfire.launcher,0,0,0,0,0,0,1,1
igniterealtime_Openfire,org.jivesoftware.openfire.starter,0,0,0,0,0,0,1,1
igniterealtime_Openfire,org.apache.mina.management,0,0,0,0,0,0,1,1
igniterealtime_Openfire,org.dom4j.io,0,0,0,0,0,0,1,1
igniterealtime_Openfire,org.eclipse.jetty.util,0,0,0,0,0,0,1,1
igniterealtime_Openfire,org.jivesoftware.admin,4,1,0,1,1,0,1,8
igniterealtime_Openfire,org.jivesoftware.admin.servlet,2,0,0,0,0,0,1,3
igniterealtime_Openfire,org.jivesoftware.database,14,1,0,0,1,0,1,17
igniterealtime_Openfire,org.jivesoftware.database.bugfix,3,0,0,0,0,0,1,4
igniterealtime_Openfire,org.jivesoftware.openfire.admin,14,0,0,2,1,0,1,18
igniterealtime_Openfire,org.jivesoftware.openfire.archive,3,0,0,0,1,0,1,5
igniterealtime_Openfire,org.jivesoftware.openfire.audit,0,0,0,0,0,0,1,1
igniterealtime_Openfire,org.jivesoftware.openfire.audit.spi,2,0,0,0,0,0,1,3
igniterealtime_Openfire,org.jivesoftware.openfire.auth,2,1,0,0,1,0,1,5
igniterealtime_Openfire,org.jivesoftware.openfire.carbons,0,0,0,0,0,0,1,1
igniterealtime_Openfire,org.jivesoftware.openfire,90,1,0,1,1,1,1,95
igniterealtime_Openfire,org.jivesoftware.openfire.cluster,3,1,0,0,1,0,1,6
igniterealtime_Openfire,org.jivesoftware.openfire.commands,3,1,0,0,0,0,1,5
igniterealtime_Openfire,org.jivesoftware.openfire.commands.admin,0,0,0,0,1,0,1,2
igniterealtime_Openfire,org.jivesoftware.openfire.commands.admin.group,0,0,0,0,1,0,1,2
igniterealtime_Openfire,org.jivesoftware.openfire.commands.admin.muc,0,0,0,0,0,0,1,1
igniterealtime_Openfire,org.jivesoftware.openfire.commands.admin.user,0,0,0,0,0,0,1,1
igniterealtime_Openfire,org.jivesoftware.openfire.commands.event,0,0,0,0,1,0,1,2
igniterealtime_Openfire,org.jivesoftware.openfire.component,5,1,0,0,1,0,1,8
igniterealtime_Openfire,org.jivesoftware.openfire.container,3,0,0,0,1,0,1,5
igniterealtime_Openfire,org.jivesoftware.openfire.crowd,0,0,0,0,1,0,1,2
igniterealtime_Openfire,org.jivesoftware.openfire.crowd.jaxb,0,0,1,0,0,0,1,2
igniterealtime_Openfire,org.jivesoftware.openfire.disco,4,0,0,0,1,0,1,6
igniterealtime_Openfire,org.jivesoftware.openfire.entitycaps,6,0,0,0,0,0,1,7
igniterealtime_Openfire,org.jivesoftware.openfire.event,0,0,0,0,1,0,1,2
igniterealtime_Openfire,org.jivesoftware.openfire.filetransfer,3,1,0,0,1,0,1,6
igniterealtime_Openfire,org.jivesoftware.openfire.filetransfer.proxy,3,0,0,0,1,0,1,5
igniterealtime_Openfire,org.jivesoftware.openfire.forms,0,0,0,0,0,0,1,1
igniterealtime_Openfire,org.jivesoftware.openfire.forms.spi,0,0,0,0,0,0,1,1
igniterealtime_Openfire,org.jivesoftware.openfire.forward,0,0,0,0,0,0,1,1
igniterealtime_Openfire,org.jivesoftware.openfire.group,4,1,0,0,1,0,1,7
igniterealtime_Openfire,org.jivesoftware.openfire.handler,3,0,0,0,1,0,1,5
igniterealtime_Openfire,org.jivesoftware.openfire.http,3,0,0,0,1,0,1,5
igniterealtime_Openfire,org.jivesoftware.openfire.interceptor,3,0,0,0,1,0,1,5
igniterealtime_Openfire,org.jivesoftware.openfire.keystore,5,0,0,0,1,0,1,7
igniterealtime_Openfire,org.jivesoftware.openfire.ldap,2,0,0,0,1,0,1,4
igniterealtime_Openfire,org.jivesoftware.openfire.lockout,3,0,0,0,1,0,1,5
igniterealtime_Openfire,org.jivesoftware.openfire.mediaproxy,3,0,0,0,1,0,1,5
igniterealtime_Openfire,org.jivesoftware.openfire.muc,6,1,0,0,1,1,1,10
igniterealtime_Openfire,org.jivesoftware.openfire.muc.cluster,3,0,0,0,1,1,1,6
igniterealtime_Openfire,org.jivesoftware.openfire.muc.spi,8,1,0,0,1,0,1,11
igniterealtime_Openfire,org.jivesoftware.openfire.multiplex,2,1,0,0,1,0,1,5
igniterealtime_Openfire,org.jivesoftware.openfire.net,9,1,0,1,1,0,1,13
igniterealtime_Openfire,org.jivesoftware.openfire.nio,0,0,0,0,1,0,1,2
igniterealtime_Openfire,org.jivesoftware.openfire.pep,4,0,0,0,1,0,1,6
igniterealtime_Openfire,org.jivesoftware.openfire.privacy,4,1,0,0,0,0,1,6
igniterealtime_Openfire,org.jivesoftware.openfire.pubsub.cluster,0,0,0,0,1,0,1,2
igniterealtime_Openfire,org.jivesoftware.openfire.pubsub,4,1,0,0,1,0,1,7
igniterealtime_Openfire,org.jivesoftware.openfire.pubsub.models,2,1,0,0,1,0,1,5
igniterealtime_Openfire,org.jivesoftware.openfire.resultsetmanager,0,0,0,0,0,0,1,1
igniterealtime_Openfire,org.jivesoftware.openfire.roster,9,0,0,0,1,0,1,11
igniterealtime_Openfire,org.jivesoftware.openfire.sasl,3,0,0,0,1,0,1,5
igniterealtime_Openfire,org.jivesoftware.openfire.security,2,0,0,0,1,0,1,4
igniterealtime_Openfire,org.jivesoftware.openfire.server,4,1,0,0,1,0,1,7
igniterealtime_Openfire,org.jivesoftware.openfire.session,8,1,0,0,1,0,1,11
igniterealtime_Openfire,org.jivesoftware.openfire.spi,8,0,0,0,1,0,1,10
igniterealtime_Openfire,org.jivesoftware.openfire.stanzaid,1,0,0,0,0,0,1,2
igniterealtime_Openfire,org.jivesoftware.openfire.stats,2,0,0,0,0,0,1,3
igniterealtime_Openfire,org.jivesoftware.openfire.streammanagement,2,0,0,0,0,0,1,3
igniterealtime_Openfire,org.jivesoftware.openfire.transport,2,0,0,0,0,0,1,3
igniterealtime_Openfire,org.jivesoftware.openfire.update,3,0,0,0,0,0,1,4
igniterealtime_Openfire,org.jivesoftware.openfire.user,3,1,0,0,1,0,1,6
igniterealtime_Openfire,org.jivesoftware.openfire.user.property,0,0,0,0,1,0,1,2
igniterealtime_Openfire,org.jivesoftware.openfire.vcard,3,0,0,0,1,0,1,5
igniterealtime_Openfire,org.jivesoftware.openfire.webdav,0,0,0,0,0,0,1,1
igniterealtime_Openfire,org.jivesoftware.openfire.websocket,0,0,0,0,1,0,1,2
igniterealtime_Openfire,org.jivesoftware.util,88,1,0,1,1,0,1,92
igniterealtime_Openfire,org.jivesoftware.util.cache,40,1,0,0,1,0,1,43
igniterealtime_Openfire,org.jivesoftware.util.cert,0,0,0,0,0,0,1,1
igniterealtime_Openfire,org.jivesoftware.util.log.util,0,0,0,0,0,0,1,1
igniterealtime_Openfire,dom.io,0,0,0,0,0,0,1,1
igniterealtime_Openfire,org.jivesoftware,2,0,0,0,0,0,1,3
igniterealtime_Openfire,org.apache.jsp.tag.meta.admin.admin,0,0,0,0,0,0,1,1
igniterealtime_Openfire,org.apache.jsp.tag.meta.admin.admin.security,0,0,0,0,0,0,1,1
igniterealtime_Openfire,org.jivesoftware.openfire.admin.decorators,0,0,0,0,0,0,1,1
igniterealtime_Openfire,org.jivesoftware.openfire.admin.js.jscalendar,0,0,0,0,0,0,1,1
igniterealtime_Openfire,org.jivesoftware.openfire.admin.setup,0,0,0,0,1,0,1,2
igniterealtime_Spark,org.jivesoftware,30,1,0,0,1,3,1,36
igniterealtime_Spark,org.jivesoftware.launcher,0,0,0,0,0,0,1,1
igniterealtime_Spark,org.jivesoftware.resource,31,1,0,0,0,8,1,41
igniterealtime_Spark,org.jivesoftware.spark,54,1,0,0,1,7,1,64
igniterealtime_Spark,org.jivesoftware.spark.component,3,1,0,1,1,1,1,8
igniterealtime_Spark,org.jivesoftware.spark.component.borders,0,0,0,0,0,0,1,1
igniterealtime_Spark,org.jivesoftware.spark.component.browser,0,0,0,0,0,0,1,1
igniterealtime_Spark,org.jivesoftware.spark.component.focus,0,0,0,0,0,0,1,1
igniterealtime_Spark,org.jivesoftware.spark.component.panes,0,0,0,0,0,0,1,1
igniterealtime_Spark,org.jivesoftware.spark.component.renderer,0,0,0,0,0,0,1,1
igniterealtime_Spark,org.jivesoftware.spark.component.tabbedPane,0,0,0,0,0,0,1,1
igniterealtime_Spark,org.jivesoftware.spark.decorator,0,0,0,0,0,0,1,1
igniterealtime_Spark,org.jivesoftware.spark.filetransfer,8,1,0,0,0,0,1,10
igniterealtime_Spark,org.jivesoftware.spark.filetransfer.preferences,0,0,0,0,0,0,1,1
igniterealtime_Spark,org.jivesoftware.spark.plugin,2,0,0,0,1,1,1,5
igniterealtime_Spark,org.jivesoftware.spark.preference,0,0,0,0,0,2,1,3
igniterealtime_Spark,org.jivesoftware.spark.sasl,0,0,0,0,0,0,1,1
igniterealtime_Spark,org.jivesoftware.spark.search,3,0,0,0,0,0,1,4
igniterealtime_Spark,org.jivesoftware.spark.ui,17,1,0,1,1,2,1,23
igniterealtime_Spark,org.jivesoftware.spark.ui.conferences,4,0,0,0,1,0,1,6
igniterealtime_Spark,org.jivesoftware.spark.ui.history,0,0,0,0,0,0,1,1
igniterealtime_Spark,org.jivesoftware.spark.ui.login,4,0,0,0,1,3,1,9
igniterealtime_Spark,org.jivesoftware.spark.ui.rooms,0,0,0,0,0,0,1,1
igniterealtime_Spark,org.jivesoftware.spark.ui.status,0,0,0,0,1,0,1,2
igniterealtime_Spark,org.jivesoftware.spark.ui.themes,4,0,0,0,1,2,1,8
igniterealtime_Spark,org.jivesoftware.spark.uri,7,0,0,0,0,0,1,8
igniterealtime_Spark,org.jivesoftware.spark.util,10,1,0,0,1,5,1,18
igniterealtime_Spark,org.jivesoftware.spark.util.log,12,1,0,0,0,8,1,22
igniterealtime_Spark,org.jivesoftware.sparkimpl.certificates,11,1,0,0,0,3,1,16
igniterealtime_Spark,org.jivesoftware.sparkimpl.plugin.alerts,0,0,0,0,1,0,1,2
igniterealtime_Spark,org.jivesoftware.sparkimpl.plugin.bookmarks,0,0,0,0,0,0,1,1
igniterealtime_Spark,org.jivesoftware.sparkimpl.plugin.chat,0,0,0,0,0,0,1,1
igniterealtime_Spark,org.jivesoftware.sparkimpl.plugin.emoticons,4,0,0,0,0,1,1,6
igniterealtime_Spark,org.jivesoftware.sparkimpl.plugin.filetransfer.transfer,2,0,0,0,0,0,1,3
igniterealtime_Spark,org.jivesoftware.sparkimpl.plugin.filetransfer.transfer.ui,2,0,0,0,0,0,1,3
igniterealtime_Spark,org.jivesoftware.sparkimpl.plugin.gateways,4,0,0,0,1,0,1,6
igniterealtime_Spark,org.jivesoftware.sparkimpl.plugin.gateways.transports,5,1,0,0,1,0,1,8
igniterealtime_Spark,org.jivesoftware.sparkimpl.plugin.history,0,0,0,0,0,0,1,1
igniterealtime_Spark,org.jivesoftware.sparkimpl.plugin.idle,0,0,0,0,0,0,1,1
igniterealtime_Spark,org.jivesoftware.sparkimpl.plugin.idle.linux,0,0,0,0,0,0,1,1
igniterealtime_Spark,org.jivesoftware.sparkimpl.plugin.idle.mac,0,0,0,0,0,0,1,1
igniterealtime_Spark,org.jivesoftware.sparkimpl.plugin.idle.windows,0,0,0,0,0,0,1,1
igniterealtime_Spark,org.jivesoftware.sparkimpl.plugin.jabber,0,0,0,0,0,0,1,1
igniterealtime_Spark,org.jivesoftware.sparkimpl.plugin.language,0,0,0,0,0,1,1,2
igniterealtime_Spark,org.jivesoftware.sparkimpl.plugin.layout,3,0,0,0,0,0,1,4
igniterealtime_Spark,org.jivesoftware.sparkimpl.plugin.manager,2,1,0,0,0,0,1,4
igniterealtime_Spark,org.jivesoftware.sparkimpl.plugin.privacy.list,0,0,0,0,0,1,1,2
igniterealtime_Spark,org.jivesoftware.sparkimpl.plugin.privacy,2,0,0,0,0,1,1,4
igniterealtime_Spark,org.jivesoftware.sparkimpl.plugin.privacy.ui,0,0,0,0,0,1,1,2
igniterealtime_Spark,org.jivesoftware.sparkimpl.plugin.scratchpad,0,0,0,0,0,0,1,1
igniterealtime_Spark,org.jivesoftware.sparkimpl.plugin.sparklers,0,0,0,0,0,0,1,1
igniterealtime_Spark,org.jivesoftware.sparkimpl.plugin.systray,0,0,0,0,0,0,1,1
igniterealtime_Spark,org.jivesoftware.sparkimpl.plugin.transcripts,0,0,0,0,1,0,1,2
igniterealtime_Spark,org.jivesoftware.sparkimpl.plugin.viewer,0,0,0,0,0,1,1,2
igniterealtime_Spark,org.jivesoftware.sparkimpl.preference.chat,0,0,0,0,0,0,1,1
igniterealtime_Spark,org.jivesoftware.sparkimpl.preference.groupchat,0,0,0,0,0,0,1,1
igniterealtime_Spark,org.jivesoftware.sparkimpl.preference.notifications,0,0,0,0,0,0,1,1
igniterealtime_Spark,org.jivesoftware.sparkimpl.preference,0,0,0,0,0,1,1,2
igniterealtime_Spark,org.jivesoftware.sparkimpl.preference.sounds,0,0,0,0,0,1,1,2
igniterealtime_Spark,org.jivesoftware.sparkimpl.profile,0,0,0,0,1,1,1,3
igniterealtime_Spark,org.jivesoftware.sparkimpl.profile.ext,0,0,0,0,0,0,1,1
igniterealtime_Spark,org.jivesoftware.sparkimpl.search.users,0,0,0,0,0,0,1,1
igniterealtime_Spark,org.jivesoftware.sparkimpl.settings,3,0,0,0,0,0,1,4
igniterealtime_Spark,org.jivesoftware.sparkimpl.settings.local,6,1,0,0,1,2,1,11
igniterealtime_Spark,org.jivesoftware.sparkimpl.updater,0,0,0,0,0,0,1,1
igniterealtime_Spark,(default package),0,0,0,0,0,0,1,1
igniterealtime_Spark,com.jivesoftware.spark.plugin.apple,0,0,0,0,1,0,1,2
igniterealtime_Spark,battleship,1,0,0,0,0,0,1,2
igniterealtime_Spark,battleship.gui,0,0,0,0,0,0,1,1
igniterealtime_Spark,battleship.listener,1,1,0,0,0,0,1,3
igniterealtime_Spark,battleship.logic,0,0,0,0,0,0,1,1
igniterealtime_Spark,battleship.packets,0,0,0,0,0,0,1,1
igniterealtime_Spark,org.jivesoftware.fastpath,0,1,0,0,0,0,1,2
igniterealtime_Spark,org.jivesoftware.fastpath.internal,0,0,0,0,1,0,1,2
igniterealtime_Spark,org.jivesoftware.fastpath.resources,0,0,0,0,0,0,1,1
igniterealtime_Spark,org.jivesoftware.fastpath.workspace.assistants,0,0,0,0,1,0,1,2
igniterealtime_Spark,org.jivesoftware.fastpath.workspace,0,1,0,0,0,0,1,2
igniterealtime_Spark,org.jivesoftware.fastpath.workspace.invite,0,0,0,0,0,0,1,1
igniterealtime_Spark,org.jivesoftware.fastpath.workspace.macros,0,0,0,0,0,0,1,1
igniterealtime_Spark,org.jivesoftware.fastpath.workspace.panes,0,0,0,0,1,0,1,2
igniterealtime_Spark,org.jivesoftware.fastpath.workspace.search,0,0,0,0,0,0,1,1
igniterealtime_Spark,org.jivesoftware.fastpath.workspace.util,0,0,0,0,0,0,1,1
igniterealtime_Spark,org.jivesoftware.spark.plugin.fileupload,0,0,0,0,0,0,1,1
igniterealtime_Spark,org.jivesoftware.spark.plugin.flashing,0,0,0,0,0,1,1,2
igniterealtime_Spark,com.jivesoftware.spark.plugin.growl,0,0,0,0,0,0,1,1
igniterealtime_Spark,org.jivesoftware.sparkplugin,0,0,0,0,0,0,1,1
igniterealtime_Spark,org.jivesoftware.spark.plugin.ofmeet,0,0,0,0,0,0,1,1
igniterealtime_Spark,org.jivesoftware.spark.otrplug.impl,0,0,0,0,0,0,1,1
igniterealtime_Spark,org.jivesoftware.spark.otrplug,0,0,0,0,0,0,1,1
igniterealtime_Spark,org.jivesoftware.spark.otrplug.pref,0,0,0,0,0,0,1,1
igniterealtime_Spark,org.jivesoftware.spark.otrplug.ui,0,0,0,0,0,0,1,1
igniterealtime_Spark,org.jivesoftware.spark.otrplug.util,0,0,0,0,0,0,1,1
igniterealtime_Spark,org.jivesoftware.spark.phone,1,1,0,0,0,0,1,3
igniterealtime_Spark,org.jivesoftware.sparkimpl.plugin.phone,1,0,0,0,1,0,1,3
igniterealtime_Spark,org.jivesoftware.sparkimpl.preference.media,0,0,0,0,0,0,1,1
igniterealtime_Spark,org.jivesoftware.game.reversi,0,0,0,0,0,0,1,1
igniterealtime_Spark,org.jivesoftware.spark.roar.displaytype,0,0,0,0,1,1,1,3
igniterealtime_Spark,org.jivesoftware.spark.roar.gui,1,0,0,0,1,1,1,4
igniterealtime_Spark,org.jivesoftware.spark.roar,1,1,0,0,0,1,1,4
igniterealtime_Spark,net.java.sipmack.common,0,0,0,0,1,0,1,2
igniterealtime_Spark,net.java.sipmack.common.scheduler,0,0,0,0,0,0,1,1
igniterealtime_Spark,net.java.sipmack.events,1,0,0,0,0,0,1,2
igniterealtime_Spark,net.java.sipmack.media,1,0,0,0,1,0,1,3
igniterealtime_Spark,net.java.sipmack.media.event,0,0,0,0,0,0,1,1
igniterealtime_Spark,net.java.sipmack.sip,14,1,0,0,0,0,1,16
igniterealtime_Spark,net.java.sipmack.sip.event,4,1,0,0,1,0,1,7
igniterealtime_Spark,net.java.sipmack.sip.security,2,0,0,0,1,0,1,4
igniterealtime_Spark,net.java.sipmack.sip.simple,1,0,0,0,0,0,1,2
igniterealtime_Spark,net.java.sipmack.softphone.gui,4,0,0,0,0,0,1,5
igniterealtime_Spark,net.java.sipmack.softphone.listeners,4,0,0,0,0,0,1,5
igniterealtime_Spark,net.java.sipmack.softphone,7,1,0,0,0,0,1,9
igniterealtime_Spark,org.jivesoftware.spark.plugin.phone.resource,0,0,0,0,0,0,1,1
igniterealtime_Spark,org.jivesoftware.sparkplugin.callhistory,0,0,0,0,0,0,1,1
igniterealtime_Spark,org.jivesoftware.sparkplugin.calllog,2,0,0,0,1,0,1,4
igniterealtime_Spark,org.jivesoftware.sparkplugin.components,0,0,0,0,1,0,1,2
igniterealtime_Spark,org.jivesoftware.sparkplugin.phonebook,0,0,0,0,0,0,1,1
igniterealtime_Spark,org.jivesoftware.sparkplugin.phonebook.ui,0,0,0,0,0,0,1,1
igniterealtime_Spark,org.jivesoftware.sparkplugin.preferences,0,0,0,0,1,0,1,2
igniterealtime_Spark,org.jivesoftware.sparkplugin.sipaccount,0,0,0,0,0,0,1,1
igniterealtime_Spark,org.jivesoftware.sparkplugin.ui,1,1,0,0,1,0,1,4
igniterealtime_Spark,org.jivesoftware.sparkplugin.ui.call,1,0,0,0,1,1,1,4
igniterealtime_Spark,org.jivesoftware.sparkplugin.ui.components,0,0,0,0,1,0,1,2
igniterealtime_Spark,org.jivesoftware.sparkplugin.ui.transfer,0,0,0,0,0,0,1,1
igniterealtime_Spark,org.jivesoftware.spellchecker,0,0,0,0,0,0,1,1
igniterealtime_Spark,org.jivesoftware.spark.plugins,0,0,0,0,0,0,1,1
igniterealtime_Spark,tic.tac.toe,0,0,0,0,0,0,1,1
igniterealtime_Spark,tic.tac.toe.packet,0,0,0,0,1,0,1,2
igniterealtime_Spark,tic.tac.toe.ui,0,0,0,0,0,0,1,1
igniterealtime_Spark,org.jivesoftware.spark.plugins.transfersettings,0,0,0,0,1,0,1,2
igniterealtime_Spark,org.jivesoftware.spark.translator,0,0,0,0,0,0,1,1
igniterealtime_Spark,com.jivesoftware.spark.translator,0,0,0,0,0,0,1,1
igniterealtime_tinder,org.jivesoftware.util,0,0,0,0,0,0,0,0
igniterealtime_tinder,org.xmpp.component,0,0,0,0,1,0,0,1
igniterealtime_tinder,org.xmpp.forms,0,0,0,0,0,0,0,0
igniterealtime_tinder,org.xmpp.muc,0,0,0,0,0,0,0,0
igniterealtime_tinder,org.xmpp.packet,0,0,0,0,1,0,0,1
igniterealtime_tinder,org.xmpp.resultsetmanagement,0,0,0,0,0,0,0,0
igniterealtime_tinder,org.xmpp.util,0,0,0,0,0,0,0,0
iipc_webarchive-commons,org.archive.extract,0,0,0,0,1,0,0,1
iipc_webarchive-commons,org.archive.format.arc,0,0,0,0,1,0,0,1
iipc_webarchive-commons,org.archive.format,0,0,0,0,0,0,0,0
iipc_webarchive-commons,org.archive.format.cdx,0,0,0,0,1,1,0,2
iipc_webarchive-commons,org.archive.format.dns,0,0,0,0,0,0,0,0
iipc_webarchive-commons,org.archive.format.gzip,1,0,0,0,0,1,0,2
iipc_webarchive-commons,org.archive.format.gzip.zipnum,0,0,0,0,0,3,0,3
iipc_webarchive-commons,org.archive.format.http,1,0,0,1,0,0,0,2
iipc_webarchive-commons,org.archive.format.json,0,0,0,0,1,0,0,1
iipc_webarchive-commons,org.archive.format.text.charset,0,0,0,0,0,0,0,0
iipc_webarchive-commons,org.archive.format.text.html,0,0,0,0,0,0,0,0
iipc_webarchive-commons,org.archive.format.warc,2,1,0,0,0,0,0,3
iipc_webarchive-commons,org.archive.hadoop,0,0,0,0,1,0,0,1
iipc_webarchive-commons,org.archive.hadoop.func,0,0,0,0,0,0,0,0
iipc_webarchive-commons,org.archive.httpclient,0,0,0,0,1,0,0,1
iipc_webarchive-commons,org.archive.io.arc,2,0,0,0,1,3,0,6
iipc_webarchive-commons,org.archive.io,8,1,0,1,1,5,0,16
iipc_webarchive-commons,org.archive.io.warc,4,0,0,0,0,3,0,7
iipc_webarchive-commons,org.archive.net,0,0,0,0,0,0,0,0
iipc_webarchive-commons,org.archive.net.md5,0,0,0,0,0,0,0,0
iipc_webarchive-commons,org.archive.net.rsync,0,0,0,0,0,0,0,0
iipc_webarchive-commons,org.archive,0,0,0,0,0,0,0,0
iipc_webarchive-commons,org.archive.resource,0,0,0,0,1,0,0,1
iipc_webarchive-commons,org.archive.resource.arc,0,0,0,0,0,0,0,0
iipc_webarchive-commons,org.archive.resource.arc.record,0,0,0,0,0,0,0,0
iipc_webarchive-commons,org.archive.resource.generic,0,0,0,0,0,0,0,0
iipc_webarchive-commons,org.archive.resource.gzip,0,0,0,0,0,0,0,0
iipc_webarchive-commons,org.archive.resource.html,0,0,0,0,1,0,0,1
iipc_webarchive-commons,org.archive.resource.http,0,0,0,0,1,0,0,1
iipc_webarchive-commons,org.archive.resource.producer,0,0,0,0,0,0,0,0
iipc_webarchive-commons,org.archive.resource.warc.record,0,0,0,0,1,0,0,1
iipc_webarchive-commons,org.archive.resource.warc,0,0,0,0,0,0,0,0
iipc_webarchive-commons,org.archive.streamcontext,0,0,0,0,1,0,0,1
iipc_webarchive-commons,org.archive.uid,0,0,0,0,0,0,0,0
iipc_webarchive-commons,org.archive.url,5,0,0,1,0,0,0,6
iipc_webarchive-commons,org.archive.util.anvl,0,0,0,0,0,0,0,0
iipc_webarchive-commons,org.archive.util,13,1,0,1,1,4,0,20
iipc_webarchive-commons,org.archive.util.binsearch,4,0,0,0,1,3,0,8
iipc_webarchive-commons,org.archive.util.binsearch.impl,4,1,0,0,1,1,0,7
iipc_webarchive-commons,org.archive.util.binsearch.impl.http,1,0,0,0,1,0,0,2
iipc_webarchive-commons,org.archive.util.io,0,0,0,0,1,1,0,2
iipc_webarchive-commons,org.archive.util.iterator,2,0,0,0,0,0,0,2
iipc_webarchive-commons,org.archive.util.zip,0,0,0,0,0,2,0,2
IKCAP_wings,edu.isi.wings.catalog.component.api.impl.oodt,0,0,0,0,0,0,0,0
IKCAP_wings,edu.isi.wings.catalog.data.api.impl.oodt,0,0,0,0,0,0,0,0
IKCAP_wings,edu.isi.wings.execution.engine.api.impl.oodt,0,0,0,0,0,1,0,1
IKCAP_wings,edu.isi.wings.util.oodt,0,0,0,0,0,0,0,0
IKCAP_wings,org.apache.oodt.cas.workflow.misc,0,0,0,0,0,0,0,0
IKCAP_wings,org.apache.oodt.cas.wmservices.client,0,0,0,0,0,0,0,0
IKCAP_wings,org.apache.oodt.cas.wmservices.repository,0,0,0,0,0,0,0,0
IKCAP_wings,org.apache.oodt.cas.wmservices.resources,0,0,0,0,0,0,0,0
IKCAP_wings,org.apache.oodt.cas.wmservices.servlets,0,0,0,0,0,0,0,0
IKCAP_wings,edu.isi.wings.execution.engine.api.impl.pegasus,0,0,0,0,0,3,0,3
IKCAP_wings,edu.isi.wings.opmm,0,0,0,0,1,0,0,1
IKCAP_wings,edu.isi.wings.opmw_validator,0,0,0,0,0,0,0,0
IKCAP_wings,edu.isi.wings.catalog.component.api,0,0,0,0,0,0,0,0
IKCAP_wings,edu.isi.wings.catalog.component.api.impl.kb,0,0,0,0,0,0,0,0
IKCAP_wings,edu.isi.wings.catalog.component.classes,0,0,0,0,1,0,0,1
IKCAP_wings,edu.isi.wings.catalog.component.classes.requirements,0,0,0,0,0,0,0,0
IKCAP_wings,edu.isi.wings.catalog.component.classes.rules,0,0,0,0,0,0,0,0
IKCAP_wings,edu.isi.wings.catalog.component,0,1,0,0,0,0,0,1
IKCAP_wings,edu.isi.wings.catalog.data.api,0,0,0,0,0,0,0,0
IKCAP_wings,edu.isi.wings.catalog.data.api.impl.kb,0,0,0,0,0,0,0,0
IKCAP_wings,edu.isi.wings.catalog.data.classes,0,0,0,0,1,0,0,1
IKCAP_wings,edu.isi.wings.catalog.data.classes.metrics,0,0,0,0,0,0,0,0
IKCAP_wings,edu.isi.wings.catalog.data,0,1,0,0,0,0,0,1
IKCAP_wings,edu.isi.wings.catalog.provenance.api.impl.kb,0,0,0,0,0,0,0,0
IKCAP_wings,edu.isi.wings.catalog.provenance.api,0,0,0,0,0,0,0,0
IKCAP_wings,edu.isi.wings.catalog.provenance.classes,0,0,0,0,0,0,0,0
IKCAP_wings,edu.isi.wings.catalog.provenance,0,0,0,0,0,0,0,0
IKCAP_wings,edu.isi.wings.catalog.resource.api.impl.kb,0,0,0,0,0,0,0,0
IKCAP_wings,edu.isi.wings.catalog.resource.api,0,0,0,0,0,0,0,0
IKCAP_wings,edu.isi.wings.catalog.resource.classes,0,0,0,0,1,1,0,2
IKCAP_wings,edu.isi.wings.catalog.resource,0,0,0,0,0,0,0,0
IKCAP_wings,edu.isi.wings.common,0,0,0,0,1,4,0,5
IKCAP_wings,edu.isi.wings.common.kb,0,0,0,0,0,0,0,0
IKCAP_wings,edu.isi.wings.common.logging,0,0,0,0,1,0,0,1
IKCAP_wings,edu.isi.wings.execution.engine.api.impl.distributed,0,0,0,0,1,0,0,1
IKCAP_wings,edu.isi.wings.execution.engine.api.impl.local,0,0,0,0,0,1,0,1
IKCAP_wings,edu.isi.wings.execution.engine.api,0,0,0,0,0,1,0,1
IKCAP_wings,edu.isi.wings.execution.engine.classes,0,0,0,0,0,5,0,5
IKCAP_wings,edu.isi.wings.execution.engine,0,0,0,0,0,0,0,0
IKCAP_wings,edu.isi.wings.execution.tools.api,0,0,0,0,0,0,0,0
IKCAP_wings,edu.isi.wings.execution.tools.api.impl.kb,0,0,0,0,0,0,0,0
IKCAP_wings,edu.isi.wings.execution.tools,0,0,0,0,0,0,0,0
IKCAP_wings,edu.isi.wings.planner.api.impl.kb,0,0,0,0,0,0,0,0
IKCAP_wings,edu.isi.wings.planner.api,0,0,0,0,0,0,0,0
IKCAP_wings,edu.isi.wings.planner.cli,0,0,0,0,0,0,0,0
IKCAP_wings,edu.isi.wings.planner,0,0,0,0,0,0,0,0
IKCAP_wings,edu.isi.wings.workflow.plan.api,0,0,0,0,0,4,0,4
IKCAP_wings,edu.isi.wings.workflow.plan.api.impl.pplan,0,0,0,0,0,0,0,0
IKCAP_wings,edu.isi.wings.workflow.plan.classes,0,0,0,0,0,4,0,4
IKCAP_wings,edu.isi.wings.workflow.plan,0,0,0,0,0,0,0,0
IKCAP_wings,edu.isi.wings.workflow.template.api,0,0,0,0,0,0,0,0
IKCAP_wings,edu.isi.wings.workflow.template.api.impl.kb,0,0,0,0,0,0,0,0
IKCAP_wings,edu.isi.wings.workflow.template.classes,0,0,0,0,1,0,0,1
IKCAP_wings,edu.isi.wings.workflow.template.classes.sets,0,0,0,0,0,0,0,0
IKCAP_wings,edu.isi.wings.workflow.template.classes.variables,0,0,0,0,0,0,0,0
IKCAP_wings,edu.isi.wings.workflow.template,0,0,0,0,0,0,0,0
IKCAP_wings,edu.isi.wings.workflows.util,0,0,0,0,0,0,0,0
IKCAP_wings,edu.isi.wings.portal.classes.config,0,0,0,0,0,0,0,0
IKCAP_wings,edu.isi.wings.portal.classes.domains,0,0,0,0,1,0,0,1
IKCAP_wings,edu.isi.wings.portal.classes.html,0,0,0,0,0,0,0,0
IKCAP_wings,edu.isi.wings.portal.classes,0,1,0,0,1,0,0,2
IKCAP_wings,edu.isi.wings.portal.classes.users,0,0,0,0,0,0,0,0
IKCAP_wings,edu.isi.wings.portal.classes.util,0,0,0,0,0,0,0,0
IKCAP_wings,edu.isi.wings.portal.controllers,0,0,0,0,1,0,0,1
IKCAP_wings,edu.isi.wings.portal.filters.resources,0,0,0,0,0,0,0,0
IKCAP_wings,edu.isi.wings.portal.filters.servlets,0,0,0,0,0,0,0,0
IKCAP_wings,edu.isi.wings.portal.resources,0,1,0,0,1,0,0,2
IKCAP_wings,edu.isi.wings.portal.servlets,0,0,0,0,0,0,0,0
IKCAP_wings,edu.isi.wings.portal,0,0,0,0,0,0,0,0
iluwatar_java-design-patterns,com.iluwatar.abstractdocument,0,0,0,0,1,0,0,1
iluwatar_java-design-patterns,com.iluwatar.abstractdocument.domain,0,0,0,0,0,0,0,0
iluwatar_java-design-patterns,com.iluwatar.abstractfactory,0,0,0,0,0,0,0,0
iluwatar_java-design-patterns,com.iluwatar.acyclicvisitor,0,0,0,0,0,0,0,0
iluwatar_java-design-patterns,com.iluwatar.adapter,0,0,0,0,0,0,0,0
iluwatar_java-design-patterns,com.iluwatar.aggregator.microservices,0,0,0,0,1,0,0,1
iluwatar_java-design-patterns,com.iluwatar.information.microservice,0,0,0,0,0,0,0,0
iluwatar_java-design-patterns,com.iluwatar.inventory.microservice,0,0,0,0,0,0,0,0
iluwatar_java-design-patterns,com.iluwatar.ambassador,0,0,0,0,0,0,0,0
iluwatar_java-design-patterns,com.iluwatar.ambassador.util,0,0,0,0,0,0,0,0
iluwatar_java-design-patterns,com.iluwatar.api.gateway,0,0,0,0,1,0,0,1
iluwatar_java-design-patterns,com.iluwatar.image.microservice,0,0,0,0,0,0,0,0
iluwatar_java-design-patterns,com.iluwatar.price.microservice,0,0,0,0,0,0,0,0
iluwatar_java-design-patterns,com.iluwatar.async.method.invocation,0,0,0,0,1,0,0,1
iluwatar_java-design-patterns,com.iluwatar.balking,0,0,0,0,1,0,0,1
iluwatar_java-design-patterns,com.iluwatar.bridge,0,0,0,0,0,0,0,0
iluwatar_java-design-patterns,com.iluwatar.builder,0,0,0,0,0,0,0,0
iluwatar_java-design-patterns,com.iluwatar.business.delegate,0,0,0,0,0,0,0,0
iluwatar_java-design-patterns,com.iluwatar.bytecode,0,0,0,0,0,0,0,0
iluwatar_java-design-patterns,com.iluwatar.bytecode.util,0,0,0,0,0,0,0,0
iluwatar_java-design-patterns,com.iluwatar.caching,0,0,0,0,0,0,0,0
iluwatar_java-design-patterns,com.iluwatar.caching.constants,0,0,0,0,0,0,0,0
iluwatar_java-design-patterns,com.iluwatar.callback,0,0,0,0,1,0,0,1
iluwatar_java-design-patterns,com.iluwatar.chain,0,0,0,0,0,0,0,0
iluwatar_java-design-patterns,com.iluwatar.collectionpipeline,0,0,0,0,0,0,0,0
iluwatar_java-design-patterns,com.iluwatar.command,0,0,0,0,0,0,0,0
iluwatar_java-design-patterns,com.iluwatar.commander,0,0,0,0,1,0,0,1
iluwatar_java-design-patterns,com.iluwatar.commander.employeehandle,0,0,0,0,0,0,0,0
iluwatar_java-design-patterns,com.iluwatar.commander.exceptions,0,0,0,0,0,0,0,0
iluwatar_java-design-patterns,com.iluwatar.commander.messagingservice,0,0,0,0,0,0,0,0
iluwatar_java-design-patterns,com.iluwatar.commander.paymentservice,0,0,0,0,0,0,0,0
iluwatar_java-design-patterns,com.iluwatar.commander.queue,0,0,0,0,0,0,0,0
iluwatar_java-design-patterns,com.iluwatar.commander.shippingservice,0,0,0,0,0,0,0,0
iluwatar_java-design-patterns,com.iluwatar.composite,0,0,0,0,0,0,0,0
iluwatar_java-design-patterns,com.iluwatar.converter,0,0,0,0,0,0,0,0
iluwatar_java-design-patterns,com.iluwatar.cqrs.app,0,0,0,0,0,0,0,0
iluwatar_java-design-patterns,com.iluwatar.cqrs.commandes,0,0,0,0,0,0,0,0
iluwatar_java-design-patterns,com.iluwatar.cqrs.constants,0,0,0,0,0,0,0,0
iluwatar_java-design-patterns,com.iluwatar.cqrs.domain.model,0,0,0,0,0,0,0,0
iluwatar_java-design-patterns,com.iluwatar.cqrs.dto,0,0,0,0,0,1,0,1
iluwatar_java-design-patterns,com.iluwatar.cqrs.queries,0,0,0,0,0,1,0,1
iluwatar_java-design-patterns,com.iluwatar.cqrs.util,0,0,0,0,0,0,0,0
iluwatar_java-design-patterns,com.iluwatar.cqrs,0,0,0,0,0,1,0,1
iluwatar_java-design-patterns,com.iluwatar.dao,0,0,0,0,0,0,0,0
iluwatar_java-design-patterns,com.iluwatar.databus,1,0,0,0,1,0,0,2
iluwatar_java-design-patterns,com.iluwatar.databus.data,0,0,0,0,0,0,0,0
iluwatar_java-design-patterns,com.iluwatar.databus.members,1,1,0,0,0,0,0,2
iluwatar_java-design-patterns,com.iluwatar.datamapper,0,0,0,0,1,0,0,1
iluwatar_java-design-patterns,com.iluwatar.datatransfer,0,0,0,0,0,0,0,0
iluwatar_java-design-patterns,com.iluwatar.decorator,0,0,0,0,0,0,0,0
iluwatar_java-design-patterns,com.iluwatar.delegation.simple,0,0,0,0,0,0,0,0
iluwatar_java-design-patterns,com.iluwatar.delegation.simple.printers,0,0,0,0,0,0,0,0
iluwatar_java-design-patterns,com.iluwatar.dependency.injection,0,0,0,0,0,0,0,0
iluwatar_java-design-patterns,com.iluwatar.dependency.injection.utils,0,0,0,0,0,0,0,0
iluwatar_java-design-patterns,com.iluwatar.dirtyflag,0,0,0,0,0,0,0,0
iluwatar_java-design-patterns,org.dirty.flag,0,0,0,0,0,0,0,0
iluwatar_java-design-patterns,com.iluwatar.doublechecked.locking,0,0,0,0,1,0,0,1
iluwatar_java-design-patterns,com.iluwatar.doubledispatch,0,0,0,0,0,0,0,0
iluwatar_java-design-patterns,com.iluwatar.doubledispatch.constants,0,0,0,0,0,0,0,0
iluwatar_java-design-patterns,com.iluwatar.eip.aggregator,0,0,0,0,0,0,0,0
iluwatar_java-design-patterns,com.iluwatar.eip.aggregator.routes,0,0,0,0,0,0,0,0
iluwatar_java-design-patterns,com.iluwatar.eip.message.channel,0,0,0,0,0,0,0,0
iluwatar_java-design-patterns,com.iluwatar.eip.publish.subscribe,0,0,0,0,0,0,0,0
iluwatar_java-design-patterns,com.iluwatar.eip.splitter,0,0,0,0,0,0,0,0
iluwatar_java-design-patterns,com.iluwatar.eip.splitter.routes,0,0,0,0,0,0,0,0
iluwatar_java-design-patterns,com.iluwatar.eip.wiretap,0,0,0,0,0,0,0,0
iluwatar_java-design-patterns,com.iluwatar.eip.wiretap.routes,0,0,0,0,0,0,0,0
iluwatar_java-design-patterns,com.iluwatar.event.aggregator,0,0,0,0,0,0,0,0
iluwatar_java-design-patterns,com.iluwatar.event.asynchronous,0,0,0,0,0,0,0,0
iluwatar_java-design-patterns,com.iluwatar.eda,0,0,0,0,0,0,0,0
iluwatar_java-design-patterns,com.iluwatar.eda.event,0,0,0,0,0,1,0,1
iluwatar_java-design-patterns,com.iluwatar.eda.framework,0,0,0,0,0,0,0,0
iluwatar_java-design-patterns,com.iluwatar.eda.handler,0,0,0,0,0,1,0,1
iluwatar_java-design-patterns,com.iluwatar.eda.model,0,0,0,0,0,1,0,1
iluwatar_java-design-patterns,com.iluwatar.event.queue,0,0,0,0,0,0,0,0
iluwatar_java-design-patterns,com.iluwatar.event.sourcing.app,0,0,0,0,0,0,0,0
iluwatar_java-design-patterns,com.iluwatar.event.sourcing.domain,0,0,0,0,0,1,0,1
iluwatar_java-design-patterns,com.iluwatar.event.sourcing.event,0,1,0,0,0,1,0,2
iluwatar_java-design-patterns,com.iluwatar.event.sourcing.processor,0,0,0,0,0,0,0,0
iluwatar_java-design-patterns,com.iluwatar.event.sourcing.state,0,0,0,0,0,1,0,1
iluwatar_java-design-patterns,(default package),0,0,0,0,1,0,0,1
iluwatar_java-design-patterns,com.iluwatar.execute.around,0,0,0,0,0,0,0,0
iluwatar_java-design-patterns,abstractextensions,0,0,0,0,0,0,0,0
iluwatar_java-design-patterns,concreteextensions,1,0,0,0,1,0,0,2
iluwatar_java-design-patterns,units,1,1,0,0,0,0,0,2
iluwatar_java-design-patterns,com.iluwatar.facade,0,0,0,0,0,0,0,0
iluwatar_java-design-patterns,com.iluwatar.factorykit,0,0,0,0,1,0,0,1
iluwatar_java-design-patterns,com.iluwatar.factorykit.app,0,0,0,0,0,0,0,0
iluwatar_java-design-patterns,com.iluwatar.factorykit.factorykit,0,0,0,0,0,0,0,0
iluwatar_java-design-patterns,com.iluwatar.factory.method,0,0,0,0,0,0,0,0
iluwatar_java-design-patterns,com.iluwatar.featuretoggle,0,0,0,0,0,0,0,0
iluwatar_java-design-patterns,com.iluwatar.featuretoggle.pattern.propertiesversion,0,0,0,0,0,0,0,0
iluwatar_java-design-patterns,com.iluwatar.featuretoggle.pattern,0,0,0,0,0,0,0,0
iluwatar_java-design-patterns,com.iluwatar.featuretoggle.pattern.tieredversion,0,0,0,0,0,0,0,0
iluwatar_java-design-patterns,com.iluwatar.featuretoggle.user,0,0,0,0,0,0,0,0
iluwatar_java-design-patterns,com.iluwatar.fluentinterface.app,0,0,0,0,0,0,0,0
iluwatar_java-design-patterns,com.iluwatar.fluentinterface.fluentiterable,0,0,0,0,0,0,0,0
iluwatar_java-design-patterns,com.iluwatar.fluentinterface.fluentiterable.lazy,0,0,0,0,0,0,0,0
iluwatar_java-design-patterns,com.iluwatar.fluentinterface.fluentiterable.simple,0,0,0,0,0,0,0,0
iluwatar_java-design-patterns,com.iluwatar.flux.action,0,0,0,0,0,0,0,0
iluwatar_java-design-patterns,com.iluwatar.flux.app,0,0,0,0,0,0,0,0
iluwatar_java-design-patterns,com.iluwatar.flux.dispatcher,1,0,0,0,0,0,0,1
iluwatar_java-design-patterns,com.iluwatar.flux.store,2,1,0,0,0,0,0,3
iluwatar_java-design-patterns,com.iluwatar.flux.view,2,0,0,0,0,0,0,2
iluwatar_java-design-patterns,com.iluwatar.flyweight,0,0,0,0,0,0,0,0
iluwatar_java-design-patterns,com.iluwatar.front.controller,0,0,0,0,0,0,0,0
iluwatar_java-design-patterns,com.iluwatar.front.controller.utils,0,0,0,0,0,0,0,0
iluwatar_java-design-patterns,com.iluwatar.guarded.suspension,0,0,0,0,0,0,0,0
iluwatar_java-design-patterns,com.iluwatar.halfsynchalfasync,0,0,0,0,0,0,0,0
iluwatar_java-design-patterns,com.iluwatar.hexagonal.administration,0,0,0,0,0,0,0,0
iluwatar_java-design-patterns,com.iluwatar.hexagonal,0,0,0,0,0,0,0,0
iluwatar_java-design-patterns,com.iluwatar.hexagonal.banking,1,0,0,0,0,0,0,1
iluwatar_java-design-patterns,com.iluwatar.hexagonal.database,2,0,0,0,0,0,0,2
iluwatar_java-design-patterns,com.iluwatar.hexagonal.domain,4,1,0,0,0,0,0,5
iluwatar_java-design-patterns,com.iluwatar.hexagonal.eventlog,0,0,0,0,0,0,0,0
iluwatar_java-design-patterns,com.iluwatar.hexagonal.module,3,0,0,0,0,0,0,3
iluwatar_java-design-patterns,com.iluwatar.hexagonal.mongo,0,0,0,0,0,0,0,0
iluwatar_java-design-patterns,com.iluwatar.hexagonal.service,0,0,0,0,0,0,0,0
iluwatar_java-design-patterns,com.iluwatar.intercepting.filter,0,0,0,0,0,0,0,0
iluwatar_java-design-patterns,com.iluwatar.interpreter,0,0,0,0,0,0,0,0
iluwatar_java-design-patterns,com.iluwatar.iterator,0,0,0,0,0,0,0,0
iluwatar_java-design-patterns,com.iluwatar.iterator.bst,0,0,0,0,0,0,0,0
iluwatar_java-design-patterns,com.iluwatar.iterator.list,0,0,0,0,0,0,0,0
iluwatar_java-design-patterns,com.iluwatar.layers,0,0,0,0,0,0,0,0
iluwatar_java-design-patterns,com.iluwatar.lazy.loading,0,0,0,0,0,0,0,0
iluwatar_java-design-patterns,com.iluwatar.masterworker,3,1,0,0,1,0,0,5
iluwatar_java-design-patterns,com.iluwatar.masterworker.system,3,0,0,0,0,0,0,3
iluwatar_java-design-patterns,com.iluwatar.masterworker.system.systemmaster,3,1,0,0,0,0,0,4
iluwatar_java-design-patterns,com.iluwatar.masterworker.system.systemworkers,2,0,0,0,0,0,0,2
iluwatar_java-design-patterns,com.iluwatar.mediator,0,0,0,0,0,0,0,0
iluwatar_java-design-patterns,com.iluwatar.memento,0,0,0,0,0,0,0,0
iluwatar_java-design-patterns,com.iluwatar.model.view.controller,0,0,0,0,0,0,0,0
iluwatar_java-design-patterns,com.iluwatar.model.view.presenter,0,0,0,0,0,0,0,0
iluwatar_java-design-patterns,com.iluwatar.module,0,0,0,0,0,0,0,0
iluwatar_java-design-patterns,com.iluwatar.monad,0,0,0,0,0,0,0,0
iluwatar_java-design-patterns,com.iluwatar.monostate,0,0,0,0,0,0,0,0
iluwatar_java-design-patterns,com.iluwatar.multiton,0,0,0,0,0,0,0,0
iluwatar_java-design-patterns,com.iluwatar.mute,0,0,0,0,1,0,0,1
iluwatar_java-design-patterns,com.iluwatar.mutex,0,0,0,0,0,0,0,0
iluwatar_java-design-patterns,domainapp.dom.app.homepage,0,0,0,0,0,0,0,0
iluwatar_java-design-patterns,domainapp.dom.modules.simple,0,0,0,0,1,0,0,1
iluwatar_java-design-patterns,domainapp.fixture,0,0,0,0,0,0,0,0
iluwatar_java-design-patterns,domainapp.fixture.modules.simple,0,0,0,0,0,0,0,0
iluwatar_java-design-patterns,domainapp.fixture.scenarios,0,0,0,0,0,0,0,0
iluwatar_java-design-patterns,domainapp.webapp,0,0,0,0,0,0,0,0
iluwatar_java-design-patterns,com.iluwatar.nullobject,0,0,0,0,0,0,0,0
iluwatar_java-design-patterns,com.iluwatar.objectmother,0,0,0,0,0,0,0,0
iluwatar_java-design-patterns,com.iluwatar.object.pool,0,0,0,0,1,0,0,1
iluwatar_java-design-patterns,com.iluwatar.observer,0,0,0,0,1,0,0,1
iluwatar_java-design-patterns,com.iluwatar.observer.generic,0,0,0,0,1,0,0,1
iluwatar_java-design-patterns,com.iluwatar.observer.utils,0,0,0,0,0,0,0,0
iluwatar_java-design-patterns,com.iluwatar.pageobject,0,0,0,0,1,0,0,1
iluwatar_java-design-patterns,com.iluwatar.pageobject.pages,0,0,0,0,0,0,0,0
iluwatar_java-design-patterns,com.iluwatar.partialresponse,0,0,0,0,0,0,0,0
iluwatar_java-design-patterns,com.iluwatar.poison.pill,0,0,0,0,0,0,0,0
iluwatar_java-design-patterns,com.iluwatar.priority.queue,0,0,0,0,0,0,0,0
iluwatar_java-design-patterns,com.iluwatar.privateclassdata,0,0,0,0,0,0,0,0
iluwatar_java-design-patterns,com.iluwatar.privateclassdata.utils,0,0,0,0,0,0,0,0
iluwatar_java-design-patterns,com.iluwatar.producer.consumer,0,0,0,0,0,0,0,0
iluwatar_java-design-patterns,com.iluwatar.promise,0,0,0,0,1,0,0,1
iluwatar_java-design-patterns,com.iluwatar.property,0,0,0,0,0,0,0,0
iluwatar_java-design-patterns,com.iluwatar.prototype,0,0,0,0,0,0,0,0
iluwatar_java-design-patterns,com.iluwatar.proxy,0,0,0,0,0,0,0,0
iluwatar_java-design-patterns,com.iluwatar.proxy.utils,0,0,0,0,0,0,0,0
iluwatar_java-design-patterns,com.iluwatar.queue.load.leveling,0,0,0,0,0,0,0,0
iluwatar_java-design-patterns,com.iluwatar.reactor.app,0,0,0,0,0,0,0,0
iluwatar_java-design-patterns,com.iluwatar.reactor.framework,0,0,0,0,1,0,0,1
iluwatar_java-design-patterns,com.iluwatar.reader.writer.lock,0,0,0,0,0,0,0,0
iluwatar_java-design-patterns,com.iluwatar.reader.writer.lock.utils,0,0,0,0,0,0,0,0
iluwatar_java-design-patterns,com.iluwatar.repository,0,0,0,0,1,0,0,1
iluwatar_java-design-patterns,com.iluwatar.resource.acquisition.is.initialization,0,0,0,0,0,0,0,0
iluwatar_java-design-patterns,com.iluwatar.retry,0,0,0,0,0,0,0,0
iluwatar_java-design-patterns,com.iluwatar.semaphore,0,0,0,0,0,0,0,0
iluwatar_java-design-patterns,com.iluwatar.servant,0,0,0,0,0,0,0,0
iluwatar_java-design-patterns,com.iluwatar.serverless.baas.api,0,0,0,0,0,0,0,0
iluwatar_java-design-patterns,com.iluwatar.serverless.baas.model,0,0,0,0,0,0,0,0
iluwatar_java-design-patterns,com.iluwatar.serverless.faas.api,0,0,0,0,0,0,0,0
iluwatar_java-design-patterns,com.iluwatar.serverless.faas,0,0,0,0,0,0,0,0
iluwatar_java-design-patterns,com.iluwatar.servicelayer.app,0,0,0,0,0,0,0,0
iluwatar_java-design-patterns,com.iluwatar.servicelayer.common,0,0,0,0,0,0,0,0
iluwatar_java-design-patterns,com.iluwatar.servicelayer.hibernate,0,0,0,0,0,0,0,0
iluwatar_java-design-patterns,com.iluwatar.servicelayer.magic,0,0,0,0,0,1,0,1
iluwatar_java-design-patterns,com.iluwatar.servicelayer.spell,0,0,0,0,0,1,0,1
iluwatar_java-design-patterns,com.iluwatar.servicelayer.spellbook,0,0,0,0,0,1,0,1
iluwatar_java-design-patterns,com.iluwatar.servicelayer.wizard,0,0,0,0,0,0,0,0
iluwatar_java-design-patterns,com.iluwatar.servicelocator,0,0,0,0,1,0,0,1
iluwatar_java-design-patterns,com.iluwatar.singleton,0,0,0,0,0,0,0,0
iluwatar_java-design-patterns,com.iluwatar.spatialpartition,0,0,1,0,0,0,0,1
iluwatar_java-design-patterns,com.iluwatar.specification.app,0,0,0,0,0,0,0,0
iluwatar_java-design-patterns,com.iluwatar.specification.creature,0,0,0,0,0,0,0,0
iluwatar_java-design-patterns,com.iluwatar.specification.selector,0,0,0,0,1,0,0,1
iluwatar_java-design-patterns,com.iluwatar.state,0,0,0,0,0,0,0,0
iluwatar_java-design-patterns,com.iluwatar.stepbuilder,0,0,0,0,0,0,0,0
iluwatar_java-design-patterns,com.iluwatar.strategy,0,0,0,0,0,0,0,0
iluwatar_java-design-patterns,com.iluwatar.templatemethod,0,0,0,0,0,0,0,0
iluwatar_java-design-patterns,com.iluwatar.threadpool,0,0,0,0,1,0,0,1
iluwatar_java-design-patterns,com.iluwatar.throttling,0,0,0,0,1,0,0,1
iluwatar_java-design-patterns,com.iluwatar.throttling.timer,0,0,0,0,0,0,0,0
iluwatar_java-design-patterns,com.iluwatar.tls,0,0,0,0,0,0,0,0
iluwatar_java-design-patterns,com.iluwatar.tolerantreader,0,0,0,0,0,0,0,0
iluwatar_java-design-patterns,com.iluwatar.trampoline,0,0,0,0,0,0,0,0
iluwatar_java-design-patterns,com.iluwatar.twin,0,0,0,0,1,0,0,1
iluwatar_java-design-patterns,com.iluwatar.typeobject,0,0,1,0,0,0,0,1
iluwatar_java-design-patterns,com.iluwatar.unitofwork,0,0,0,0,0,0,0,0
iluwatar_java-design-patterns,com.iluwatar.value.object,0,0,0,0,0,0,0,0
iluwatar_java-design-patterns,com.iluwatar.visitor,0,0,0,0,0,0,0,0
imagej_imagej-ops,net.imagej.ops,77,1,0,1,0,12,0,91
imagej_imagej-ops,net.imagej.ops.bufferfactories,0,0,0,0,0,0,0,0
imagej_imagej-ops,net.imagej.ops.cached,0,0,0,0,1,0,0,1
imagej_imagej-ops,net.imagej.ops.coloc,1,0,0,0,1,0,0,2
imagej_imagej-ops,net.imagej.ops.coloc.icq,0,0,0,0,0,0,0,0
imagej_imagej-ops,net.imagej.ops.coloc.kendallTau,0,0,0,0,0,0,0,0
imagej_imagej-ops,net.imagej.ops.coloc.maxTKendallTau,0,0,0,0,0,0,0,0
imagej_imagej-ops,net.imagej.ops.coloc.pearsons,0,0,0,0,0,0,0,0
imagej_imagej-ops,net.imagej.ops.coloc.pValue,0,0,0,0,0,0,0,0
imagej_imagej-ops,net.imagej.ops.commands.convert,0,0,0,0,0,0,0,0
imagej_imagej-ops,net.imagej.ops.commands.convolve,0,0,0,0,0,0,0,0
imagej_imagej-ops,net.imagej.ops.commands.filter,0,0,0,0,0,0,0,0
imagej_imagej-ops,net.imagej.ops.commands.morphology,0,0,0,0,0,0,0,0
imagej_imagej-ops,net.imagej.ops.commands.project,0,0,0,0,0,0,0,0
imagej_imagej-ops,net.imagej.ops.commands.threshold,0,0,0,0,0,0,0,0
imagej_imagej-ops,net.imagej.ops.convert.clip,0,0,0,0,0,0,0,0
imagej_imagej-ops,net.imagej.ops.convert,3,0,0,1,1,0,0,5
imagej_imagej-ops,net.imagej.ops.convert.copy,0,0,0,0,0,0,0,0
imagej_imagej-ops,net.imagej.ops.convert.imageType,1,0,0,0,0,0,0,1
imagej_imagej-ops,net.imagej.ops.convert.normalizeScale,1,0,0,0,0,0,0,1
imagej_imagej-ops,net.imagej.ops.convert.scale,0,0,0,0,0,0,0,0
imagej_imagej-ops,net.imagej.ops.copy,4,0,0,0,1,1,0,6
imagej_imagej-ops,net.imagej.ops.create,5,0,0,0,1,0,0,6
imagej_imagej-ops,net.imagej.ops.create.img,1,0,0,0,1,0,0,2
imagej_imagej-ops,net.imagej.ops.create.imgFactory,0,0,0,0,0,0,0,0
imagej_imagej-ops,net.imagej.ops.create.imgLabeling,1,0,0,0,0,0,0,1
imagej_imagej-ops,net.imagej.ops.create.imgPlus,1,0,0,0,0,0,0,1
imagej_imagej-ops,net.imagej.ops.create.integerType,1,0,0,0,0,0,0,1
imagej_imagej-ops,net.imagej.ops.create.kernel,0,0,0,0,0,0,0,0
imagej_imagej-ops,net.imagej.ops.create.kernelBiGauss,0,0,0,0,1,0,0,1
imagej_imagej-ops,net.imagej.ops.create.kernelDiffraction,0,0,0,0,0,0,0,0
imagej_imagej-ops,net.imagej.ops.create.kernelGabor,0,0,0,0,1,0,0,1
imagej_imagej-ops,net.imagej.ops.create.kernelGauss,0,0,0,0,0,0,0,0
imagej_imagej-ops,net.imagej.ops.create.kernelLog,0,0,0,0,0,0,0,0
imagej_imagej-ops,net.imagej.ops.create.kernelSobel,0,0,0,0,0,0,0,0
imagej_imagej-ops,net.imagej.ops.create.labelingMapping,0,0,0,0,0,0,0,0
imagej_imagej-ops,net.imagej.ops.create.nativeType,1,0,0,0,0,0,0,1
imagej_imagej-ops,net.imagej.ops.create.object,0,0,0,0,0,0,0,0
imagej_imagej-ops,net.imagej.ops.deconvolve.accelerate,1,0,0,0,0,0,0,1
imagej_imagej-ops,net.imagej.ops.deconvolve,13,0,0,0,1,0,0,14
imagej_imagej-ops,net.imagej.ops.eval,0,0,0,0,0,0,0,0
imagej_imagej-ops,net.imagej.ops.features.haralick,2,0,0,0,1,0,0,3
imagej_imagej-ops,net.imagej.ops.features.haralick.helper,0,0,0,0,1,0,0,1
imagej_imagej-ops,net.imagej.ops.features.hog,0,0,0,0,0,0,0,0
imagej_imagej-ops,net.imagej.ops.features.lbp2d,2,0,0,0,1,0,0,3
imagej_imagej-ops,net.imagej.ops.features.tamura2d,2,0,0,0,1,0,0,3
imagej_imagej-ops,net.imagej.ops.features.zernike,2,0,0,0,1,0,0,3
imagej_imagej-ops,net.imagej.ops.features.zernike.helper,1,0,0,0,0,0,0,1
imagej_imagej-ops,net.imagej.ops.filter,16,0,0,0,1,0,0,17
imagej_imagej-ops,net.imagej.ops.filter.addNoise,0,0,0,0,0,0,0,0
imagej_imagej-ops,net.imagej.ops.filter.addPoissonNoise,0,0,0,0,0,0,0,0
imagej_imagej-ops,net.imagej.ops.filter.bilateral,1,0,0,0,0,0,0,1
imagej_imagej-ops,net.imagej.ops.filter.convolve,3,1,0,0,0,0,0,4
imagej_imagej-ops,net.imagej.ops.filter.correlate,3,1,0,0,0,0,0,4
imagej_imagej-ops,net.imagej.ops.filter.derivative,0,0,0,0,0,0,0,0
imagej_imagej-ops,net.imagej.ops.filter.derivativeGauss,0,0,0,0,0,0,0,0
imagej_imagej-ops,net.imagej.ops.filter.dog,0,0,0,0,0,0,0,0
imagej_imagej-ops,net.imagej.ops.filter.fft,4,1,0,0,0,0,0,5
imagej_imagej-ops,net.imagej.ops.filter.fftSize,2,0,0,0,0,0,0,2
imagej_imagej-ops,net.imagej.ops.filter.gauss,2,0,0,0,0,0,0,2
imagej_imagej-ops,net.imagej.ops.filter.hessian,0,0,0,0,0,0,0,0
imagej_imagej-ops,net.imagej.ops.filter.ifft,2,0,0,0,0,0,0,2
imagej_imagej-ops,net.imagej.ops.filter.max,1,0,0,0,0,0,0,1
imagej_imagej-ops,net.imagej.ops.filter.mean,2,0,0,0,0,0,0,2
imagej_imagej-ops,net.imagej.ops.filter.median,1,0,0,0,0,0,0,1
imagej_imagej-ops,net.imagej.ops.filter.min,1,0,0,0,0,0,0,1
imagej_imagej-ops,net.imagej.ops.filter.pad,4,0,0,0,1,0,0,5
imagej_imagej-ops,net.imagej.ops.filter.sigma,1,0,0,0,0,0,0,1
imagej_imagej-ops,net.imagej.ops.filter.sobel,0,0,0,0,0,0,0,0
imagej_imagej-ops,net.imagej.ops.filter.tubeness,0,0,0,0,0,0,0,0
imagej_imagej-ops,net.imagej.ops.filter.variance,1,0,0,0,0,0,0,1
imagej_imagej-ops,net.imagej.ops.filter.vesselness,0,0,0,0,0,0,0,0
imagej_imagej-ops,net.imagej.ops.geom,6,1,0,0,1,2,0,10
imagej_imagej-ops,net.imagej.ops.geom.geom2d,2,0,0,1,1,1,0,5
imagej_imagej-ops,net.imagej.ops.geom.geom3d,1,0,0,0,1,2,0,4
imagej_imagej-ops,net.imagej.ops.geom.geom3d.mesh,1,0,0,0,1,0,0,2
imagej_imagej-ops,net.imagej.ops.help,0,0,0,0,1,0,0,1
imagej_imagej-ops,net.imagej.ops.identity,0,0,0,0,0,0,0,0
imagej_imagej-ops,net.imagej.ops.image.ascii,0,0,0,0,0,0,0,0
imagej_imagej-ops,net.imagej.ops.image.cooccurrenceMatrix,0,0,0,0,0,0,0,0
imagej_imagej-ops,net.imagej.ops.image.distancetransform,0,0,0,0,1,0,0,1
imagej_imagej-ops,net.imagej.ops.image.equation,0,0,0,0,1,0,0,1
imagej_imagej-ops,net.imagej.ops.image.fill,0,0,0,0,0,0,0,0
imagej_imagej-ops,net.imagej.ops.image.histogram,1,0,0,0,0,0,0,1
imagej_imagej-ops,net.imagej.ops.image,1,0,0,0,0,0,0,1
imagej_imagej-ops,net.imagej.ops.image.integral,0,0,0,0,1,1,0,2
imagej_imagej-ops,net.imagej.ops.image.invert,0,0,0,0,0,0,0,0
imagej_imagej-ops,net.imagej.ops.image.normalize,0,0,0,0,0,0,0,0
imagej_imagej-ops,net.imagej.ops.image.watershed,0,0,0,0,1,0,0,1
imagej_imagej-ops,net.imagej.ops.imagemoments,1,0,0,0,0,0,0,1
imagej_imagej-ops,net.imagej.ops.imagemoments.centralmoments,0,0,0,0,1,1,0,2
imagej_imagej-ops,net.imagej.ops.imagemoments.hu,0,0,0,0,1,1,0,2
imagej_imagej-ops,net.imagej.ops.imagemoments.moments,0,0,0,0,0,0,0,0
imagej_imagej-ops,net.imagej.ops.imagemoments.normalizedcentralmoments,0,0,0,0,1,1,0,2
imagej_imagej-ops,net.imagej.ops.join,0,0,0,0,1,0,0,1
imagej_imagej-ops,net.imagej.ops.labeling.cca,0,0,0,0,0,0,0,0
imagej_imagej-ops,net.imagej.ops.labeling,2,0,0,0,0,0,0,2
imagej_imagej-ops,net.imagej.ops.linalg,1,0,0,0,0,0,0,1
imagej_imagej-ops,net.imagej.ops.linalg.rotate,1,0,0,0,0,0,0,1
imagej_imagej-ops,net.imagej.ops.logic,2,0,0,1,1,0,0,4
imagej_imagej-ops,net.imagej.ops.lookup,0,0,0,0,0,0,0,0
imagej_imagej-ops,net.imagej.ops.loop,0,0,0,0,1,0,0,1
imagej_imagej-ops,net.imagej.ops.map,8,1,0,1,0,0,0,10
imagej_imagej-ops,net.imagej.ops.map.neighborhood,0,0,0,0,1,0,0,1
imagej_imagej-ops,net.imagej.ops.math,5,0,0,1,1,1,0,8
imagej_imagej-ops,net.imagej.ops.math.multiply,2,0,0,0,0,0,0,2
imagej_imagej-ops,net.imagej.ops.morphology.blackTopHat,0,0,0,0,0,0,0,0
imagej_imagej-ops,net.imagej.ops.morphology.close,0,0,0,0,0,0,0,0
imagej_imagej-ops,net.imagej.ops.morphology.dilate,0,0,0,0,0,0,0,0
imagej_imagej-ops,net.imagej.ops.morphology.erode,0,0,0,0,0,0,0,0
imagej_imagej-ops,net.imagej.ops.morphology.extractHoles,0,0,0,0,0,0,0,0
imagej_imagej-ops,net.imagej.ops.morphology.fillHoles,0,0,0,0,0,0,0,0
imagej_imagej-ops,net.imagej.ops.morphology.floodFill,0,0,0,0,0,0,0,0
imagej_imagej-ops,net.imagej.ops.morphology,1,0,0,0,0,0,0,1
imagej_imagej-ops,net.imagej.ops.morphology.open,0,0,0,0,0,0,0,0
imagej_imagej-ops,net.imagej.ops.morphology.outline,0,0,0,0,0,0,0,0
imagej_imagej-ops,net.imagej.ops.morphology.thin,0,0,0,0,1,0,0,1
imagej_imagej-ops,net.imagej.ops.morphology.topHat,0,0,0,0,0,0,0,0
imagej_imagej-ops,net.imagej.ops.run,0,0,0,0,0,0,0,0
imagej_imagej-ops,net.imagej.ops.search,0,0,0,0,0,0,0,0
imagej_imagej-ops,net.imagej.ops.segment.detectJunctions,0,0,0,0,0,0,0,0
imagej_imagej-ops,net.imagej.ops.segment.detectRidges,0,0,0,0,0,0,0,0
imagej_imagej-ops,net.imagej.ops.segment,0,0,0,0,0,0,0,0
imagej_imagej-ops,net.imagej.ops.slice,0,0,0,0,1,0,0,1
imagej_imagej-ops,net.imagej.ops.special,2,0,0,1,1,2,0,6
imagej_imagej-ops,net.imagej.ops.special.chain,7,0,0,1,0,0,0,8
imagej_imagej-ops,net.imagej.ops.special.computer,0,0,0,0,1,1,0,2
imagej_imagej-ops,net.imagej.ops.special.function,0,0,0,0,1,2,0,3
imagej_imagej-ops,net.imagej.ops.special.hybrid,0,0,0,0,0,12,0,12
imagej_imagej-ops,net.imagej.ops.special.inplace,4,0,0,0,0,1,0,5
imagej_imagej-ops,net.imagej.ops.stats,1,0,0,1,0,1,0,3
imagej_imagej-ops,net.imagej.ops.stats.regression.leastSquares,0,0,0,0,0,0,0,0
imagej_imagej-ops,net.imagej.ops.thread.chunker,4,0,0,0,1,0,0,5
imagej_imagej-ops,net.imagej.ops.thread,2,0,0,0,1,0,0,3
imagej_imagej-ops,net.imagej.ops.threshold,1,0,0,1,1,0,0,3
imagej_imagej-ops,net.imagej.ops.threshold.apply,0,0,0,0,1,0,0,1
imagej_imagej-ops,net.imagej.ops.threshold.huang,0,0,0,0,0,0,0,0
imagej_imagej-ops,net.imagej.ops.threshold.ij1,0,0,0,0,0,0,0,0
imagej_imagej-ops,net.imagej.ops.threshold.intermodes,0,0,0,0,0,0,0,0
imagej_imagej-ops,net.imagej.ops.threshold.isoData,0,0,0,0,0,0,0,0
imagej_imagej-ops,net.imagej.ops.threshold.li,0,0,0,0,0,0,0,0
imagej_imagej-ops,net.imagej.ops.threshold.localBernsen,0,0,0,0,0,0,0,0
imagej_imagej-ops,net.imagej.ops.threshold.localContrast,0,0,0,0,0,0,0,0
imagej_imagej-ops,net.imagej.ops.threshold.localMean,0,0,0,0,0,0,0,0
imagej_imagej-ops,net.imagej.ops.threshold.localMedian,0,0,0,0,0,0,0,0
imagej_imagej-ops,net.imagej.ops.threshold.localMidGrey,0,0,0,0,0,0,0,0
imagej_imagej-ops,net.imagej.ops.threshold.localNiblack,0,0,0,0,0,0,0,0
imagej_imagej-ops,net.imagej.ops.threshold.localPhansalkar,0,0,0,0,0,0,0,0
imagej_imagej-ops,net.imagej.ops.threshold.localSauvola,0,0,0,0,0,0,0,0
imagej_imagej-ops,net.imagej.ops.threshold.maxEntropy,0,0,0,0,0,0,0,0
imagej_imagej-ops,net.imagej.ops.threshold.maxLikelihood,0,0,0,0,0,0,0,0
imagej_imagej-ops,net.imagej.ops.threshold.mean,0,0,0,0,0,0,0,0
imagej_imagej-ops,net.imagej.ops.threshold.minError,0,0,0,0,0,0,0,0
imagej_imagej-ops,net.imagej.ops.threshold.minimum,0,0,0,0,0,0,0,0
imagej_imagej-ops,net.imagej.ops.threshold.moments,0,0,0,0,0,0,0,0
imagej_imagej-ops,net.imagej.ops.threshold.otsu,0,0,0,0,0,0,0,0
imagej_imagej-ops,net.imagej.ops.threshold.percentile,0,0,0,0,0,0,0,0
imagej_imagej-ops,net.imagej.ops.threshold.renyiEntropy,0,0,0,0,0,0,0,0
imagej_imagej-ops,net.imagej.ops.threshold.rosin,0,0,0,0,0,0,0,0
imagej_imagej-ops,net.imagej.ops.threshold.shanbhag,0,0,0,0,0,0,0,0
imagej_imagej-ops,net.imagej.ops.threshold.triangle,0,0,0,0,0,0,0,0
imagej_imagej-ops,net.imagej.ops.threshold.yen,0,0,0,0,0,0,0,0
imagej_imagej-ops,net.imagej.ops.topology,1,0,0,0,0,0,0,1
imagej_imagej-ops,net.imagej.ops.topology.eulerCharacteristic,0,0,0,0,1,0,0,1
imagej_imagej-ops,net.imagej.ops.transform.addDimensionView,0,0,0,0,0,0,0,0
imagej_imagej-ops,net.imagej.ops.transform.collapseNumericView,0,0,0,0,0,0,0,0
imagej_imagej-ops,net.imagej.ops.transform.collapseRealView,0,0,0,0,0,0,0,0
imagej_imagej-ops,net.imagej.ops.transform.collapseView,0,0,0,0,0,0,0,0
imagej_imagej-ops,net.imagej.ops.transform.concatenateView,1,0,0,0,0,0,0,1
imagej_imagej-ops,net.imagej.ops.transform.crop,0,0,0,0,0,0,0,0
imagej_imagej-ops,net.imagej.ops.transform.dropSingletonDimensionsView,0,0,0,0,0,0,0,0
imagej_imagej-ops,net.imagej.ops.transform.extendBorderView,0,0,0,0,0,0,0,0
imagej_imagej-ops,net.imagej.ops.transform.extendMirrorDoubleView,0,0,0,0,0,0,0,0
imagej_imagej-ops,net.imagej.ops.transform.extendMirrorSingleView,0,0,0,0,0,0,0,0
imagej_imagej-ops,net.imagej.ops.transform.extendPeriodicView,0,0,0,0,0,0,0,0
imagej_imagej-ops,net.imagej.ops.transform.extendRandomView,0,0,0,0,0,0,0,0
imagej_imagej-ops,net.imagej.ops.transform.extendValueView,0,0,0,0,0,0,0,0
imagej_imagej-ops,net.imagej.ops.transform.extendView,0,0,0,0,0,0,0,0
imagej_imagej-ops,net.imagej.ops.transform.extendZeroView,0,0,0,0,0,0,0,0
imagej_imagej-ops,net.imagej.ops.transform.flatIterableView,0,0,0,0,0,0,0,0
imagej_imagej-ops,net.imagej.ops.transform.hyperSliceView,0,0,0,0,0,0,0,0
imagej_imagej-ops,net.imagej.ops.transform.interpolateView,0,0,0,0,0,0,0,0
imagej_imagej-ops,net.imagej.ops.transform.intervalView,0,0,0,0,0,0,0,0
imagej_imagej-ops,net.imagej.ops.transform.invertAxisView,0,0,0,0,0,0,0,0
imagej_imagej-ops,net.imagej.ops.transform.offsetView,0,0,0,0,0,0,0,0
imagej_imagej-ops,net.imagej.ops.transform.permuteCoordinatesInverseView,0,0,0,0,0,0,0,0
imagej_imagej-ops,net.imagej.ops.transform.permuteCoordinatesView,0,0,0,0,0,0,0,0
imagej_imagej-ops,net.imagej.ops.transform.permuteView,0,0,0,0,0,0,0,0
imagej_imagej-ops,net.imagej.ops.transform.project,0,0,0,0,1,0,0,1
imagej_imagej-ops,net.imagej.ops.transform.rasterView,0,0,0,0,0,0,0,0
imagej_imagej-ops,net.imagej.ops.transform.rotateView,0,0,0,0,0,0,0,0
imagej_imagej-ops,net.imagej.ops.transform.scaleView,0,0,0,0,0,0,0,0
imagej_imagej-ops,net.imagej.ops.transform.shearView,0,0,0,0,0,0,0,0
imagej_imagej-ops,net.imagej.ops.transform.stackView,0,0,0,0,0,0,0,0
imagej_imagej-ops,net.imagej.ops.transform,2,0,0,0,0,0,0,2
imagej_imagej-ops,net.imagej.ops.transform.translateView,0,0,0,0,0,0,0,0
imagej_imagej-ops,net.imagej.ops.transform.unshearView,0,0,0,0,0,0,0,0
imagej_imagej-ops,net.imagej.ops.transform.zeroMinView,0,0,0,0,0,0,0,0
imagej_imagej-ops,net.imagej.ops.benchmark,0,0,0,0,0,0,0,0
imagej_imagej-ops,net.imagej.ops.features,1,0,0,0,0,0,0,1
imagej_imagej-ops,net.imagej.ops.math.add,0,0,0,0,0,0,0,0
imagej_imagej-ops,net.imagej.ops.transform.dropSingleDimensionsView,0,0,0,0,0,0,0,0
imglib_imglib2,net.imglib2,10,1,0,1,0,46,1,59
imglib_imglib2,net.imglib2.concatenate,0,0,0,0,0,0,1,1
imglib_imglib2,net.imglib2.converter,10,0,0,1,1,4,1,17
imglib_imglib2,net.imglib2.converter.read,0,0,0,0,1,0,1,2
imglib_imglib2,net.imglib2.converter.readwrite,1,0,0,0,1,2,1,5
imglib_imglib2,net.imglib2.display,3,1,0,0,1,2,1,8
imglib_imglib2,net.imglib2.display.awt,0,0,0,0,0,0,1,1
imglib_imglib2,net.imglib2.display.projector,0,0,0,0,0,0,1,1
imglib_imglib2,net.imglib2.display.projector.composite,0,0,0,0,0,1,1,2
imglib_imglib2,net.imglib2.display.projector.specialized,0,0,0,0,0,2,1,3
imglib_imglib2,net.imglib2.display.projector.volatiles,0,0,0,0,0,0,1,1
imglib_imglib2,net.imglib2.display.screenimage.awt,1,0,0,0,0,0,1,2
imglib_imglib2,net.imglib2.display.screenimage,0,0,0,0,0,0,1,1
imglib_imglib2,net.imglib2.exception,0,0,0,0,0,0,1,1
imglib_imglib2,net.imglib2.histogram,0,0,0,0,0,3,1,4
imglib_imglib2,net.imglib2.img,3,0,0,0,1,15,1,20
imglib_imglib2,net.imglib2.img.array,14,1,0,0,0,11,1,27
imglib_imglib2,net.imglib2.img.basictypeaccess,0,0,0,0,1,0,1,2
imglib_imglib2,net.imglib2.img.basictypeaccess.array,0,0,0,0,0,4,1,5
imglib_imglib2,net.imglib2.img.basictypeaccess.volatiles.array,0,0,0,0,1,0,1,2
imglib_imglib2,net.imglib2.img.basictypeaccess.volatiles,0,0,0,0,0,1,1,2
imglib_imglib2,net.imglib2.img.cell,3,0,0,0,0,5,1,9
imglib_imglib2,net.imglib2.img.list,3,1,0,0,0,1,1,6
imglib_imglib2,net.imglib2.img.planar,1,0,0,0,0,6,1,8
imglib_imglib2,net.imglib2.img.sparse,0,0,0,0,0,1,1,2
imglib_imglib2,net.imglib2.interpolation,0,0,0,0,0,0,1,1
imglib_imglib2,net.imglib2.interpolation.neighborsearch,0,0,0,0,0,0,1,1
imglib_imglib2,net.imglib2.interpolation.randomaccess,0,0,0,0,1,4,1,6
imglib_imglib2,net.imglib2.iterator,0,0,0,0,0,0,1,1
imglib_imglib2,net.imglib2.loops,4,1,0,1,1,2,1,10
imglib_imglib2,net.imglib2.neighborsearch,0,0,0,0,1,1,1,3
imglib_imglib2,net.imglib2.outofbounds,4,1,0,0,0,2,1,8
imglib_imglib2,net.imglib2.position,0,0,0,0,1,1,1,3
imglib_imglib2,net.imglib2.position.transform,0,0,0,0,0,0,1,1
imglib_imglib2,net.imglib2.transform.integer,2,0,0,0,0,4,1,7
imglib_imglib2,net.imglib2.transform.integer.permutation,1,1,0,0,0,1,1,4
imglib_imglib2,net.imglib2.transform.integer.shear,2,0,0,0,0,2,1,5
imglib_imglib2,net.imglib2.transform,0,0,0,0,0,3,1,4
imglib_imglib2,net.imglib2.type,0,0,0,0,1,15,1,17
imglib_imglib2,net.imglib2.type.label,0,0,0,0,0,0,1,1
imglib_imglib2,net.imglib2.type.logic,2,1,0,0,1,2,1,7
imglib_imglib2,net.imglib2.type.numeric,3,0,0,0,1,14,1,19
imglib_imglib2,net.imglib2.type.numeric.complex,3,0,0,0,0,0,1,4
imglib_imglib2,net.imglib2.type.numeric.integer,4,1,0,1,0,18,1,25
imglib_imglib2,net.imglib2.type.numeric.real,4,1,0,0,0,4,1,10
imglib_imglib2,net.imglib2.type.operators,0,0,0,0,1,3,1,5
imglib_imglib2,net.imglib2.type.volatiles,0,0,0,0,0,4,1,5
imglib_imglib2,net.imglib2.util,37,1,0,1,1,10,1,51
imglib_imglib2,net.imglib2.view.composite,2,0,0,0,0,2,1,5
imglib_imglib2,net.imglib2.view,17,1,0,1,1,15,1,36
imglib_imglib2,net.imglib2.view.iteration,0,0,0,0,0,1,1,2
imglib_imglib2,net.imglib2.iterationorder,0,0,0,0,0,0,1,1
imglib_imglib2,net.imglib2.nearestneighbor,0,0,0,0,0,1,1,2
imglib_imglib2,net.imglib2.converter.generated,0,0,0,0,0,0,1,1
imglib_imglib2,net.imglib2.loops.generated,0,0,0,1,0,0,1,2
imglib_imglib2,net.imglib2.util.generated,0,0,0,0,0,0,1,1
imixs_imixs-workflow,org.imixs.workflow,5,1,0,1,0,14,1,22
imixs_imixs-workflow,org.imixs.workflow.bpmn,3,0,0,0,0,1,1,5
imixs_imixs-workflow,org.imixs.workflow.exceptions,0,0,0,0,1,3,1,5
imixs_imixs-workflow,org.imixs.workflow.services.rest,0,0,0,0,1,0,1,2
imixs_imixs-workflow,org.imixs.workflow.util,2,0,0,0,0,3,1,6
imixs_imixs-workflow,org.imixs.workflow.xml,4,0,0,0,1,3,1,9
imixs_imixs-workflow,org.imixs.workflow.engine.adapters,0,0,0,0,0,0,1,1
imixs_imixs-workflow,org.imixs.workflow.engine.adminp,0,0,0,0,0,1,1,2
imixs_imixs-workflow,org.imixs.workflow.engine,1,1,0,1,1,11,1,16
imixs_imixs-workflow,org.imixs.workflow.engine.index,1,0,0,0,0,0,1,2
imixs_imixs-workflow,org.imixs.workflow.engine.jpa,0,0,0,0,0,1,1,2
imixs_imixs-workflow,org.imixs.workflow.engine.plugins,0,1,0,0,0,5,1,7
imixs_imixs-workflow,org.imixs.workflow.engine.scheduler,0,0,0,0,0,2,1,3
imixs_imixs-workflow,org.imixs.workflow.plugins,0,0,0,0,1,2,1,4
imixs_imixs-workflow,org.imixs.workflow.faces.data,0,0,0,0,1,0,1,2
imixs_imixs-workflow,org.imixs.workflow.faces.fileupload,0,0,0,0,0,0,1,1
imixs_imixs-workflow,org.imixs.workflow.faces.util,0,0,0,0,1,0,1,2
imixs_imixs-workflow,org.imixs.workflow.jee.faces.workitem,0,0,0,0,0,0,1,1
imixs_imixs-workflow,org.imixs.workflow.engine.lucene,0,0,0,0,0,0,1,1
imixs_imixs-workflow,org.imixs.workflow.engine.solr,0,0,0,0,0,0,1,1
imixs_imixs-workflow,org.imixs.workflow.jaxrs,0,0,0,0,1,3,1,5
immutables_immutables,android,0,0,0,0,0,0,0,0
immutables_immutables,org.immutables.fixture.bug,0,0,0,0,0,0,0,0
immutables_immutables,org.immutable.fixture.annotate,0,0,0,0,1,0,0,1
immutables_immutables,org.immutables.builder.fixture,0,0,0,1,1,0,0,2
immutables_immutables,org.immutables.builder.fixture.telescopic,0,0,0,0,1,0,0,1
immutables_immutables,org.immutables.builder.fixture.external,0,0,0,0,0,0,0,0
immutables_immutables,org.immutables.criteria.backend,13,1,0,1,1,2,0,18
immutables_immutables,org.immutables.criteria,10,1,0,0,0,0,0,11
immutables_immutables,org.immutables.criteria.expression,0,0,0,0,1,2,0,3
immutables_immutables,org.immutables.criteria.matcher,13,1,0,1,0,0,0,15
immutables_immutables,org.immutables.criteria.reflect,0,0,0,0,1,0,0,1
immutables_immutables,org.immutables.criteria.repository,7,1,0,1,1,0,0,10
immutables_immutables,org.immutables.criteria.repository.async,4,0,0,1,0,0,0,5
immutables_immutables,org.immutables.criteria.repository.reactive,7,1,0,0,1,0,0,9
immutables_immutables,org.immutables.criteria.repository.sync,10,1,0,1,0,0,0,12
immutables_immutables,org.immutables.criteria.javabean,2,0,0,0,1,0,0,3
immutables_immutables,org.immutables.criteria.nested,0,0,0,1,0,0,0,1
immutables_immutables,org.immutables.criteria.personmodel,21,1,0,1,0,0,0,23
immutables_immutables,org.immutables.criteria.processor,0,0,0,1,1,0,0,2
immutables_immutables,org.immutables.criteria.self,0,0,0,0,1,0,0,1
immutables_immutables,org.immutables.criteria.typemodel,4,0,0,1,0,0,0,5
immutables_immutables,org.immutables.criteria.elasticsearch,0,0,0,1,1,0,0,2
immutables_immutables,org.immutables.criteria.geode,0,0,0,1,1,1,0,3
immutables_immutables,org.immutables.criteria.inmemory,0,0,0,1,1,0,0,2
immutables_immutables,org.immutables.criteria.mongo,0,0,0,1,1,1,0,3
immutables_immutables,org.immutables.criteria.mongo.bson4jackson,0,0,0,0,1,0,0,1
immutables_immutables,org.immutables.criteria.mongo.codecs,0,0,0,0,1,0,0,1
immutables_immutables,org.immutables.criteria.reactor,0,0,0,1,0,0,0,1
immutables_immutables,org.immutables.criteria.repository.rxjava2,0,0,0,1,0,0,0,1
immutables_immutables,org.immutables.criteria.sql,0,0,0,0,0,0,0,0
immutables_immutables,org.immutables.func.fixture,0,0,0,0,0,0,0,0
immutables_immutables,org.immutables.extgenerator,0,0,0,0,0,0,0,0
immutables_immutables,org.immutables.generator,0,0,0,1,1,0,0,2
immutables_immutables,org.immutables.generator.fixture,0,0,0,0,1,0,0,1
immutables_immutables,org.immutables.generator.processor,0,0,0,1,0,0,0,1
immutables_immutables,org.immutables.gson.adapter,0,0,0,1,0,0,0,1
immutables_immutables,org.immutables.gson.stream,0,0,0,0,1,0,0,1
immutables_immutables,org.immutables.fixture.modifiable,0,0,0,1,1,0,0,2
immutables_immutables,org.immutables.gson.adapter.android,0,0,0,0,0,0,0,0
immutables_immutables,org.immutables.gson.bridge,0,0,0,0,0,0,0,0
immutables_immutables,org.immutables.gson.packg,0,0,0,0,1,0,0,1
immutables_immutables,org.immutables.gson.packg.sub,0,0,0,0,0,0,0,0
immutables_immutables,org.immutables.metainf.processor,0,0,0,0,0,0,0,0
immutables_immutables,org.immutables.mirror.processor,0,0,0,0,1,0,0,1
immutables_immutables,org.immutables.mirror.fixture,0,0,0,0,0,0,0,0
immutables_immutables,org.immutables.mongo.bson4gson,0,0,0,0,1,0,0,1
immutables_immutables,org.immutables.mongo.bson4jackson,0,0,0,0,1,0,0,1
immutables_immutables,org.immutables.mongo.concurrent,0,0,0,0,0,0,0,0
immutables_immutables,org.immutables.mongo,0,0,0,0,0,0,0,0
immutables_immutables,org.immutables.mongo.repository.internal,0,0,0,0,0,0,0,0
immutables_immutables,org.immutables.mongo.repository,0,0,0,0,1,0,0,1
immutables_immutables,org.immutables.mongo.types,0,0,0,0,0,0,0,0
immutables_immutables,org.immutables.mongo.fixture,0,1,0,1,1,0,0,3
immutables_immutables,org.immutables.mongo.fixture.criteria,0,0,0,0,1,0,0,1
immutables_immutables,org.immutables.mongo.fixture.ent,0,0,0,0,1,0,0,1
immutables_immutables,org.immutables.mongo.fixture.flags,0,0,0,1,0,0,0,1
immutables_immutables,org.immutables.mongo.fixture.holder,0,0,0,0,1,0,0,1
immutables_immutables,org.immutables.mongo.fixture.sub,0,0,0,0,1,0,0,1
immutables_immutables,org.immutables.mongo.fixture.imp,0,0,0,0,0,0,0,0
immutables_immutables,org.immutables.ordinal,0,0,0,0,1,0,0,1
immutables_immutables,org.immutables.value.processor.meta,1,1,0,2,1,0,0,5
immutables_immutables,org.immutables.serial.fixture,0,0,0,0,0,0,0,0
immutables_immutables,org.immutables.check,0,0,0,0,1,0,0,1
immutables_immutables,org.immutables.trees.ast,0,0,0,1,0,0,0,1
immutables_immutables,org.immutables.dummy,0,0,0,0,0,0,0,0
immutables_immutables,android.os,0,0,0,0,1,0,0,1
immutables_immutables,(default package),0,0,0,0,1,0,0,1
immutables_immutables,nonimmutables,0,0,0,1,0,0,0,1
immutables_immutables,nonimmutables.alpha,0,0,0,0,1,0,0,1
immutables_immutables,nonimmutables.bravo,0,0,0,0,1,0,0,1
immutables_immutables,nonimmutables.imprt,0,0,0,0,0,0,0,0
immutables_immutables,nonimmutables.recurs,0,0,0,0,1,0,0,1
immutables_immutables,nonimmutables.shallow,0,0,0,0,0,0,0,0
immutables_immutables,nonimmutables.shallow.deep,0,0,0,0,1,0,0,1
immutables_immutables,nonimmutables.Uppercase,0,0,0,0,0,0,0,0
immutables_immutables,nonimmutables.Uppercase.nested,0,0,0,0,0,0,0,0
immutables_immutables,nonimmutables._underscore,0,0,0,0,0,0,0,0
immutables_immutables,org.immutables.fixture,0,0,0,2,1,0,0,3
immutables_immutables,org.immutables.fixture.annotation,0,0,0,1,1,0,0,2
immutables_immutables,org.immutables.fixture.ast,0,0,0,0,1,0,0,1
immutables_immutables,org.immutables.fixture.builder,0,0,0,0,0,0,0,0
immutables_immutables,org.immutables.fixture.builder.attribute_builders,0,0,0,0,0,0,0,0
immutables_immutables,org.immutables.fixture.builder.detection,0,0,0,0,0,0,0,0
immutables_immutables,org.immutables.fixture.builder.functional,0,0,0,0,0,0,0,0
immutables_immutables,org.immutables.fixture.couse,1,0,0,0,1,0,0,2
immutables_immutables,org.immutables.fixture.couse.sub,1,1,0,0,1,0,0,3
immutables_immutables,org.immutables.fixture.couse.sub2,0,0,0,0,0,0,0,0
immutables_immutables,org.immutables.fixture.custann,0,0,0,0,0,0,0,0
immutables_immutables,org.immutables.fixture.deep,0,0,0,0,1,0,0,1
immutables_immutables,org.immutables.fixture.encoding.defs,0,0,0,0,1,0,0,1
immutables_immutables,org.immutables.fixture.generatorext,0,0,0,0,0,0,0,0
immutables_immutables,org.immutables.fixture.generics,0,0,0,1,1,0,0,2
immutables_immutables,org.immutables.fixture.generics.alpha,0,0,0,0,0,0,0,0
immutables_immutables,org.immutables.fixture.generics.bravo,0,0,0,0,0,0,0,0
immutables_immutables,org.immutables.fixture.jackson,0,0,0,1,1,0,0,2
immutables_immutables,org.immutables.fixture.jackson.poly2,0,0,0,0,1,0,0,1
immutables_immutables,org.immutables.fixture.jdkonly,0,0,0,1,1,0,0,2
immutables_immutables,org.immutables.fixture.modifiable.nested,0,0,0,0,0,0,0,0
immutables_immutables,org.immutables.fixture.nested,1,1,0,1,0,0,0,3
immutables_immutables,org.immutables.fixture.nullable,0,0,0,1,1,0,0,2
immutables_immutables,org.immutables.fixture.ordered,0,0,0,0,0,0,0,0
immutables_immutables,org.immutables.fixture.packoutput,1,1,0,0,0,0,0,2
immutables_immutables,org.immutables.fixture.parcelable,0,0,0,0,0,0,0,0
immutables_immutables,org.immutables.fixture.routine,0,0,0,0,1,0,0,1
immutables_immutables,org.immutables.fixture.serial,0,0,0,0,1,0,0,1
immutables_immutables,org.immutables.fixture.strict,0,0,0,0,1,0,0,1
immutables_immutables,org.immutables.fixture.style,0,0,0,1,1,0,0,2
immutables_immutables,org.immutables.fixture.style.depl,0,0,0,0,0,0,0,0
immutables_immutables,org.immutables.fixture.style.nested.nest,0,0,0,0,0,0,0,0
immutables_immutables,org.immutables.fixture.style.nested,0,0,0,0,0,0,0,0
immutables_immutables,org.immutables.fixture.subpack,0,0,0,0,1,0,0,1
immutables_immutables,org.immutables.fixture.with,0,0,0,0,0,0,0,0
immutables_immutables,borg.immutables.fixture.packoutput.impl,1,0,0,0,1,0,0,2
immutables_immutables,org.immutables.fixture.encoding,0,0,0,1,0,0,0,1
immutables_immutables,org.immutables.fixture.marshal,1,0,0,0,0,0,0,1
immutables_immutables,org.immutables.metainf.fixture,0,0,0,0,1,0,0,1
immutables_immutables,org.immutables.processor,0,0,0,0,0,0,0,0
immutables_immutables,org.immutables.value.processor,0,0,0,2,1,0,0,3
immutables_immutables,org.immutables.value.processor.encode,1,0,0,1,0,0,0,2
indexiatech_antiquity,co.indexia.antiquity.graph,0,0,0,1,1,0,0,2
indexiatech_antiquity,co.indexia.antiquity.graph.blueprints,0,0,0,0,0,0,0,0
indexiatech_antiquity,co.indexia.antiquity.graph.identifierBehavior,0,0,0,0,0,0,0,0
indexiatech_antiquity,co.indexia.antiquity.range,0,0,0,0,0,0,0,0
indexiatech_antiquity,co.indexia.antiquity.graph.matchers,0,0,0,0,0,0,0,0
inductiveautomation_opc-ua-stack,com.digitalpetri.opcua.stack.client,0,0,0,0,1,0,1,2
inductiveautomation_opc-ua-stack,com.digitalpetri.opcua.stack.client.config,0,1,0,0,0,0,1,2
inductiveautomation_opc-ua-stack,com.digitalpetri.opcua.stack.client.handlers,0,0,0,0,0,0,1,1
inductiveautomation_opc-ua-stack,com.digitalpetri.opcua.stack.core.application,0,0,0,0,1,0,1,2
inductiveautomation_opc-ua-stack,com.digitalpetri.opcua.stack.core.application.services,0,0,0,0,1,0,1,2
inductiveautomation_opc-ua-stack,com.digitalpetri.opcua.stack.core,3,1,0,0,1,0,1,6
inductiveautomation_opc-ua-stack,com.digitalpetri.opcua.stack.core.channel,1,1,0,0,1,0,1,4
inductiveautomation_opc-ua-stack,com.digitalpetri.opcua.stack.core.channel.headers,0,1,0,0,0,0,1,2
inductiveautomation_opc-ua-stack,com.digitalpetri.opcua.stack.core.channel.messages,0,0,0,0,0,0,1,1
inductiveautomation_opc-ua-stack,com.digitalpetri.opcua.stack.core.serialization.binary,1,0,0,0,1,0,1,3
inductiveautomation_opc-ua-stack,com.digitalpetri.opcua.stack.core.serialization,2,0,0,0,1,0,1,4
inductiveautomation_opc-ua-stack,com.digitalpetri.opcua.stack.core.serialization.xml,0,0,0,0,0,0,1,1
inductiveautomation_opc-ua-stack,com.digitalpetri.opcua.stack.core.types.builtin,5,1,0,0,1,0,1,8
inductiveautomation_opc-ua-stack,com.digitalpetri.opcua.stack.core.types.builtin.unsigned,0,0,0,0,0,0,1,1
inductiveautomation_opc-ua-stack,com.digitalpetri.opcua.stack.core.types.structured,0,0,0,1,1,0,1,3
inductiveautomation_opc-ua-stack,com.digitalpetri.opcua.stack.core.util,2,0,0,0,1,0,1,4
inductiveautomation_opc-ua-stack,com.digitalpetri.opcua.stack,0,0,0,0,1,0,1,2
inductiveautomation_opc-ua-stack,com.digitalpetri.opcua.stack.examples.client,0,0,0,0,0,0,1,1
inductiveautomation_opc-ua-stack,com.digitalpetri.opcua.stack.examples,0,0,0,0,0,0,1,1
inductiveautomation_opc-ua-stack,com.digitalpetri.opcua.stack.examples.server,0,0,0,0,0,0,1,1
inductiveautomation_opc-ua-stack,com.digitalpetri.opcua.stack.server.config,0,1,0,0,0,0,1,2
inductiveautomation_opc-ua-stack,com.digitalpetri.opcua.stack.server,0,0,0,0,0,0,1,1
inductiveautomation_opc-ua-stack,com.digitalpetri.opcua.stack.server.handlers,0,0,0,0,0,0,1,1
inductiveautomation_opc-ua-stack,com.digitalpetri.opcua.stack.server.tcp,0,0,0,0,1,0,1,2
infiniteautomation_modbus4j,com.serotonin.modbus4j.base,16,1,0,0,1,2,1,21
infiniteautomation_modbus4j,com.serotonin.modbus4j,16,1,0,0,1,6,1,25
infiniteautomation_modbus4j,com.serotonin.modbus4j.code,0,0,0,0,0,0,1,1
infiniteautomation_modbus4j,com.serotonin.modbus4j.exception,0,0,0,0,1,0,1,2
infiniteautomation_modbus4j,com.serotonin.modbus4j.ip.encap,6,1,0,0,1,0,1,9
infiniteautomation_modbus4j,com.serotonin.modbus4j.ip,0,0,0,0,0,1,1,2
infiniteautomation_modbus4j,com.serotonin.modbus4j.ip.listener,2,0,0,0,0,1,1,4
infiniteautomation_modbus4j,com.serotonin.modbus4j.ip.tcp,5,0,0,0,0,1,1,7
infiniteautomation_modbus4j,com.serotonin.modbus4j.ip.udp,3,0,0,0,0,1,1,5
infiniteautomation_modbus4j,com.serotonin.modbus4j.ip.xa,2,1,0,0,1,0,1,5
infiniteautomation_modbus4j,com.serotonin.modbus4j.locator,1,0,0,0,0,0,1,2
infiniteautomation_modbus4j,com.serotonin.modbus4j.msg,7,0,0,0,0,1,1,9
infiniteautomation_modbus4j,com.serotonin.modbus4j.serial.ascii,1,0,0,0,0,1,1,3
infiniteautomation_modbus4j,com.serotonin.modbus4j.serial.rtu,2,0,0,0,0,1,1,4
infiniteautomation_modbus4j,com.serotonin.modbus4j.serial,0,0,0,0,1,0,1,2
infiniteautomation_modbus4j,com.serotonin.modbus4j.sero.epoll,0,0,0,0,0,0,1,1
infiniteautomation_modbus4j,com.serotonin.modbus4j.sero.io,0,0,0,0,0,0,1,1
infiniteautomation_modbus4j,com.serotonin.modbus4j.sero.log,0,0,0,0,0,0,1,1
infiniteautomation_modbus4j,com.serotonin.modbus4j.sero.messaging,0,0,0,0,1,5,1,7
infiniteautomation_modbus4j,com.serotonin.modbus4j.sero,0,0,0,0,0,0,1,1
infiniteautomation_modbus4j,com.serotonin.modbus4j.sero.timer,0,0,0,0,0,0,1,1
infiniteautomation_modbus4j,com.serotonin.modbus4j.sero.util,0,0,0,0,0,0,1,1
infiniteautomation_modbus4j,com.serotonin.modbus4j.sero.util.queue,0,0,0,0,0,0,1,1
infiniteautomation_modbus4j,com.serotonin.modbus4j.value,0,0,0,0,0,0,1,1
infiniteautomation_modbus4j,com.serotonin.modbus4j.logs,0,0,0,0,0,0,1,1
infiniteautomation_modbus4j,com.serotonin.cdc.io.serial,0,0,0,0,0,0,1,1
infiniteautomation_modbus4j,com.serotonin.cdc.io,0,0,0,0,0,0,1,1
infiniteautomation_modbus4j,com.serotonin.cdc.messaging,0,0,0,0,0,0,1,1
infiniteautomation_modbus4j,com.serotonin.cdc.modbus4j.base,5,1,0,0,1,0,1,8
infiniteautomation_modbus4j,com.serotonin.cdc.modbus4j,6,1,0,0,1,0,1,9
infiniteautomation_modbus4j,com.serotonin.cdc.modbus4j.code,0,0,0,0,0,0,1,1
infiniteautomation_modbus4j,com.serotonin.cdc.modbus4j.exception,0,0,0,0,1,0,1,2
infiniteautomation_modbus4j,com.serotonin.cdc.modbus4j.ip.encap,0,0,0,0,1,0,1,2
infiniteautomation_modbus4j,com.serotonin.cdc.modbus4j.ip,2,0,0,0,0,0,1,3
infiniteautomation_modbus4j,com.serotonin.cdc.modbus4j.ip.tcp,0,0,0,0,0,0,1,1
infiniteautomation_modbus4j,com.serotonin.cdc.modbus4j.ip.udp,0,0,0,0,0,0,1,1
infiniteautomation_modbus4j,com.serotonin.cdc.modbus4j.ip.xa,0,0,0,0,0,0,1,1
infiniteautomation_modbus4j,com.serotonin.cdc.modbus4j.locator,2,0,0,0,0,0,1,3
infiniteautomation_modbus4j,com.serotonin.cdc.modbus4j.msg,4,1,0,0,0,0,1,6
infiniteautomation_modbus4j,com.serotonin.cdc.modbus4j.serial.ascii,0,0,0,0,0,0,1,1
infiniteautomation_modbus4j,com.serotonin.cdc.modbus4j.serial.rtu,0,0,0,0,0,0,1,1
infiniteautomation_modbus4j,com.serotonin.cdc.modbus4j.serial,0,0,0,0,1,0,1,2
infiniteautomation_modbus4j,com.serotonin.cdc.modbus4j.value,0,0,0,0,0,0,1,1
infiniteautomation_modbus4j,com.serotonin.cdc,0,0,0,0,0,0,1,1
infiniteautomation_modbus4j,com.serotonin.cdc.util,0,0,0,0,0,0,1,1
infiniteautomation_modbus4j,com.serotonin.cdc.util.queue,0,0,0,0,0,0,1,1
infiniteautomation_modbus4j,gnu.io,0,0,0,0,0,0,1,1
infiniteautomation_modbus4j,(default package),0,0,0,0,0,0,1,1
internet-research-network_breeze,eu.icolumbo.breeze.build,0,0,0,0,0,0,0,0
internet-research-network_breeze,eu.icolumbo.breeze,0,0,0,0,1,0,0,1
internet-research-network_breeze,eu.icolumbo.breeze.connect,0,0,0,0,0,0,0,0
internet-research-network_breeze,eu.icolumbo.breeze.namespace,0,0,0,0,0,0,0,0
irobertson_pojomatic,org.pojomatic.diff,0,0,0,0,1,0,0,1
irobertson_pojomatic,org.pojomatic.formatter,1,1,0,0,1,0,0,3
irobertson_pojomatic,org.pojomatic.internal,2,0,0,1,1,0,0,4
irobertson_pojomatic,org.pojomatic,1,1,0,0,1,0,0,3
irobertson_pojomatic,examples,0,0,0,0,1,0,0,1
irobertson_pojomatic,org.pojomatic.internal.a,0,0,0,0,0,0,0,0
irobertson_pojomatic,org.pojomatic.internal.b,0,0,0,0,0,0,0,0
irobertson_pojomatic,org.pojomatic.internal.factory,0,0,0,0,0,0,0,0
irobertson_pojomatic,org.pojomatic.benchmark,0,0,0,0,0,0,0,0
irobertson_pojomatic,org.pojomatic.junit,0,0,0,0,0,0,0,0
j2ro_mod-http-event-bus-bridge,org.vertx.java.http.eventbusbridge.model,0,0,0,0,0,0,0,0
j2ro_mod-http-event-bus-bridge,org.vertx.java.http.eventbusbridge.security,0,0,0,0,0,0,0,0
j2ro_mod-http-event-bus-bridge,org.vertx.java.http.eventbusbridge.service,0,0,0,0,1,0,0,1
j2ro_mod-http-event-bus-bridge,org.vertx.java.http.eventbusbridge.util,0,0,0,0,0,0,0,0
j2ro_mod-http-event-bus-bridge,org.vertx.java.http.eventbusbridge.integration.handler,0,0,0,0,0,0,0,0
j2ro_mod-http-event-bus-bridge,org.vertx.java.http.eventbusbridge.integration,0,0,0,0,0,0,0,0
j2ro_mod-http-event-bus-bridge,org.vertx.java.http.eventbusbridge.integration.util,0,0,0,0,0,0,0,0
j2ro_mod-http-event-bus-bridge,org.vertx.java.http.eventbusbridge.unit,0,0,0,0,1,0,0,1
jabrena_livingrobots,livingrobots.ev3.ch1.helloWorld,0,0,0,0,1,0,0,1
jabrena_livingrobots,org.java_websocket,0,0,0,0,0,0,0,0
jabrena_livingrobots,org.java_websocket.client,0,0,0,0,1,0,0,1
jabrena_livingrobots,org.java_websocket.drafts,0,0,0,0,0,0,0,0
jabrena_livingrobots,org.java_websocket.exceptions,0,0,0,0,1,0,0,1
jabrena_livingrobots,org.java_websocket.framing,1,1,0,0,0,0,0,2
jabrena_livingrobots,org.java_websocket.handshake,0,0,0,0,0,0,0,0
jabrena_livingrobots,org.java_websocket.server,0,0,0,0,1,0,0,1
jabrena_livingrobots,org.java_websocket.util,1,0,0,0,0,0,0,1
jabrena_livingrobots,tts2,0,0,0,0,0,0,0,0
jabrena_livingrobots,(default package),0,0,0,1,1,0,0,2
jabrena_livingrobots,livingrobots.ev3.ch15,0,0,0,0,0,0,0,0
jabrena_livingrobots,livingrobots.ev3.ch15.syslog,0,0,0,0,0,0,0,0
jabrena_livingrobots,lejos.ev3.tools,0,0,0,0,1,0,0,1
jabrena_livingrobots,livingrobots.ev3.ch15.WLANSwitcher,0,0,0,0,0,0,0,0
jabrena_livingrobots,livingrobots.ev3.ch3,0,0,0,0,0,0,0,0
jabrena_livingrobots,livingrobots.ev3.ch3.Magic8Ball,0,0,0,0,0,0,0,0
jabrena_livingrobots,livingrobots.ev3.utils,0,0,0,0,0,0,0,0
jabrena_livingrobots,lejos.hardware.sensor,0,0,0,0,0,0,0,0
jabrena_livingrobots,mapping,0,0,0,0,1,0,0,1
jabrena_livingrobots,org.json,0,0,0,1,0,0,0,1
jabrena_livingrobots,graph,0,0,0,0,0,0,0,0
jabrena_livingrobots,livingrobots.ev3.ch7.motionDetection,0,0,0,0,0,0,0,0
jabrena_livingrobots,fi.iki.elonen,0,0,0,0,0,0,0,0
jabrena_livingrobots,org.projectodd.nodyn.buffer,0,0,0,0,0,0,0,0
jabrena_livingrobots,org.projectodd.nodyn.crypto.encoders,0,0,0,0,0,0,0,0
jabrena_livingrobots,org.projectodd.nodyn.crypto,0,0,0,0,0,0,0,0
jabrena_livingrobots,org.projectodd.nodyn,0,0,0,0,0,0,0,0
jabrena_livingrobots,org.projectodd.nodyn.posix,0,0,0,0,0,0,0,0
jabrena_livingrobots,org.projectodd.nodyn.process,0,0,0,0,0,0,0,0
jabrena_livingrobots,org.projectodd.nodyn.util,0,0,0,0,0,0,0,0
jai-imageio_jai-imageio-jpeg2000,com.github.jaiimageio.jpeg2000.impl,0,1,0,1,1,5,1,9
jai-imageio_jai-imageio-jpeg2000,com.github.jaiimageio.jpeg2000,0,0,0,0,0,0,1,1
jai-imageio_jai-imageio-jpeg2000,jj2000.j2k.codestream,0,0,0,0,1,3,1,5
jai-imageio_jai-imageio-jpeg2000,jj2000.j2k.codestream.reader,0,0,0,0,1,5,1,7
jai-imageio_jai-imageio-jpeg2000,jj2000.j2k.codestream.writer,0,0,0,0,1,3,1,5
jai-imageio_jai-imageio-jpeg2000,jj2000.j2k.decoder,0,0,0,0,0,0,1,1
jai-imageio_jai-imageio-jpeg2000,jj2000.j2k.entropy,0,0,0,0,1,0,1,2
jai-imageio_jai-imageio-jpeg2000,jj2000.j2k.entropy.decoder,0,0,0,0,1,0,1,2
jai-imageio_jai-imageio-jpeg2000,jj2000.j2k.entropy.encoder,0,0,0,0,0,1,1,2
jai-imageio_jai-imageio-jpeg2000,jj2000.j2k.fileformat,0,0,0,0,0,0,1,1
jai-imageio_jai-imageio-jpeg2000,jj2000.j2k.fileformat.reader,0,0,0,0,0,1,1,2
jai-imageio_jai-imageio-jpeg2000,jj2000.j2k.fileformat.writer,0,0,0,0,0,0,1,1
jai-imageio_jai-imageio-jpeg2000,jj2000.j2k.image,1,1,0,0,1,5,1,9
jai-imageio_jai-imageio-jpeg2000,jj2000.j2k.image.forwcomptransf,0,0,0,0,0,1,1,2
jai-imageio_jai-imageio-jpeg2000,jj2000.j2k.image.input,0,0,0,0,0,0,1,1
jai-imageio_jai-imageio-jpeg2000,jj2000.j2k.image.invcomptransf,1,0,0,0,0,1,1,3
jai-imageio_jai-imageio-jpeg2000,jj2000.j2k,0,0,0,0,1,11,1,13
jai-imageio_jai-imageio-jpeg2000,jj2000.j2k.io,0,0,0,0,0,4,1,5
jai-imageio_jai-imageio-jpeg2000,jj2000.j2k.quantization.dequantizer,0,0,0,0,0,1,1,2
jai-imageio_jai-imageio-jpeg2000,jj2000.j2k.quantization,0,0,0,0,0,0,1,1
jai-imageio_jai-imageio-jpeg2000,jj2000.j2k.quantization.quantizer,0,1,0,0,0,3,1,5
jai-imageio_jai-imageio-jpeg2000,jj2000.j2k.roi.encoder,0,0,0,0,0,0,1,1
jai-imageio_jai-imageio-jpeg2000,jj2000.j2k.roi,0,0,0,0,0,0,1,1
jai-imageio_jai-imageio-jpeg2000,jj2000.j2k.util,0,0,0,0,1,4,1,6
jai-imageio_jai-imageio-jpeg2000,jj2000.j2k.wavelet.analysis,0,0,0,0,0,4,1,5
jai-imageio_jai-imageio-jpeg2000,jj2000.j2k.wavelet,0,0,0,0,1,2,1,4
jai-imageio_jai-imageio-jpeg2000,jj2000.j2k.wavelet.synthesis,0,0,0,0,1,2,1,4
jaibeermalik_elasticsearch-tutorial,org.jai.search.client.impl,0,0,0,0,0,0,0,0
jaibeermalik_elasticsearch-tutorial,org.jai.search.client,0,0,0,0,0,0,0,0
jaibeermalik_elasticsearch-tutorial,org.jai.search.data,0,0,0,0,0,0,0,0
jaibeermalik_elasticsearch-tutorial,org.jai.search.index.impl,0,0,0,0,0,0,0,0
jaibeermalik_elasticsearch-tutorial,org.jai.search.index,0,0,0,0,0,0,0,0
jaibeermalik_elasticsearch-tutorial,org.jai.search.model,0,0,0,0,1,0,0,1
jaibeermalik_elasticsearch-tutorial,org.jai.search.query.impl,0,0,0,0,0,0,0,0
jaibeermalik_elasticsearch-tutorial,org.jai.search.query,0,0,0,0,0,0,0,0
jaibeermalik_elasticsearch-tutorial,org.jai.search.setup.impl,0,0,0,0,0,0,0,0
jaibeermalik_elasticsearch-tutorial,org.jai.search.setup,0,0,0,0,0,0,0,0
jaibeermalik_elasticsearch-tutorial,org.jai.search.util,0,0,0,0,0,0,0,0
jaibeermalik_elasticsearch-tutorial,org.jai.search.parts.five,0,0,0,0,0,0,0,0
jaibeermalik_elasticsearch-tutorial,org.jai.search.parts.four,0,0,0,0,0,0,0,0
jaibeermalik_elasticsearch-tutorial,org.jai.search.parts.one,0,0,0,0,0,0,0,0
jaibeermalik_elasticsearch-tutorial,org.jai.search.parts.three,0,0,0,0,0,0,0,0
jaibeermalik_elasticsearch-tutorial,org.jai.search.parts.two,0,0,0,0,0,0,0,0
jamesagnew_hapi-fhir,(default package),0,0,0,0,0,0,1,1
jamesagnew_hapi-fhir,embedded,0,0,0,0,0,0,1,1
jamesagnew_hapi-fhir,embedded.example,0,0,0,0,0,0,1,1
jamesagnew_hapi-fhir,embedded.example.jerseyguice,0,0,0,0,0,0,1,1
jamesagnew_hapi-fhir,ca.uhn.fhir.jpa.cds.example,0,0,0,0,0,0,1,1
jamesagnew_hapi-fhir,ca.uhn.fhir.jpa.demo,0,0,0,0,1,0,1,2
jamesagnew_hapi-fhir,example,0,0,0,1,1,9,1,12
jamesagnew_hapi-fhir,example.customtype,0,0,0,0,0,0,1,1
jamesagnew_hapi-fhir,example.interceptor,0,0,0,0,0,0,1,1
jamesagnew_hapi-fhir,ca.uhn.fhir.android,0,0,0,0,0,0,1,1
jamesagnew_hapi-fhir,android.util,0,0,0,0,0,0,1,1
jamesagnew_hapi-fhir,ca.uhn.fhir.android.client,0,0,0,0,0,0,1,1
jamesagnew_hapi-fhir,ca.uhn.fhir.context,6,1,0,1,1,54,1,64
jamesagnew_hapi-fhir,ca.uhn.fhir.context.support,0,0,0,0,1,0,1,2
jamesagnew_hapi-fhir,ca.uhn.fhir.fluentpath,0,0,0,0,0,0,1,1
jamesagnew_hapi-fhir,ca.uhn.fhir.i18n,1,0,0,0,0,0,1,2
jamesagnew_hapi-fhir,ca.uhn.fhir.interceptor.api,0,0,0,0,1,2,1,4
jamesagnew_hapi-fhir,ca.uhn.fhir.interceptor.executor,0,0,0,0,1,0,1,2
jamesagnew_hapi-fhir,ca.uhn.fhir.model.api,6,0,0,1,1,21,1,30
jamesagnew_hapi-fhir,ca.uhn.fhir.model.base.composite,4,0,0,0,1,6,1,12
jamesagnew_hapi-fhir,ca.uhn.fhir.model.base.resource,0,0,0,0,0,0,1,1
jamesagnew_hapi-fhir,ca.uhn.fhir.model.primitive,19,1,0,1,1,7,1,30
jamesagnew_hapi-fhir,ca.uhn.fhir.model.view,0,0,0,0,0,1,1,2
jamesagnew_hapi-fhir,ca.uhn.fhir.narrative,0,0,0,0,1,0,1,2
jamesagnew_hapi-fhir,ca.uhn.fhir.narrative2,0,0,0,0,1,1,1,3
jamesagnew_hapi-fhir,ca.uhn.fhir.parser,14,1,0,1,1,20,1,38
jamesagnew_hapi-fhir,ca.uhn.fhir.parser.json,0,0,0,0,0,0,1,1
jamesagnew_hapi-fhir,ca.uhn.fhir.rest.api,10,1,0,0,1,13,1,26
jamesagnew_hapi-fhir,ca.uhn.fhir.rest.client.api,0,0,0,0,1,19,1,21
jamesagnew_hapi-fhir,ca.uhn.fhir.rest.client.exceptions,0,0,0,0,0,0,1,1
jamesagnew_hapi-fhir,ca.uhn.fhir.rest.gclient,0,0,0,1,1,14,1,17
jamesagnew_hapi-fhir,ca.uhn.fhir.rest.param,5,1,0,1,0,6,1,14
jamesagnew_hapi-fhir,ca.uhn.fhir.rest.param.binder,2,0,0,0,0,0,1,3
jamesagnew_hapi-fhir,ca.uhn.fhir.rest.server.exceptions,4,0,0,0,0,1,1,6
jamesagnew_hapi-fhir,ca.uhn.fhir.store,0,0,0,0,0,0,1,1
jamesagnew_hapi-fhir,ca.uhn.fhir.util,21,1,0,1,1,8,1,33
jamesagnew_hapi-fhir,ca.uhn.fhir.util.bundle,1,0,0,0,0,0,1,2
jamesagnew_hapi-fhir,ca.uhn.fhir.util.jar,0,0,0,0,0,0,1,1
jamesagnew_hapi-fhir,ca.uhn.fhir.util.rdf,0,0,0,0,0,0,1,1
jamesagnew_hapi-fhir,ca.uhn.fhir.validation,0,1,0,0,1,0,1,3
jamesagnew_hapi-fhir,ca.uhn.fhir.validation.schematron,0,0,0,0,0,0,1,1
jamesagnew_hapi-fhir,org.hl7.fhir.instance.model.api,0,0,0,1,0,16,1,18
jamesagnew_hapi-fhir,ca.uhn.fhir.cli,0,0,0,1,1,0,1,3
jamesagnew_hapi-fhir,ca.uhn.fhir.rest.client.apache,0,1,0,0,1,1,1,4
jamesagnew_hapi-fhir,ca.uhn.fhir.rest.client.impl,1,1,0,1,1,1,1,6
jamesagnew_hapi-fhir,ca.uhn.fhir.rest.client.interceptor,0,0,0,0,1,3,1,5
jamesagnew_hapi-fhir,ca.uhn.fhir.rest.client.method,1,0,0,1,1,3,1,7
jamesagnew_hapi-fhir,ca.uhn.fhir.okhttp.client,0,1,0,0,0,0,1,2
jamesagnew_hapi-fhir,ca.uhn.fhir.okhttp.utils,0,0,0,0,0,0,1,1
jamesagnew_hapi-fhir,ca.uhn.fhir.okhttp,0,0,0,0,0,0,1,1
jamesagnew_hapi-fhir,ca.uhn.hapi.converters.server,0,0,0,0,0,0,1,1
jamesagnew_hapi-fhir,org.hl7.fhir.converter,0,0,0,0,0,0,1,1
jamesagnew_hapi-fhir,ca.uhn.hapi.fhir.docs,0,0,0,1,1,16,1,19
jamesagnew_hapi-fhir,ca.uhn.hapi.fhir.docs.customtype,0,0,0,0,1,0,1,2
jamesagnew_hapi-fhir,ca.uhn.hapi.fhir.docs.interceptor,0,0,0,0,0,0,1,1
jamesagnew_hapi-fhir,ca.uhn.fhir.igpacks.parser,0,0,0,0,0,0,1,1
jamesagnew_hapi-fhir,ca.uhn.fhir.igpack.parser,0,0,0,0,0,0,1,1
jamesagnew_hapi-fhir,ca.uhn.fhir.jaxrs.client,0,1,0,0,1,0,1,3
jamesagnew_hapi-fhir,ca.uhn.fhir.jaxrs.server,0,0,0,0,1,0,1,2
jamesagnew_hapi-fhir,ca.uhn.fhir.jaxrs.server.interceptor,0,0,0,0,0,0,1,1
jamesagnew_hapi-fhir,ca.uhn.fhir.jaxrs.server.util,0,1,0,0,1,1,1,4
jamesagnew_hapi-fhir,ca.uhn.fhir.jaxrs.server.example,0,0,0,0,1,0,1,2
jamesagnew_hapi-fhir,ca.uhn.fhir.jpa.binstore,0,0,0,0,1,0,1,2
jamesagnew_hapi-fhir,ca.uhn.fhir.jpa.bulk,0,0,0,0,1,0,1,2
jamesagnew_hapi-fhir,ca.uhn.fhir.jpa.config,2,1,0,0,1,0,1,5
jamesagnew_hapi-fhir,ca.uhn.fhir.jpa.config.dstu3,0,0,0,0,0,0,1,1
jamesagnew_hapi-fhir,ca.uhn.fhir.jpa.config.r4,0,0,0,0,0,0,1,1
jamesagnew_hapi-fhir,ca.uhn.fhir.jpa.config.r5,0,0,0,0,0,0,1,1
jamesagnew_hapi-fhir,ca.uhn.fhir.jpa.dao,22,1,0,1,1,3,1,29
jamesagnew_hapi-fhir,ca.uhn.fhir.jpa.dao.data,0,0,1,1,1,0,1,4
jamesagnew_hapi-fhir,ca.uhn.fhir.jpa.dao.dstu3,4,0,0,1,1,1,1,8
jamesagnew_hapi-fhir,ca.uhn.fhir.jpa.dao.expunge,0,0,0,0,1,0,1,2
jamesagnew_hapi-fhir,ca.uhn.fhir.jpa.dao.index,1,0,0,0,0,0,1,2
jamesagnew_hapi-fhir,ca.uhn.fhir.jpa.dao.r4,16,0,0,1,1,0,1,19
jamesagnew_hapi-fhir,ca.uhn.fhir.jpa.dao.r5,0,0,0,0,1,0,1,2
jamesagnew_hapi-fhir,ca.uhn.fhir.jpa.delete,1,0,0,0,1,0,1,3
jamesagnew_hapi-fhir,ca.uhn.fhir.jpa.entity,3,0,0,0,1,0,1,5
jamesagnew_hapi-fhir,ca.uhn.fhir.jpa.graphql,0,0,0,0,0,0,1,1
jamesagnew_hapi-fhir,ca.uhn.fhir.jpa.interceptor,0,0,0,0,0,0,1,1
jamesagnew_hapi-fhir,ca.uhn.fhir.jpa.provider,12,1,0,1,1,0,1,16
jamesagnew_hapi-fhir,ca.uhn.fhir.jpa.provider.dstu3,8,1,0,1,1,0,1,12
jamesagnew_hapi-fhir,ca.uhn.fhir.jpa.provider.r4,4,0,0,1,1,0,1,7
jamesagnew_hapi-fhir,ca.uhn.fhir.jpa.provider.r5,0,0,0,0,1,0,1,2
jamesagnew_hapi-fhir,ca.uhn.fhir.jpa.sched,0,0,0,0,1,0,1,2
jamesagnew_hapi-fhir,ca.uhn.fhir.jpa.search.cache,0,0,0,0,1,0,1,2
jamesagnew_hapi-fhir,ca.uhn.fhir.jpa.search,6,1,0,0,1,0,1,9
jamesagnew_hapi-fhir,ca.uhn.fhir.jpa.search.elastic,0,0,0,0,0,0,1,1
jamesagnew_hapi-fhir,ca.uhn.fhir.jpa.search.reindex,1,0,0,0,0,0,1,2
jamesagnew_hapi-fhir,ca.uhn.fhir.jpa.search.warm,0,0,0,0,0,0,1,1
jamesagnew_hapi-fhir,ca.uhn.fhir.jpa.sp,0,0,0,0,0,0,1,1
jamesagnew_hapi-fhir,ca.uhn.fhir.jpa.subscription,1,0,0,0,1,2,1,5
jamesagnew_hapi-fhir,ca.uhn.fhir.jpa.subscription.dbcache,0,0,0,0,0,0,1,1
jamesagnew_hapi-fhir,ca.uhn.fhir.jpa.subscription.dbmatcher,0,0,0,0,0,0,1,1
jamesagnew_hapi-fhir,ca.uhn.fhir.jpa.term.api,5,1,0,0,1,0,1,8
jamesagnew_hapi-fhir,ca.uhn.fhir.jpa.term,9,1,0,1,1,0,1,13
jamesagnew_hapi-fhir,ca.uhn.fhir.jpa.term.custom,3,1,0,0,0,0,1,5
jamesagnew_hapi-fhir,ca.uhn.fhir.jpa.term.ex,0,0,0,0,0,0,1,1
jamesagnew_hapi-fhir,ca.uhn.fhir.jpa.term.loinc,2,0,0,0,1,0,1,4
jamesagnew_hapi-fhir,ca.uhn.fhir.jpa.term.snomedct,0,0,0,0,0,0,1,1
jamesagnew_hapi-fhir,ca.uhn.fhir.jpa.util,0,0,0,1,1,1,1,4
jamesagnew_hapi-fhir,ca.uhn.fhir.jpa.util.jsonpatch,0,0,0,0,0,0,1,1
jamesagnew_hapi-fhir,ca.uhn.fhir.jpa.util.xmlpatch,0,0,0,0,0,0,1,1
jamesagnew_hapi-fhir,ca.uhn.fhir.jpa.validation,0,0,0,0,0,0,1,1
jamesagnew_hapi-fhir,ca.uhn.fhir.jpa.config.min,0,0,0,0,0,0,1,1
jamesagnew_hapi-fhir,ca.uhn.fhir.jpa.dao.dstu2,4,1,0,0,1,1,1,8
jamesagnew_hapi-fhir,ca.uhn.fhir.jpa.search.r4,0,0,0,0,0,0,1,1
jamesagnew_hapi-fhir,ca.uhn.fhir.jpa.searchparam,1,1,0,0,1,0,1,4
jamesagnew_hapi-fhir,ca.uhn.fhir.jpa.subscription.email,0,0,0,0,0,0,1,1
jamesagnew_hapi-fhir,ca.uhn.fhir.jpa.subscription.module.matcher,0,0,0,0,1,0,1,2
jamesagnew_hapi-fhir,ca.uhn.fhir.jpa.subscription.resthook,0,0,0,0,1,0,1,2
jamesagnew_hapi-fhir,ca.uhn.fhir.jpa.subscription.websocket,0,0,0,0,1,3,1,5
jamesagnew_hapi-fhir,ca.uhn.fhir.jpa.z,0,0,0,0,0,0,1,1
jamesagnew_hapi-fhir,ca.uhn.fhir.validator,0,0,0,0,0,1,1,2
jamesagnew_hapi-fhir,ca.uhn.fhir.jpa.rp.dstu2,0,0,0,1,1,0,1,3
jamesagnew_hapi-fhir,ca.uhn.fhir.jpa.rp.dstu3,0,0,0,1,1,0,1,3
jamesagnew_hapi-fhir,ca.uhn.fhir.jpa.rp.r4,0,0,0,1,1,0,1,3
jamesagnew_hapi-fhir,ca.uhn.fhir.jpa.rp.r5,0,0,0,1,1,0,1,3
jamesagnew_hapi-fhir,ca.uhn.fhir.jpa.demo.elasticsearch,0,0,0,0,0,0,1,1
jamesagnew_hapi-fhir,ca.uhn.fhir.jpa.migrate,1,1,0,0,1,0,1,4
jamesagnew_hapi-fhir,ca.uhn.fhir.jpa.migrate.taskdef,4,1,0,1,1,0,1,8
jamesagnew_hapi-fhir,ca.uhn.fhir.jpa.migrate.tasks.api,2,1,0,0,1,0,1,5
jamesagnew_hapi-fhir,ca.uhn.fhir.jpa.migrate.tasks,2,0,0,0,0,0,1,3
jamesagnew_hapi-fhir,ca.uhn.fhir.jpa.api,0,0,0,0,0,0,1,1
jamesagnew_hapi-fhir,ca.uhn.fhir.jpa.model.any,0,0,0,0,0,1,1,2
jamesagnew_hapi-fhir,ca.uhn.fhir.jpa.model.cross,0,0,0,0,0,2,1,3
jamesagnew_hapi-fhir,ca.uhn.fhir.jpa.model.entity,0,0,0,1,1,0,1,3
jamesagnew_hapi-fhir,ca.uhn.fhir.jpa.model.sched,0,0,0,0,0,0,1,1
jamesagnew_hapi-fhir,ca.uhn.fhir.jpa.model.search,0,0,0,0,0,0,1,1
jamesagnew_hapi-fhir,ca.uhn.fhir.jpa.model.util,0,0,0,0,0,0,1,1
jamesagnew_hapi-fhir,ca.uhn.fhir.jpa.searchparam.config,0,0,0,0,0,0,1,1
jamesagnew_hapi-fhir,ca.uhn.fhir.jpa.searchparam.extractor,0,0,0,0,1,1,1,3
jamesagnew_hapi-fhir,ca.uhn.fhir.jpa.searchparam.matcher,0,0,0,0,1,0,1,2
jamesagnew_hapi-fhir,ca.uhn.fhir.jpa.searchparam.provider,0,0,0,0,0,0,1,1
jamesagnew_hapi-fhir,ca.uhn.fhir.jpa.searchparam.registry,1,0,0,0,0,0,1,2
jamesagnew_hapi-fhir,ca.uhn.fhir.jpa.searchparam.retry,0,0,0,0,0,0,1,1
jamesagnew_hapi-fhir,ca.uhn.fhir.jpa.searchparam.util,0,0,0,0,0,0,1,1
jamesagnew_hapi-fhir,ca.uhn.fhir.jpa.subscription.module.cache,1,0,0,0,1,0,1,3
jamesagnew_hapi-fhir,ca.uhn.fhir.jpa.subscription.module,2,1,0,0,1,1,1,6
jamesagnew_hapi-fhir,ca.uhn.fhir.jpa.subscription.module.channel,0,0,0,0,1,0,1,2
jamesagnew_hapi-fhir,ca.uhn.fhir.jpa.subscription.module.config,0,0,0,0,1,0,1,2
jamesagnew_hapi-fhir,ca.uhn.fhir.jpa.subscription.module.interceptor,0,0,0,0,0,1,1,2
jamesagnew_hapi-fhir,ca.uhn.fhir.jpa.subscription.module.standalone,0,0,0,0,1,0,1,2
jamesagnew_hapi-fhir,ca.uhn.fhir.jpa.subscription.module.subscriber,1,1,0,0,1,1,1,5
jamesagnew_hapi-fhir,ca.uhn.fhir.jpa.subscription.module.subscriber.email,0,0,0,0,0,0,1,1
jamesagnew_hapi-fhir,ca.uhn.fhir.jpa.subscription.module.subscriber.websocket,0,0,0,0,1,0,1,2
jamesagnew_hapi-fhir,ca.uhn.fhir.narrative.template.filters,0,0,0,1,0,0,1,2
jamesagnew_hapi-fhir,ca.uhn.fhir.narrative.template,3,0,0,0,0,0,1,4
jamesagnew_hapi-fhir,ca.uhn.fhir.narrative.template.nodes,4,1,0,0,0,0,1,6
jamesagnew_hapi-fhir,ca.uhn.fhir.narrative.template.tags,3,1,0,0,0,0,1,5
jamesagnew_hapi-fhir,ca.uhn.fhir.rest.server.security,0,0,0,0,1,0,1,2
jamesagnew_hapi-fhir,ca.uhn.fhir.osgi,0,0,0,0,1,0,1,2
jamesagnew_hapi-fhir,ca.uhn.fhir.osgi.impl,0,0,0,0,0,0,1,1
jamesagnew_hapi-fhir,ca.uhn.fhir.rest.api.server,4,1,0,0,1,5,1,12
jamesagnew_hapi-fhir,ca.uhn.fhir.rest.server,6,1,0,2,1,1,1,12
jamesagnew_hapi-fhir,ca.uhn.fhir.rest.server.interceptor.auth,1,0,0,1,1,2,1,6
jamesagnew_hapi-fhir,ca.uhn.fhir.rest.server.interceptor,3,1,0,1,1,0,1,7
jamesagnew_hapi-fhir,ca.uhn.fhir.rest.server.interceptor.consent,0,0,0,0,1,0,1,2
jamesagnew_hapi-fhir,ca.uhn.fhir.rest.server.method,5,0,0,1,1,3,1,11
jamesagnew_hapi-fhir,ca.uhn.fhir.rest.server.provider,0,0,0,0,1,0,1,2
jamesagnew_hapi-fhir,ca.uhn.fhir.rest.server.servlet,0,0,0,0,0,0,1,1
jamesagnew_hapi-fhir,ca.uhn.fhir.rest.server.tenant,0,0,0,0,0,0,1,1
jamesagnew_hapi-fhir,ca.uhn.fhir.rest.server.util,0,0,0,0,0,0,1,1
jamesagnew_hapi-fhir,ca.uhn.fhir.spring.boot.autoconfigure,0,0,0,0,1,0,1,2
jamesagnew_hapi-fhir,ca.uhn.fhir.model.dstu.api,0,0,0,0,0,0,1,1
jamesagnew_hapi-fhir,ca.uhn.fhir.model.dstu.composite,4,0,0,0,0,0,1,5
jamesagnew_hapi-fhir,ca.uhn.fhir.model.dstu,0,0,0,0,0,0,1,1
jamesagnew_hapi-fhir,ca.uhn.fhir.model.dstu.resource,3,0,0,0,0,1,1,5
jamesagnew_hapi-fhir,ca.uhn.fhir.rest.server.audit,0,0,0,0,0,0,1,1
jamesagnew_hapi-fhir,ca.uhn.fhir.context.copy,0,0,0,1,1,0,1,3
jamesagnew_hapi-fhir,ca.uhn.fhir.parser.jsonlike,0,0,0,0,1,0,1,2
jamesagnew_hapi-fhir,ca.uhn.fhir.rest.client,0,0,0,1,1,8,1,11
jamesagnew_hapi-fhir,ca.uhn.fhir.model.dstu2.composite,7,0,0,1,1,11,1,21
jamesagnew_hapi-fhir,ca.uhn.fhir.model.dstu2,0,0,0,0,1,3,1,5
jamesagnew_hapi-fhir,ca.uhn.fhir.model.dstu2.resource,4,0,0,2,0,22,1,29
jamesagnew_hapi-fhir,ca.uhn.fhir.rest.server.provider.dstu2,0,0,0,0,0,0,1,1
jamesagnew_hapi-fhir,ca.uhn.fhir.ctx,0,0,0,0,0,0,1,1
jamesagnew_hapi-fhir,ca.uhn.fhir.parser.i391,0,0,0,0,0,0,1,1
jamesagnew_hapi-fhir,ca.uhn.fhir.parser.i423,0,0,0,0,0,0,1,1
jamesagnew_hapi-fhir,org.hl7.fhir.dstu2016may.hapi.ctx,0,0,0,0,0,0,1,1
jamesagnew_hapi-fhir,org.hl7.fhir.dstu2016may.hapi.rest.server,0,0,0,0,0,1,1,2
jamesagnew_hapi-fhir,org.hl7.fhir.dstu2016may.hapi.validation,0,0,0,0,1,0,1,2
jamesagnew_hapi-fhir,ca.uhn.fhir.model,0,0,0,0,1,1,1,3
jamesagnew_hapi-fhir,org.hl7.fhir.dstu3.hapi.ctx,1,1,0,0,0,0,1,3
jamesagnew_hapi-fhir,org.hl7.fhir.dstu3.hapi.fluentpath,1,0,0,0,0,0,1,2
jamesagnew_hapi-fhir,org.hl7.fhir.dstu3.hapi.rest.server,0,0,0,1,1,1,1,4
jamesagnew_hapi-fhir,ca.uhn.fhir.rest.method,0,0,0,0,0,0,1,1
jamesagnew_hapi-fhir,org.hl7.fhir.dstu3.model,0,0,0,0,1,0,1,2
jamesagnew_hapi-fhir,org.hl7.fhir.utilities.xhtml,0,0,0,0,0,0,1,1
jamesagnew_hapi-fhir,ca.uhn.fhir.rest.server.provider.dstu2hl7org,0,0,0,0,0,0,1,1
jamesagnew_hapi-fhir,org.hl7.fhir.dstu2.hapi.ctx,0,0,0,0,0,0,1,1
jamesagnew_hapi-fhir,org.hl7.fhir.dstu2.hapi.rest.server,0,0,0,0,0,0,1,1
jamesagnew_hapi-fhir,org.hl7.fhir.r4.hapi.ctx,1,1,0,0,0,0,1,3
jamesagnew_hapi-fhir,org.hl7.fhir.r4.hapi.fluentpath,1,0,0,0,0,0,1,2
jamesagnew_hapi-fhir,org.hl7.fhir.r4.hapi.rest.server,0,0,0,0,0,2,1,3
jamesagnew_hapi-fhir,ca.uhn.fhir.parser.view,0,0,0,0,0,0,1,1
jamesagnew_hapi-fhir,org.hl7.fhir.r4.elementmodel,0,0,0,0,0,0,1,1
jamesagnew_hapi-fhir,org.hl7.fhir.r4.model,0,0,0,0,1,0,1,2
jamesagnew_hapi-fhir,org.hl7.fhir.r5.hapi.ctx,1,1,0,0,0,0,1,3
jamesagnew_hapi-fhir,org.hl7.fhir.r5.hapi.fhirpath,1,1,0,0,0,0,1,3
jamesagnew_hapi-fhir,org.hl7.fhir.r5.hapi.rest.server,0,0,0,0,0,1,1,2
jamesagnew_hapi-fhir,org.hl7.fhir.r5.model,0,0,0,0,0,0,1,1
jamesagnew_hapi-fhir,ca.uhn.fhir.to,0,1,0,0,1,0,1,3
jamesagnew_hapi-fhir,ca.uhn.fhir.to.client,0,0,0,0,0,0,1,1
jamesagnew_hapi-fhir,ca.uhn.fhir.to.model,0,0,0,0,0,0,1,1
jamesagnew_hapi-fhir,ca.uhn.fhir.to.mvc,0,0,0,0,0,0,1,1
jamesagnew_hapi-fhir,ca.uhn.fhir.to.util,0,0,0,0,0,0,1,1
jamesagnew_hapi-fhir,org.hl7.fhir.common.hapi.validation,0,0,0,0,0,0,1,1
jamesagnew_hapi-fhir,org.hl7.fhir.dstu3.hapi.validation,0,0,0,0,1,0,1,2
jamesagnew_hapi-fhir,org.hl7.fhir.instance.hapi.validation,0,0,0,0,1,0,1,2
jamesagnew_hapi-fhir,org.hl7.fhir.r4.hapi.validation,0,0,0,0,1,0,1,2
jamesagnew_hapi-fhir,org.hl7.fhir.r5.hapi.validation,0,1,0,0,1,0,1,3
jamesagnew_hapi-fhir,fluentpath,0,0,0,0,0,0,1,1
jamesagnew_hapi-fhir,org.hl7.fhir.dstu3.elementmodel,0,0,0,0,0,0,1,1
jamesagnew_hapi-fhir,org.hl7.fhir.dstu3.utils,0,0,0,0,0,0,1,1
jamesagnew_hapi-fhir,org.hl7.fhir.r4.utils,0,0,0,0,0,0,1,1
jamesagnew_hapi-fhir,org.hl7.fhir.r4.validation,0,0,0,0,1,0,1,2
jamesagnew_hapi-fhir,org.hl7.fhir.r5.validation,0,0,0,0,0,0,1,1
jamesagnew_hapi-fhir,ca.uhn.fhir.model.dstu3.composite,0,0,0,0,1,0,1,2
jamesagnew_hapi-fhir,ca.uhn.fhir.tinder,1,0,0,0,1,0,1,3
jamesagnew_hapi-fhir,ca.uhn.fhir.tinder.ant,0,0,0,0,0,0,1,1
jamesagnew_hapi-fhir,ca.uhn.fhir.tinder.model,0,0,0,0,1,0,1,2
jamesagnew_hapi-fhir,ca.uhn.fhir.tinder.parser,1,1,0,0,1,0,1,4
jamesagnew_hapi-fhir,ca.uhn.fhir.tinder.util,0,0,0,0,0,0,1,1
jamesagnew_hapi-fhir,org.hl7.fhir.dstu2.model,0,0,0,0,0,0,1,1
jamesagnew_hapi-fhir,ca.uhn.example.config,0,0,0,0,0,0,1,1
jamesagnew_hapi-fhir,ca.uhn.example.model,0,0,0,0,0,0,1,1
jamesagnew_hapi-fhir,ca.uhn.example.provider,0,0,0,0,0,2,1,3
jamesagnew_hapi-fhir,ca.uhn.example.servlet,0,0,0,0,0,0,1,1
jansorg_BashSupport,com.ansorgit.plugins.bash.actions,0,0,0,0,1,0,1,2
jansorg_BashSupport,com.ansorgit.plugins.bash.documentation,0,0,0,0,0,0,1,1
jansorg_BashSupport,com.ansorgit.plugins.bash.editor.accessDetector,0,0,0,0,0,0,1,1
jansorg_BashSupport,com.ansorgit.plugins.bash.editor.annotator,0,0,0,0,0,0,1,1
jansorg_BashSupport,com.ansorgit.plugins.bash.editor,0,0,0,0,1,0,1,2
jansorg_BashSupport,com.ansorgit.plugins.bash.editor.codecompletion,0,0,0,0,1,0,1,2
jansorg_BashSupport,com.ansorgit.plugins.bash.editor.codefolding,0,0,0,0,0,0,1,1
jansorg_BashSupport,com.ansorgit.plugins.bash.editor.formatting,1,1,0,0,0,0,1,3
jansorg_BashSupport,com.ansorgit.plugins.bash.editor.formatting.noOpModel,0,0,0,0,0,0,1,1
jansorg_BashSupport,com.ansorgit.plugins.bash.editor.formatting.processor,1,0,0,0,0,0,1,2
jansorg_BashSupport,com.ansorgit.plugins.bash.editor.highlighting,0,0,0,0,1,0,1,2
jansorg_BashSupport,com.ansorgit.plugins.bash.editor.inspections,0,1,0,0,0,0,1,2
jansorg_BashSupport,com.ansorgit.plugins.bash.editor.inspections.inspections,1,0,0,1,1,0,1,4
jansorg_BashSupport,com.ansorgit.plugins.bash.editor.inspections.quickfix,1,1,0,0,1,0,1,4
jansorg_BashSupport,com.ansorgit.plugins.bash.editor.liveTemplates,0,0,0,0,0,0,1,1
jansorg_BashSupport,com.ansorgit.plugins.bash.editor.usages,0,0,0,0,0,0,1,1
jansorg_BashSupport,com.ansorgit.plugins.bash.file,0,0,0,0,0,0,1,1
jansorg_BashSupport,com.ansorgit.plugins.bash.jetbrains,0,0,0,0,0,0,1,1
jansorg_BashSupport,com.ansorgit.plugins.bash.lang,0,0,0,0,0,0,1,1
jansorg_BashSupport,com.ansorgit.plugins.bash.lang.lexer,0,0,0,0,0,0,1,1
jansorg_BashSupport,com.ansorgit.plugins.bash.lang.parser.arithmetic,0,0,0,0,0,0,1,1
jansorg_BashSupport,com.ansorgit.plugins.bash.lang.parser,13,1,0,1,0,0,1,16
jansorg_BashSupport,com.ansorgit.plugins.bash.lang.parser.builtin,0,0,0,0,0,0,1,1
jansorg_BashSupport,com.ansorgit.plugins.bash.lang.parser.builtin.varDef,0,0,0,0,0,0,1,1
jansorg_BashSupport,com.ansorgit.plugins.bash.lang.parser.command,3,0,0,0,1,0,1,5
jansorg_BashSupport,com.ansorgit.plugins.bash.lang.parser.eval,0,0,0,0,1,0,1,2
jansorg_BashSupport,com.ansorgit.plugins.bash.lang.parser.misc,5,0,0,0,1,0,1,7
jansorg_BashSupport,com.ansorgit.plugins.bash.lang.parser.paramExpansion,2,0,0,0,0,0,1,3
jansorg_BashSupport,com.ansorgit.plugins.bash.lang.parser.shellCommand,0,0,0,0,1,0,1,2
jansorg_BashSupport,com.ansorgit.plugins.bash.lang.parser.util,3,1,0,0,0,0,1,5
jansorg_BashSupport,com.ansorgit.plugins.bash.lang.parser.variable,2,0,0,0,0,0,1,3
jansorg_BashSupport,com.ansorgit.plugins.bash.lang.psi.api.arithmetic,0,0,0,0,1,0,1,2
jansorg_BashSupport,com.ansorgit.plugins.bash.lang.psi.api,0,0,0,0,1,0,1,2
jansorg_BashSupport,com.ansorgit.plugins.bash.lang.psi.api.command,0,0,0,0,1,0,1,2
jansorg_BashSupport,com.ansorgit.plugins.bash.lang.psi.api.expression,0,0,0,0,0,0,1,1
jansorg_BashSupport,com.ansorgit.plugins.bash.lang.psi.api.function,0,0,0,0,0,0,1,1
jansorg_BashSupport,com.ansorgit.plugins.bash.lang.psi.api.heredoc,0,0,0,0,0,0,1,1
jansorg_BashSupport,com.ansorgit.plugins.bash.lang.psi.api.loops,0,0,0,0,0,0,1,1
jansorg_BashSupport,com.ansorgit.plugins.bash.lang.psi.api.shell,0,0,0,0,1,0,1,2
jansorg_BashSupport,com.ansorgit.plugins.bash.lang.psi.api.vars,0,0,0,0,1,0,1,2
jansorg_BashSupport,com.ansorgit.plugins.bash.lang.psi.api.word,0,0,0,0,0,0,1,1
jansorg_BashSupport,com.ansorgit.plugins.bash.lang.psi,7,1,0,0,1,0,1,10
jansorg_BashSupport,com.ansorgit.plugins.bash.lang.psi.eval,0,0,0,0,0,0,1,1
jansorg_BashSupport,com.ansorgit.plugins.bash.lang.psi.impl.arithmetic,0,0,0,0,0,0,1,1
jansorg_BashSupport,com.ansorgit.plugins.bash.lang.psi.impl,5,1,0,0,0,0,1,7
jansorg_BashSupport,com.ansorgit.plugins.bash.lang.psi.impl.command,0,0,0,0,1,0,1,2
jansorg_BashSupport,com.ansorgit.plugins.bash.lang.psi.impl.expression,0,0,0,0,0,0,1,1
jansorg_BashSupport,com.ansorgit.plugins.bash.lang.psi.impl.function,0,0,0,0,0,0,1,1
jansorg_BashSupport,com.ansorgit.plugins.bash.lang.psi.impl.heredoc,0,0,0,0,1,0,1,2
jansorg_BashSupport,com.ansorgit.plugins.bash.lang.psi.impl.loops,0,0,0,0,1,0,1,2
jansorg_BashSupport,com.ansorgit.plugins.bash.lang.psi.impl.refactoring,0,0,0,0,1,0,1,2
jansorg_BashSupport,com.ansorgit.plugins.bash.lang.psi.impl.shell,4,0,0,0,1,0,1,6
jansorg_BashSupport,com.ansorgit.plugins.bash.lang.psi.impl.vars,2,0,0,0,1,0,1,4
jansorg_BashSupport,com.ansorgit.plugins.bash.lang.psi.impl.word,0,0,0,0,1,0,1,2
jansorg_BashSupport,com.ansorgit.plugins.bash.lang.psi.stubs.api,0,0,1,0,1,0,1,3
jansorg_BashSupport,com.ansorgit.plugins.bash.lang.psi.stubs.elements,0,0,0,0,1,0,1,2
jansorg_BashSupport,com.ansorgit.plugins.bash.lang.psi.stubs.impl,0,0,0,0,1,0,1,2
jansorg_BashSupport,com.ansorgit.plugins.bash.lang.psi.stubs.index,0,0,0,0,0,0,1,1
jansorg_BashSupport,com.ansorgit.plugins.bash.lang.psi.util,8,1,0,0,1,0,1,11
jansorg_BashSupport,com.ansorgit.plugins.bash.lang.util,0,0,0,0,0,0,1,1
jansorg_BashSupport,com.ansorgit.plugins.bash.lang.valueExpansion,0,0,0,0,1,0,1,2
jansorg_BashSupport,com.ansorgit.plugins.bash.refactoring,0,0,0,0,0,0,1,1
jansorg_BashSupport,com.ansorgit.plugins.bash.runner,1,0,0,0,0,0,1,2
jansorg_BashSupport,com.ansorgit.plugins.bash.runner.repl,0,0,0,0,0,0,1,1
jansorg_BashSupport,com.ansorgit.plugins.bash.runner.terminal,1,1,0,0,0,0,1,3
jansorg_BashSupport,com.ansorgit.plugins.bash.settings,0,0,0,0,0,0,1,1
jansorg_BashSupport,com.ansorgit.plugins.bash.structureview,0,0,0,0,1,0,1,2
jansorg_BashSupport,com.ansorgit.plugins.bash.util,0,0,0,0,1,0,1,2
jansorg_BashSupport,nu.studer.idea.errorreporting,0,0,0,0,0,0,1,1
jansorg_BashSupport,com.ansorgit.plugins.bash,0,0,0,0,0,0,1,1
jansorg_BashSupport,com.ansorgit.plugins.bash.codeInsight.completion,0,0,0,0,1,0,1,2
jansorg_BashSupport,com.ansorgit.plugins.bash.editor.refactoring,0,0,0,0,1,0,1,2
jansorg_BashSupport,com.ansorgit.plugins.bash.errorFiles,0,0,0,0,0,0,1,1
jansorg_BashSupport,com.ansorgit.plugins.bash.intelliLang,0,0,0,0,0,0,1,1
jansorg_BashSupport,com.ansorgit.plugins.bash.lang.base,0,0,0,0,0,0,1,1
jansorg_BashSupport,com.ansorgit.plugins.bash.lang.editor.formatting,0,0,0,0,0,0,1,1
jansorg_BashSupport,com.ansorgit.plugins.bash.lang.parser.parameterExpansion,0,0,0,0,0,0,1,1
jansorg_BashSupport,com.ansorgit.plugins.bash.lang.psi.arithmetic,0,0,0,0,0,0,1,1
jansorg_BashSupport,com.ansorgit.plugins.bash.lang.psi.fileInclude,0,0,0,0,1,0,1,2
jansorg_BashSupport,com.ansorgit.plugins.bash.lang.psi.resolve,0,0,0,0,1,0,1,2
jansorg_BashSupport,com.ansorgit.plugins.bash.lang.psiTree,0,0,0,0,0,0,1,1
jansorg_BashSupport,(default package),0,0,0,0,0,0,1,1
JasonRuckman_sidney,com.github.jasonruckman.sidney.core,5,0,0,0,1,2,0,8
JasonRuckman_sidney,com.github.jasonruckman.sidney.core.bitpacking,0,0,0,0,0,3,0,3
JasonRuckman_sidney,com.github.jasonruckman.sidney.core.bitpacking.packers.be.int32,0,0,0,1,1,0,0,2
JasonRuckman_sidney,com.github.jasonruckman.sidney.core.bitpacking.packers.le.int32,0,0,0,1,1,0,0,2
JasonRuckman_sidney,com.github.jasonruckman.sidney.core.bitpacking.parquet,0,0,0,0,0,0,0,0
JasonRuckman_sidney,com.github.jasonruckman.sidney.core.io.bool,0,0,0,0,1,0,0,1
JasonRuckman_sidney,com.github.jasonruckman.sidney.core.io.bytes,0,0,0,0,1,0,0,1
JasonRuckman_sidney,com.github.jasonruckman.sidney.core.io.character,0,0,0,0,1,1,0,2
JasonRuckman_sidney,com.github.jasonruckman.sidney.core.io,3,0,0,1,0,4,0,8
JasonRuckman_sidney,com.github.jasonruckman.sidney.core.io.float32,0,0,0,0,1,0,0,1
JasonRuckman_sidney,com.github.jasonruckman.sidney.core.io.float64,0,0,0,0,1,0,0,1
JasonRuckman_sidney,com.github.jasonruckman.sidney.core.io.input,0,0,0,0,0,2,0,2
JasonRuckman_sidney,com.github.jasonruckman.sidney.core.io.int16,0,0,0,0,1,1,0,2
JasonRuckman_sidney,com.github.jasonruckman.sidney.core.io.int32,0,0,0,0,1,2,0,3
JasonRuckman_sidney,com.github.jasonruckman.sidney.core.io.int64,0,0,0,0,1,0,0,1
JasonRuckman_sidney,com.github.jasonruckman.sidney.core.io.output,0,0,0,0,0,2,0,2
JasonRuckman_sidney,com.github.jasonruckman.sidney.core.io.string,0,0,0,0,1,0,0,1
JasonRuckman_sidney,com.github.jasonruckman.sidney.core.serde,9,1,0,1,0,5,0,16
JasonRuckman_sidney,com.github.jasonruckman.sidney.core.serde.factory,0,0,0,0,0,1,0,1
JasonRuckman_sidney,com.github.jasonruckman.sidney.core.serde.serializer,5,1,0,0,0,3,0,9
JasonRuckman_sidney,com.github.jasonruckman.sidney.core.serde.serializer.jdkserializers,2,1,0,0,1,2,0,6
JasonRuckman_sidney,com.github.jasonruckman.sidney.core.type,0,0,0,0,0,2,0,2
JasonRuckman_sidney,com.github.jasonruckman.sidney.core.util,0,0,0,0,1,5,0,6
JasonRuckman_sidney,com.github.jasonruckman,0,0,0,0,0,0,0,0
JasonRuckman_sidney,com.github.jasonruckman.gzip,0,0,0,0,0,0,0,0
JasonRuckman_sidney,com.github.jasonruckman.gzip.allarrays,0,0,0,0,0,0,0,0
JasonRuckman_sidney,com.github.jasonruckman.gzip.allarrays.read,0,0,0,0,0,0,0,0
JasonRuckman_sidney,com.github.jasonruckman.gzip.allarrays.write,0,0,0,0,0,0,0,0
JasonRuckman_sidney,com.github.jasonruckman.gzip.complexbean,0,0,0,0,0,0,0,0
JasonRuckman_sidney,com.github.jasonruckman.gzip.complexbean.read,0,0,0,0,0,0,0,0
JasonRuckman_sidney,com.github.jasonruckman.gzip.complexbean.roundtrip,0,0,0,0,0,0,0,0
JasonRuckman_sidney,com.github.jasonruckman.gzip.complexbean.write,0,0,0,0,0,0,0,0
JasonRuckman_sidney,com.github.jasonruckman.gzip.intmaps,0,0,0,0,0,0,0,0
JasonRuckman_sidney,com.github.jasonruckman.gzip.intmaps.read,0,0,0,0,0,0,0,0
JasonRuckman_sidney,com.github.jasonruckman.gzip.intmaps.write,0,0,0,0,0,0,0,0
JasonRuckman_sidney,com.github.jasonruckman.gzip.simplebean.read,0,0,0,0,0,0,0,0
JasonRuckman_sidney,com.github.jasonruckman.gzip.simplebean,0,0,0,0,0,0,0,0
JasonRuckman_sidney,com.github.jasonruckman.gzip.simplebean.write,0,0,0,0,0,0,0,0
JasonRuckman_sidney,com.github.jasonruckman.lz4,0,0,0,0,0,0,0,0
JasonRuckman_sidney,com.github.jasonruckman.lz4.allarrays,0,0,0,0,0,0,0,0
JasonRuckman_sidney,com.github.jasonruckman.lz4.allarrays.read,0,0,0,0,0,0,0,0
JasonRuckman_sidney,com.github.jasonruckman.lz4.allarrays.write,0,0,0,0,0,0,0,0
JasonRuckman_sidney,com.github.jasonruckman.lz4.complexbean,0,0,0,0,0,0,0,0
JasonRuckman_sidney,com.github.jasonruckman.lz4.complexbean.read,0,0,0,0,0,0,0,0
JasonRuckman_sidney,com.github.jasonruckman.lz4.complexbean.roundtrip,0,0,0,0,0,0,0,0
JasonRuckman_sidney,com.github.jasonruckman.lz4.complexbean.write,0,0,0,0,0,0,0,0
JasonRuckman_sidney,com.github.jasonruckman.lz4.intmaps,0,0,0,0,0,0,0,0
JasonRuckman_sidney,com.github.jasonruckman.lz4.intmaps.read,0,0,0,0,0,0,0,0
JasonRuckman_sidney,com.github.jasonruckman.lz4.intmaps.write,0,0,0,0,0,0,0,0
JasonRuckman_sidney,com.github.jasonruckman.lz4.simplebean.read,0,0,0,0,0,0,0,0
JasonRuckman_sidney,com.github.jasonruckman.lz4.simplebean,0,0,0,0,0,0,0,0
JasonRuckman_sidney,com.github.jasonruckman.lz4.simplebean.write,0,0,0,0,0,0,0,0
JasonRuckman_sidney,com.github.jasonruckman.model,0,0,0,0,0,0,0,0
JasonRuckman_sidney,com.github.jasonruckman.uncompressed,0,0,0,0,0,0,0,0
JasonRuckman_sidney,com.github.jasonruckman.uncompressed.allarrays,0,0,0,0,0,0,0,0
JasonRuckman_sidney,com.github.jasonruckman.uncompressed.allarrays.read,0,0,0,0,0,0,0,0
JasonRuckman_sidney,com.github.jasonruckman.uncompressed.allarrays.write,0,0,0,0,0,0,0,0
JasonRuckman_sidney,com.github.jasonruckman.uncompressed.complexbean,0,0,0,0,0,0,0,0
JasonRuckman_sidney,com.github.jasonruckman.uncompressed.complexbean.read,0,0,0,0,0,0,0,0
JasonRuckman_sidney,com.github.jasonruckman.uncompressed.complexbean.roundtrip,0,0,0,0,0,0,0,0
JasonRuckman_sidney,com.github.jasonruckman.uncompressed.complexbean.write,0,0,0,0,0,0,0,0
JasonRuckman_sidney,com.github.jasonruckman.uncompressed.intmaps,0,0,0,0,0,0,0,0
JasonRuckman_sidney,com.github.jasonruckman.uncompressed.intmaps.read,0,0,0,0,0,0,0,0
JasonRuckman_sidney,com.github.jasonruckman.uncompressed.intmaps.write,0,0,0,0,0,0,0,0
JasonRuckman_sidney,com.github.jasonruckman.uncompressed.simplebean.read,0,0,0,0,0,0,0,0
JasonRuckman_sidney,com.github.jasonruckman.uncompressed.simplebean,0,0,0,0,0,0,0,0
JasonRuckman_sidney,com.github.jasonruckman.uncompressed.simplebean.write,0,0,0,0,0,0,0,0
JasonRuckman_sidney,com.github.jasonruckman.gzip.allarrays.read.generated,0,0,0,0,1,0,0,1
JasonRuckman_sidney,com.github.jasonruckman.gzip.allarrays.write.generated,0,0,0,0,1,0,0,1
JasonRuckman_sidney,com.github.jasonruckman.gzip.complexbean.read.generated,0,0,0,0,1,0,0,1
JasonRuckman_sidney,com.github.jasonruckman.gzip.complexbean.roundtrip.generated,0,0,0,0,1,0,0,1
JasonRuckman_sidney,com.github.jasonruckman.gzip.complexbean.write.generated,0,0,0,0,1,0,0,1
JasonRuckman_sidney,com.github.jasonruckman.gzip.intmaps.read.generated,0,0,0,0,1,0,0,1
JasonRuckman_sidney,com.github.jasonruckman.gzip.intmaps.write.generated,0,0,0,0,1,0,0,1
JasonRuckman_sidney,com.github.jasonruckman.gzip.simplebean.read.generated,0,0,0,0,1,0,0,1
JasonRuckman_sidney,com.github.jasonruckman.gzip.simplebean.write.generated,0,0,0,0,1,0,0,1
JasonRuckman_sidney,com.github.jasonruckman.lz4.allarrays.read.generated,0,0,0,0,1,0,0,1
JasonRuckman_sidney,com.github.jasonruckman.lz4.allarrays.write.generated,0,0,0,0,1,0,0,1
JasonRuckman_sidney,com.github.jasonruckman.lz4.complexbean.read.generated,0,0,0,0,1,0,0,1
JasonRuckman_sidney,com.github.jasonruckman.lz4.complexbean.roundtrip.generated,0,0,0,0,1,0,0,1
JasonRuckman_sidney,com.github.jasonruckman.lz4.complexbean.write.generated,0,0,0,0,1,0,0,1
JasonRuckman_sidney,com.github.jasonruckman.lz4.intmaps.read.generated,0,0,0,0,1,0,0,1
JasonRuckman_sidney,com.github.jasonruckman.lz4.intmaps.write.generated,0,0,0,0,1,0,0,1
JasonRuckman_sidney,com.github.jasonruckman.lz4.simplebean.read.generated,0,0,0,0,1,0,0,1
JasonRuckman_sidney,com.github.jasonruckman.lz4.simplebean.write.generated,0,0,0,0,1,0,0,1
JasonRuckman_sidney,com.github.jasonruckman.uncompressed.allarrays.read.generated,0,0,0,0,1,0,0,1
JasonRuckman_sidney,com.github.jasonruckman.uncompressed.allarrays.write.generated,0,0,0,0,1,0,0,1
JasonRuckman_sidney,com.github.jasonruckman.uncompressed.complexbean.read.generated,0,0,0,0,1,0,0,1
JasonRuckman_sidney,com.github.jasonruckman.uncompressed.complexbean.roundtrip.generated,0,0,0,0,1,0,0,1
JasonRuckman_sidney,com.github.jasonruckman.uncompressed.complexbean.write.generated,0,0,0,0,1,0,0,1
JasonRuckman_sidney,com.github.jasonruckman.uncompressed.intmaps.read.generated,0,0,0,0,1,0,0,1
JasonRuckman_sidney,com.github.jasonruckman.uncompressed.intmaps.write.generated,0,0,0,0,1,0,0,1
JasonRuckman_sidney,com.github.jasonruckman.uncompressed.simplebean.read.generated,0,0,0,0,1,0,0,1
JasonRuckman_sidney,com.github.jasonruckman.uncompressed.simplebean.write.generated,0,0,0,0,1,0,0,1
JasonRuckman_sidney,org.openjdk.jmh.infra.generated,0,0,0,0,0,0,0,0
JasonRuckman_sidney,com.github.jasonruckman.sidney.ext.common,0,0,0,0,0,0,0,0
JasonRuckman_sidney,com.github.jasonruckman.sidney.generator,0,0,0,1,0,1,0,2
JasonRuckman_sidney,com.github.jasonruckman.sidney.benchmarking,0,0,0,0,0,0,0,0
JasonRuckman_sidney,com.github.jasonruckman.sidney.ext.guava,0,0,0,0,1,1,0,2
JasonRuckman_sidney,com.github.jasonruckman.sidney.scala,0,0,0,0,0,0,0,0
JasonRuckman_sidney,com.github.jasonruckman.sidney.core,5,0,0,0,1,2,0,8
JasonRuckman_sidney,com.github.jasonruckman.sidney.core.bitpacking,0,0,0,0,0,3,0,3
JasonRuckman_sidney,com.github.jasonruckman.sidney.core.bitpacking.packers.be.int32,0,0,0,1,1,0,0,2
JasonRuckman_sidney,com.github.jasonruckman.sidney.core.bitpacking.packers.le.int32,0,0,0,1,1,0,0,2
JasonRuckman_sidney,com.github.jasonruckman.sidney.core.bitpacking.parquet,0,0,0,0,0,0,0,0
JasonRuckman_sidney,com.github.jasonruckman.sidney.core.io.bool,0,0,0,0,1,0,0,1
JasonRuckman_sidney,com.github.jasonruckman.sidney.core.io.bytes,0,0,0,0,1,0,0,1
JasonRuckman_sidney,com.github.jasonruckman.sidney.core.io.character,0,0,0,0,1,1,0,2
JasonRuckman_sidney,com.github.jasonruckman.sidney.core.io,3,0,0,1,0,4,0,8
JasonRuckman_sidney,com.github.jasonruckman.sidney.core.io.float32,0,0,0,0,1,0,0,1
JasonRuckman_sidney,com.github.jasonruckman.sidney.core.io.float64,0,0,0,0,1,0,0,1
JasonRuckman_sidney,com.github.jasonruckman.sidney.core.io.input,0,0,0,0,0,2,0,2
JasonRuckman_sidney,com.github.jasonruckman.sidney.core.io.int16,0,0,0,0,1,1,0,2
JasonRuckman_sidney,com.github.jasonruckman.sidney.core.io.int32,0,0,0,0,1,2,0,3
JasonRuckman_sidney,com.github.jasonruckman.sidney.core.io.int64,0,0,0,0,1,0,0,1
JasonRuckman_sidney,com.github.jasonruckman.sidney.core.io.output,0,0,0,0,0,2,0,2
JasonRuckman_sidney,com.github.jasonruckman.sidney.core.io.string,0,0,0,0,1,0,0,1
JasonRuckman_sidney,com.github.jasonruckman.sidney.core.serde,9,1,0,1,0,5,0,16
JasonRuckman_sidney,com.github.jasonruckman.sidney.core.serde.factory,0,0,0,0,0,1,0,1
JasonRuckman_sidney,com.github.jasonruckman.sidney.core.serde.serializer,5,1,0,0,0,3,0,9
JasonRuckman_sidney,com.github.jasonruckman.sidney.core.serde.serializer.jdkserializers,2,1,0,0,1,2,0,6
JasonRuckman_sidney,com.github.jasonruckman.sidney.core.type,0,0,0,0,0,2,0,2
JasonRuckman_sidney,com.github.jasonruckman.sidney.core.util,0,0,0,0,1,5,0,6
JasonRuckman_sidney,com.github.jasonruckman,0,0,0,0,0,0,0,0
JasonRuckman_sidney,com.github.jasonruckman.gzip,0,0,0,0,0,0,0,0
JasonRuckman_sidney,com.github.jasonruckman.gzip.allarrays,0,0,0,0,0,0,0,0
JasonRuckman_sidney,com.github.jasonruckman.gzip.allarrays.read,0,0,0,0,0,0,0,0
JasonRuckman_sidney,com.github.jasonruckman.gzip.allarrays.write,0,0,0,0,0,0,0,0
JasonRuckman_sidney,com.github.jasonruckman.gzip.complexbean,0,0,0,0,0,0,0,0
JasonRuckman_sidney,com.github.jasonruckman.gzip.complexbean.read,0,0,0,0,0,0,0,0
JasonRuckman_sidney,com.github.jasonruckman.gzip.complexbean.roundtrip,0,0,0,0,0,0,0,0
JasonRuckman_sidney,com.github.jasonruckman.gzip.complexbean.write,0,0,0,0,0,0,0,0
JasonRuckman_sidney,com.github.jasonruckman.gzip.intmaps,0,0,0,0,0,0,0,0
JasonRuckman_sidney,com.github.jasonruckman.gzip.intmaps.read,0,0,0,0,0,0,0,0
JasonRuckman_sidney,com.github.jasonruckman.gzip.intmaps.write,0,0,0,0,0,0,0,0
JasonRuckman_sidney,com.github.jasonruckman.gzip.simplebean.read,0,0,0,0,0,0,0,0
JasonRuckman_sidney,com.github.jasonruckman.gzip.simplebean,0,0,0,0,0,0,0,0
JasonRuckman_sidney,com.github.jasonruckman.gzip.simplebean.write,0,0,0,0,0,0,0,0
JasonRuckman_sidney,com.github.jasonruckman.lz4,0,0,0,0,0,0,0,0
JasonRuckman_sidney,com.github.jasonruckman.lz4.allarrays,0,0,0,0,0,0,0,0
JasonRuckman_sidney,com.github.jasonruckman.lz4.allarrays.read,0,0,0,0,0,0,0,0
JasonRuckman_sidney,com.github.jasonruckman.lz4.allarrays.write,0,0,0,0,0,0,0,0
JasonRuckman_sidney,com.github.jasonruckman.lz4.complexbean,0,0,0,0,0,0,0,0
JasonRuckman_sidney,com.github.jasonruckman.lz4.complexbean.read,0,0,0,0,0,0,0,0
JasonRuckman_sidney,com.github.jasonruckman.lz4.complexbean.roundtrip,0,0,0,0,0,0,0,0
JasonRuckman_sidney,com.github.jasonruckman.lz4.complexbean.write,0,0,0,0,0,0,0,0
JasonRuckman_sidney,com.github.jasonruckman.lz4.intmaps,0,0,0,0,0,0,0,0
JasonRuckman_sidney,com.github.jasonruckman.lz4.intmaps.read,0,0,0,0,0,0,0,0
JasonRuckman_sidney,com.github.jasonruckman.lz4.intmaps.write,0,0,0,0,0,0,0,0
JasonRuckman_sidney,com.github.jasonruckman.lz4.simplebean.read,0,0,0,0,0,0,0,0
JasonRuckman_sidney,com.github.jasonruckman.lz4.simplebean,0,0,0,0,0,0,0,0
JasonRuckman_sidney,com.github.jasonruckman.lz4.simplebean.write,0,0,0,0,0,0,0,0
JasonRuckman_sidney,com.github.jasonruckman.model,0,0,0,0,0,0,0,0
JasonRuckman_sidney,com.github.jasonruckman.uncompressed,0,0,0,0,0,0,0,0
JasonRuckman_sidney,com.github.jasonruckman.uncompressed.allarrays,0,0,0,0,0,0,0,0
JasonRuckman_sidney,com.github.jasonruckman.uncompressed.allarrays.read,0,0,0,0,0,0,0,0
JasonRuckman_sidney,com.github.jasonruckman.uncompressed.allarrays.write,0,0,0,0,0,0,0,0
JasonRuckman_sidney,com.github.jasonruckman.uncompressed.complexbean,0,0,0,0,0,0,0,0
JasonRuckman_sidney,com.github.jasonruckman.uncompressed.complexbean.read,0,0,0,0,0,0,0,0
JasonRuckman_sidney,com.github.jasonruckman.uncompressed.complexbean.roundtrip,0,0,0,0,0,0,0,0
JasonRuckman_sidney,com.github.jasonruckman.uncompressed.complexbean.write,0,0,0,0,0,0,0,0
JasonRuckman_sidney,com.github.jasonruckman.uncompressed.intmaps,0,0,0,0,0,0,0,0
JasonRuckman_sidney,com.github.jasonruckman.uncompressed.intmaps.read,0,0,0,0,0,0,0,0
JasonRuckman_sidney,com.github.jasonruckman.uncompressed.intmaps.write,0,0,0,0,0,0,0,0
JasonRuckman_sidney,com.github.jasonruckman.uncompressed.simplebean.read,0,0,0,0,0,0,0,0
JasonRuckman_sidney,com.github.jasonruckman.uncompressed.simplebean,0,0,0,0,0,0,0,0
JasonRuckman_sidney,com.github.jasonruckman.uncompressed.simplebean.write,0,0,0,0,0,0,0,0
JasonRuckman_sidney,com.github.jasonruckman.gzip.allarrays.read.generated,0,0,0,0,1,0,0,1
JasonRuckman_sidney,com.github.jasonruckman.gzip.allarrays.write.generated,0,0,0,0,1,0,0,1
JasonRuckman_sidney,com.github.jasonruckman.gzip.complexbean.read.generated,0,0,0,0,1,0,0,1
JasonRuckman_sidney,com.github.jasonruckman.gzip.complexbean.roundtrip.generated,0,0,0,0,1,0,0,1
JasonRuckman_sidney,com.github.jasonruckman.gzip.complexbean.write.generated,0,0,0,0,1,0,0,1
JasonRuckman_sidney,com.github.jasonruckman.gzip.intmaps.read.generated,0,0,0,0,1,0,0,1
JasonRuckman_sidney,com.github.jasonruckman.gzip.intmaps.write.generated,0,0,0,0,1,0,0,1
JasonRuckman_sidney,com.github.jasonruckman.gzip.simplebean.read.generated,0,0,0,0,1,0,0,1
JasonRuckman_sidney,com.github.jasonruckman.gzip.simplebean.write.generated,0,0,0,0,1,0,0,1
JasonRuckman_sidney,com.github.jasonruckman.lz4.allarrays.read.generated,0,0,0,0,1,0,0,1
JasonRuckman_sidney,com.github.jasonruckman.lz4.allarrays.write.generated,0,0,0,0,1,0,0,1
JasonRuckman_sidney,com.github.jasonruckman.lz4.complexbean.read.generated,0,0,0,0,1,0,0,1
JasonRuckman_sidney,com.github.jasonruckman.lz4.complexbean.roundtrip.generated,0,0,0,0,1,0,0,1
JasonRuckman_sidney,com.github.jasonruckman.lz4.complexbean.write.generated,0,0,0,0,1,0,0,1
JasonRuckman_sidney,com.github.jasonruckman.lz4.intmaps.read.generated,0,0,0,0,1,0,0,1
JasonRuckman_sidney,com.github.jasonruckman.lz4.intmaps.write.generated,0,0,0,0,1,0,0,1
JasonRuckman_sidney,com.github.jasonruckman.lz4.simplebean.read.generated,0,0,0,0,1,0,0,1
JasonRuckman_sidney,com.github.jasonruckman.lz4.simplebean.write.generated,0,0,0,0,1,0,0,1
JasonRuckman_sidney,com.github.jasonruckman.uncompressed.allarrays.read.generated,0,0,0,0,1,0,0,1
JasonRuckman_sidney,com.github.jasonruckman.uncompressed.allarrays.write.generated,0,0,0,0,1,0,0,1
JasonRuckman_sidney,com.github.jasonruckman.uncompressed.complexbean.read.generated,0,0,0,0,1,0,0,1
JasonRuckman_sidney,com.github.jasonruckman.uncompressed.complexbean.roundtrip.generated,0,0,0,0,1,0,0,1
JasonRuckman_sidney,com.github.jasonruckman.uncompressed.complexbean.write.generated,0,0,0,0,1,0,0,1
JasonRuckman_sidney,com.github.jasonruckman.uncompressed.intmaps.read.generated,0,0,0,0,1,0,0,1
JasonRuckman_sidney,com.github.jasonruckman.uncompressed.intmaps.write.generated,0,0,0,0,1,0,0,1
JasonRuckman_sidney,com.github.jasonruckman.uncompressed.simplebean.read.generated,0,0,0,0,1,0,0,1
JasonRuckman_sidney,com.github.jasonruckman.uncompressed.simplebean.write.generated,0,0,0,0,1,0,0,1
JasonRuckman_sidney,org.openjdk.jmh.infra.generated,0,0,0,0,0,0,0,0
JasonRuckman_sidney,com.github.jasonruckman.sidney.ext.common,0,0,0,0,0,0,0,0
JasonRuckman_sidney,com.github.jasonruckman.sidney.generator,0,0,0,1,0,1,0,2
JasonRuckman_sidney,com.github.jasonruckman.sidney.benchmarking,0,0,0,0,0,0,0,0
JasonRuckman_sidney,com.github.jasonruckman.sidney.ext.guava,0,0,0,0,1,1,0,2
JasonRuckman_sidney,com.github.jasonruckman.sidney.scala,0,0,0,0,0,0,0,0
jbachorik_btrace,com.sun.btrace.runtime,3,1,0,1,0,0,0,5
jbachorik_btrace,net.java.btrace,0,0,0,0,1,0,0,1
jbachorik_btrace,scripts,0,0,0,0,0,0,0,0
jbachorik_btrace,com.sun.btrace.agent,0,0,0,0,0,0,0,0
jbachorik_btrace,com.sun.btrace.aggregation,0,0,0,0,0,0,0,0
jbachorik_btrace,com.sun.btrace,1,1,0,1,0,0,0,3
jbachorik_btrace,com.sun.btrace.api,0,0,0,0,1,0,0,1
jbachorik_btrace,com.sun.btrace.api.impl,0,0,0,0,0,0,0,0
jbachorik_btrace,com.sun.btrace.client,0,0,0,0,0,0,0,0
jbachorik_btrace,com.sun.btrace.comm,1,0,0,0,0,0,0,1
jbachorik_btrace,com.sun.btrace.compiler,0,0,0,0,1,0,0,1
jbachorik_btrace,com.sun.btrace.instr,0,0,0,0,0,0,0,0
jbachorik_btrace,com.sun.btrace.instr.random,0,0,0,0,0,0,0,0
jbachorik_btrace,com.sun.btrace.profiling,0,0,0,0,0,0,0,0
jbachorik_btrace,com.sun.btrace.runtime.instr,1,0,0,0,0,0,0,1
jbachorik_btrace,com.sun.btrace.services.api,0,0,0,0,0,0,0,0
jbachorik_btrace,com.sun.btrace.services.impl,0,0,0,0,0,0,0,0
jbachorik_btrace,com.sun.btrace.services.spi,0,0,0,0,0,0,0,0
jbachorik_btrace,com.sun.btrace.shared,0,0,0,0,1,0,0,1
jbachorik_btrace,com.sun.btrace.spi,0,1,0,0,1,0,0,2
jbachorik_btrace,com.sun.btrace.spi.impl,0,0,0,0,0,0,0,0
jbachorik_btrace,com.sun.btrace.util,0,0,0,0,1,0,0,1
jbachorik_btrace,com.sun.btrace.util.templates,1,1,0,0,1,0,0,3
jbachorik_btrace,com.sun.btrace.util.templates.impl,2,0,0,0,0,0,0,2
jbachorik_btrace,com.sun.btrace.dtrace,0,0,0,0,0,0,0,0
jbachorik_btrace,resources,0,0,0,0,1,0,0,1
jbachorik_btrace,resources.issues,0,0,0,0,0,0,0,0
jbachorik_btrace,services,0,0,0,0,0,0,0,0
jbachorik_btrace,support,0,0,0,0,0,0,0,0
jbachorik_btrace,traces,0,0,0,0,1,0,0,1
jbachorik_btrace,traces.issues,0,0,0,0,1,0,0,1
jbachorik_btrace,traces.onmethod,0,0,0,1,1,0,0,2
jbachorik_btrace,traces.onmethod.leveled,0,0,0,1,1,0,0,2
jbachorik_btrace,traces.verifier,0,0,0,0,0,0,0,0
jbake-org_jbake,org.jbake.app,17,1,0,1,0,0,0,19
jbake-org_jbake,org.jbake.app.configuration,12,1,0,0,0,0,0,13
jbake-org_jbake,org.jbake.launcher,3,0,0,0,0,0,0,3
jbake-org_jbake,org.jbake.model,4,1,0,0,0,0,0,5
jbake-org_jbake,org.jbake.parser,6,0,0,0,0,0,0,6
jbake-org_jbake,org.jbake.render,0,0,0,0,1,0,0,1
jbake-org_jbake,org.jbake.template,4,0,0,0,0,0,0,4
jbake-org_jbake,org.jbake.template.model,0,0,0,0,1,0,0,1
jbake-org_jbake,org.jbake.util,2,0,0,0,0,0,0,2
jbake-org_jbake,org.jbake.app.template,0,0,0,0,0,0,0,0
jbake-org_jbake,org.jbake,6,1,0,0,0,0,0,7
jbake-org_jbake,org.jbake.render.support,0,0,0,0,0,0,0,0
jbox2d_jbox2d,org.jbox2d.collision.broadphase,2,1,0,0,1,5,0,9
jbox2d_jbox2d,org.jbox2d.callbacks,0,0,0,0,1,3,0,4
jbox2d_jbox2d,org.jbox2d.collision,2,1,0,0,1,7,0,11
jbox2d_jbox2d,org.jbox2d.collision.shapes,0,0,0,0,1,4,0,5
jbox2d_jbox2d,org.jbox2d.common,0,0,0,0,1,12,0,13
jbox2d_jbox2d,org.jbox2d.dynamics,2,1,0,0,1,12,0,16
jbox2d_jbox2d,org.jbox2d.dynamics.contacts,1,0,0,0,1,5,0,7
jbox2d_jbox2d,org.jbox2d.dynamics.joints,0,0,0,0,0,4,0,4
jbox2d_jbox2d,java.lang,0,0,0,0,0,0,0,0
jbox2d_jbox2d,org.jbox2d.particle,0,0,0,0,1,2,0,3
jbox2d_jbox2d,org.jbox2d.pooling.arrays,0,0,0,0,0,0,0,0
jbox2d_jbox2d,org.jbox2d.pooling,0,0,0,0,0,6,0,6
jbox2d_jbox2d,org.jbox2d.pooling.normal,2,0,0,0,0,0,0,2
jbox2d_jbox2d,org.jbox2d.pooling.stacks,0,0,0,0,0,0,0,0
jbox2d_jbox2d,org.box2d.proto,0,0,0,1,0,0,0,1
jbox2d_jbox2d,org.jbox2d.serialization,0,0,0,0,1,0,0,1
jbox2d_jbox2d,org.jbox2d.serialization.pb,0,0,0,0,0,0,0,0
jbox2d_jbox2d,org.jbox2d.profile,0,0,0,0,0,0,0,0
jbox2d_jbox2d,org.jbox2d.profile.worlds,0,0,0,0,0,0,0,0
jcabi_jcabi-http,com.jcabi.http,8,1,0,0,1,0,1,11
jcabi_jcabi-http,com.jcabi.http.mock,5,1,0,0,1,0,1,8
jcabi_jcabi-http,com.jcabi.http.request,3,0,0,0,1,0,1,5
jcabi_jcabi-http,com.jcabi.http.response,5,1,0,0,1,0,1,8
jcabi_jcabi-http,com.jcabi.http.wire,3,0,0,0,1,0,1,5
jcabi_jcabi-immutable,com.jcabi.immutable,0,0,0,0,1,0,0,1
JCTools_JCTools,org.jctools.channels.mpsc,0,0,0,0,1,1,0,2
JCTools_JCTools,org.jctools.channels.spsc,1,1,0,0,1,1,0,4
JCTools_JCTools,org.jctools.handrolled.throughput.spsc,0,0,0,0,1,0,0,1
JCTools_JCTools,org.jctools.jmh.baseline,0,0,0,0,0,0,0,0
JCTools_JCTools,org.jctools.jmh.collections,0,1,0,0,0,0,0,1
JCTools_JCTools,org.jctools.jmh.counters,0,1,0,0,0,0,0,1
JCTools_JCTools,org.jctools.jmh.latency,0,0,0,0,0,0,0,0
JCTools_JCTools,org.jctools.jmh.latency.spsc,0,1,0,0,1,0,0,2
JCTools_JCTools,org.jctools.jmh.throughput.channels,0,0,0,0,1,1,0,2
JCTools_JCTools,org.jctools.jmh.throughput,0,1,0,0,1,0,0,2
JCTools_JCTools,org.jctools.queues.alt,0,0,0,0,0,0,0,0
JCTools_JCTools,org.jctools.queues,1,1,0,1,0,2,0,5
JCTools_JCTools,org.jctools.channels.mpsc.generated,0,0,0,0,0,0,0,0
JCTools_JCTools,org.jctools.channels.spsc.generated,0,0,0,1,0,0,0,1
JCTools_JCTools,org.jctools.jmh.baseline.generated,0,0,0,0,1,0,0,1
JCTools_JCTools,org.jctools.jmh.collections.generated,0,0,0,0,0,0,0,0
JCTools_JCTools,org.jctools.jmh.counters.generated,0,0,0,0,0,0,0,0
JCTools_JCTools,org.jctools.jmh.latency.generated,0,0,0,0,0,0,0,0
JCTools_JCTools,org.jctools.jmh.latency.spsc.generated,0,0,0,1,1,0,0,2
JCTools_JCTools,org.jctools.jmh.throughput.channels.generated,0,0,0,0,1,0,0,1
JCTools_JCTools,org.jctools.jmh.throughput.generated,0,0,0,1,0,0,0,1
JCTools_JCTools,org.jctools.queues.atomic,1,0,0,1,1,0,0,3
JCTools_JCTools,org.jctools.channels,0,0,0,0,1,3,0,4
JCTools_JCTools,org.jctools.channels.mapping,1,0,0,0,1,0,0,2
JCTools_JCTools,org.jctools.channels.proxy,0,0,0,0,0,1,0,1
JCTools_JCTools,org.jctools.util,0,0,0,0,1,4,0,5
JCTools_JCTools,org.jctools.sets,0,0,0,0,1,1,0,2
JCTools_JCTools,org.openjdk.jcstress.infra.results,0,0,0,0,1,0,0,1
JCTools_JCTools,org.jctools.maps,0,0,0,1,0,0,0,1
JCTools_JCTools,org.jctools.queues.spec,0,0,0,0,0,1,0,1
JCTools_JCTools,org.jctools.queues.matchers,0,0,0,0,0,0,0,0
JCTools_JCTools,org.jctools.counters,0,0,0,0,0,0,0,0
JCTools_JCTools,org.jctools.queues.blocking,0,0,0,0,1,0,0,1
JCTools_JCTools,org.jctools.queues.intrusive,0,0,0,0,1,0,0,1
JDatePicker_JDatePicker,org.jdatepicker,0,0,0,0,0,0,0,0
JDatePicker_JDatePicker,org.jdatepicker.constraints,0,0,0,0,0,0,0,0
JDatePicker_JDatePicker,org.jdatepicker.graphics,0,0,0,0,0,0,0,0
JDatePicker_JDatePicker,org.jdatepicker.features,0,0,0,0,1,0,0,1
JDatePicker_JDatePicker,org.jdatepicker.issues,0,0,0,0,1,0,0,1
jelkosz_Kanbanik,com.googlecode.kanbanik.dto,0,0,0,0,0,0,0,0
jelkosz_Kanbanik,com.allen_sauer.gwt.dnd.client.util,0,0,0,0,0,0,0,0
jelkosz_Kanbanik,com.google.gwt.i18n.client.constants,0,0,0,0,0,0,0,0
jelkosz_Kanbanik,com.google.gwt.i18n.client.impl,0,0,0,0,0,0,0,0
jelkosz_Kanbanik,com.google.gwt.lang,0,0,0,0,0,0,0,0
jelkosz_Kanbanik,com.google.gwt.user.client,0,0,0,0,0,0,0,0
jelkosz_Kanbanik,com.google.gwt.user.client.impl,0,0,0,0,0,0,0,0
jelkosz_Kanbanik,com.google.gwt.user.client.ui,0,0,0,0,1,0,0,1
jelkosz_Kanbanik,com.google.gwt.user.client.ui.impl,0,0,0,0,0,0,0,0
jelkosz_Kanbanik,com.google.gwt.useragent.client,0,0,0,0,0,0,0,0
jelkosz_Kanbanik,com.googlecode.kanbanik.client.api,19,1,0,1,0,10,0,31
jelkosz_Kanbanik,com.googlecode.kanbanik.client.components.board,0,0,0,1,1,3,0,5
jelkosz_Kanbanik,com.googlecode.kanbanik.client.components.common,0,0,0,0,1,0,0,1
jelkosz_Kanbanik,com.googlecode.kanbanik.client.components.common.filters,0,0,0,0,1,0,0,1
jelkosz_Kanbanik,com.googlecode.kanbanik.client.components.filter,0,0,0,0,1,1,0,2
jelkosz_Kanbanik,com.googlecode.kanbanik.client.components.header,4,0,0,0,1,1,0,6
jelkosz_Kanbanik,com.googlecode.kanbanik.client.components,5,1,0,0,1,1,0,8
jelkosz_Kanbanik,com.googlecode.kanbanik.client.components.security,0,0,0,1,1,0,0,2
jelkosz_Kanbanik,com.googlecode.kanbanik.client.components.task.tag,0,0,0,0,1,0,0,1
jelkosz_Kanbanik,com.googlecode.kanbanik.client.components.task,3,0,0,1,1,1,0,6
jelkosz_Kanbanik,com.googlecode.kanbanik.client,17,1,0,1,0,2,0,21
jelkosz_Kanbanik,com.googlecode.kanbanik.client.modules.editworkflow.boards,0,0,0,0,1,0,0,1
jelkosz_Kanbanik,com.googlecode.kanbanik.client.modules.editworkflow.classofservice,0,0,0,0,1,0,0,1
jelkosz_Kanbanik,com.googlecode.kanbanik.client.modules.editworkflow.projects,0,0,0,0,1,0,0,1
jelkosz_Kanbanik,com.googlecode.kanbanik.client.modules.editworkflow.workflow,0,0,0,1,1,3,0,5
jelkosz_Kanbanik,com.googlecode.kanbanik.client.modules,7,0,0,0,1,1,0,9
jelkosz_Kanbanik,emul.java.util,0,0,0,0,0,0,0,0
jelkosz_Kanbanik,net.auroris.ColorPicker.client.images,0,0,0,0,0,0,0,0
jelkosz_Kanbanik,com.googlecode.kanbanik.client.managers,3,0,0,0,1,2,0,6
jelkosz_Kanbanik,com.googlecode.kanbanik.client.messaging,0,0,0,0,0,7,0,7
jelkosz_Kanbanik,com.googlecode.kanbanik.client.messaging.messages.board,1,1,0,0,1,0,0,3
jelkosz_Kanbanik,com.googlecode.kanbanik.client.messaging.messages.classesofservice,0,0,0,0,0,0,0,0
jelkosz_Kanbanik,com.googlecode.kanbanik.client.messaging.messages.modules,0,0,0,0,0,0,0,0
jelkosz_Kanbanik,com.googlecode.kanbanik.client.messaging.messages.project,0,0,0,0,1,0,0,1
jelkosz_Kanbanik,com.googlecode.kanbanik.client.messaging.messages.task,1,1,0,0,1,2,0,5
jelkosz_Kanbanik,com.googlecode.kanbanik.client.messaging.messages.user,5,0,0,0,0,0,0,5
jelkosz_Kanbanik,com.googlecode.kanbanik.client.messaging.messages.workflowitem,0,0,0,0,0,0,0,0
jelkosz_Kanbanik,com.googlecode.kanbanik.client.modules.lifecyclelisteners,0,0,0,0,0,0,0,0
jelkosz_Kanbanik,com.googlecode.kanbanik.client.security,10,0,0,0,0,2,0,12
jelkosz_Kanbanik,com.googlecode.kanbanik.server,0,0,0,0,0,0,0,0
jelkosz_Kanbanik,com.googlecode.kanbanik.shared,0,0,0,0,0,0,0,0
jelkosz_Kanbanik,com.googlecode.kanbanik.dto,0,0,0,0,0,0,0,0
jelkosz_Kanbanik,com.allen_sauer.gwt.dnd.client.util,0,0,0,0,0,0,0,0
jelkosz_Kanbanik,com.google.gwt.i18n.client.constants,0,0,0,0,0,0,0,0
jelkosz_Kanbanik,com.google.gwt.i18n.client.impl,0,0,0,0,0,0,0,0
jelkosz_Kanbanik,com.google.gwt.lang,0,0,0,0,0,0,0,0
jelkosz_Kanbanik,com.google.gwt.user.client,0,0,0,0,0,0,0,0
jelkosz_Kanbanik,com.google.gwt.user.client.impl,0,0,0,0,0,0,0,0
jelkosz_Kanbanik,com.google.gwt.user.client.ui,0,0,0,0,1,0,0,1
jelkosz_Kanbanik,com.google.gwt.user.client.ui.impl,0,0,0,0,0,0,0,0
jelkosz_Kanbanik,com.google.gwt.useragent.client,0,0,0,0,0,0,0,0
jelkosz_Kanbanik,com.googlecode.kanbanik.client.api,19,1,0,1,0,10,0,31
jelkosz_Kanbanik,com.googlecode.kanbanik.client.components.board,0,0,0,1,1,3,0,5
jelkosz_Kanbanik,com.googlecode.kanbanik.client.components.common,0,0,0,0,1,0,0,1
jelkosz_Kanbanik,com.googlecode.kanbanik.client.components.common.filters,0,0,0,0,1,0,0,1
jelkosz_Kanbanik,com.googlecode.kanbanik.client.components.filter,0,0,0,0,1,1,0,2
jelkosz_Kanbanik,com.googlecode.kanbanik.client.components.header,4,0,0,0,1,1,0,6
jelkosz_Kanbanik,com.googlecode.kanbanik.client.components,5,1,0,0,1,1,0,8
jelkosz_Kanbanik,com.googlecode.kanbanik.client.components.security,0,0,0,1,1,0,0,2
jelkosz_Kanbanik,com.googlecode.kanbanik.client.components.task.tag,0,0,0,0,1,0,0,1
jelkosz_Kanbanik,com.googlecode.kanbanik.client.components.task,3,0,0,1,1,1,0,6
jelkosz_Kanbanik,com.googlecode.kanbanik.client,17,1,0,1,0,2,0,21
jelkosz_Kanbanik,com.googlecode.kanbanik.client.modules.editworkflow.boards,0,0,0,0,1,0,0,1
jelkosz_Kanbanik,com.googlecode.kanbanik.client.modules.editworkflow.classofservice,0,0,0,0,1,0,0,1
jelkosz_Kanbanik,com.googlecode.kanbanik.client.modules.editworkflow.projects,0,0,0,0,1,0,0,1
jelkosz_Kanbanik,com.googlecode.kanbanik.client.modules.editworkflow.workflow,0,0,0,1,1,3,0,5
jelkosz_Kanbanik,com.googlecode.kanbanik.client.modules,7,0,0,0,1,1,0,9
jelkosz_Kanbanik,emul.java.util,0,0,0,0,0,0,0,0
jelkosz_Kanbanik,net.auroris.ColorPicker.client.images,0,0,0,0,0,0,0,0
jelkosz_Kanbanik,com.googlecode.kanbanik.client.managers,3,0,0,0,1,2,0,6
jelkosz_Kanbanik,com.googlecode.kanbanik.client.messaging,0,0,0,0,0,7,0,7
jelkosz_Kanbanik,com.googlecode.kanbanik.client.messaging.messages.board,1,1,0,0,1,0,0,3
jelkosz_Kanbanik,com.googlecode.kanbanik.client.messaging.messages.classesofservice,0,0,0,0,0,0,0,0
jelkosz_Kanbanik,com.googlecode.kanbanik.client.messaging.messages.modules,0,0,0,0,0,0,0,0
jelkosz_Kanbanik,com.googlecode.kanbanik.client.messaging.messages.project,0,0,0,0,1,0,0,1
jelkosz_Kanbanik,com.googlecode.kanbanik.client.messaging.messages.task,1,1,0,0,1,2,0,5
jelkosz_Kanbanik,com.googlecode.kanbanik.client.messaging.messages.user,5,0,0,0,0,0,0,5
jelkosz_Kanbanik,com.googlecode.kanbanik.client.messaging.messages.workflowitem,0,0,0,0,0,0,0,0
jelkosz_Kanbanik,com.googlecode.kanbanik.client.modules.lifecyclelisteners,0,0,0,0,0,0,0,0
jelkosz_Kanbanik,com.googlecode.kanbanik.client.security,10,0,0,0,0,2,0,12
jelkosz_Kanbanik,com.googlecode.kanbanik.server,0,0,0,0,0,0,0,0
jelkosz_Kanbanik,com.googlecode.kanbanik.shared,0,0,0,0,0,0,0,0
jelkosz_Kanbanik,com.googlecode.kanbanik.dto,0,0,0,0,0,0,0,0
jelkosz_Kanbanik,com.allen_sauer.gwt.dnd.client.util,0,0,0,0,0,0,0,0
jelkosz_Kanbanik,com.google.gwt.i18n.client.constants,0,0,0,0,0,0,0,0
jelkosz_Kanbanik,com.google.gwt.i18n.client.impl,0,0,0,0,0,0,0,0
jelkosz_Kanbanik,com.google.gwt.lang,0,0,0,0,0,0,0,0
jelkosz_Kanbanik,com.google.gwt.user.client,0,0,0,0,0,0,0,0
jelkosz_Kanbanik,com.google.gwt.user.client.impl,0,0,0,0,0,0,0,0
jelkosz_Kanbanik,com.google.gwt.user.client.ui,0,0,0,0,1,0,0,1
jelkosz_Kanbanik,com.google.gwt.user.client.ui.impl,0,0,0,0,0,0,0,0
jelkosz_Kanbanik,com.google.gwt.useragent.client,0,0,0,0,0,0,0,0
jelkosz_Kanbanik,com.googlecode.kanbanik.client.api,19,1,0,1,0,10,0,31
jelkosz_Kanbanik,com.googlecode.kanbanik.client.components.board,0,0,0,1,1,3,0,5
jelkosz_Kanbanik,com.googlecode.kanbanik.client.components.common,0,0,0,0,1,0,0,1
jelkosz_Kanbanik,com.googlecode.kanbanik.client.components.common.filters,0,0,0,0,1,0,0,1
jelkosz_Kanbanik,com.googlecode.kanbanik.client.components.filter,0,0,0,0,1,1,0,2
jelkosz_Kanbanik,com.googlecode.kanbanik.client.components.header,4,0,0,0,1,1,0,6
jelkosz_Kanbanik,com.googlecode.kanbanik.client.components,5,1,0,0,1,1,0,8
jelkosz_Kanbanik,com.googlecode.kanbanik.client.components.security,0,0,0,1,1,0,0,2
jelkosz_Kanbanik,com.googlecode.kanbanik.client.components.task.tag,0,0,0,0,1,0,0,1
jelkosz_Kanbanik,com.googlecode.kanbanik.client.components.task,3,0,0,1,1,1,0,6
jelkosz_Kanbanik,com.googlecode.kanbanik.client,17,1,0,1,0,2,0,21
jelkosz_Kanbanik,com.googlecode.kanbanik.client.modules.editworkflow.boards,0,0,0,0,1,0,0,1
jelkosz_Kanbanik,com.googlecode.kanbanik.client.modules.editworkflow.classofservice,0,0,0,0,1,0,0,1
jelkosz_Kanbanik,com.googlecode.kanbanik.client.modules.editworkflow.projects,0,0,0,0,1,0,0,1
jelkosz_Kanbanik,com.googlecode.kanbanik.client.modules.editworkflow.workflow,0,0,0,1,1,3,0,5
jelkosz_Kanbanik,com.googlecode.kanbanik.client.modules,7,0,0,0,1,1,0,9
jelkosz_Kanbanik,emul.java.util,0,0,0,0,0,0,0,0
jelkosz_Kanbanik,net.auroris.ColorPicker.client.images,0,0,0,0,0,0,0,0
jelkosz_Kanbanik,com.googlecode.kanbanik.client.managers,3,0,0,0,1,2,0,6
jelkosz_Kanbanik,com.googlecode.kanbanik.client.messaging,0,0,0,0,0,7,0,7
jelkosz_Kanbanik,com.googlecode.kanbanik.client.messaging.messages.board,1,1,0,0,1,0,0,3
jelkosz_Kanbanik,com.googlecode.kanbanik.client.messaging.messages.classesofservice,0,0,0,0,0,0,0,0
jelkosz_Kanbanik,com.googlecode.kanbanik.client.messaging.messages.modules,0,0,0,0,0,0,0,0
jelkosz_Kanbanik,com.googlecode.kanbanik.client.messaging.messages.project,0,0,0,0,1,0,0,1
jelkosz_Kanbanik,com.googlecode.kanbanik.client.messaging.messages.task,1,1,0,0,1,2,0,5
jelkosz_Kanbanik,com.googlecode.kanbanik.client.messaging.messages.user,5,0,0,0,0,0,0,5
jelkosz_Kanbanik,com.googlecode.kanbanik.client.messaging.messages.workflowitem,0,0,0,0,0,0,0,0
jelkosz_Kanbanik,com.googlecode.kanbanik.client.modules.lifecyclelisteners,0,0,0,0,0,0,0,0
jelkosz_Kanbanik,com.googlecode.kanbanik.client.security,10,0,0,0,0,2,0,12
jelkosz_Kanbanik,com.googlecode.kanbanik.server,0,0,0,0,0,0,0,0
jelkosz_Kanbanik,com.googlecode.kanbanik.shared,0,0,0,0,0,0,0,0
jimmoores_quandl4j,com.jimmoores.quandl.classic,0,0,0,0,0,0,0,0
jimmoores_quandl4j,com.jimmoores.quandl,2,1,0,0,1,0,0,4
jimmoores_quandl4j,com.jimmoores.quandl.generic,1,0,0,0,0,0,0,1
jimmoores_quandl4j,com.jimmoores.quandl.processing,1,0,0,0,1,0,0,2
jimmoores_quandl4j,com.jimmoores.quandl.processing.classic,0,0,0,0,0,0,0,0
jimmoores_quandl4j,com.jimmoores.quandl.util,0,0,0,0,1,0,0,1
jimmoores_quandl4j,com.jimmoores.quandl.classic.example,0,0,0,0,1,0,0,1
jimmoores_quandl4j,com.jimmoores.quandl.example,0,0,0,0,1,0,0,1
jimmoores_quandl4j,com.jimmoores.quandl.processing.tablesaw,0,0,0,0,0,0,0,0
jimmoores_quandl4j,com.jimmoores.quandl.tablesaw,0,0,0,0,0,0,0,0
jimmoores_quandl4j,com.jimmoores.quandl.tablesaw.example,0,0,0,0,0,0,0,0
Jimmy-Shi_bean-query,cn.jimmyshi.beanquery,0,0,0,0,1,0,0,1
Jimmy-Shi_bean-query,cn.jimmyshi.beanquery.comparators,0,0,0,0,1,0,0,1
Jimmy-Shi_bean-query,cn.jimmyshi.beanquery.selectors,0,0,0,0,1,0,0,1
Jimmy-Shi_bean-query,cn.jimmyshi.beanquery.example,0,0,0,0,0,0,0,0
jindrapetrik_jpexs-decompiler,(default package),0,0,0,0,0,0,1,1
jindrapetrik_jpexs-decompiler,org.monte.media,0,0,0,0,0,0,1,1
jindrapetrik_jpexs-decompiler,org.monte.media.avi,0,0,0,0,1,0,1,2
jindrapetrik_jpexs-decompiler,org.monte.media.color,0,0,0,0,0,0,1,1
jindrapetrik_jpexs-decompiler,org.monte.media.io,0,0,0,0,1,0,1,2
jindrapetrik_jpexs-decompiler,org.monte.media.jpeg,0,1,0,0,1,0,1,3
jindrapetrik_jpexs-decompiler,org.monte.media.math,0,0,0,0,0,0,1,1
jindrapetrik_jpexs-decompiler,org.monte.media.png,0,0,0,0,0,0,1,1
jindrapetrik_jpexs-decompiler,org.monte.media.riff,0,0,0,0,0,0,1,1
jindrapetrik_jpexs-decompiler,org.monte.media.util,0,0,0,0,0,0,1,1
jindrapetrik_jpexs-decompiler,com.jpexs.decompiler.flash.abc,16,0,0,0,1,24,1,42
jindrapetrik_jpexs-decompiler,com.jpexs.decompiler.flash.abc.avm2,12,1,0,0,1,38,1,53
jindrapetrik_jpexs-decompiler,com.jpexs.decompiler.flash.abc.avm2.deobfuscation,4,0,0,0,1,5,1,11
jindrapetrik_jpexs-decompiler,com.jpexs.decompiler.flash.abc.avm2.exceptions,0,0,0,0,0,0,1,1
jindrapetrik_jpexs-decompiler,com.jpexs.decompiler.flash.abc.avm2.fastavm2,0,0,0,0,0,0,1,1
jindrapetrik_jpexs-decompiler,com.jpexs.decompiler.flash.abc.avm2.graph,3,0,0,0,0,0,1,4
jindrapetrik_jpexs-decompiler,com.jpexs.decompiler.flash.abc.avm2.instructions.alchemy,2,0,0,0,0,1,1,4
jindrapetrik_jpexs-decompiler,com.jpexs.decompiler.flash.abc.avm2.instructions.arithmetic,0,0,0,0,1,0,1,2
jindrapetrik_jpexs-decompiler,com.jpexs.decompiler.flash.abc.avm2.instructions,9,1,0,0,1,14,1,26
jindrapetrik_jpexs-decompiler,com.jpexs.decompiler.flash.abc.avm2.instructions.bitwise,0,0,0,0,1,0,1,2
jindrapetrik_jpexs-decompiler,com.jpexs.decompiler.flash.abc.avm2.instructions.comparison,0,0,0,0,1,0,1,2
jindrapetrik_jpexs-decompiler,com.jpexs.decompiler.flash.abc.avm2.instructions.construction,0,0,0,0,1,0,1,2
jindrapetrik_jpexs-decompiler,com.jpexs.decompiler.flash.abc.avm2.instructions.debug,0,0,0,0,0,0,1,1
jindrapetrik_jpexs-decompiler,com.jpexs.decompiler.flash.abc.avm2.instructions.executing,0,0,0,0,1,2,1,4
jindrapetrik_jpexs-decompiler,com.jpexs.decompiler.flash.abc.avm2.instructions.jumps,0,0,0,0,1,1,1,3
jindrapetrik_jpexs-decompiler,com.jpexs.decompiler.flash.abc.avm2.instructions.localregs,0,0,0,0,1,3,1,5
jindrapetrik_jpexs-decompiler,com.jpexs.decompiler.flash.abc.avm2.instructions.other,0,0,0,0,1,4,1,6
jindrapetrik_jpexs-decompiler,com.jpexs.decompiler.flash.abc.avm2.instructions.other2,0,0,0,1,1,1,1,4
jindrapetrik_jpexs-decompiler,com.jpexs.decompiler.flash.abc.avm2.instructions.stack,0,0,0,0,1,1,1,3
jindrapetrik_jpexs-decompiler,com.jpexs.decompiler.flash.abc.avm2.instructions.types,0,0,0,0,1,2,1,4
jindrapetrik_jpexs-decompiler,com.jpexs.decompiler.flash.abc.avm2.instructions.xml,0,0,0,0,0,0,1,1
jindrapetrik_jpexs-decompiler,com.jpexs.decompiler.flash.abc.avm2.model,9,1,0,1,0,7,1,19
jindrapetrik_jpexs-decompiler,com.jpexs.decompiler.flash.abc.avm2.model.clauses,3,0,0,0,1,2,1,7
jindrapetrik_jpexs-decompiler,com.jpexs.decompiler.flash.abc.avm2.model.operations,2,1,0,0,1,2,1,7
jindrapetrik_jpexs-decompiler,com.jpexs.decompiler.flash.abc.avm2.parser,0,0,0,0,0,0,1,1
jindrapetrik_jpexs-decompiler,com.jpexs.decompiler.flash.abc.avm2.parser.pcode,3,0,0,0,1,0,1,5
jindrapetrik_jpexs-decompiler,com.jpexs.decompiler.flash.abc.avm2.parser.script,6,0,0,1,0,8,1,16
jindrapetrik_jpexs-decompiler,com.jpexs.decompiler.flash.abc.methodinfo_parser,0,0,0,0,0,0,1,1
jindrapetrik_jpexs-decompiler,com.jpexs.decompiler.flash.abc.types,18,1,0,0,1,35,1,56
jindrapetrik_jpexs-decompiler,com.jpexs.decompiler.flash.abc.types.traits,8,1,0,0,1,9,1,20
jindrapetrik_jpexs-decompiler,com.jpexs.decompiler.flash.abc.usages,3,0,0,0,0,4,1,8
jindrapetrik_jpexs-decompiler,com.jpexs.decompiler.flash,111,1,0,1,1,57,1,172
jindrapetrik_jpexs-decompiler,com.jpexs.decompiler.flash.action,23,1,0,0,1,21,1,47
jindrapetrik_jpexs-decompiler,com.jpexs.decompiler.flash.action.deobfuscation,2,0,0,0,0,1,1,4
jindrapetrik_jpexs-decompiler,com.jpexs.decompiler.flash.action.fastactionlist,4,1,0,0,0,3,1,9
jindrapetrik_jpexs-decompiler,com.jpexs.decompiler.flash.action.flashlite,1,1,0,0,0,0,1,3
jindrapetrik_jpexs-decompiler,com.jpexs.decompiler.flash.action.model,18,1,0,1,0,6,1,27
jindrapetrik_jpexs-decompiler,com.jpexs.decompiler.flash.action.model.clauses,2,0,0,0,1,1,1,5
jindrapetrik_jpexs-decompiler,com.jpexs.decompiler.flash.action.model.operations,13,1,0,1,1,7,1,24
jindrapetrik_jpexs-decompiler,com.jpexs.decompiler.flash.action.parser,0,0,0,0,0,0,1,1
jindrapetrik_jpexs-decompiler,com.jpexs.decompiler.flash.action.parser.pcode,2,0,0,0,0,3,1,6
jindrapetrik_jpexs-decompiler,com.jpexs.decompiler.flash.action.parser.script,5,0,0,0,0,4,1,10
jindrapetrik_jpexs-decompiler,com.jpexs.decompiler.flash.action.special,2,0,0,0,1,1,1,5
jindrapetrik_jpexs-decompiler,com.jpexs.decompiler.flash.action.swf3,3,1,0,0,1,0,1,6
jindrapetrik_jpexs-decompiler,com.jpexs.decompiler.flash.action.swf4,13,1,0,1,1,9,1,26
jindrapetrik_jpexs-decompiler,com.jpexs.decompiler.flash.action.swf5,3,1,0,1,1,4,1,11
jindrapetrik_jpexs-decompiler,com.jpexs.decompiler.flash.action.swf6,4,1,0,0,0,1,1,7
jindrapetrik_jpexs-decompiler,com.jpexs.decompiler.flash.action.swf7,3,1,0,0,1,1,1,7
jindrapetrik_jpexs-decompiler,com.jpexs.decompiler.flash.amf.amf3,9,1,0,0,1,3,1,15
jindrapetrik_jpexs-decompiler,com.jpexs.decompiler.flash.amf.amf3.types,3,1,0,0,0,2,1,7
jindrapetrik_jpexs-decompiler,com.jpexs.decompiler.flash.cache,0,0,0,0,0,4,1,5
jindrapetrik_jpexs-decompiler,com.jpexs.decompiler.flash.configuration,15,1,0,0,0,16,1,33
jindrapetrik_jpexs-decompiler,com.jpexs.decompiler.flash.docs,0,1,0,0,0,0,1,2
jindrapetrik_jpexs-decompiler,com.jpexs.decompiler.flash.dumpview,3,1,0,0,0,4,1,9
jindrapetrik_jpexs-decompiler,com.jpexs.decompiler.flash.ecma,0,0,0,0,1,13,1,15
jindrapetrik_jpexs-decompiler,com.jpexs.decompiler.flash.exporters.amf.amf3,3,0,0,0,0,2,1,6
jindrapetrik_jpexs-decompiler,com.jpexs.decompiler.flash.exporters,4,1,0,0,1,2,1,9
jindrapetrik_jpexs-decompiler,com.jpexs.decompiler.flash.exporters.commonshape,9,1,0,0,0,4,1,15
jindrapetrik_jpexs-decompiler,com.jpexs.decompiler.flash.exporters.morphshape,3,0,0,0,0,0,1,4
jindrapetrik_jpexs-decompiler,com.jpexs.decompiler.flash.exporters.script,10,1,0,0,1,4,1,17
jindrapetrik_jpexs-decompiler,com.jpexs.decompiler.flash.exporters.settings,0,0,0,0,1,1,1,3
jindrapetrik_jpexs-decompiler,com.jpexs.decompiler.flash.exporters.shape,5,1,0,0,0,2,1,9
jindrapetrik_jpexs-decompiler,com.jpexs.decompiler.flash.exporters.swf,5,1,0,0,0,1,1,8
jindrapetrik_jpexs-decompiler,com.jpexs.decompiler.flash.flexsdk,3,0,0,0,0,1,1,5
jindrapetrik_jpexs-decompiler,com.jpexs.decompiler.flash.flv,0,0,0,0,1,0,1,2
jindrapetrik_jpexs-decompiler,com.jpexs.decompiler.flash.helpers,8,1,0,0,1,17,1,28
jindrapetrik_jpexs-decompiler,com.jpexs.decompiler.flash.helpers.collections,0,0,0,0,0,0,1,1
jindrapetrik_jpexs-decompiler,com.jpexs.decompiler.flash.helpers.hilight,5,0,0,0,0,1,1,7
jindrapetrik_jpexs-decompiler,com.jpexs.decompiler.flash.iggy.annotations,0,0,0,0,0,0,1,1
jindrapetrik_jpexs-decompiler,com.jpexs.decompiler.flash.iggy.conversion,4,0,0,0,0,0,1,5
jindrapetrik_jpexs-decompiler,com.jpexs.decompiler.flash.iggy,1,1,0,0,0,0,1,3
jindrapetrik_jpexs-decompiler,com.jpexs.decompiler.flash.iggy.streams,1,0,0,0,1,0,1,3
jindrapetrik_jpexs-decompiler,com.jpexs.decompiler.flash.importers.amf.amf3,2,0,0,0,0,0,1,3
jindrapetrik_jpexs-decompiler,com.jpexs.decompiler.flash.importers,5,1,0,0,1,3,1,11
jindrapetrik_jpexs-decompiler,com.jpexs.decompiler.flash.importers.svg,0,0,0,0,0,0,1,1
jindrapetrik_jpexs-decompiler,com.jpexs.decompiler.flash.search,3,1,0,0,0,0,1,5
jindrapetrik_jpexs-decompiler,com.jpexs.decompiler.flash.tags,16,1,0,1,0,39,1,58
jindrapetrik_jpexs-decompiler,com.jpexs.decompiler.flash.tags.base,8,1,0,0,1,29,1,40
jindrapetrik_jpexs-decompiler,com.jpexs.decompiler.flash.tags.dynamictext,0,0,0,0,1,1,1,3
jindrapetrik_jpexs-decompiler,com.jpexs.decompiler.flash.tags.font,0,0,0,0,0,0,1,1
jindrapetrik_jpexs-decompiler,com.jpexs.decompiler.flash.tags.gfx,4,1,0,0,1,1,1,8
jindrapetrik_jpexs-decompiler,com.jpexs.decompiler.flash.tags.text,0,0,0,0,0,0,1,1
jindrapetrik_jpexs-decompiler,com.jpexs.decompiler.flash.timeline,9,1,0,0,1,14,1,26
jindrapetrik_jpexs-decompiler,com.jpexs.decompiler.flash.treeitems,0,0,0,0,1,8,1,10
jindrapetrik_jpexs-decompiler,com.jpexs.decompiler.flash.types,26,1,0,1,1,10,1,40
jindrapetrik_jpexs-decompiler,com.jpexs.decompiler.flash.types.annotations.parser,0,0,0,0,0,0,1,1
jindrapetrik_jpexs-decompiler,com.jpexs.decompiler.flash.types.filters,4,0,0,0,0,0,1,5
jindrapetrik_jpexs-decompiler,com.jpexs.decompiler.flash.types.gfx,3,0,0,0,1,1,1,6
jindrapetrik_jpexs-decompiler,com.jpexs.decompiler.flash.types.shaperecords,7,1,0,0,0,2,1,11
jindrapetrik_jpexs-decompiler,com.jpexs.decompiler.flash.types.sound,2,1,0,0,1,0,1,5
jindrapetrik_jpexs-decompiler,com.jpexs.decompiler.flash.xfl,4,0,0,0,0,1,1,6
jindrapetrik_jpexs-decompiler,com.jpexs.decompiler.graph,18,1,0,0,1,40,1,61
jindrapetrik_jpexs-decompiler,com.jpexs.decompiler.graph.model,4,1,0,1,1,3,1,11
jindrapetrik_jpexs-decompiler,com.jpexs.helpers,54,1,0,0,1,19,1,76
jindrapetrik_jpexs-decompiler,com.jpexs.helpers.plugin,0,0,0,0,0,0,1,1
jindrapetrik_jpexs-decompiler,com.jpexs.helpers.sound,0,0,0,0,0,0,1,1
jindrapetrik_jpexs-decompiler,com.jpexs.helpers.stat,2,0,0,0,0,0,1,3
jindrapetrik_jpexs-decompiler,com.jpexs.helpers.streams,0,0,0,0,0,0,1,1
jindrapetrik_jpexs-decompiler,com.jpexs.helpers.utf8,0,0,0,0,0,0,1,1
jindrapetrik_jpexs-decompiler,com.jpexs.decompiler.flash.generators,0,0,0,0,0,0,1,1
jindrapetrik_jpexs-decompiler,com.jpexs.decompiler.flash.importers.amf.amf3.parser,0,0,0,0,0,0,1,1
jindrapetrik_jpexs-decompiler,net.kroo.elliot,0,0,0,0,0,0,1,1
jindrapetrik_jpexs-decompiler,net.weiner.kevin,0,0,0,0,0,0,1,1
jindrapetrik_jpexs-decompiler,gnu.jpdf,0,0,0,0,0,0,1,1
jindrapetrik_jpexs-decompiler,com.jpacker.encoders,0,0,0,0,0,0,1,1
jindrapetrik_jpexs-decompiler,com.jpacker.evaluators,1,1,0,0,0,0,1,3
jindrapetrik_jpexs-decompiler,com.jpacker.exceptions,0,0,0,0,0,0,1,1
jindrapetrik_jpexs-decompiler,com.jpacker,1,0,0,0,0,0,1,2
jindrapetrik_jpexs-decompiler,com.jpacker.strategies,0,0,0,0,0,0,1,1
jindrapetrik_jpexs-decompiler,com.jpexs.proxy,0,0,0,0,0,0,1,1
jindrapetrik_jpexs-decompiler,jsyntaxpane.actions,9,1,0,1,0,0,1,12
jindrapetrik_jpexs-decompiler,jsyntaxpane.actions.gui,8,1,0,0,0,0,1,10
jindrapetrik_jpexs-decompiler,jsyntaxpane.components,6,0,0,0,1,0,1,8
jindrapetrik_jpexs-decompiler,jsyntaxpane,8,1,0,0,0,0,1,10
jindrapetrik_jpexs-decompiler,jsyntaxpane.lexers,0,0,0,0,0,0,1,1
jindrapetrik_jpexs-decompiler,jsyntaxpane.syntaxkits,0,0,0,0,1,0,1,2
jindrapetrik_jpexs-decompiler,jsyntaxpane.util,5,1,0,0,1,0,1,8
jindrapetrik_jpexs-decompiler,SevenZip.Compression.LZ,0,0,0,0,0,0,1,1
jindrapetrik_jpexs-decompiler,SevenZip.Compression.LZMA,1,0,0,0,0,0,1,2
jindrapetrik_jpexs-decompiler,SevenZip.Compression.RangeCoder,0,0,0,0,0,0,1,1
jindrapetrik_jpexs-decompiler,SevenZip,1,1,0,0,0,0,1,3
jindrapetrik_jpexs-decompiler,lt.dkd.nellymoser,0,0,0,0,0,0,1,1
jindrapetrik_jpexs-decompiler,de.hameister.treetable,0,0,0,0,0,0,1,1
jindrapetrik_jpexs-decompiler,fontastic,0,1,0,0,0,0,1,2
jindrapetrik_jpexs-decompiler,org.doubletype.ossa.adapter,0,0,0,0,0,0,1,1
jindrapetrik_jpexs-decompiler,org.doubletype.ossa,0,0,0,0,0,0,1,1
jindrapetrik_jpexs-decompiler,org.doubletype.ossa.module,0,0,0,0,0,0,1,1
jindrapetrik_jpexs-decompiler,org.doubletype.ossa.truetype,0,0,0,0,0,0,1,1
jindrapetrik_jpexs-decompiler,com.jpexs.uploader,0,0,0,0,0,0,1,1
jindrapetrik_jpexs-decompiler,com.jpexs.browsers.cache,2,0,0,0,0,0,1,3
jindrapetrik_jpexs-decompiler,com.jpexs.browsers.cache.chrome,1,0,0,0,1,0,1,3
jindrapetrik_jpexs-decompiler,com.jpexs.browsers.cache.firefox,1,0,0,0,0,0,1,2
jindrapetrik_jpexs-decompiler,com.jpexs.decompiler.flash.console,2,0,0,0,0,4,1,7
jindrapetrik_jpexs-decompiler,com.jpexs.decompiler.flash.gui.abc,6,0,0,0,1,6,1,14
jindrapetrik_jpexs-decompiler,com.jpexs.decompiler.flash.gui.abc.tablemodels,0,0,0,0,1,1,1,3
jindrapetrik_jpexs-decompiler,com.jpexs.decompiler.flash.gui,19,1,0,1,1,26,1,49
jindrapetrik_jpexs-decompiler,com.jpexs.decompiler.flash.gui.action,1,0,0,0,0,1,1,3
jindrapetrik_jpexs-decompiler,com.jpexs.decompiler.flash.gui.controls,0,0,0,0,0,0,1,1
jindrapetrik_jpexs-decompiler,com.jpexs.decompiler.flash.gui.debugger,1,1,0,0,0,1,1,4
jindrapetrik_jpexs-decompiler,com.jpexs.decompiler.flash.gui.dumpview,4,0,0,0,0,3,1,8
jindrapetrik_jpexs-decompiler,com.jpexs.decompiler.flash.gui.editor,4,1,0,0,1,2,1,9
jindrapetrik_jpexs-decompiler,com.jpexs.decompiler.flash.gui.generictageditors,1,1,0,0,1,2,1,6
jindrapetrik_jpexs-decompiler,com.jpexs.decompiler.flash.gui.graph,0,0,0,0,0,0,1,1
jindrapetrik_jpexs-decompiler,com.jpexs.decompiler.flash.gui.helpers,2,1,0,0,1,2,1,7
jindrapetrik_jpexs-decompiler,com.jpexs.decompiler.flash.gui.hexview,0,0,0,0,1,1,1,3
jindrapetrik_jpexs-decompiler,com.jpexs.decompiler.flash.gui.pipes,1,0,0,0,0,0,1,2
jindrapetrik_jpexs-decompiler,com.jpexs.decompiler.flash.gui.player,1,1,0,0,1,0,1,4
jindrapetrik_jpexs-decompiler,com.jpexs.decompiler.flash.gui.proxy,0,0,0,0,0,1,1,2
jindrapetrik_jpexs-decompiler,com.jpexs.decompiler.flash.gui.tagtree,6,0,0,0,0,7,1,14
jindrapetrik_jpexs-decompiler,com.jpexs.decompiler.flash.gui.timeline,1,1,0,0,0,0,1,3
jindrapetrik_jpexs-decompiler,com.jpexs.process,0,1,0,0,0,0,1,2
jindrapetrik_jpexs-decompiler,com.jpexs.process.win32,0,0,0,0,0,0,1,1
jindrapetrik_jpexs-decompiler,com.sun.jna.platform.win32,0,0,0,1,1,0,1,3
jirutka_spring-rest-exception-handler,cz.jirutka.spring.exhandler.handlers,0,0,0,0,1,0,0,1
jirutka_spring-rest-exception-handler,cz.jirutka.spring.exhandler.interpolators,0,0,0,0,0,0,0,0
jirutka_spring-rest-exception-handler,cz.jirutka.spring.exhandler,0,0,0,0,0,0,0,0
jirutka_spring-rest-exception-handler,cz.jirutka.spring.exhandler.messages,0,0,0,0,0,0,0,0
jirutka_spring-rest-exception-handler,cz.jirutka.spring.exhandler.support,0,0,0,0,0,0,0,0
jitsi_jicofo,org.jitsi.impl.protocol.xmpp,0,0,0,0,1,0,0,1
jitsi_jicofo,org.jitsi.impl.protocol.xmpp.colibri,0,0,0,0,0,0,0,0
jitsi_jicofo,org.jitsi.impl.reservation.rest,0,0,0,0,1,0,0,1
jitsi_jicofo,org.jitsi.impl.reservation.rest.json,0,0,0,0,0,0,0,0
jitsi_jicofo,org.jitsi.jicofo,3,1,0,1,1,0,0,6
jitsi_jicofo,org.jitsi.jicofo.auth,0,0,0,0,1,0,0,1
jitsi_jicofo,org.jitsi.jicofo.discovery,0,0,0,0,0,0,0,0
jitsi_jicofo,org.jitsi.jicofo.event,0,0,0,0,0,0,0,0
jitsi_jicofo,org.jitsi.jicofo.jigasi,0,0,0,0,0,0,0,0
jitsi_jicofo,org.jitsi.jicofo.osgi,0,0,0,0,0,0,0,0
jitsi_jicofo,org.jitsi.jicofo.recording.jibri,0,0,0,0,1,0,0,1
jitsi_jicofo,org.jitsi.jicofo.reservation,0,0,0,0,0,0,0,0
jitsi_jicofo,org.jitsi.jicofo.rest,0,0,0,0,0,0,0,0
jitsi_jicofo,org.jitsi.jicofo.stats,0,0,0,0,0,0,0,0
jitsi_jicofo,org.jitsi.jicofo.util,0,0,0,0,1,0,0,1
jitsi_jicofo,org.jitsi.jicofo.version,0,0,0,0,0,0,0,0
jitsi_jicofo,org.jitsi.jicofo.xmpp,2,1,0,0,1,0,0,4
jitsi_jicofo,org.jitsi.protocol.xmpp,0,0,0,0,1,0,0,1
jitsi_jicofo,org.jitsi.protocol.xmpp.colibri,0,0,0,0,0,0,0,0
jitsi_jicofo,org.jitsi.protocol.xmpp.colibri.exception,0,0,0,0,0,0,0,0
jitsi_jicofo,org.jitsi.protocol.xmpp.util,0,0,0,0,1,0,0,1
jitsi_jicofo,mock.jvb,0,0,0,0,0,0,0,0
jitsi_jicofo,mock.media,0,0,0,0,0,0,0,0
jitsi_jicofo,mock,2,1,0,0,1,0,0,4
jitsi_jicofo,mock.muc,0,0,0,0,0,0,0,0
jitsi_jicofo,mock.util,0,0,0,0,0,0,0,0
jitsi_jicofo,mock.xmpp,0,0,0,0,1,0,0,1
jitsi_jicofo,mock.xmpp.colibri,0,0,0,0,0,0,0,0
jitsi_jicofo,mock.xmpp.pubsub,0,0,0,0,0,0,0,0
jitsi_jigasi,org.jitsi.jigasi,1,1,0,1,1,0,0,4
jitsi_jigasi,org.jitsi.jigasi.health,0,0,0,0,0,0,0,0
jitsi_jigasi,org.jitsi.jigasi.osgi,0,0,0,0,0,0,0,0
jitsi_jigasi,org.jitsi.jigasi.rest,0,0,0,0,0,0,0,0
jitsi_jigasi,org.jitsi.jigasi.stats,0,0,0,0,0,0,0,0
jitsi_jigasi,org.jitsi.jigasi.transcription,0,0,0,1,1,0,0,2
jitsi_jigasi,org.jitsi.jigasi.transcription.action,0,0,0,0,0,0,0,0
jitsi_jigasi,org.jitsi.jigasi.util,0,0,0,0,0,0,0,0
jitsi_jigasi,org.jitsi.jigasi.version,0,0,0,0,0,0,0,0
jitsi_jigasi,org.jitsi.jigasi.xmpp,1,0,0,0,1,0,0,2
jitsi_jigasi,net.java.sip.communicator.service.protocol.mock,0,0,0,0,0,0,0,0
jitsi_jigasi,net.java.sip.communicator.service.protocol.mock.muc,0,0,0,0,0,0,0,0
jitsi_jigasi,org.jitsi.jigasi.xmpp.rayo,0,0,0,0,0,0,0,0
jivesoftware_jive-selenium-pages-framework,com.jivesoftware.selenium.pagefactory.framework.actions,0,0,0,0,1,0,0,1
jivesoftware_jive-selenium-pages-framework,com.jivesoftware.selenium.pagefactory.framework.browser,0,0,0,0,1,0,0,1
jivesoftware_jive-selenium-pages-framework,com.jivesoftware.selenium.pagefactory.framework.browser.mobile,0,0,0,0,0,0,0,0
jivesoftware_jive-selenium-pages-framework,com.jivesoftware.selenium.pagefactory.framework.browser.web,0,0,0,0,1,0,0,1
jivesoftware_jive-selenium-pages-framework,com.jivesoftware.selenium.pagefactory.framework.config,0,0,0,0,0,0,0,0
jivesoftware_jive-selenium-pages-framework,com.jivesoftware.selenium.pagefactory.framework.exception,0,0,0,0,0,0,0,0
jivesoftware_jive-selenium-pages-framework,com.jivesoftware.selenium.pagefactory.framework.pages,0,0,0,0,1,0,0,1
jivesoftware_jive-selenium-pages-framework,com.jivesoftware.selenium.pagefactory.framework.webservice,0,0,0,0,0,0,0,0
jivesoftware_jive-selenium-pages-framework,com.jivesoftware.selenium.pagefactory.framework,0,0,0,0,0,0,0,0
jlinn_quartz-redis-jobstore,net.joelinn.quartz.jobstore,0,0,0,0,1,0,0,1
jlinn_quartz-redis-jobstore,net.joelinn.quartz.jobstore.jedis,0,0,0,0,0,0,0,0
jlinn_quartz-redis-jobstore,net.joelinn.quartz.jobstore.mixin,0,0,0,0,0,0,0,0
jlinn_quartz-redis-jobstore,net.joelinn.junit,0,0,0,0,0,0,0,0
jlinn_quartz-redis-jobstore,net.joelinn.quartz,0,1,0,0,1,0,0,2
jlinn_quartz-redis-jobstore,net.joelinn.quartz.mixin,0,0,0,0,0,0,0,0
jlpoolen_libreveris,com.audiveris.installer,0,0,0,1,1,0,1,3
jlpoolen_libreveris,com.audiveris.installer.unix,0,0,0,0,1,0,1,2
jlpoolen_libreveris,com.audiveris.installer.windows,0,0,0,0,1,0,1,2
jlpoolen_libreveris,hudson.util.jna,0,0,0,0,1,0,1,2
jlpoolen_libreveris,(default package),0,0,0,0,0,0,1,1
jlpoolen_libreveris,omr.action,3,0,0,0,0,0,1,4
jlpoolen_libreveris,omr.check,2,1,0,0,1,0,1,5
jlpoolen_libreveris,omr,24,1,0,0,1,0,1,27
jlpoolen_libreveris,omr.constant,19,1,0,0,0,0,1,21
jlpoolen_libreveris,omr.glyph,23,1,0,1,1,3,1,30
jlpoolen_libreveris,omr.glyph.facets,3,1,0,0,1,4,1,10
jlpoolen_libreveris,omr.glyph.pattern,0,0,0,1,1,0,1,3
jlpoolen_libreveris,omr.glyph.ui,7,0,0,1,1,2,1,12
jlpoolen_libreveris,omr.glyph.ui.panel,4,0,0,0,1,0,1,6
jlpoolen_libreveris,omr.graph,0,0,0,0,1,1,1,3
jlpoolen_libreveris,omr.grid,4,0,0,1,1,2,1,9
jlpoolen_libreveris,omr.lag,3,1,0,0,1,1,1,7
jlpoolen_libreveris,omr.lag.ui,0,0,0,0,0,0,1,1
jlpoolen_libreveris,omr.log,0,0,0,0,1,0,1,2
jlpoolen_libreveris,omr.math,5,1,0,1,1,0,1,9
jlpoolen_libreveris,omr.moments,2,0,0,0,1,1,1,5
jlpoolen_libreveris,omr.plugin,3,1,0,0,1,0,1,6
jlpoolen_libreveris,omr.run,3,1,0,1,1,0,1,7
jlpoolen_libreveris,omr.score,7,0,0,1,1,1,1,11
jlpoolen_libreveris,omr.score.entity,11,1,0,1,1,0,1,15
jlpoolen_libreveris,omr.score.midi,0,0,0,0,0,0,1,1
jlpoolen_libreveris,omr.score.ui,11,1,0,1,1,0,1,15
jlpoolen_libreveris,omr.score.visitor,0,0,0,0,0,0,1,1
jlpoolen_libreveris,omr.script,5,1,0,0,1,3,1,11
jlpoolen_libreveris,omr.selection,7,1,0,0,1,0,1,10
jlpoolen_libreveris,omr.sheet,18,1,0,1,1,5,1,27
jlpoolen_libreveris,omr.sheet.picture,5,0,0,0,1,0,1,7
jlpoolen_libreveris,omr.sheet.picture.jai,3,1,0,0,0,0,1,5
jlpoolen_libreveris,omr.sheet.ui,7,1,0,0,1,0,1,10
jlpoolen_libreveris,omr.step,24,1,0,1,1,2,1,30
jlpoolen_libreveris,omr.stick,0,0,0,0,1,0,1,2
jlpoolen_libreveris,omr.text,4,0,0,0,1,0,1,6
jlpoolen_libreveris,omr.text.tesseract,0,0,0,0,0,0,1,1
jlpoolen_libreveris,omr.ui,30,1,0,1,1,1,1,35
jlpoolen_libreveris,omr.ui.dnd,0,0,0,0,1,0,1,2
jlpoolen_libreveris,omr.ui.field,0,0,0,0,1,1,1,3
jlpoolen_libreveris,omr.ui.symbol,4,1,0,1,0,0,1,7
jlpoolen_libreveris,omr.ui.treetable,0,0,0,0,1,0,1,2
jlpoolen_libreveris,omr.ui.util,4,1,0,0,1,0,1,7
jlpoolen_libreveris,omr.ui.view,4,1,0,0,1,1,1,8
jlpoolen_libreveris,omr.util,19,1,0,1,1,0,1,23
jlpoolen_libreveris,omr.jai,0,0,0,0,1,0,1,2
jlpoolen_libreveris,omr.jaxb.basic,0,0,0,0,0,0,1,1
jlpoolen_libreveris,omr.moment,0,0,0,0,0,0,1,1
jlpoolen_libreveris,com.audiveris.musicxmldiff,1,1,0,0,1,0,1,4
jlpoolen_libreveris,com.audiveris.musicxmldiff.info,1,0,0,0,0,0,1,2
jlpoolen_libreveris,wixheatuser,0,0,0,0,0,0,1,1
jmeter-maven-plugin_jmeter-maven-plugin,com.lazerycode.jmeter.configuration,0,0,0,0,1,0,0,1
jmeter-maven-plugin_jmeter-maven-plugin,com.lazerycode.jmeter.json,0,0,0,0,0,0,0,0
jmeter-maven-plugin_jmeter-maven-plugin,com.lazerycode.jmeter.mojo,0,0,0,0,1,0,0,1
jmeter-maven-plugin_jmeter-maven-plugin,com.lazerycode.jmeter.properties,0,0,0,0,0,0,0,0
jmeter-maven-plugin_jmeter-maven-plugin,com.lazerycode.jmeter.utility,0,0,0,0,0,0,0,0
jmrozanec_cron-utils,com.cronutils.builder,4,1,0,0,0,1,1,7
jmrozanec_cron-utils,com.cronutils.converter,0,0,0,0,0,0,1,1
jmrozanec_cron-utils,com.cronutils.descriptor,0,0,0,0,0,4,1,5
jmrozanec_cron-utils,com.cronutils.descriptor.refactor,0,0,0,0,0,0,1,1
jmrozanec_cron-utils,com.cronutils,5,0,0,0,1,6,1,13
jmrozanec_cron-utils,com.cronutils.mapper,10,1,0,0,1,2,1,15
jmrozanec_cron-utils,com.cronutils.model,14,1,0,0,0,8,1,24
jmrozanec_cron-utils,com.cronutils.model.definition,9,1,0,0,1,15,1,27
jmrozanec_cron-utils,com.cronutils.model.field.constraint,0,0,0,0,0,6,1,7
jmrozanec_cron-utils,com.cronutils.model.field,11,1,0,0,0,8,1,21
jmrozanec_cron-utils,com.cronutils.model.field.definition,9,1,0,0,0,3,1,14
jmrozanec_cron-utils,com.cronutils.model.field.expression,0,0,0,0,0,10,1,11
jmrozanec_cron-utils,com.cronutils.model.field.expression.visitor,3,0,0,0,0,1,1,5
jmrozanec_cron-utils,com.cronutils.model.field.value,0,0,0,0,0,6,1,7
jmrozanec_cron-utils,com.cronutils.model.time,4,1,0,0,0,7,1,13
jmrozanec_cron-utils,com.cronutils.model.time.generator,4,0,0,1,0,8,1,14
jmrozanec_cron-utils,com.cronutils.parser,16,1,0,0,0,17,1,35
jmrozanec_cron-utils,com.cronutils.utils,0,0,0,0,0,1,1,2
jmrozanec_cron-utils,com.cronutils.validation,0,0,0,0,0,0,1,1
jmrozanec_cron-utils,com.cronutils.model.field.constraints,0,0,0,0,0,0,1,1
jmrozanec_cron-utils,com.cronutils.utils.descriptor,0,0,0,0,1,4,1,6
jmrozanec_cron-utils,com.cronutils.validator,0,0,0,0,0,0,1,1
JodaOrg_joda-collect,org.joda.collect.grid,0,0,0,1,1,0,0,2
jodastephen_property-alliance,org.joda.pa,0,0,0,0,1,0,0,1
jodastephen_property-alliance,org.joda.pa.convert,0,0,0,0,0,0,0,0
jodastephen_property-alliance,org.joda.pa.style,0,0,0,0,1,0,0,1
joel-costigliola_assertj-swing,org.assertj.swing.annotation,0,0,0,0,0,0,0,0
joel-costigliola_assertj-swing,org.assertj.swing.applet,0,0,0,0,0,0,0,0
joel-costigliola_assertj-swing,org.assertj.swing.assertions,0,0,0,0,0,0,0,0
joel-costigliola_assertj-swing,org.assertj.swing.assertions.data,0,0,0,0,1,0,0,1
joel-costigliola_assertj-swing,org.assertj.swing.assertions.error,0,0,0,0,1,0,0,1
joel-costigliola_assertj-swing,org.assertj.swing.awt,1,1,0,0,0,1,0,3
joel-costigliola_assertj-swing,org.assertj.swing.cell,0,0,0,0,0,0,0,0
joel-costigliola_assertj-swing,org.assertj.swing.core,20,1,0,1,0,3,0,25
joel-costigliola_assertj-swing,org.assertj.swing.core.matcher,0,0,0,1,0,1,0,2
joel-costigliola_assertj-swing,org.assertj.swing.data,0,0,0,0,1,0,0,1
joel-costigliola_assertj-swing,org.assertj.swing.driver,4,1,0,2,0,2,0,9
joel-costigliola_assertj-swing,org.assertj.swing.edt,6,0,0,0,1,0,0,7
joel-costigliola_assertj-swing,org.assertj.swing.exception,0,0,0,0,1,0,0,1
joel-costigliola_assertj-swing,org.assertj.swing.finder,5,1,0,1,1,0,0,8
joel-costigliola_assertj-swing,org.assertj.swing.fixture,9,0,0,1,1,1,0,12
joel-costigliola_assertj-swing,org.assertj.swing.format,1,1,0,1,0,0,0,3
joel-costigliola_assertj-swing,org.assertj.swing.hierarchy,3,1,0,1,0,0,0,5
joel-costigliola_assertj-swing,org.assertj.swing.image,0,0,0,0,1,0,0,1
joel-costigliola_assertj-swing,org.assertj.swing.input,1,0,0,0,0,0,0,1
joel-costigliola_assertj-swing,org.assertj.swing.internal.annotation,0,0,0,0,0,0,0,0
joel-costigliola_assertj-swing,org.assertj.swing.internal.assertions,0,1,0,0,0,0,0,1
joel-costigliola_assertj-swing,org.assertj.swing.keystroke,0,0,0,1,1,0,0,2
joel-costigliola_assertj-swing,org.assertj.swing.launcher,0,0,0,0,1,0,0,1
joel-costigliola_assertj-swing,org.assertj.swing.listener,0,0,0,0,1,0,0,1
joel-costigliola_assertj-swing,org.assertj.swing.lock,0,0,0,0,0,1,0,1
joel-costigliola_assertj-swing,org.assertj.swing.monitor,5,0,0,1,0,0,0,6
joel-costigliola_assertj-swing,org.assertj.swing.query,4,0,0,0,0,1,0,5
joel-costigliola_assertj-swing,org.assertj.swing.security,0,0,0,0,0,0,0,0
joel-costigliola_assertj-swing,org.assertj.swing.text,0,0,0,0,1,0,0,1
joel-costigliola_assertj-swing,org.assertj.swing.timing,0,0,0,0,1,1,0,2
joel-costigliola_assertj-swing,org.assertj.swing.util,0,0,0,1,1,0,0,2
joel-costigliola_assertj-swing,org.assertj.core.api,0,0,0,0,0,0,0,0
joel-costigliola_assertj-swing,org.assertj.swing.assertions.image,0,0,0,0,1,0,0,1
joel-costigliola_assertj-swing,org.assertj.swing.internal.assertions.images,0,0,0,0,0,0,0,0
joel-costigliola_assertj-swing,org.assertj.swing.conditions,0,0,0,0,0,0,0,0
joel-costigliola_assertj-swing,org.assertj.swing.jide.action,0,0,0,0,0,0,0,0
joel-costigliola_assertj-swing,org.assertj.swing.jide.action.driver,0,0,0,0,0,0,0,0
joel-costigliola_assertj-swing,org.assertj.swing.jide.action.format,0,0,0,0,0,0,0,0
joel-costigliola_assertj-swing,org.assertj.swing.jide.components,0,0,0,0,0,0,0,0
joel-costigliola_assertj-swing,org.assertj.swing.jide.components.driver,0,0,0,0,0,0,0,0
joel-costigliola_assertj-swing,org.assertj.swing.jide.grids,0,0,0,0,1,1,0,2
joel-costigliola_assertj-swing,org.assertj.swing.jide.grids.driver,0,0,0,0,1,0,0,1
joel-costigliola_assertj-swing,org.assertj.swing.jide,0,0,0,0,0,0,0,0
joel-costigliola_assertj-swing,org.assertj.swing.junit.ant,0,0,0,1,1,0,0,2
joel-costigliola_assertj-swing,org.assertj.swing.junit.runner,0,0,0,0,1,0,0,1
joel-costigliola_assertj-swing,org.assertj.swing.junit.xml,0,0,0,1,0,0,0,1
jooby-project_jooby,io.jooby.adoc,0,0,0,0,0,0,0,0
jooby-project_jooby,examples,0,0,0,0,1,0,0,1
jooby-project_jooby,io.jooby,7,1,0,1,1,1,0,11
jooby-project_jooby,io.jooby.exception,1,0,0,0,1,0,0,2
jooby-project_jooby,io.jooby.internal,5,0,0,1,1,1,0,8
jooby-project_jooby,io.jooby.internal.asm,1,0,0,0,1,0,0,2
jooby-project_jooby,io.jooby.internal.converter,1,0,0,0,1,0,0,2
jooby-project_jooby,io.jooby.internal.handler,1,0,0,0,1,1,0,3
jooby-project_jooby,io.jooby.internal.handler.reactive,1,0,0,0,1,1,0,3
jooby-project_jooby,io.jooby.internal.reflect,0,0,0,0,0,0,0,0
jooby-project_jooby,io.jooby.internal.x509,0,0,0,0,0,0,0,0
jooby-project_jooby,io.jooby.internal.generated,0,0,0,0,0,0,0,0
jooby-project_jooby,io.jooby.apt,1,1,0,0,0,0,0,2
jooby-project_jooby,io.jooby.internal.apt.asm,1,0,0,0,1,0,0,2
jooby-project_jooby,io.jooby.internal.apt,2,1,0,0,0,0,0,3
jooby-project_jooby,output,0,0,0,0,1,0,0,1
jooby-project_jooby,source,0,0,0,0,1,0,0,1
jooby-project_jooby,$,0,0,0,0,1,0,0,1
jooby-project_jooby,io.jooby.banner,0,0,0,0,0,0,0,0
jooby-project_jooby,io.jooby.cli,0,0,0,0,1,0,0,1
jooby-project_jooby,io.jooby.internal.cli,0,0,0,0,0,0,0,0
jooby-project_jooby,io.jooby.flyway,0,0,0,0,0,0,0,0
jooby-project_jooby,io.jooby.freemarker,0,0,0,0,1,0,0,1
jooby-project_jooby,io.jooby.gradle,0,0,0,0,0,0,0,0
jooby-project_jooby,io.jooby.graphql,0,0,0,0,0,0,0,0
jooby-project_jooby,io.jooby.internal.graphql,0,0,0,0,0,0,0,0
jooby-project_jooby,io.jooby.di,0,0,0,0,1,0,0,1
jooby-project_jooby,io.jooby.handlebars,0,0,0,0,0,0,0,0
jooby-project_jooby,io.jooby.hibernate,0,0,0,0,0,0,0,0
jooby-project_jooby,io.jooby.internal.hibernate,0,0,0,0,0,0,0,0
jooby-project_jooby,io.jooby.hikari,0,0,0,0,0,0,0,0
jooby-project_jooby,io.jooby.json,0,0,0,0,0,0,0,0
jooby-project_jooby,io.jooby.internal.jdbi,0,0,0,0,0,0,0,0
jooby-project_jooby,io.jooby.jdbi,0,0,0,0,0,0,0,0
jooby-project_jooby,io.jooby.internal.jetty,0,0,0,0,1,0,0,1
jooby-project_jooby,io.jooby.jetty,0,0,0,0,0,0,0,0
jooby-project_jooby,io.jooby.jwt,0,0,0,0,0,0,0,0
jooby-project_jooby,io.jooby.maven,0,0,0,0,0,0,0,0
jooby-project_jooby,io.jooby.internal.netty,0,0,0,0,1,0,0,1
jooby-project_jooby,io.jooby.netty,0,0,0,0,0,0,0,0
jooby-project_jooby,io.jooby.internal.pac4j,0,0,0,0,1,1,0,2
jooby-project_jooby,io.jooby.pac4j,0,0,0,0,0,1,0,1
jooby-project_jooby,io.jooby.pebble,0,0,0,0,0,0,0,0
jooby-project_jooby,io.jooby.rocker,0,0,0,0,0,0,0,0
jooby-project_jooby,io.jooby.run,0,0,0,0,1,0,0,1
jooby-project_jooby,io.jooby.internal.utow,0,0,0,0,1,0,0,1
jooby-project_jooby,io.jooby.utow,0,0,0,0,0,0,0,0
jooby-project_jooby,starter,0,0,0,0,1,0,0,1
jooby-project_jooby,starter.domain,0,0,0,0,1,0,0,1
jooby-project_jooby,starter.service,0,0,0,0,0,0,0,0
jooby-project_jooby,io.jooby.junit,1,0,0,0,0,0,0,1
jooby-project_jooby,error,0,0,0,0,0,0,0,0
jooby-project_jooby,io.jooby.internal.mvc,0,0,0,0,0,0,0,0
jooby-project_jooby,(default package),0,0,0,0,0,0,0,0
jordw_heftydb,com.jordanwilliams.heftydb.cache,0,0,0,0,0,0,1,1
jordw_heftydb,com.jordanwilliams.heftydb.compact,0,0,0,0,1,0,1,2
jordw_heftydb,com.jordanwilliams.heftydb.compact.planner,0,0,0,0,0,0,1,1
jordw_heftydb,com.jordanwilliams.heftydb.data,0,0,0,0,0,2,1,3
jordw_heftydb,com.jordanwilliams.heftydb.db,0,1,0,0,1,1,1,4
jordw_heftydb,com.jordanwilliams.heftydb.index,0,0,0,0,1,0,1,2
jordw_heftydb,com.jordanwilliams.heftydb.io,0,0,0,0,0,5,1,6
jordw_heftydb,com.jordanwilliams.heftydb.metrics,0,0,0,0,0,0,1,1
jordw_heftydb,com.jordanwilliams.heftydb.offheap.allocator,0,0,0,0,0,0,1,1
jordw_heftydb,com.jordanwilliams.heftydb.offheap,0,0,0,0,0,2,1,3
jordw_heftydb,com.jordanwilliams.heftydb.read,1,1,0,0,1,0,1,4
jordw_heftydb,com.jordanwilliams.heftydb.state,1,1,0,0,0,3,1,6
jordw_heftydb,com.jordanwilliams.heftydb.table.file,1,0,0,0,1,3,1,6
jordw_heftydb,com.jordanwilliams.heftydb.table.memory,0,0,0,0,1,0,1,2
jordw_heftydb,com.jordanwilliams.heftydb.table,0,0,0,0,0,0,1,1
jordw_heftydb,com.jordanwilliams.heftydb.util,0,0,0,0,1,2,1,4
jordw_heftydb,com.jordanwilliams.heftydb.write,0,0,0,0,0,2,1,3
jphp-compiler_jphp,$package$,0,0,0,0,0,0,1,1
jphp-compiler_jphp,org.develnext.jphp.ext.$ns$,0,0,0,0,0,0,1,1
jphp-compiler_jphp,org.develnext.jphp.ext.compress.classes,0,0,0,0,1,0,1,2
jphp-compiler_jphp,org.develnext.jphp.ext.compress,0,1,0,0,0,0,1,2
jphp-compiler_jphp,org.develnext.jphp.ext.compress.support,0,0,0,0,0,0,1,1
jphp-compiler_jphp,php.runtime.util,3,1,0,0,0,0,1,5
jphp-compiler_jphp,org.develnext.jphp.ext.crypto.classes,1,0,0,0,0,0,1,2
jphp-compiler_jphp,org.develnext.jphp.ext.crypto,1,1,0,0,0,0,1,3
jphp-compiler_jphp,org.develnext.jphp.ext.gdx.classes,1,0,0,0,0,0,1,2
jphp-compiler_jphp,org.develnext.jphp.ext.gdx,1,1,0,0,0,0,1,3
jphp-compiler_jphp,org.develnext.jphp.ext.git.classes,1,0,0,0,0,0,1,2
jphp-compiler_jphp,org.develnext.jphp.ext.git,1,1,0,0,0,0,1,3
jphp-compiler_jphp,org.develnext.jphp.ext.git.support,0,0,0,0,0,0,1,1
jphp-compiler_jphp,org.develnext.jphp.ext.image.bind,0,0,0,0,0,0,1,1
jphp-compiler_jphp,org.develnext.jphp.ext.image.classes,1,0,0,0,0,0,1,2
jphp-compiler_jphp,org.develnext.jphp.ext.image,1,1,0,0,0,0,1,3
jphp-compiler_jphp,org.develnext.jphp.ext.image.support,0,0,0,0,0,0,1,1
jphp-compiler_jphp,org.develnext.jphp.ext.httpserver.classes,0,0,0,0,0,0,1,1
jphp-compiler_jphp,org.develnext.jphp.ext.httpserver,0,1,0,0,0,0,1,2
jphp-compiler_jphp,org.develnext.jphp.json.classes,0,0,0,0,0,0,1,1
jphp-compiler_jphp,org.develnext.jphp.json.gson,0,0,0,0,0,0,1,1
jphp-compiler_jphp,org.develnext.jphp.json,0,0,0,0,0,0,1,1
jphp-compiler_jphp,org.develnext.jphp.ext.jsoup.bind,0,0,0,0,0,0,1,1
jphp-compiler_jphp,org.develnext.jphp.ext.jsoup.classes,0,0,0,0,1,0,1,2
jphp-compiler_jphp,org.develnext.jphp.ext.jsoup,0,1,0,0,0,0,1,2
jphp-compiler_jphp,json.classes,0,0,0,0,0,0,1,1
jphp-compiler_jphp,json,0,0,0,0,0,0,1,1
jphp-compiler_jphp,org.develnext.jphp.ext.mail.bind,0,0,0,0,0,0,1,1
jphp-compiler_jphp,org.develnext.jphp.ext.mail.classes,1,0,0,0,0,0,1,2
jphp-compiler_jphp,org.develnext.jphp.ext.mail,1,1,0,0,0,0,1,3
jphp-compiler_jphp,org.develnext.jphp.ext.markdown.classes,1,0,0,0,0,0,1,2
jphp-compiler_jphp,org.develnext.jphp.ext.markdown,1,1,0,0,0,0,1,3
jphp-compiler_jphp,org.develnext.jphp.ext.markdown.support,0,0,0,0,0,0,1,1
jphp-compiler_jphp,org.develnext.jphp.ext.mongo.bind,0,0,0,0,0,0,1,1
jphp-compiler_jphp,org.develnext.jphp.ext.mongo.classes,1,0,0,0,1,0,1,3
jphp-compiler_jphp,org.develnext.jphp.ext.mongo,1,1,0,0,0,0,1,3
jphp-compiler_jphp,org.develnext.jphp.parser.classes,0,0,0,0,0,0,1,1
jphp-compiler_jphp,org.develnext.jphp.parser,0,1,0,0,0,0,1,2
jphp-compiler_jphp,org.develnext.jphp.ext.semver.classes,1,0,0,0,0,0,1,2
jphp-compiler_jphp,org.develnext.jphp.ext.semver,1,1,0,0,0,0,1,3
jphp-compiler_jphp,org.develnext.jphp.ext.sql.classes,0,0,0,0,0,0,1,1
jphp-compiler_jphp,org.develnext.jphp.ext.sql,0,0,0,0,0,0,1,1
jphp-compiler_jphp,sql.classes,0,0,0,0,0,0,1,1
jphp-compiler_jphp,sql,0,0,0,0,0,0,1,1
jphp-compiler_jphp,org.develnext.jphp.ext.ssh.classes,0,0,0,0,1,0,1,2
jphp-compiler_jphp,org.develnext.jphp.ext.ssh,0,0,0,0,0,0,1,1
jphp-compiler_jphp,org.develnext.jphp.ext.text.classes,1,0,0,0,0,0,1,2
jphp-compiler_jphp,org.develnext.jphp.ext.text,1,1,0,0,0,0,1,3
jphp-compiler_jphp,org.develnext.jphp.ext.xml.classes,0,0,0,0,1,0,1,2
jphp-compiler_jphp,org.develnext.jphp.ext.xml,0,1,0,0,0,0,1,2
jphp-compiler_jphp,org.develnext.jphp.yaml.classes,0,0,0,0,0,0,1,1
jphp-compiler_jphp,org.develnext.jphp.yaml,0,0,0,0,0,0,1,1
jphp-compiler_jphp,org.develnext.jphp.zend.ext.json,0,0,0,0,0,0,1,1
jphp-compiler_jphp,org.develnext.jphp.zend.ext.standard,1,1,0,0,1,0,1,4
jphp-compiler_jphp,org.develnext.jphp.zend.ext.standard.date,1,0,0,1,0,0,1,3
jphp-compiler_jphp,org.develnext.jphp.zend.ext.support,0,0,0,0,0,0,1,1
jphp-compiler_jphp,org.develnext.jphp.zend.ext,0,0,0,0,0,0,1,1
jphp-compiler_jphp,file,0,0,0,0,0,0,1,1
jphp-compiler_jphp,org.develnext.jphp.zend,0,0,0,0,0,0,1,1
jphp-compiler_jphp,strings,0,0,0,0,0,0,1,1
jphp-compiler_jphp,zend,0,0,0,0,1,0,1,2
jphp-compiler_jphp,zend.ext.serialize,0,0,0,0,0,0,1,1
jphp-compiler_jphp,org.develnext.jphp.ext.zip.classes,1,0,0,0,0,0,1,2
jphp-compiler_jphp,org.develnext.jphp.ext.zip,1,1,0,0,0,0,1,3
jphp-compiler_jphp,org.develnext.jphp.core.common,2,0,0,0,0,0,1,3
jphp-compiler_jphp,org.develnext.jphp.core.compiler.common,0,0,0,0,0,0,1,1
jphp-compiler_jphp,org.develnext.jphp.core.compiler.common.misc,0,1,0,0,0,0,1,2
jphp-compiler_jphp,org.develnext.jphp.core.compiler.common.util,0,0,0,0,0,0,1,1
jphp-compiler_jphp,org.develnext.jphp.core.compiler.jvm,0,1,0,1,0,0,1,3
jphp-compiler_jphp,org.develnext.jphp.core.compiler.jvm.misc,0,0,0,0,0,0,1,1
jphp-compiler_jphp,org.develnext.jphp.core.compiler.jvm.node,0,0,0,0,0,0,1,1
jphp-compiler_jphp,org.develnext.jphp.core.compiler.jvm.statement,2,1,0,0,1,0,1,5
jphp-compiler_jphp,org.develnext.jphp.core.compiler.jvm.statement.expr,3,1,0,0,0,0,1,5
jphp-compiler_jphp,org.develnext.jphp.core.compiler.jvm.statement.expr.operator,0,0,0,0,0,0,1,1
jphp-compiler_jphp,org.develnext.jphp.core.compiler.jvm.statement.expr.value,2,0,0,0,1,0,1,4
jphp-compiler_jphp,org.develnext.jphp.core.opcode,0,0,0,0,0,0,1,1
jphp-compiler_jphp,org.develnext.jphp.core.sourcemap,0,0,0,0,0,0,1,1
jphp-compiler_jphp,org.develnext.jphp.core.syntax,7,1,0,0,0,0,1,9
jphp-compiler_jphp,org.develnext.jphp.core.syntax.generators,1,0,0,0,0,0,1,2
jphp-compiler_jphp,org.develnext.jphp.core.syntax.generators.manually,1,1,0,0,0,0,1,3
jphp-compiler_jphp,org.develnext.jphp.core.tokenizer.token,5,1,0,0,1,0,1,8
jphp-compiler_jphp,org.develnext.jphp.core.tokenizer.token.expr,3,0,0,0,1,0,1,5
jphp-compiler_jphp,org.develnext.jphp.core.tokenizer.token.expr.operator,3,0,0,1,1,0,1,6
jphp-compiler_jphp,org.develnext.jphp.core.tokenizer.token.expr.operator.cast,0,0,0,0,0,0,1,1
jphp-compiler_jphp,org.develnext.jphp.core.tokenizer.token.expr.value,11,1,0,1,1,0,1,15
jphp-compiler_jphp,org.develnext.jphp.core.tokenizer.token.expr.value.macro,0,0,0,0,0,0,1,1
jphp-compiler_jphp,org.develnext.jphp.core.tokenizer.token.stmt,12,1,0,1,0,0,1,15
jphp-compiler_jphp,org.develnext.jphp.core.tokenizer,14,1,0,0,0,0,1,16
jphp-compiler_jphp,php.runtime.launcher,0,0,0,0,0,0,1,1
jphp-compiler_jphp,org.develnext.jphp.assertj,0,0,0,0,0,0,1,1
jphp-compiler_jphp,org.develnext.jphp.core.compiler.jvm.ext.core,0,0,0,0,0,0,1,1
jphp-compiler_jphp,org.develnext.jphp.core.compiler.jvm.ext.reflection,0,0,0,0,0,0,1,1
jphp-compiler_jphp,org.develnext.jphp.core.compiler.jvm.ext,0,0,0,0,0,0,1,1
jphp-compiler_jphp,org.develnext.jphp.core.compiler.jvm.ext.standart,0,0,0,0,1,0,1,2
jphp-compiler_jphp,org.develnext.jphp,0,0,0,0,0,0,1,1
jphp-compiler_jphp,php.runtime.loader.dump,4,0,0,0,0,0,1,5
jphp-compiler_jphp,php.runtime.memory,11,1,0,0,0,0,1,13
jphp-compiler_jphp,php.runtime.memory.serialization,0,0,0,0,0,0,1,1
jphp-compiler_jphp,php.runtime.memory.support,4,1,0,1,0,0,1,7
jphp-compiler_jphp,php.runtime,19,1,0,0,0,0,1,21
jphp-compiler_jphp,org.develnext.jphp.debug,0,0,0,0,0,0,1,1
jphp-compiler_jphp,org.develnext.jphp.debug.impl.breakpoint,2,0,0,0,0,0,1,3
jphp-compiler_jphp,org.develnext.jphp.debug.impl.command,3,0,0,0,0,0,1,4
jphp-compiler_jphp,org.develnext.jphp.debug.impl.command.support,2,1,0,0,0,0,1,4
jphp-compiler_jphp,org.develnext.jphp.debug.impl,5,1,0,0,0,0,1,7
jphp-compiler_jphp,php.runtime.common,2,1,0,0,1,0,1,5
jphp-compiler_jphp,php.runtime.common.collections.collection,0,0,0,0,0,0,1,1
jphp-compiler_jphp,php.runtime.common.collections,0,0,0,0,1,0,1,2
jphp-compiler_jphp,php.runtime.common.collections.iterators,1,0,0,0,1,0,1,3
jphp-compiler_jphp,php.runtime.common.collections.keyvalue,0,0,0,0,0,0,1,1
jphp-compiler_jphp,php.runtime.common.collections.list,1,1,0,0,0,0,1,3
jphp-compiler_jphp,php.runtime.common.collections.map,0,0,0,1,0,0,1,2
jphp-compiler_jphp,php.runtime.env,86,1,0,0,0,0,1,88
jphp-compiler_jphp,php.runtime.env.handler,3,0,0,0,1,0,1,5
jphp-compiler_jphp,php.runtime.env.message,2,0,0,0,0,0,1,3
jphp-compiler_jphp,php.runtime.exceptions,2,0,0,0,1,0,1,4
jphp-compiler_jphp,php.runtime.exceptions.support,2,0,0,0,0,0,1,3
jphp-compiler_jphp,php.runtime.ext.core,4,0,0,0,1,0,1,6
jphp-compiler_jphp,php.runtime.ext.core.classes.format,3,0,0,0,0,0,1,4
jphp-compiler_jphp,php.runtime.ext.core.classes.lib,11,1,0,0,1,0,1,14
jphp-compiler_jphp,php.runtime.ext.core.classes.lib.legacy,2,0,0,0,0,0,1,3
jphp-compiler_jphp,php.runtime.ext.core.classes.net,2,0,0,0,0,0,1,3
jphp-compiler_jphp,php.runtime.ext.core.classes.stream,13,1,0,0,0,0,1,15
jphp-compiler_jphp,php.runtime.ext.core.classes.time,0,0,0,0,0,0,1,1
jphp-compiler_jphp,php.runtime.ext.core.classes.util,5,1,0,0,1,0,1,8
jphp-compiler_jphp,php.runtime.ext.core.classes,6,1,0,0,1,0,1,9
jphp-compiler_jphp,php.runtime.ext.core.reflection,3,0,0,0,0,0,1,4
jphp-compiler_jphp,php.runtime.ext,16,0,0,0,0,0,1,17
jphp-compiler_jphp,php.runtime.ext.java,2,0,0,0,0,0,1,3
jphp-compiler_jphp,php.runtime.ext.net,3,1,0,0,0,0,1,5
jphp-compiler_jphp,php.runtime.ext.spl,0,0,0,0,0,0,1,1
jphp-compiler_jphp,php.runtime.ext.support.compile,4,0,0,0,1,0,1,6
jphp-compiler_jphp,php.runtime.ext.support,12,1,0,0,0,0,1,14
jphp-compiler_jphp,php.runtime.invoke.cache,4,1,0,0,0,0,1,6
jphp-compiler_jphp,php.runtime.invoke,6,1,0,0,0,0,1,8
jphp-compiler_jphp,php.runtime.lang,20,1,0,0,1,0,1,23
jphp-compiler_jphp,php.runtime.lang.exception,2,0,0,0,0,0,1,3
jphp-compiler_jphp,php.runtime.lang.spl,2,0,0,0,0,0,1,3
jphp-compiler_jphp,php.runtime.lang.spl.exception,2,0,0,0,1,0,1,4
jphp-compiler_jphp,php.runtime.lang.spl.iterator,4,0,0,0,1,0,1,6
jphp-compiler_jphp,php.runtime.lang.support,0,0,0,0,0,0,1,1
jphp-compiler_jphp,php.runtime.loader.compile,0,0,0,0,0,0,1,1
jphp-compiler_jphp,php.runtime.loader.dump.io,2,0,0,0,0,0,1,3
jphp-compiler_jphp,php.runtime.loader,8,1,0,0,0,0,1,10
jphp-compiler_jphp,php.runtime.loader.sourcemap,0,0,0,0,0,0,1,1
jphp-compiler_jphp,php.runtime.memory.helper,2,0,0,0,1,0,1,4
jphp-compiler_jphp,php.runtime.memory.output,2,0,0,0,1,0,1,4
jphp-compiler_jphp,php.runtime.memory.output.serialization,1,0,0,0,0,0,1,2
jphp-compiler_jphp,php.runtime.memory.support.operation.array,0,0,0,0,1,0,1,2
jphp-compiler_jphp,php.runtime.memory.support.operation,0,0,0,1,1,0,1,3
jphp-compiler_jphp,php.runtime.memory.support.operation.collection,0,0,0,0,0,0,1,1
jphp-compiler_jphp,php.runtime.memory.support.operation.iterator,0,0,0,0,0,0,1,1
jphp-compiler_jphp,php.runtime.memory.support.operation.map,0,0,0,0,0,0,1,1
jphp-compiler_jphp,php.runtime.output,3,0,0,0,0,0,1,4
jphp-compiler_jphp,php.runtime.reflection,30,1,0,0,0,0,1,32
jphp-compiler_jphp,php.runtime.reflection.helper,5,1,0,0,0,0,1,7
jphp-compiler_jphp,php.runtime.reflection.support,8,0,0,0,0,0,1,9
jphp-compiler_jphp,php.runtime.util.generator,0,0,0,0,0,0,1,1
jphp-compiler_jphp,php.runtime.wrap,3,0,0,0,0,0,1,4
jphp-compiler_jphp,org.develnext.jphp.scripting,0,0,0,0,0,0,1,1
jphp-compiler_jphp,org.develnext.jphp.scripting.util,0,0,0,0,0,0,1,1
jphp-compiler_jphp,scripting,0,0,0,0,0,0,1,1
jqm4gwt_jqm4gwt,com.sksamuel.jqm4gwt.examples.collapsible,0,0,0,0,0,0,0,0
jqm4gwt_jqm4gwt,com.sksamuel.jqm4gwt.examples.datatables,0,0,0,0,1,0,0,1
jqm4gwt_jqm4gwt,com.sksamuel.jqm4gwt.examples.dynotable,0,0,0,0,1,0,0,1
jqm4gwt_jqm4gwt,com.sksamuel.jqm4gwt.examples.events,0,0,0,0,0,0,0,0
jqm4gwt_jqm4gwt,com.sksamuel.jqm4gwt.examples,0,0,0,0,0,0,0,0
jqm4gwt_jqm4gwt,com.sksamuel.jqm4gwt.examples.helloworld,0,0,0,0,0,0,0,0
jqm4gwt_jqm4gwt,com.sksamuel.jqm4gwt.examples.lists,0,0,0,0,0,0,0,0
jqm4gwt_jqm4gwt,com.sksamuel.jqm4gwt.examples.showcase,0,0,0,0,0,0,0,0
jqm4gwt_jqm4gwt,com.sksamuel.jqm4gwt.examples.transition,0,0,0,0,0,0,0,0
jqm4gwt_jqm4gwt,com.sksamuel.jqm4gwt.examples.uibinder,0,0,0,1,1,0,0,2
jqm4gwt_jqm4gwt,com.google.gwt.i18n.client.constants,0,0,0,0,0,0,0,0
jqm4gwt_jqm4gwt,com.google.gwt.i18n.client.impl,0,0,0,0,0,0,0,0
jqm4gwt_jqm4gwt,com.google.gwt.lang,0,0,0,0,0,0,0,0
jqm4gwt_jqm4gwt,com.google.gwt.user.client,0,0,0,0,0,0,0,0
jqm4gwt_jqm4gwt,com.google.gwt.user.client.impl,0,0,0,0,0,0,0,0
jqm4gwt_jqm4gwt,com.google.gwt.user.client.ui.impl,0,0,0,0,0,0,0,0
jqm4gwt_jqm4gwt,com.google.gwt.useragent.client,0,0,0,0,0,0,0,0
jqm4gwt_jqm4gwt,com.sksamuel.jqm4gwt,5,1,0,1,1,0,0,8
jqm4gwt_jqm4gwt,com.vx.sw.client.jqm4gwt,0,0,0,0,1,0,0,1
jqm4gwt_jqm4gwt,com.sksamuel.jqm4gwt.button,2,0,0,0,1,0,0,3
jqm4gwt_jqm4gwt,com.sksamuel.jqm4gwt.events,3,1,0,1,1,0,0,6
jqm4gwt_jqm4gwt,com.sksamuel.jqm4gwt.form.elements,4,0,0,1,1,0,0,6
jqm4gwt_jqm4gwt,com.sksamuel.jqm4gwt.form,0,0,0,0,1,0,0,1
jqm4gwt_jqm4gwt,com.sksamuel.jqm4gwt.form.validators,0,0,0,0,1,0,0,1
jqm4gwt_jqm4gwt,com.sksamuel.jqm4gwt.html,0,0,0,1,1,0,0,2
jqm4gwt_jqm4gwt,com.sksamuel.jqm4gwt.layout,0,0,0,0,1,0,0,1
jqm4gwt_jqm4gwt,com.sksamuel.jqm4gwt.list,0,0,0,1,1,0,0,2
jqm4gwt_jqm4gwt,com.sksamuel.jqm4gwt.panel,0,0,0,0,1,0,0,1
jqm4gwt_jqm4gwt,com.sksamuel.jqm4gwt.table,0,0,0,0,1,0,0,1
jqm4gwt_jqm4gwt,com.sksamuel.jqm4gwt.toolbar,0,0,0,1,1,0,0,2
jqm4gwt_jqm4gwt,com.sksamuel.jqm4gwt.plugins.datatables,0,0,0,1,1,0,0,2
jqm4gwt_jqm4gwt,com.sksamuel.jqm4gwt.plugins.datatables.events,0,0,0,0,0,0,0,0
jqm4gwt_jqm4gwt,com.sksamuel.jqm4gwt.plugins.datebox,0,0,0,0,1,0,0,1
jqm4gwt_jqm4gwt,com.sksamuel.jqm4gwt.plugins.grid960,0,0,0,0,0,0,0,0
jqm4gwt_jqm4gwt,com.sksamuel.jqm4gwt.plugins.iscroll,0,0,0,0,1,0,0,1
jtrfp_terminal-recall,net.java.games.input,0,0,0,0,0,0,1,1
jtrfp_terminal-recall,org.jtrfp.jfdt.v2,0,0,0,0,0,0,1,1
jtrfp_terminal-recall,org.jtrfp.trcl,38,1,0,1,1,2,1,44
jtrfp_terminal-recall,org.jtrfp.trcl.beh,8,1,0,1,1,7,1,19
jtrfp_terminal-recall,org.jtrfp.trcl.beh.phy,4,1,0,0,1,1,1,8
jtrfp_terminal-recall,org.jtrfp.trcl.beh.tun,0,0,0,0,0,0,1,1
jtrfp_terminal-recall,org.jtrfp.trcl.beh.ui,9,1,0,0,0,3,1,14
jtrfp_terminal-recall,org.jtrfp.trcl.coll,0,0,0,1,1,0,1,3
jtrfp_terminal-recall,org.jtrfp.trcl.conf,3,0,0,0,1,0,1,5
jtrfp_terminal-recall,org.jtrfp.trcl.core,35,1,0,1,1,3,1,42
jtrfp_terminal-recall,org.jtrfp.trcl.ctl,8,0,0,1,1,0,1,11
jtrfp_terminal-recall,org.jtrfp.trcl.dbg,2,0,0,0,1,0,1,4
jtrfp_terminal-recall,org.jtrfp.trcl.ext.tr,5,1,0,0,1,0,1,8
jtrfp_terminal-recall,org.jtrfp.trcl.file,15,1,0,1,1,1,1,20
jtrfp_terminal-recall,org.jtrfp.trcl.flow,7,1,0,0,1,0,1,10
jtrfp_terminal-recall,org.jtrfp.trcl.game,7,1,0,1,1,1,1,12
jtrfp_terminal-recall,org.jtrfp.trcl.gpu,15,1,0,1,1,0,1,19
jtrfp_terminal-recall,org.jtrfp.trcl.gpu.gl3,0,0,0,0,1,0,1,2
jtrfp_terminal-recall,org.jtrfp.trcl.gui,17,1,0,1,1,0,1,21
jtrfp_terminal-recall,org.jtrfp.trcl.img,0,0,0,0,0,0,1,1
jtrfp_terminal-recall,org.jtrfp.trcl.img.vq,1,0,0,0,0,0,1,2
jtrfp_terminal-recall,org.jtrfp.trcl.math,0,0,0,0,1,3,1,5
jtrfp_terminal-recall,org.jtrfp.trcl.mem,2,0,0,1,1,0,1,5
jtrfp_terminal-recall,org.jtrfp.trcl.miss,12,1,0,1,1,0,1,16
jtrfp_terminal-recall,org.jtrfp.trcl.obj,13,0,0,1,1,8,1,24
jtrfp_terminal-recall,org.jtrfp.trcl.pool,2,1,0,0,1,0,1,5
jtrfp_terminal-recall,org.jtrfp.trcl.prop,0,0,0,0,1,0,1,2
jtrfp_terminal-recall,org.jtrfp.trcl.shell,4,0,0,0,1,1,1,7
jtrfp_terminal-recall,org.jtrfp.trcl.snd,4,1,0,1,1,1,1,9
jtrfp_terminal-recall,org.jtrfp.trcl.tools,3,1,0,0,1,1,1,7
jubeio_jube,io.fabric8.jube.util,0,0,0,0,1,0,0,1
jubeio_jube,org.apache.karaf.demos.command,0,0,0,0,0,0,0,0
jubeio_jube,org.apache.karaf.demos.deployer.bundle,0,0,0,0,0,0,0,0
jubeio_jube,org.apache.karaf.diagnostic.demo,0,0,0,0,0,0,0,0
jubeio_jube,org.apache.karaf.web,0,0,0,0,0,0,0,0
jubeio_jube,mypackage,0,0,0,0,0,0,0,0
jubeio_jube,(default package),0,0,0,0,1,0,0,1
jubeio_jube,async,0,0,0,0,1,0,0,1
jubeio_jube,cal,0,0,0,0,0,0,0,0
jubeio_jube,chat,0,0,0,0,0,0,0,0
jubeio_jube,checkbox,0,0,0,0,0,0,0,0
jubeio_jube,colors,0,0,0,0,0,0,0,0
jubeio_jube,compressionFilters,0,0,0,0,0,0,0,0
jubeio_jube,dates,0,0,0,0,0,0,0,0
jubeio_jube,error,0,0,0,0,0,0,0,0
jubeio_jube,examples,0,0,0,0,1,0,0,1
jubeio_jube,filters,0,0,0,0,0,0,0,0
jubeio_jube,jsp2.examples,0,0,0,0,0,0,0,0
jubeio_jube,jsp2.examples.el,0,0,0,0,0,0,0,0
jubeio_jube,jsp2.examples.simpletag,0,0,0,0,1,0,0,1
jubeio_jube,listeners,0,0,0,0,0,0,0,0
jubeio_jube,nonblocking,0,0,0,0,0,0,0,0
jubeio_jube,num,0,0,0,0,0,0,0,0
jubeio_jube,sessions,0,0,0,0,0,0,0,0
jubeio_jube,util,0,0,0,0,0,0,0,0
jubeio_jube,validators,0,0,0,0,0,0,0,0
jubeio_jube,websocket.chat,0,0,0,0,0,0,0,0
jubeio_jube,websocket.drawboard,0,0,0,0,0,0,0,0
jubeio_jube,websocket.drawboard.wsmessages,0,0,0,0,0,0,0,0
jubeio_jube,websocket.echo,0,0,0,0,1,0,0,1
jubeio_jube,websocket,0,0,0,0,0,0,0,0
jubeio_jube,websocket.snake,0,0,0,0,0,0,0,0
jubeio_jube,io.jube.images.wildfly,0,0,0,0,0,0,0,0
jubeio_jube,io.fabric8.quickstarts.cxfcdi,0,0,0,0,1,0,0,1
jubeio_jube,io.jube.examples.hello,0,0,0,0,0,0,0,0
jubeio_jube,io.fabric8.jube.process,0,1,0,0,1,0,0,2
jubeio_jube,io.fabric8.jube.main,0,0,0,0,0,0,0,0
jubeio_jube,io.fabric8.jube.maven,0,0,0,0,0,0,0,0
jubeio_jube,org.apache.maven.plugin.assembly.archive,0,1,0,0,0,0,0,1
jubeio_jube,org.apache.maven.plugin.assembly.archive.archiver,0,0,0,0,0,0,0,0
jubeio_jube,org.apache.maven.plugin.assembly.archive.phase,0,0,0,0,0,0,0,0
jubeio_jube,org.apache.maven.plugin.assembly.archive.phase.wrappers,0,0,0,0,0,0,0,0
jubeio_jube,org.apache.maven.plugin.assembly.archive.task,0,0,0,0,0,0,0,0
jubeio_jube,org.apache.maven.plugin.assembly.artifact,0,1,0,0,0,0,0,1
jubeio_jube,org.apache.maven.plugin.assembly,0,0,0,0,0,0,0,0
jubeio_jube,org.apache.maven.plugin.assembly.filter,0,0,0,0,0,0,0,0
jubeio_jube,org.apache.maven.plugin.assembly.format,0,0,0,0,0,0,0,0
jubeio_jube,org.apache.maven.plugin.assembly.interpolation,0,0,0,0,0,0,0,0
jubeio_jube,org.apache.maven.plugin.assembly.io,0,1,0,0,0,0,0,1
jubeio_jube,org.apache.maven.plugin.assembly.model,0,0,0,0,0,0,0,0
jubeio_jube,org.apache.maven.plugin.assembly.model.io.xpp3,0,0,0,0,0,0,0,0
jubeio_jube,org.apache.maven.plugin.assembly.mojos,0,0,0,0,1,0,0,1
jubeio_jube,org.apache.maven.plugin.assembly.utils,0,0,0,0,1,0,0,1
jubeio_jube,io.fabric8.jube.apimaster,1,1,0,0,0,0,0,2
jubeio_jube,io.fabric8.jube,0,0,0,0,0,0,0,0
jubeio_jube,io.fabric8.jube.local,1,1,0,0,1,0,0,3
jubeio_jube,io.fabric8.jube.model,0,0,0,0,1,0,0,1
jubeio_jube,io.fabric8.jube.proxy,0,0,0,0,1,0,0,1
jubeio_jube,io.fabric8.jube.replicator,0,0,0,0,0,0,0,0
jubeio_jube,io.fabric8.jube.websocket,0,0,0,0,0,0,0,0
jubeio_jube,io.fabric8.jube.process.config,0,0,0,0,0,0,0,0
jubeio_jube,io.fabric8.jube.process.service,0,0,0,0,0,0,0,0
jubeio_jube,io.fabric8.jube.process.support,0,0,0,0,1,0,0,1
jubeio_jube,io.fabric8.jube.process.support.command,0,0,0,0,0,0,0,0
jubeio_jube,io.fabric8.jube.registry,0,0,0,0,1,0,0,1
jubeio_jube,io.fabric8.jube.war,0,0,0,0,0,0,0,0
jubeio_jube,io.fabric8.jube.zookeeper.client,0,0,0,0,0,0,0,0
jubeio_jube,io.fabric8.jube.zookeeper,0,0,0,0,0,0,0,0
jubeio_jube,io.fabric8.jube.zookeeper.server,0,0,0,0,0,0,0,0
junkdog_entity-system-benchmarks,com.artemis,0,0,0,0,1,1,0,2
junkdog_entity-system-benchmarks,com.artemis.component,0,0,0,1,1,0,0,2
junkdog_entity-system-benchmarks,com.artemis.system,0,0,0,1,1,0,0,2
junkdog_entity-system-benchmarks,com.artemis.generated,0,0,0,1,0,1,0,2
junkdog_entity-system-benchmarks,org.openjdk.jmh.infra.generated,0,0,0,1,1,0,0,2
junkdog_entity-system-benchmarks,com.artemis.system.iterating,0,0,0,0,1,0,0,1
junkdog_entity-system-benchmarks,com.github.esfbench.ashley,0,0,0,0,0,1,0,1
junkdog_entity-system-benchmarks,com.github.esfbench.ashley.component,0,0,0,0,1,0,0,1
junkdog_entity-system-benchmarks,com.github.esfbench.ashley.system,0,0,0,0,1,0,0,1
junkdog_entity-system-benchmarks,com.github.esfbench.ashley.generated,0,0,0,0,1,1,0,2
junkdog_entity-system-benchmarks,com.github.esfbench.chartgen,1,0,0,0,0,0,0,1
junkdog_entity-system-benchmarks,com.github.esfbench.chartgen.json,1,0,0,0,0,0,0,1
junkdog_entity-system-benchmarks,com.github.esfbench.chartgen.model,1,0,0,0,0,0,0,1
junkdog_entity-system-benchmarks,com.github.esfbench,0,0,0,0,0,3,0,3
junkdog_entity-system-benchmarks,com.github.esfbench.util,0,0,0,0,0,0,0,0
junkdog_entity-system-benchmarks,com.github.antag99.retinazer,0,0,0,0,0,1,0,1
junkdog_entity-system-benchmarks,com.github.antag99.retinazer.component,0,0,0,0,1,0,0,1
junkdog_entity-system-benchmarks,com.github.antag99.retinazer.system,0,0,0,0,1,0,0,1
junkdog_entity-system-benchmarks,com.github.antag99.retinazer.generated,0,0,0,0,1,1,0,2
jurmous_etcd4j,mousio.client,0,0,0,0,0,0,0,0
jurmous_etcd4j,mousio.client.exceptions,0,0,0,0,0,0,0,0
jurmous_etcd4j,mousio.client.promises,0,0,0,0,0,0,0,0
jurmous_etcd4j,mousio.client.retry,0,0,0,0,0,0,0,0
jurmous_etcd4j,mousio.client.util,0,0,0,0,0,0,0,0
jurmous_etcd4j,mousio.etcd4j,2,0,0,0,0,0,0,2
jurmous_etcd4j,mousio.etcd4j.promises,0,0,0,0,0,0,0,0
jurmous_etcd4j,mousio.etcd4j.requests,2,0,0,0,0,0,0,2
jurmous_etcd4j,mousio.etcd4j.responses,0,0,0,0,0,0,0,0
jurmous_etcd4j,mousio.etcd4j.security,0,0,0,0,0,0,0,0
jurmous_etcd4j,mousio.etcd4j.transport,3,1,0,0,1,0,0,5
jurmous_etcd4j,mousio.etcd4j.support,0,0,0,0,0,0,0,0
jvirtanen_nassau,com.paritytrading.nassau.binaryfile.recorder,0,0,0,0,0,0,0,0
jvirtanen_nassau,com.paritytrading.nassau.soupbintcp.gateway,0,0,0,0,0,1,0,1
jvirtanen_nassau,com.paritytrading.nassau.soupbintcp.client,0,0,0,0,0,0,0,0
jvirtanen_nassau,com.paritytrading.nassau.soupbintcp.server,0,0,0,0,0,0,0,0
jvirtanen_nassau,com.paritytrading.nassau.binaryfile,0,0,0,0,1,0,0,1
jvirtanen_nassau,com.paritytrading.nassau,0,0,0,0,0,0,0,0
jvirtanen_nassau,com.paritytrading.nassau.moldudp64,0,0,0,0,0,1,0,1
jvirtanen_nassau,com.paritytrading.nassau.soupbintcp,0,0,0,0,0,1,0,1
jvirtanen_nassau,com.paritytrading.nassau.time,0,0,0,0,0,0,0,0
jvirtanen_nassau,com.paritytrading.nassau.util,0,0,0,0,1,0,0,1
jvirtanen_nassau,com.paritytrading.nassau.binaryfile.perf,0,0,0,0,0,0,0,0
jvirtanen_parity,com.paritytrading.parity.client,0,0,0,0,0,0,0,0
jvirtanen_parity,com.paritytrading.parity.fix,0,0,0,0,1,0,0,1
jvirtanen_parity,com.paritytrading.parity.reporter,0,0,0,0,1,0,0,1
jvirtanen_parity,com.paritytrading.parity.system,0,0,0,0,1,0,0,1
jvirtanen_parity,com.paritytrading.parity.ticker,0,0,0,0,0,2,0,2
jvirtanen_parity,com.paritytrading.parity.book,0,0,0,0,1,2,0,3
jvirtanen_parity,com.paritytrading.parity.file.taq,0,0,0,0,0,1,0,1
jvirtanen_parity,com.paritytrading.parity.match,0,0,0,0,1,0,0,1
jvirtanen_parity,com.paritytrading.parity.net,0,0,0,0,0,0,0,0
jvirtanen_parity,com.paritytrading.parity.net.pmd,0,0,0,0,1,0,0,1
jvirtanen_parity,com.paritytrading.parity.net.pmr,0,0,0,0,1,0,0,1
jvirtanen_parity,com.paritytrading.parity.net.poe,0,0,0,0,1,0,0,1
jvirtanen_parity,com.paritytrading.parity.util,0,0,0,0,1,2,0,3
jvirtanen_parity,com.paritytrading.parity.book.perf,0,0,0,0,0,0,0,0
jvirtanen_parity,com.paritytrading.parity.book.perf.generated,0,0,0,0,0,0,0,0
jvirtanen_parity,com.paritytrading.parity.match.perf,0,0,0,0,0,0,0,0
jvirtanen_parity,com.paritytrading.parity.match.perf.generated,0,0,0,0,0,0,0,0
jwtk_jjwt,(default package),0,0,0,0,0,0,0,0
jwtk_jjwt,io.jsonwebtoken,0,0,0,1,1,0,0,2
jwtk_jjwt,io.jsonwebtoken.io,0,0,0,1,1,0,0,2
jwtk_jjwt,io.jsonwebtoken.lang,0,0,0,0,1,0,0,1
jwtk_jjwt,io.jsonwebtoken.security,0,0,0,0,1,0,0,1
jwtk_jjwt,io.jsonwebtoken.gson.io,0,0,0,0,0,0,0,0
jwtk_jjwt,io.jsonwebtoken.jackson.io,0,0,0,0,0,0,0,0
jwtk_jjwt,io.jsonwebtoken.jackson.io.stubs,0,0,0,0,0,0,0,0
jwtk_jjwt,io.jsonwebtoken.orgjson.io,0,0,0,0,0,0,0,0
jwtk_jjwt,io.jsonwebtoken.impl,0,0,0,1,1,0,0,2
jwtk_jjwt,io.jsonwebtoken.impl.compression,0,0,0,0,1,0,0,1
jwtk_jjwt,io.jsonwebtoken.impl.crypto,0,0,0,1,1,0,0,2
jwtk_jjwt,io.jsonwebtoken.impl.lang,0,0,0,0,1,0,0,1
jwtk_jjwt,io.jsonwebtoken.impl.io,0,0,0,0,0,0,0,0
kaazing_gateway,org.kaazing.gateway.management,9,1,0,0,1,0,1,12
kaazing_gateway,org.kaazing.gateway.management.config,3,1,0,0,1,2,1,8
kaazing_gateway,org.kaazing.gateway.management.context,12,1,0,0,0,0,1,14
kaazing_gateway,org.kaazing.gateway.management.filter,5,0,0,0,0,0,1,6
kaazing_gateway,org.kaazing.gateway.management.gateway,5,1,0,0,0,0,1,7
kaazing_gateway,org.kaazing.gateway.management.jmx,0,0,0,1,1,0,1,3
kaazing_gateway,org.kaazing.gateway.management.monitoring.configuration.impl,1,0,0,0,0,0,1,2
kaazing_gateway,org.kaazing.gateway.management.monitoring.configuration,0,0,0,0,0,0,1,1
kaazing_gateway,org.kaazing.gateway.management.monitoring.entity.impl,1,1,0,0,1,0,1,4
kaazing_gateway,org.kaazing.gateway.management.monitoring.entity.manager.factory,0,0,0,0,0,0,1,1
kaazing_gateway,org.kaazing.gateway.management.monitoring.entity.manager.impl,0,0,0,0,0,0,1,1
kaazing_gateway,org.kaazing.gateway.management.monitoring.entity.manager,0,0,0,0,0,0,1,1
kaazing_gateway,org.kaazing.gateway.management.monitoring.service.impl,0,0,0,0,0,0,1,1
kaazing_gateway,org.kaazing.gateway.management.monitoring.service,0,0,0,0,0,0,1,1
kaazing_gateway,org.kaazing.gateway.management.monitoring.writer,0,0,0,0,0,0,1,1
kaazing_gateway,org.kaazing.gateway.management.monitoring.writer.impl,0,0,0,0,0,0,1,1
kaazing_gateway,org.kaazing.gateway.management.service,6,1,0,0,1,0,1,9
kaazing_gateway,org.kaazing.gateway.management.session,3,1,0,0,0,1,1,6
kaazing_gateway,org.kaazing.gateway.management.update.check,0,0,0,0,0,0,1,1
kaazing_gateway,org.kaazing.gateway.management.impl,0,0,0,0,0,0,1,1
kaazing_gateway,org.apache.mina.core.buffer,0,0,0,0,0,28,1,29
kaazing_gateway,org.apache.mina.core.file,0,0,0,0,0,0,1,1
kaazing_gateway,org.apache.mina.core.filterchain,0,0,0,0,0,36,1,37
kaazing_gateway,org.apache.mina.core.future,4,1,0,0,0,33,1,39
kaazing_gateway,org.apache.mina.core,7,1,0,0,1,2,1,12
kaazing_gateway,org.apache.mina.core.polling,0,0,0,0,1,5,1,7
kaazing_gateway,org.apache.mina.core.service,5,1,0,0,1,33,1,41
kaazing_gateway,org.apache.mina.core.session,6,0,0,0,1,62,1,70
kaazing_gateway,org.apache.mina.core.write,0,0,0,0,1,18,1,20
kaazing_gateway,org.apache.mina.filter.buffer,0,0,0,0,0,0,1,1
kaazing_gateway,org.apache.mina.filter.codec,1,1,0,0,1,26,1,30
kaazing_gateway,org.apache.mina.filter.codec.demux,1,0,0,0,1,0,1,3
kaazing_gateway,org.apache.mina.filter.codec.prefixedstring,0,0,0,0,0,1,1,2
kaazing_gateway,org.apache.mina.filter.codec.serialization,0,0,0,0,0,1,1,2
kaazing_gateway,org.apache.mina.filter.codec.statemachine,0,0,0,0,1,1,1,3
kaazing_gateway,org.apache.mina.filter.codec.textline,0,0,0,0,0,1,1,2
kaazing_gateway,org.apache.mina.filter.errorgenerating,0,0,0,0,0,0,1,1
kaazing_gateway,org.apache.mina.filter.executor,0,0,0,0,1,0,1,2
kaazing_gateway,org.apache.mina.filter.firewall,0,0,0,0,1,0,1,2
kaazing_gateway,org.apache.mina.filter.keepalive,0,0,0,0,0,0,1,1
kaazing_gateway,org.apache.mina.filter.logging,0,0,0,0,1,0,1,2
kaazing_gateway,org.apache.mina.filter.reqres,0,0,0,0,0,2,1,3
kaazing_gateway,org.apache.mina.filter.ssl,0,0,0,0,1,2,1,4
kaazing_gateway,org.apache.mina.filter.statistic,0,0,0,0,0,0,1,1
kaazing_gateway,org.apache.mina.filter.stream,0,0,0,0,0,5,1,6
kaazing_gateway,org.apache.mina.filter.util,3,0,0,0,1,3,1,8
kaazing_gateway,org.apache.mina.handler.chain,0,0,0,0,0,0,1,1
kaazing_gateway,org.apache.mina.handler.demux,0,0,0,0,0,0,1,1
kaazing_gateway,org.apache.mina.handler.multiton,0,0,0,0,0,0,1,1
kaazing_gateway,org.apache.mina.handler.stream,0,0,0,0,0,0,1,1
kaazing_gateway,org.apache.mina.proxy,3,0,0,0,1,1,1,6
kaazing_gateway,org.apache.mina.proxy.event,0,0,0,0,0,0,1,1
kaazing_gateway,org.apache.mina.proxy.filter,0,0,0,0,0,0,1,1
kaazing_gateway,org.apache.mina.proxy.handlers.http,3,1,0,0,1,0,1,6
kaazing_gateway,org.apache.mina.proxy.handlers.http.basic,1,0,0,0,0,0,1,2
kaazing_gateway,org.apache.mina.proxy.handlers.http.digest,1,0,0,0,0,0,1,2
kaazing_gateway,org.apache.mina.proxy.handlers.http.ntlm,1,0,0,0,0,0,1,2
kaazing_gateway,org.apache.mina.proxy.handlers,0,0,0,0,0,0,1,1
kaazing_gateway,org.apache.mina.proxy.handlers.socks,0,0,0,0,0,0,1,1
kaazing_gateway,org.apache.mina.proxy.session,0,0,0,0,0,1,1,2
kaazing_gateway,org.apache.mina.proxy.utils,0,0,0,0,1,0,1,2
kaazing_gateway,org.apache.mina.transport.socket,0,0,0,0,1,0,1,2
kaazing_gateway,org.apache.mina.transport.socket.nio,0,0,0,1,1,4,1,7
kaazing_gateway,org.apache.mina.transport.vmpipe,0,0,0,0,0,4,1,5
kaazing_gateway,org.apache.mina.util,0,0,0,0,1,5,1,7
kaazing_gateway,org.apache.mina.util.byteaccess,0,0,0,0,0,0,1,1
kaazing_gateway,org.apache.mina.transport,0,0,0,0,1,2,1,4
kaazing_gateway,org.apache.mina.integration.beans,0,1,0,1,0,0,1,3
kaazing_gateway,org.apache.mina.integration.jmx,0,0,0,0,0,0,1,1
kaazing_gateway,org.apache.mina.integration.ognl,0,0,0,0,1,0,1,2
kaazing_gateway,org.apache.mina.transport.serial,0,0,0,0,1,0,1,2
kaazing_gateway,org.jboss.netty.channel,0,0,0,0,0,0,1,1
kaazing_gateway,org.jboss.netty.channel.socket.nio,0,0,0,1,1,0,1,3
kaazing_gateway,org.jboss.netty.logging,0,0,0,0,0,0,1,1
kaazing_gateway,org.kaazing.mina.core.buffer,0,0,0,0,0,30,1,31
kaazing_gateway,org.kaazing.mina.core.filterchain,0,0,0,0,0,7,1,8
kaazing_gateway,org.kaazing.mina.core.future,0,1,0,0,1,4,1,7
kaazing_gateway,org.kaazing.mina.core.service,1,0,0,0,1,8,1,11
kaazing_gateway,org.kaazing.mina.core.session,1,1,0,0,0,34,1,37
kaazing_gateway,org.kaazing.mina.core.util,0,0,0,0,0,0,1,1
kaazing_gateway,org.kaazing.mina.core.write,0,0,0,0,0,1,1,2
kaazing_gateway,org.kaazing.mina.filter.codec,0,0,0,0,1,16,1,18
kaazing_gateway,org.kaazing.mina.filter.codec.statemachine,0,0,0,0,0,1,1,2
kaazing_gateway,org.kaazing.mina.filter.util,0,0,0,0,0,0,1,1
kaazing_gateway,org.kaazing.mina.netty.bootstrap,0,0,0,0,1,0,1,2
kaazing_gateway,org.kaazing.mina.netty.buffer,0,0,0,0,0,0,1,1
kaazing_gateway,org.kaazing.mina.netty.channel,0,0,0,0,0,0,1,1
kaazing_gateway,org.kaazing.mina.netty,0,0,0,1,1,2,1,5
kaazing_gateway,org.kaazing.mina.netty.socket,0,0,0,0,1,0,1,2
kaazing_gateway,org.kaazing.mina.netty.socket.nio,0,0,0,0,1,0,1,2
kaazing_gateway,org.kaazing.mina.netty.util.threadlocal,0,0,0,0,0,0,1,1
kaazing_gateway,org.kaazing.mina.util,0,0,0,0,0,1,1,2
kaazing_gateway,org.jboss.netty.channel.socket,0,0,0,0,0,0,1,1
kaazing_gateway,org.jboss.netty.util,0,0,0,0,0,0,1,1
kaazing_gateway,org.kaazing.hamcrest.core,0,0,0,0,0,0,1,1
kaazing_gateway,org.kaazing.junit.matchers,0,0,0,0,0,0,1,1
kaazing_gateway,org.kaazing.gateway.resource.address.http,0,1,0,1,0,0,1,3
kaazing_gateway,org.kaazing.gateway.resource.address.httpx,0,0,0,0,0,0,1,1
kaazing_gateway,org.kaazing.gateway.resource.address.httpxdraft,0,0,0,0,0,0,1,1
kaazing_gateway,org.kaazing.gateway.resource.address.httpxe,0,0,0,0,0,0,1,1
kaazing_gateway,org.kaazing.gateway.resource.address.pipe,0,0,0,0,0,0,1,1
kaazing_gateway,org.kaazing.gateway.resource.address.rtmp,0,0,0,0,0,0,1,1
kaazing_gateway,org.kaazing.gateway.resource.address,1,1,0,1,1,13,1,18
kaazing_gateway,org.kaazing.gateway.resource.address.uri,1,0,0,0,0,0,1,2
kaazing_gateway,org.kaazing.gateway.resource.address.sse,0,0,0,0,0,0,1,1
kaazing_gateway,org.kaazing.gateway.resource.address.ssl,0,0,0,0,0,0,1,1
kaazing_gateway,org.kaazing.gateway.resource.address.tcp,0,0,0,0,1,0,1,2
kaazing_gateway,org.kaazing.gateway.resource.address.udp,0,0,0,0,1,0,1,2
kaazing_gateway,org.kaazing.gateway.resource.address.ws,0,0,0,0,0,0,1,1
kaazing_gateway,org.kaazing.gateway.resource.address.wsdraft,0,0,0,0,0,0,1,1
kaazing_gateway,org.kaazing.gateway.resource.address.wse,0,0,0,0,0,0,1,1
kaazing_gateway,org.kaazing.gateway.resource.address.wsn,0,0,0,0,0,0,1,1
kaazing_gateway,org.kaazing.gateway.resource.address.wsx,0,0,0,0,0,0,1,1
kaazing_gateway,org.kaazing.gateway.resource.address.wsxdraft,0,0,0,0,0,0,1,1
kaazing_gateway,com.kaazing.demo.protocolinjection,0,0,0,0,0,0,1,1
kaazing_gateway,com.kaazing.demo.loginmodules,0,0,0,0,0,0,1,1
kaazing_gateway,org.kaazing.gateway.security.auth,1,0,0,1,1,0,1,4
kaazing_gateway,org.kaazing.gateway.security.auth.config,0,0,0,0,0,0,1,1
kaazing_gateway,org.kaazing.gateway.security.auth.config.parse,0,0,0,0,0,0,1,1
kaazing_gateway,org.kaazing.gateway.security.auth.context,1,1,0,0,0,0,1,3
kaazing_gateway,org.kaazing.gateway.security.auth.token,0,0,0,0,0,0,1,1
kaazing_gateway,org.kaazing.gateway.security,0,0,0,0,1,1,1,3
kaazing_gateway,org.kaazing.gateway.server.api,0,0,0,0,0,0,1,1
kaazing_gateway,org.kaazing.gateway.server.collections,0,0,0,0,0,0,1,1
kaazing_gateway,org.kaazing.gateway.server.config.parse,0,0,0,0,1,1,1,3
kaazing_gateway,org.kaazing.gateway.server.config.parse.translate,0,0,0,0,1,0,1,2
kaazing_gateway,org.kaazing.gateway.server.config.parse.translate.june2016,0,0,0,0,0,0,1,1
kaazing_gateway,org.kaazing.gateway.server.config.parse.translate.nov2015,0,0,0,0,0,0,1,1
kaazing_gateway,org.kaazing.gateway.server.config.parse.translate.sep2014,0,0,0,0,0,0,1,1
kaazing_gateway,org.kaazing.gateway.server.config.parse.translate.spi,0,0,0,0,0,0,1,1
kaazing_gateway,org.kaazing.gateway.server.config,0,0,0,0,0,0,1,1
kaazing_gateway,org.kaazing.gateway.server,1,1,0,0,1,0,1,4
kaazing_gateway,org.kaazing.gateway.server.context,0,0,0,0,0,2,1,3
kaazing_gateway,org.kaazing.gateway.server.context.resolve,1,0,0,1,1,0,1,4
kaazing_gateway,org.kaazing.gateway.server.impl,1,1,0,0,1,1,1,5
kaazing_gateway,org.kaazing.gateway.server.service,0,0,0,0,0,0,1,1
kaazing_gateway,org.kaazing.gateway.server.util.collection,0,0,0,0,0,0,1,1
kaazing_gateway,org.kaazing.gateway.server.util.der,0,0,0,0,0,0,1,1
kaazing_gateway,org.kaazing.gateway.server.util.io,0,0,0,0,1,0,1,2
kaazing_gateway,org.kaazing.gateway.server.util.session,0,0,0,0,0,0,1,1
kaazing_gateway,org.kaazing.gateway.server.util.version,0,0,0,0,0,0,1,1
kaazing_gateway,org.kaazing.gateway.server.observer,0,0,0,0,0,0,1,1
kaazing_gateway,org.kaazing.gateway.server.topic,0,0,0,0,0,0,1,1
kaazing_gateway,org.kaazing.gateway.server.util,0,0,0,0,1,1,1,3
kaazing_gateway,org.kaazing.gateway.transport,1,1,0,1,1,29,1,34
kaazing_gateway,org.kaazing.gateway.server.config.june2016,0,0,0,1,1,0,1,3
kaazing_gateway,org.kaazing.gateway.server.config.june2016.impl,0,0,0,1,1,0,1,3
kaazing_gateway,org.kaazing.gateway.server.config.nov2015,0,0,0,1,1,0,1,3
kaazing_gateway,org.kaazing.gateway.server.config.nov2015.impl,0,0,0,1,1,0,1,3
kaazing_gateway,org.kaazing.gateway.server.config.sep2014,0,0,0,1,1,0,1,3
kaazing_gateway,org.kaazing.gateway.server.config.sep2014.impl,0,0,0,1,1,0,1,3
kaazing_gateway,org.kaazing.gateway.server.spi.security,0,0,0,0,1,0,1,2
kaazing_gateway,org.kaazing.gateway.service.amqp.amqp091,2,1,0,0,0,4,1,8
kaazing_gateway,org.kaazing.gateway.service.amqp.amqp091.codec,2,0,0,0,0,2,1,5
kaazing_gateway,org.kaazing.gateway.service.amqp.amqp091.filter,1,0,0,0,0,0,1,2
kaazing_gateway,org.kaazing.gateway.service.amqp.amqp091.message,2,1,0,0,0,0,1,4
kaazing_gateway,org.kaazing.gateway.service.amqp,0,0,0,0,0,0,1,1
kaazing_gateway,org.kaazing.gateway.service.amqp.handler,0,0,0,0,0,0,1,1
kaazing_gateway,org.kaazing.gateway.service.amqp.specification.amqp901,0,0,0,0,0,0,1,1
kaazing_gateway,org.kaazing.gateway.service.broadcast,0,0,0,0,1,0,1,2
kaazing_gateway,org.kaazing.gateway.service.echo,0,0,0,0,0,0,1,1
kaazing_gateway,org.kaazing.gateway.service.http.balancer,0,1,0,0,1,2,1,5
kaazing_gateway,org.kaazing.gateway.service.http.directory.cachecontrol,0,0,0,0,1,0,1,2
kaazing_gateway,org.kaazing.gateway.service.http.directory,0,0,0,0,1,0,1,2
kaazing_gateway,org.kaazing.gateway.service.http.directory.rfc7232,0,0,0,0,0,0,1,1
kaazing_gateway,org.kaazing.gateway.service.http.directory.specification,0,0,0,0,0,0,1,1
kaazing_gateway,org.kaazing.gateway.service.http.proxy,0,0,0,1,1,1,1,4
kaazing_gateway,org.kaazing.gateway.service.http.redirect,0,0,0,0,0,0,1,1
kaazing_gateway,org.kaazing.gateway.service.proxy,0,0,0,1,1,2,1,5
kaazing_gateway,org.kaazing.gateway.service,0,0,0,0,1,5,1,7
kaazing_gateway,org.kaazing.gateway.service.cluster,0,0,0,0,0,0,1,1
kaazing_gateway,org.kaazing.gateway.service.collections,0,0,0,0,1,0,1,2
kaazing_gateway,org.kaazing.gateway.service.util,0,0,0,0,0,0,1,1
kaazing_gateway,org.kaazing.gateway.service.messaging.collections,0,0,0,0,0,0,1,1
kaazing_gateway,org.kaazing.gateway.service.turn.rest,0,0,0,0,1,1,1,3
kaazing_gateway,org.kaazing.gateway.service.turn.rest.internal,0,0,0,0,0,0,1,1
kaazing_gateway,org.kaazing.gateway.service.update.check,0,0,0,0,0,1,1,2
kaazing_gateway,org.kaazing.gateway.service.update.check.management,0,0,0,0,0,0,1,1
kaazing_gateway,org.kaazing.gateway.transport.bio,0,0,0,0,1,6,1,8
kaazing_gateway,org.kaazing.gateway.transport.http.bridge.filter,7,1,0,1,0,15,1,25
kaazing_gateway,org.kaazing.gateway.transport.http.bridge,7,1,0,0,0,0,1,9
kaazing_gateway,org.kaazing.gateway.transport.http,4,1,0,1,1,9,1,17
kaazing_gateway,org.kaazing.gateway.transport.http.resource,0,0,0,0,0,0,1,1
kaazing_gateway,org.kaazing.gateway.transport.http.resource.impl,0,0,0,0,1,1,1,3
kaazing_gateway,org.kaazing.gateway.transport.http.security.auth.challenge,2,0,0,0,0,0,1,3
kaazing_gateway,org.kaazing.gateway.transport.http.security.auth.token,2,0,0,0,1,0,1,4
kaazing_gateway,org.kaazing.gateway.transport.http.security.auth,0,0,0,0,0,0,1,1
kaazing_gateway,org.kaazing.gateway.transport.http.security,0,0,0,0,0,0,1,1
kaazing_gateway,org.kaazing.gateway.transport.http.acceptor.specification.rfc7230,0,0,0,0,0,0,1,1
kaazing_gateway,org.kaazing.gateway.transport.http.acceptor.specification.rfc7231,0,0,0,0,0,0,1,1
kaazing_gateway,org.kaazing.gateway.transport.http.acceptor.specification.rfc7232,0,0,0,0,0,0,1,1
kaazing_gateway,org.kaazing.gateway.transport.http.acceptor.specification.rfc7233,0,0,0,0,0,0,1,1
kaazing_gateway,org.kaazing.gateway.transport.http.acceptor.specification.rfc7234,0,0,0,0,1,0,1,2
kaazing_gateway,org.kaazing.gateway.transport.http.acceptor.specification.rfc7235,0,0,0,0,0,0,1,1
kaazing_gateway,org.kaazing.gateway.transport.http.connector.specification.rfc7230,0,0,0,0,1,0,1,2
kaazing_gateway,org.kaazing.gateway.transport.http.connector.specification.rfc7231,0,0,0,0,1,0,1,2
kaazing_gateway,org.kaazing.gateway.transport.http.connector.specification.rfc7232,0,0,0,1,1,0,1,3
kaazing_gateway,org.kaazing.gateway.transport.http.connector.specification.rfc7233,0,0,0,0,0,0,1,1
kaazing_gateway,org.kaazing.gateway.transport.http.connector.specification.rfc7234,0,0,0,0,1,0,1,2
kaazing_gateway,org.kaazing.gateway.transport.http.multi.auth,0,0,0,0,1,0,1,2
kaazing_gateway,org.kaazing.gateway.transport.http.security.auth.connector,0,0,0,0,0,0,1,1
kaazing_gateway,org.kaazing.gateway.transport.http.specification.httpxe,0,0,0,0,0,0,1,1
kaazing_gateway,org.kaazing.gateway.transport.nio.internal,0,0,0,0,1,9,1,11
kaazing_gateway,org.kaazing.gateway.transport.nio.internal.datagram,0,0,0,0,0,2,1,3
kaazing_gateway,org.kaazing.gateway.transport.nio.internal.socket,0,0,0,0,1,7,1,9
kaazing_gateway,org.kaazing.gateway.transport.nio,0,0,0,0,1,0,1,2
kaazing_gateway,org.kaazing.gateway.transport.tcp.specification,0,0,0,0,1,1,1,3
kaazing_gateway,org.kaazing.gateway.transport.udp.specification,0,0,0,0,1,1,1,3
kaazing_gateway,org.kaazing.gateway.transport.udp,0,0,0,0,1,1,1,3
kaazing_gateway,org.kaazing.gateway.transport.udp.generated,0,0,0,0,0,0,1,1
kaazing_gateway,org.kaazing.gateway.transport.pipe,0,0,0,0,1,2,1,4
kaazing_gateway,org.kaazing.gateway.transport.bridge,0,0,0,0,0,0,1,1
kaazing_gateway,org.kaazing.gateway.transport.der,0,0,0,0,0,0,1,1
kaazing_gateway,org.kaazing.gateway.transport.dispatch,0,0,0,0,0,0,1,1
kaazing_gateway,org.kaazing.gateway.transport.io.filter,0,0,0,0,0,2,1,3
kaazing_gateway,org.kaazing.gateway.transport.io,0,0,0,0,0,1,1,2
kaazing_gateway,org.kaazing.gateway.transport.sse.bridge.filter,0,0,0,0,1,2,1,4
kaazing_gateway,org.kaazing.gateway.transport.sse.bridge,0,0,0,0,0,0,1,1
kaazing_gateway,org.kaazing.gateway.transport.sse,0,0,0,0,1,0,1,2
kaazing_gateway,org.kaazing.gateway.transport.ssl.bridge.filter,0,0,0,0,0,1,1,2
kaazing_gateway,org.kaazing.gateway.transport.ssl.cert,0,0,0,0,0,0,1,1
kaazing_gateway,org.kaazing.gateway.transport.ssl,0,0,0,0,1,1,1,3
kaazing_gateway,org.kaazing.gateway.transport.ws,0,0,0,0,1,0,1,2
kaazing_gateway,org.kaazing.gateway.transport.ws.bridge.extensions.idletimeout,0,0,0,0,1,0,1,2
kaazing_gateway,org.kaazing.gateway.transport.ws.bridge.extensions.pingpong,0,0,0,0,1,0,1,2
kaazing_gateway,org.kaazing.gateway.transport.ws.bridge.filter,0,1,0,0,1,5,1,8
kaazing_gateway,org.kaazing.gateway.transport.ws.extension,0,1,0,0,0,0,1,2
kaazing_gateway,org.kaazing.gateway.transport.ws.util,0,0,0,0,1,0,1,2
kaazing_gateway,org.kaazing.gateway.transport.ws.bridge,0,0,0,0,0,0,1,1
kaazing_gateway,org.kaazing.gateway.transport.wseb.filter,0,0,0,0,0,7,1,8
kaazing_gateway,org.kaazing.gateway.transport.wseb.util,0,0,0,0,0,0,1,1
kaazing_gateway,org.kaazing.gateway.transport.wseb,0,1,0,1,1,2,1,6
kaazing_gateway,org.kaazing.gateway.transport.wseb.connector,0,0,0,0,0,0,1,1
kaazing_gateway,org.kaazing.gateway.transport.wseb.handshake,0,0,0,0,0,0,1,1
kaazing_gateway,org.kaazing.gateway.transport.wseb.logging.loginmodule,0,0,0,0,0,0,1,1
kaazing_gateway,org.kaazing.gateway.transport.wseb.logging,0,0,0,0,0,0,1,1
kaazing_gateway,org.kaazing.gateway.transport.wseb.specification.wse.acceptor,0,0,0,0,1,0,1,2
kaazing_gateway,org.kaazing.gateway.transport.wseb.specification.wse.connector,0,0,0,0,1,0,1,2
kaazing_gateway,org.kaazing.gateway.transport.wsn,0,0,0,1,1,2,1,5
kaazing_gateway,org.kaazing.gateway.transport.wsn.auth,0,0,0,0,1,0,1,2
kaazing_gateway,org.kaazing.gateway.transport.wsn.autobahn.closehandling,0,0,0,0,0,0,1,1
kaazing_gateway,org.kaazing.gateway.transport.wsn.autobahn.fragmentation,0,0,0,0,0,0,1,1
kaazing_gateway,org.kaazing.gateway.transport.wsn.autobahn.framing,0,0,0,0,0,0,1,1
kaazing_gateway,org.kaazing.gateway.transport.wsn.autobahn.opcodes,0,0,0,0,0,0,1,1
kaazing_gateway,org.kaazing.gateway.transport.wsn.autobahn.pingsandpongs,0,0,0,0,0,0,1,1
kaazing_gateway,org.kaazing.gateway.transport.wsn.autobahn.reservedbits,0,0,0,0,0,0,1,1
kaazing_gateway,org.kaazing.gateway.transport.wsn.autobahn.utf8handling,0,0,0,0,0,0,1,1
kaazing_gateway,org.kaazing.gateway.transport.wsn.extensions.idletimeout,0,0,0,0,0,0,1,1
kaazing_gateway,org.kaazing.gateway.transport.wsn.handshake,0,0,0,0,1,0,1,2
kaazing_gateway,org.kaazing.gateway.transport.wsn.logging,0,0,0,0,1,0,1,2
kaazing_gateway,org.kaazing.gateway.transport.wsn.proxy,0,0,0,0,0,0,1,1
kaazing_gateway,org.kaazing.gateway.transport.wsn.specification.extensions.idletimeout,0,0,0,0,0,0,1,1
kaazing_gateway,org.kaazing.gateway.transport.wsn.specification.extensions.pingpong,0,0,0,0,0,0,1,1
kaazing_gateway,org.kaazing.gateway.transport.wsn.specification.httpx,0,0,0,0,0,0,1,1
kaazing_gateway,org.kaazing.gateway.transport.wsn.specification.ws.acceptor,0,0,0,0,1,0,1,2
kaazing_gateway,org.kaazing.gateway.transport.wsn.specification.ws.connector,0,0,0,0,1,1,1,3
kaazing_gateway,org.kaazing.gateway.update.check,0,0,0,0,1,0,1,2
kaazing_gateway,org.kaazing.gateway.util.asn1,0,0,0,0,0,0,1,1
kaazing_gateway,org.kaazing.gateway.util,0,0,0,0,1,0,1,2
kaazing_gateway,org.kaazing.gateway.util.aws,0,0,0,0,0,0,1,1
kaazing_gateway,org.kaazing.gateway.util.codec,0,0,0,0,0,0,1,1
kaazing_gateway,org.kaazing.gateway.util.der,0,0,0,0,0,0,1,1
kaazing_gateway,org.kaazing.gateway.util.feature,0,0,0,0,0,2,1,3
kaazing_gateway,org.kaazing.gateway.util.file,0,0,0,0,0,0,1,1
kaazing_gateway,org.kaazing.gateway.util.http,0,0,0,0,0,0,1,1
kaazing_gateway,org.kaazing.gateway.util.parse,0,0,0,0,0,0,1,1
kaazing_gateway,org.kaazing.gateway.util.scheduler,0,0,0,0,0,7,1,8
kaazing_gateway,org.kaazing.gateway.util.ssl,0,0,0,0,0,0,1,1
kaazing_gateway,org.kaazing.gateway.util.turn,0,0,0,0,0,0,1,1
kairosdb_kairosdb,org.kairosdb.congestion,0,0,0,0,0,0,1,1
kairosdb_kairosdb,org.kairosdb.core.aggregator,5,0,0,1,1,2,1,10
kairosdb_kairosdb,org.kairosdb.core.annotation,0,0,0,0,0,0,1,1
kairosdb_kairosdb,org.kairosdb.core.blast,0,0,0,0,0,0,1,1
kairosdb_kairosdb,org.kairosdb.core.configuration,0,0,0,0,0,0,1,1
kairosdb_kairosdb,org.kairosdb.core,18,1,0,0,1,2,1,23
kairosdb_kairosdb,org.kairosdb.core.datapoints,6,1,0,0,1,1,1,10
kairosdb_kairosdb,org.kairosdb.core.datastore,8,1,0,1,1,1,1,13
kairosdb_kairosdb,org.kairosdb.core.demo,0,0,0,0,0,0,1,1
kairosdb_kairosdb,org.kairosdb.core.exception,0,0,0,0,0,0,1,1
kairosdb_kairosdb,org.kairosdb.core.formatter,3,0,0,0,1,0,1,5
kairosdb_kairosdb,org.kairosdb.core.groupby,4,1,0,0,1,0,1,7
kairosdb_kairosdb,org.kairosdb.core.health,0,0,0,0,1,0,1,2
kairosdb_kairosdb,org.kairosdb.core.http.exceptionmapper,0,0,0,0,0,0,1,1
kairosdb_kairosdb,org.kairosdb.core.http,3,1,0,0,0,0,1,5
kairosdb_kairosdb,org.kairosdb.core.http.rest,10,0,0,0,1,0,1,12
kairosdb_kairosdb,org.kairosdb.core.http.rest.json,13,1,0,1,1,0,1,17
kairosdb_kairosdb,org.kairosdb.core.http.rest.validation,0,0,0,0,0,0,1,1
kairosdb_kairosdb,org.kairosdb.core.jobs,0,0,0,0,0,0,1,1
kairosdb_kairosdb,org.kairosdb.core.oauth,0,0,0,0,1,0,1,2
kairosdb_kairosdb,org.kairosdb.core.processingstage,2,1,0,0,1,0,1,5
kairosdb_kairosdb,org.kairosdb.core.processingstage.metadata,0,0,0,0,1,0,1,2
kairosdb_kairosdb,org.kairosdb.core.queue,1,0,0,0,1,0,1,3
kairosdb_kairosdb,org.kairosdb.core.reporting,4,1,0,0,1,0,1,7
kairosdb_kairosdb,org.kairosdb.core.scheduler,2,1,0,0,0,0,1,4
kairosdb_kairosdb,org.kairosdb.core.telnet,0,0,0,0,1,0,1,2
kairosdb_kairosdb,org.kairosdb.datastore.cassandra,1,0,0,1,1,0,1,4
kairosdb_kairosdb,org.kairosdb.datastore.h2,0,0,0,0,0,0,1,1
kairosdb_kairosdb,org.kairosdb.datastore.h2.orm,0,0,0,1,1,0,1,3
kairosdb_kairosdb,org.kairosdb.eventbus,2,1,0,0,1,0,1,5
kairosdb_kairosdb,org.kairosdb.events,3,0,0,0,0,0,1,4
kairosdb_kairosdb,org.kairosdb.plugin,0,0,0,0,0,0,1,1
kairosdb_kairosdb,org.kairosdb.rollup,14,1,0,1,0,0,1,17
kairosdb_kairosdb,org.kairosdb.util,13,1,0,1,1,0,1,17
kairosdb_kairosdb,org.kairosdb.core.annotatedAggregator,0,0,0,0,0,0,1,1
kairosdb_kairosdb,org.kairosdb.datastore,1,1,0,0,0,0,1,3
kairosdb_kairosdb-client,org.kairosdb.client.builder,8,1,0,0,1,1,1,12
kairosdb_kairosdb-client,org.kairosdb.client.builder.aggregator,0,0,0,0,1,0,1,2
kairosdb_kairosdb-client,org.kairosdb.client.builder.grouper,2,1,0,0,1,0,1,5
kairosdb_kairosdb-client,org.kairosdb.client,6,0,0,0,1,1,1,9
kairosdb_kairosdb-client,org.kairosdb.client.deserializer,6,0,0,0,1,0,1,8
kairosdb_kairosdb-client,org.kairosdb.client.response,3,1,0,0,1,1,1,7
kairosdb_kairosdb-client,org.kairosdb.client.response.grouping,2,0,0,0,1,0,1,4
kairosdb_kairosdb-client,org.kairosdb.client.serializer,1,1,0,0,1,0,1,4
kairosdb_kairosdb-client,org.kairosdb.client.util,0,0,0,0,0,0,1,1
kantega_pdf-converter,com.documents4j.api,0,0,0,0,1,0,0,1
kantega_pdf-converter,com.documents4j.job,1,1,0,1,1,0,0,4
kantega_pdf-converter,com.documents4j.throwables,0,0,0,0,0,0,0,0
kantega_pdf-converter,com.documents4j.ws.endpoint,0,0,0,0,1,0,0,1
kantega_pdf-converter,com.documents4j.standalone,0,0,0,0,1,0,0,1
kantega_pdf-converter,com.documents4j.conversion,1,0,0,0,1,0,0,2
kantega_pdf-converter,com.documents4j.demo,0,0,0,0,1,0,0,1
kantega_pdf-converter,com.documents4j.ws.application,0,1,0,0,0,0,0,1
kantega_pdf-converter,com.documents4j.builder,0,0,0,0,0,0,0,0
kantega_pdf-converter,com.documents4j.server.auth,0,0,0,0,0,0,0,0
kantega_pdf-converter,com.documents4j.ws,0,1,0,0,1,0,0,2
kantega_pdf-converter,com.documents4j.conversion.msoffice,0,0,0,0,1,0,0,1
kantega_pdf-converter,com.documents4j.util,0,0,0,0,0,0,0,0
kennycason_kumo,com.kennycason.kumo.nlp.tokenizer,0,0,0,0,0,0,0,0
kennycason_kumo,com.kennycason.kumo.cli,0,0,0,0,0,0,0,0
kennycason_kumo,com.kennycason.kumo.bg,1,1,0,0,0,1,0,3
kennycason_kumo,com.kennycason.kumo.collide.checkers,0,0,0,0,0,0,0,0
kennycason_kumo,com.kennycason.kumo.collide,0,0,0,0,0,1,0,1
kennycason_kumo,com.kennycason.kumo,3,0,0,0,1,1,0,5
kennycason_kumo,com.kennycason.kumo.exception,0,0,0,0,0,0,0,0
kennycason_kumo,com.kennycason.kumo.font,0,0,0,0,0,0,0,0
kennycason_kumo,com.kennycason.kumo.font.scale,0,0,0,0,0,0,0,0
kennycason_kumo,com.kennycason.kumo.image,3,1,0,0,0,1,0,5
kennycason_kumo,com.kennycason.kumo.nlp.filter,0,0,0,0,0,0,0,0
kennycason_kumo,com.kennycason.kumo.nlp,0,0,0,0,0,1,0,1
kennycason_kumo,com.kennycason.kumo.nlp.normalize,0,0,0,0,0,0,0,0
kennycason_kumo,com.kennycason.kumo.padding,1,0,0,0,0,0,0,1
kennycason_kumo,com.kennycason.kumo.palette,0,0,0,0,0,0,0,0
kennycason_kumo,com.kennycason.kumo.placement,0,0,0,0,0,0,0,0
kennycason_kumo,com.kennycason.kumo.wordstart,0,0,0,0,0,0,0,0
kennycason_kumo,com.kennycason.kumo.examples,0,0,0,0,1,1,0,2
kennycason_kumo,com.kennycason.kumo.nlp.tokenizers,0,0,0,0,1,0,0,1
kite-sdk_kite,org.kitesdk.data,9,1,0,1,0,0,1,12
kite-sdk_kite,org.kitesdk.data.impl,2,1,0,0,0,0,1,4
kite-sdk_kite,org.kitesdk.data.spi,7,1,0,1,0,0,1,10
kite-sdk_kite,org.kitesdk.data.spi.filesystem,3,0,0,1,0,0,1,5
kite-sdk_kite,org.kitesdk.data.spi.partition,4,0,0,0,0,0,1,5
kite-sdk_kite,org.kitesdk.data.spi.predicates,3,1,0,0,0,0,1,5
kite-sdk_kite,org.kitesdk.data.event,0,0,0,0,0,0,1,1
kite-sdk_kite,org.kitesdk.data.crunch,0,0,0,0,0,0,1,1
kite-sdk_kite,org.apache.flume.clients.log4jappender,0,0,0,0,1,0,1,2
kite-sdk_kite,org.kitesdk.data.flume,0,0,0,0,0,0,1,1
kite-sdk_kite,org.kitesdk.data.hbase.avro,5,1,0,0,0,0,1,7
kite-sdk_kite,org.kitesdk.data.hbase.avro.example,0,0,0,0,0,0,1,1
kite-sdk_kite,org.kitesdk.data.hbase.avro.io,0,0,0,0,1,0,1,2
kite-sdk_kite,org.kitesdk.data.hbase,2,0,0,0,1,0,1,4
kite-sdk_kite,org.kitesdk.data.hbase.filters,4,0,0,0,0,0,1,5
kite-sdk_kite,org.kitesdk.data.hbase.impl,4,1,0,1,0,0,1,7
kite-sdk_kite,org.kitesdk.data.hbase.manager,0,0,0,0,0,0,1,1
kite-sdk_kite,org.kitesdk.data.hbase.spi,0,0,0,0,0,0,1,1
kite-sdk_kite,org.kitesdk.data.hbase.tool,5,1,0,0,0,0,1,7
kite-sdk_kite,org.kitesdk.data.spi.hive,0,0,0,1,0,0,1,2
kite-sdk_kite,org.kitesdk.data.mapreduce,0,1,0,0,0,0,1,2
kite-sdk_kite,org.kitesdk.data.oozie,0,0,0,0,0,0,1,1
kite-sdk_kite,org.kitesdk.data.spi.s3,0,0,0,0,0,0,1,1
kite-sdk_kite,org.kitesdk.data.spark,0,0,0,0,0,0,1,1
kite-sdk_kite,org.kitesdk.compat,0,0,0,0,0,0,1,1
kite-sdk_kite,org.kitesdk.maven.plugins,0,0,0,0,0,0,1,1
kite-sdk_kite,org.apache.flume.sink.kite,0,0,0,0,0,0,1,1
kite-sdk_kite,org.kitesdk.minicluster.cli,0,0,0,0,0,0,1,1
kite-sdk_kite,org.kitesdk.minicluster,0,0,0,0,0,0,1,1
kite-sdk_kite,org.kitesdk.morphline.avro,0,0,0,0,1,0,1,2
kite-sdk_kite,org.kitesdk.morphline.api,2,1,0,1,0,0,1,5
kite-sdk_kite,org.kitesdk.morphline.base,1,1,0,0,1,0,1,4
kite-sdk_kite,org.kitesdk.morphline.scriptengine.java,0,0,0,0,0,0,1,1
kite-sdk_kite,org.kitesdk.morphline.shaded.com.google.code.regexp,0,0,0,0,0,0,1,1
kite-sdk_kite,org.kitesdk.morphline.shaded.com.google.common.io,0,0,0,0,0,0,1,1
kite-sdk_kite,org.kitesdk.morphline.shaded.com.google.common.reflect,0,0,0,0,0,0,1,1
kite-sdk_kite,org.kitesdk.morphline.shaded.com.googlecode.jcsv.fastreader,1,0,0,0,0,0,1,2
kite-sdk_kite,org.kitesdk.morphline.shaded.org.apache.commons.codec.binary.binary,0,0,0,0,0,0,1,1
kite-sdk_kite,org.kitesdk.morphline.shaded.org.apache.commons.math3.random,0,0,0,0,0,0,1,1
kite-sdk_kite,org.kitesdk.morphline.shaded.org.apache.hadoop.fs,0,0,0,0,0,0,1,1
kite-sdk_kite,org.kitesdk.morphline.stdio,0,0,0,0,0,0,1,1
kite-sdk_kite,org.kitesdk.morphline.stdlib,0,0,0,1,1,0,1,3
kite-sdk_kite,org.kitesdk.morphline.hadoop.core,0,0,0,0,1,0,1,2
kite-sdk_kite,org.kitesdk.morphline.hadoop.parquet.avro,0,0,0,0,0,0,1,1
kite-sdk_kite,org.kitesdk.morphline.hadoop.rcfile,0,0,0,0,1,0,1,2
kite-sdk_kite,org.kitesdk.morphline.hadoop.sequencefile,0,0,0,0,0,0,1,1
kite-sdk_kite,org.kitesdk.morphline.json,0,0,0,0,0,0,1,1
kite-sdk_kite,org.kitesdk.morphline.maxmind,0,0,0,0,0,0,1,1
kite-sdk_kite,org.kitesdk.morphline.metrics.scalable,0,0,0,0,0,0,1,1
kite-sdk_kite,org.kitesdk.morphline.metrics.servlets,0,0,0,0,0,0,1,1
kite-sdk_kite,org.kitesdk.morphline.protobuf,0,0,0,0,0,0,1,1
kite-sdk_kite,org.kitesdk.morphline.saxon,0,0,0,0,1,0,1,2
kite-sdk_kite,org.kitesdk.morphline.solrcell,0,0,0,0,1,0,1,2
kite-sdk_kite,org.apache.solr.client.solrj.retry,0,0,0,0,0,0,1,1
kite-sdk_kite,org.kitesdk.morphline.solr,0,0,0,1,0,0,1,2
kite-sdk_kite,org.kitesdk.morphline.tika,0,0,0,0,0,0,1,1
kite-sdk_kite,org.kitesdk.morphline.tika.decompress,0,0,0,0,0,0,1,1
kite-sdk_kite,org.kitesdk.morphline.twitter,0,0,0,0,0,0,1,1
kite-sdk_kite,org.kitesdk.morphline.useragent,0,0,0,0,0,0,1,1
kite-sdk_kite,org.kitesdk.cli,0,1,0,0,0,0,1,2
kite-sdk_kite,org.kitesdk.cli.commands,0,0,0,1,0,0,1,2
kite-sdk_kite,org.kitesdk.cli.example,0,0,0,0,0,0,1,1
kite-sdk_kite,org.kitesdk.tools,0,1,0,0,1,0,1,3
KittehOrg_KittehIRCClientLib,org.kitteh.irc.client.library,14,1,0,0,1,5,0,21
KittehOrg_KittehIRCClientLib,org.kitteh.irc.client.library.command,0,0,0,0,1,1,0,2
KittehOrg_KittehIRCClientLib,org.kitteh.irc.client.library.defaults,0,0,0,0,1,0,0,1
KittehOrg_KittehIRCClientLib,org.kitteh.irc.client.library.defaults.element,3,0,0,0,1,0,0,4
KittehOrg_KittehIRCClientLib,org.kitteh.irc.client.library.defaults.element.isupport,0,0,0,0,1,0,0,1
KittehOrg_KittehIRCClientLib,org.kitteh.irc.client.library.defaults.element.messagetag,1,0,0,0,0,0,0,1
KittehOrg_KittehIRCClientLib,org.kitteh.irc.client.library.defaults.element.mode,1,0,0,0,1,0,0,2
KittehOrg_KittehIRCClientLib,org.kitteh.irc.client.library.defaults.feature,12,1,0,0,1,1,0,15
KittehOrg_KittehIRCClientLib,org.kitteh.irc.client.library.defaults.feature.network,0,0,0,0,0,0,0,0
KittehOrg_KittehIRCClientLib,org.kitteh.irc.client.library.defaults.listener,4,0,0,1,1,2,0,8
KittehOrg_KittehIRCClientLib,org.kitteh.irc.client.library.element,3,0,0,1,1,2,0,7
KittehOrg_KittehIRCClientLib,org.kitteh.irc.client.library.element.mode,0,0,0,0,1,0,0,1
KittehOrg_KittehIRCClientLib,org.kitteh.irc.client.library.event.abstractbase,0,0,0,0,1,2,0,3
KittehOrg_KittehIRCClientLib,org.kitteh.irc.client.library.event.batch,0,0,0,0,0,0,0,0
KittehOrg_KittehIRCClientLib,org.kitteh.irc.client.library.event.capabilities,0,0,0,0,1,1,0,2
KittehOrg_KittehIRCClientLib,org.kitteh.irc.client.library.event.channel,0,0,0,0,1,0,0,1
KittehOrg_KittehIRCClientLib,org.kitteh.irc.client.library.event.client,1,0,0,0,1,0,0,2
KittehOrg_KittehIRCClientLib,org.kitteh.irc.client.library.event.connection,0,0,0,0,0,0,0,0
KittehOrg_KittehIRCClientLib,org.kitteh.irc.client.library.event.helper,0,0,0,0,1,0,0,1
KittehOrg_KittehIRCClientLib,org.kitteh.irc.client.library.event.user,0,0,0,0,1,0,0,1
KittehOrg_KittehIRCClientLib,org.kitteh.irc.client.library.exception,0,0,0,0,1,0,0,1
KittehOrg_KittehIRCClientLib,org.kitteh.irc.client.library.feature,15,1,0,0,1,4,0,21
KittehOrg_KittehIRCClientLib,org.kitteh.irc.client.library.feature.auth,0,0,0,0,1,0,0,1
KittehOrg_KittehIRCClientLib,org.kitteh.irc.client.library.feature.auth.element,0,0,0,0,0,0,0,0
KittehOrg_KittehIRCClientLib,org.kitteh.irc.client.library.feature.defaultmessage,0,0,0,0,0,0,0,0
KittehOrg_KittehIRCClientLib,org.kitteh.irc.client.library.feature.filter,0,0,0,0,1,0,0,1
KittehOrg_KittehIRCClientLib,org.kitteh.irc.client.library.feature.network,0,0,0,0,0,0,0,0
KittehOrg_KittehIRCClientLib,org.kitteh.irc.client.library.feature.sending,0,0,0,0,0,0,0,0
KittehOrg_KittehIRCClientLib,org.kitteh.irc.client.library.feature.sts,3,0,0,0,1,2,0,6
KittehOrg_KittehIRCClientLib,org.kitteh.irc.client.library.feature.twitch.event,0,0,0,0,1,0,0,1
KittehOrg_KittehIRCClientLib,org.kitteh.irc.client.library.feature.twitch.messagetag,0,0,0,1,1,0,0,2
KittehOrg_KittehIRCClientLib,org.kitteh.irc.client.library.feature.twitch,0,0,0,0,0,1,0,1
KittehOrg_KittehIRCClientLib,org.kitteh.irc.client.library.util,10,1,0,1,1,2,0,15
KittehOrg_KittehIRCClientLib,org.kitteh.irc.client.library.defaults.feature.isupport,0,0,0,0,0,0,0,0
KittehOrg_KittehIRCClientLib,org.kitteh.irc.client.library.defaults.feature.sts,0,0,0,0,0,0,0,0
Kixeye_chassis,com.kixeye.chassis.bootstrap,2,0,0,0,1,0,0,3
Kixeye_chassis,com.kixeye.chassis.bootstrap.aws,1,1,0,0,1,0,0,3
Kixeye_chassis,com.kixeye.chassis.bootstrap.configuration,1,1,0,0,1,0,0,3
Kixeye_chassis,com.kixeye.chassis.bootstrap.configuration.file,0,0,0,0,0,0,0,0
Kixeye_chassis,com.kixeye.chassis.bootstrap.configuration.zookeeper,0,0,0,0,1,0,0,1
Kixeye_chassis,com.kixeye.chassis.bootstrap.spring,0,0,0,0,0,0,0,0
Kixeye_chassis,com.kixeye.chassis.bootstrap.app,0,0,0,0,0,0,0,0
Kixeye_chassis,com.kixeye.chassis.bootstrap.webapp,0,0,0,0,0,0,0,0
Kixeye_chassis,com.kixeye.chassis.support,0,0,0,0,0,0,0,0
Kixeye_chassis,com.kixeye.chassis.support.eureka,0,0,0,0,0,0,0,0
Kixeye_chassis,com.kixeye.chassis.support.events,0,0,0,0,0,0,0,0
Kixeye_chassis,com.kixeye.chassis.support.logging,0,0,0,0,0,0,0,0
Kixeye_chassis,com.kixeye.chassis.support.metrics.aws,0,0,0,0,0,0,0,0
Kixeye_chassis,com.kixeye.chassis.support.metrics.codahale,0,0,0,0,0,0,0,0
Kixeye_chassis,com.kixeye.chassis.support.metrics,0,0,0,0,0,0,0,0
Kixeye_chassis,com.kixeye.chassis.support.metrics.netflix,0,0,0,0,0,0,0,0
Kixeye_chassis,com.kixeye.chassis.support.util,0,0,0,0,0,0,0,0
Kixeye_chassis,com.kixeye.chassis.scala.transport.serde,0,0,0,0,0,0,0,0
Kixeye_chassis,com.kixeye.chassis.transport.crypto,0,0,0,0,0,0,0,0
Kixeye_chassis,com.kixeye.chassis.transport.dto,0,0,0,0,0,0,0,0
Kixeye_chassis,com.kixeye.chassis.transport.serde,0,0,0,0,0,1,0,1
Kixeye_chassis,com.kixeye.chassis.transport.websocket,2,1,0,0,1,1,0,5
Kixeye_chassis,com.kixeye.chassis.transport.util,0,0,0,0,0,0,0,0
Kixeye_chassis,com.kixeye.chassis.transport.admin,0,0,0,0,0,0,0,0
Kixeye_chassis,com.kixeye.chassis.transport,4,0,0,0,1,1,0,6
Kixeye_chassis,com.kixeye.chassis.transport.http,3,1,0,0,1,0,0,5
Kixeye_chassis,com.kixeye.chassis.transport.shared,3,1,0,0,1,0,0,5
Kixeye_chassis,com.kixeye.chassis.transport.websocket.docs,0,0,0,0,0,0,0,0
Kixeye_chassis,com.kixeye.chassis.transport.websocket.responseconverter,0,0,0,0,0,0,0,0
Kixeye_chassis,com.kixeye.chassis.transport.utils,0,0,0,0,0,0,0,0
Kixeye_chassis,com.kixeye.chassis.transport.serde.bson,0,0,0,0,0,0,0,0
Kixeye_chassis,com.kixeye.chassis.transport.serde.converter,0,0,0,0,0,0,0,0
Kixeye_chassis,com.kixeye.chassis.transport.swagger,0,0,0,0,1,0,0,1
Kixeye_kixmpp,com.kixeye.kixmpp.client,0,0,0,0,1,0,0,1
Kixeye_kixmpp,com.kixeye.kixmpp.client.module.chat,0,0,0,0,0,0,0,0
Kixeye_kixmpp,com.kixeye.kixmpp.client.module.error,0,0,0,0,0,0,0,0
Kixeye_kixmpp,com.kixeye.kixmpp.client.module,0,0,0,0,0,0,0,0
Kixeye_kixmpp,com.kixeye.kixmpp.client.module.muc,0,0,0,0,1,0,0,1
Kixeye_kixmpp,com.kixeye.kixmpp.client.module.presence,0,0,0,0,0,0,0,0
Kixeye_kixmpp,com.kixeye.kixmpp.date,0,0,0,0,0,0,0,0
Kixeye_kixmpp,com.kixeye.kixmpp.handler,0,0,0,0,1,0,0,1
Kixeye_kixmpp,com.kixeye.kixmpp.interceptor,0,0,0,0,0,0,0,0
Kixeye_kixmpp,com.kixeye.kixmpp.jdom,0,0,0,0,0,0,0,0
Kixeye_kixmpp,com.kixeye.kixmpp,0,0,0,0,1,0,0,1
Kixeye_kixmpp,com.kixeye.kixmpp.module,0,0,0,0,0,0,0,0
Kixeye_kixmpp,com.kixeye.kixmpp.tuple,0,0,0,0,0,0,0,0
Kixeye_kixmpp,com.kixeye.kixmpp.p2p,0,0,0,0,0,0,0,0
Kixeye_kixmpp,com.kixeye.kixmpp.p2p.discovery,0,0,0,0,0,0,0,0
Kixeye_kixmpp,com.kixeye.kixmpp.p2p.listener,0,0,0,0,0,0,0,0
Kixeye_kixmpp,com.kixeye.kixmpp.p2p.message,0,0,0,0,1,0,0,1
Kixeye_kixmpp,com.kixeye.kixmpp.p2p.node,0,0,0,0,1,0,0,1
Kixeye_kixmpp,com.kixeye.kixmpp.p2p.serialization,0,0,0,0,0,0,0,0
Kixeye_kixmpp,com.kixeye.kixmpp.p2p.util,0,0,0,0,0,0,0,0
Kixeye_kixmpp,com.kixeye.kixmpp.server.cluster.mapreduce,0,0,0,0,0,0,0,0
Kixeye_kixmpp,com.kixeye.kixmpp.server.cluster.message,0,0,0,0,1,0,0,1
Kixeye_kixmpp,com.kixeye.kixmpp.server,1,0,0,0,1,0,0,2
Kixeye_kixmpp,com.kixeye.kixmpp.server.module.auth,0,0,0,0,0,0,0,0
Kixeye_kixmpp,com.kixeye.kixmpp.server.module.bind,0,0,0,0,0,0,0,0
Kixeye_kixmpp,com.kixeye.kixmpp.server.module.chat,0,0,0,0,0,0,0,0
Kixeye_kixmpp,com.kixeye.kixmpp.server.module.disco,0,0,0,0,0,0,0,0
Kixeye_kixmpp,com.kixeye.kixmpp.server.module.features,0,0,0,0,0,0,0,0
Kixeye_kixmpp,com.kixeye.kixmpp.server.module,0,0,0,0,0,0,0,0
Kixeye_kixmpp,com.kixeye.kixmpp.server.module.muc,1,1,0,0,1,0,0,3
Kixeye_kixmpp,com.kixeye.kixmpp.server.module.presence,0,0,0,0,0,0,0,0
Kixeye_kixmpp,com.kixeye.kixmpp.server.module.roster,0,0,0,0,0,0,0,0
Kixeye_kixmpp,com.kixeye.kixmpp.server.module.session,0,0,0,0,0,0,0,0
Kixeye_kixmpp,com.kixeye.kixmpp.server.utils,0,0,0,0,0,0,0,0
KleeGroup_vertigo,io.vertigo.account.account,2,0,0,0,0,0,1,3
KleeGroup_vertigo,io.vertigo.account.authentication,0,1,0,0,0,0,1,2
KleeGroup_vertigo,io.vertigo.account.authorization,1,0,0,0,1,0,1,3
KleeGroup_vertigo,io.vertigo.account.authorization.metamodel,0,0,0,0,1,0,1,2
KleeGroup_vertigo,io.vertigo.account.authorization.metamodel.rulemodel,0,0,0,0,1,0,1,2
KleeGroup_vertigo,io.vertigo.account.identityprovider,0,0,0,0,0,0,1,1
KleeGroup_vertigo,io.vertigo.account.security,0,0,0,0,0,0,1,1
KleeGroup_vertigo,io.vertigo.account,2,1,0,0,0,0,1,4
KleeGroup_vertigo,io.vertigo.account.impl.account,1,0,0,0,0,0,1,2
KleeGroup_vertigo,io.vertigo.account.impl.authentication,0,0,0,0,0,0,1,1
KleeGroup_vertigo,io.vertigo.account.impl.authorization,1,0,0,0,0,0,1,2
KleeGroup_vertigo,io.vertigo.account.impl.authorization.dsl.rules,0,0,0,0,1,0,1,2
KleeGroup_vertigo,io.vertigo.account.impl.authorization.dsl.translator,0,0,0,0,0,0,1,1
KleeGroup_vertigo,io.vertigo.account.impl.identityprovider,0,0,0,0,0,0,1,1
KleeGroup_vertigo,io.vertigo.account.impl.security,0,0,0,0,0,0,1,1
KleeGroup_vertigo,io.vertigo.account.plugins.account.cache.memory,0,0,0,0,0,0,1,1
KleeGroup_vertigo,io.vertigo.account.plugins.account.cache.redis,0,0,0,0,0,0,1,1
KleeGroup_vertigo,io.vertigo.account.plugins.account.store,0,0,0,0,0,0,1,1
KleeGroup_vertigo,io.vertigo.account.plugins.account.store.datastore,0,0,0,0,0,0,1,1
KleeGroup_vertigo,io.vertigo.account.plugins.account.store.loader,0,0,0,0,0,0,1,1
KleeGroup_vertigo,io.vertigo.account.plugins.account.store.text,0,0,0,0,0,0,1,1
KleeGroup_vertigo,io.vertigo.account.plugins.authentication.ldap,0,0,0,0,0,0,1,1
KleeGroup_vertigo,io.vertigo.account.plugins.authentication.mock,0,0,0,0,0,0,1,1
KleeGroup_vertigo,io.vertigo.account.plugins.authentication.store,0,0,0,0,0,0,1,1
KleeGroup_vertigo,io.vertigo.account.plugins.authentication.text,0,0,0,0,0,0,1,1
KleeGroup_vertigo,io.vertigo.account.plugins.authorization.loaders,0,0,0,0,0,0,1,1
KleeGroup_vertigo,io.vertigo.account.plugins.identityprovider.ldap,0,0,0,0,0,0,1,1
KleeGroup_vertigo,io.vertigo.account.plugins.identityprovider.store,0,0,0,0,0,0,1,1
KleeGroup_vertigo,io.vertigo.account.plugins.identityprovider.text,0,0,0,0,0,0,1,1
KleeGroup_vertigo,io.vertigo.account.account.model,0,0,0,0,0,0,1,1
KleeGroup_vertigo,io.vertigo.account.authentication.model,0,0,0,0,0,0,1,1
KleeGroup_vertigo,io.vertigo.account.authorization.dsl,0,0,0,0,0,0,1,1
KleeGroup_vertigo,io.vertigo.account.authorization.model,0,0,0,0,0,0,1,1
KleeGroup_vertigo,io.vertigo.account.data,1,0,0,0,0,0,1,2
KleeGroup_vertigo,io.vertigo.account.identityprovider.model,0,0,0,0,0,0,1,1
KleeGroup_vertigo,io.vertigo.commons.analytics,0,0,0,0,0,5,1,6
KleeGroup_vertigo,io.vertigo.commons.analytics.health,1,1,0,0,1,5,1,9
KleeGroup_vertigo,io.vertigo.commons.analytics.metric,0,0,0,0,1,2,1,4
KleeGroup_vertigo,io.vertigo.commons.analytics.process,1,0,0,0,1,5,1,8
KleeGroup_vertigo,io.vertigo.commons.app,0,0,0,0,0,2,1,3
KleeGroup_vertigo,io.vertigo.commons.cache,0,0,0,0,1,3,1,5
KleeGroup_vertigo,io.vertigo.commons.codec,0,0,0,0,1,4,1,6
KleeGroup_vertigo,io.vertigo.commons.daemon,0,0,0,0,1,3,1,5
KleeGroup_vertigo,io.vertigo.commons.eventbus,0,0,0,0,1,1,1,3
KleeGroup_vertigo,io.vertigo.commons.peg,0,0,0,1,0,0,1,2
KleeGroup_vertigo,io.vertigo.commons.script,0,0,0,0,1,2,1,4
KleeGroup_vertigo,io.vertigo.commons.script.parser,0,0,0,0,0,1,1,2
KleeGroup_vertigo,io.vertigo.commons.transaction,0,0,0,0,1,2,1,4
KleeGroup_vertigo,io.vertigo.commons,0,0,0,0,0,6,1,7
KleeGroup_vertigo,io.vertigo.commons.impl.analytics,0,0,0,0,0,1,1,2
KleeGroup_vertigo,io.vertigo.commons.impl.analytics.health,0,0,0,0,0,2,1,3
KleeGroup_vertigo,io.vertigo.commons.impl.analytics.metric,0,0,0,0,0,2,1,3
KleeGroup_vertigo,io.vertigo.commons.impl.analytics.process,1,1,0,0,1,1,1,5
KleeGroup_vertigo,io.vertigo.commons.impl.app,0,0,0,0,1,1,1,3
KleeGroup_vertigo,io.vertigo.commons.impl.cache,0,0,0,0,0,0,1,1
KleeGroup_vertigo,io.vertigo.commons.impl.codec.base64,0,0,0,0,0,0,1,1
KleeGroup_vertigo,io.vertigo.commons.impl.codec,0,0,0,0,0,0,1,1
KleeGroup_vertigo,io.vertigo.commons.impl.codec.compressedserialization,0,0,0,0,0,0,1,1
KleeGroup_vertigo,io.vertigo.commons.impl.codec.compression,0,0,0,0,0,0,1,1
KleeGroup_vertigo,io.vertigo.commons.impl.codec.crypto,0,0,0,0,0,0,1,1
KleeGroup_vertigo,io.vertigo.commons.impl.codec.csv,0,0,0,0,0,0,1,1
KleeGroup_vertigo,io.vertigo.commons.impl.codec.hash,0,0,0,0,0,0,1,1
KleeGroup_vertigo,io.vertigo.commons.impl.codec.hex,0,0,0,0,0,0,1,1
KleeGroup_vertigo,io.vertigo.commons.impl.codec.html,0,0,0,0,0,0,1,1
KleeGroup_vertigo,io.vertigo.commons.impl.codec.serialization,0,0,0,0,0,0,1,1
KleeGroup_vertigo,io.vertigo.commons.impl.connectors.redis,0,0,0,0,0,0,1,1
KleeGroup_vertigo,io.vertigo.commons.impl.daemon,0,0,0,0,1,4,1,6
KleeGroup_vertigo,io.vertigo.commons.impl.eventbus,0,0,0,0,0,2,1,3
KleeGroup_vertigo,io.vertigo.commons.impl.script,0,0,0,0,1,1,1,3
KleeGroup_vertigo,io.vertigo.commons.impl.transaction.listener,0,0,0,0,0,2,1,3
KleeGroup_vertigo,io.vertigo.commons.impl.transaction,0,0,0,0,1,3,1,5
KleeGroup_vertigo,io.vertigo.commons.plugins.analytics.log,0,0,0,0,1,1,1,3
KleeGroup_vertigo,io.vertigo.commons.plugins.app.infos.http,0,0,0,0,0,0,1,1
KleeGroup_vertigo,io.vertigo.commons.plugins.app.registry.db,0,0,0,0,1,1,1,3
KleeGroup_vertigo,io.vertigo.commons.plugins.app.registry.redis,0,0,0,0,1,0,1,2
KleeGroup_vertigo,io.vertigo.commons.plugins.app.registry.single,0,0,0,0,0,1,1,2
KleeGroup_vertigo,io.vertigo.commons.plugins.cache.ehcache,0,0,0,0,0,1,1,2
KleeGroup_vertigo,io.vertigo.commons.plugins.cache.memory,0,0,0,0,1,1,1,3
KleeGroup_vertigo,io.vertigo.commons.plugins.cache.redis,0,0,0,0,0,0,1,1
KleeGroup_vertigo,io.vertigo.commons.plugins.script.janino,0,0,0,0,0,1,1,2
KleeGroup_vertigo,io.vertigo.commons.analytics.health.data,1,0,0,0,1,0,1,3
KleeGroup_vertigo,io.vertigo.commons.analytics.metric.data,0,0,0,0,0,1,1,2
KleeGroup_vertigo,io.vertigo.commons.analytics.process.data,0,0,0,0,0,1,1,2
KleeGroup_vertigo,io.vertigo.commons.cache.ehcache,0,0,0,0,0,1,1,2
KleeGroup_vertigo,io.vertigo.commons.cache.memory,0,0,0,0,0,1,1,2
KleeGroup_vertigo,io.vertigo.commons.cache.redis,0,0,0,0,0,1,1,2
KleeGroup_vertigo,io.vertigo.commons.codec.base64,0,0,0,0,0,0,1,1
KleeGroup_vertigo,io.vertigo.commons.codec.compressedSerialization,0,0,0,0,0,0,1,1
KleeGroup_vertigo,io.vertigo.commons.codec.compression,0,0,0,0,0,0,1,1
KleeGroup_vertigo,io.vertigo.commons.codec.crypto,0,0,0,0,1,0,1,2
KleeGroup_vertigo,io.vertigo.commons.codec.csv,0,0,0,0,0,0,1,1
KleeGroup_vertigo,io.vertigo.commons.codec.hash,0,0,0,0,1,0,1,2
KleeGroup_vertigo,io.vertigo.commons.codec.html,0,0,0,0,0,0,1,1
KleeGroup_vertigo,io.vertigo.commons.codec.serialization,0,0,0,0,0,0,1,1
KleeGroup_vertigo,io.vertigo.commons.eventbus.data.aspects,0,0,0,0,0,0,1,1
KleeGroup_vertigo,io.vertigo.commons.eventbus.data,0,0,0,0,1,0,1,2
KleeGroup_vertigo,io.vertigo.commons.node,0,0,0,0,1,2,1,4
KleeGroup_vertigo,io.vertigo.commons.transaction.data,0,0,0,0,1,0,1,2
KleeGroup_vertigo,io.vertigo.app,8,1,0,0,1,38,1,49
KleeGroup_vertigo,io.vertigo.app.config,0,1,0,1,0,40,1,43
KleeGroup_vertigo,io.vertigo.app.config.discovery,0,0,0,0,1,2,1,4
KleeGroup_vertigo,io.vertigo.app.config.xml,0,0,0,0,1,3,1,5
KleeGroup_vertigo,io.vertigo.app.config.yaml,0,0,0,0,1,4,1,6
KleeGroup_vertigo,io.vertigo.core.component,2,0,0,0,1,11,1,15
KleeGroup_vertigo,io.vertigo.core.component.aop,0,0,0,0,1,4,1,6
KleeGroup_vertigo,io.vertigo.core.component.di,6,0,0,0,0,4,1,11
KleeGroup_vertigo,io.vertigo.core.component.loader,11,0,0,0,1,13,1,26
KleeGroup_vertigo,io.vertigo.core.component.proxy,0,0,0,0,0,3,1,4
KleeGroup_vertigo,io.vertigo.core.definition,2,0,0,0,1,15,1,19
KleeGroup_vertigo,io.vertigo.core.definition.loader,3,0,0,0,0,4,1,8
KleeGroup_vertigo,io.vertigo.core.locale,0,0,0,0,1,0,1,2
KleeGroup_vertigo,io.vertigo.core.param,2,0,0,0,1,19,1,23
KleeGroup_vertigo,io.vertigo.core.plugins.component.aop.cglib,0,0,0,0,1,0,1,2
KleeGroup_vertigo,io.vertigo.core.plugins.param.env,0,0,0,0,0,1,1,2
KleeGroup_vertigo,io.vertigo.core.plugins.param.properties,0,0,0,0,0,2,1,3
KleeGroup_vertigo,io.vertigo.core.plugins.param.xml,0,0,0,0,0,1,1,2
KleeGroup_vertigo,io.vertigo.core.plugins.resource.classpath,0,0,0,0,0,0,1,1
KleeGroup_vertigo,io.vertigo.core.plugins.resource.local,0,0,0,0,0,0,1,1
KleeGroup_vertigo,io.vertigo.core.plugins.resource.url,0,0,0,0,0,0,1,1
KleeGroup_vertigo,io.vertigo.core.resource,0,0,0,0,1,2,1,4
KleeGroup_vertigo,io.vertigo.lang,11,1,0,0,1,45,1,59
KleeGroup_vertigo,io.vertigo.util,15,1,0,1,1,3,1,22
KleeGroup_vertigo,io.vertigo,0,0,0,0,0,1,1,2
KleeGroup_vertigo,io.vertigo.app.config.discovery.data,0,0,0,0,1,0,1,2
KleeGroup_vertigo,io.vertigo.app.config.xml2,0,0,0,0,0,1,1,2
KleeGroup_vertigo,io.vertigo.core.component.aop.data.aspects,0,0,0,0,0,0,1,1
KleeGroup_vertigo,io.vertigo.core.component.aop.data.components,0,0,0,0,1,0,1,2
KleeGroup_vertigo,io.vertigo.core.component.aop.data,0,0,0,0,0,0,1,1
KleeGroup_vertigo,io.vertigo.core.component.di.data,1,0,0,0,1,0,1,3
KleeGroup_vertigo,io.vertigo.core.component.proxy.data,0,0,0,0,0,0,1,1
KleeGroup_vertigo,io.vertigo.core.param.multi,0,0,0,0,0,1,1,2
KleeGroup_vertigo,io.vertigo.core.param.properties,0,0,0,0,0,1,1,2
KleeGroup_vertigo,io.vertigo.core.param.xml,0,0,0,0,0,1,1,2
KleeGroup_vertigo,io.vertigo.core.spaces.component,0,0,0,0,1,3,1,5
KleeGroup_vertigo,io.vertigo.core.spaces.component.data,0,0,0,0,1,0,1,2
KleeGroup_vertigo,io.vertigo.core.spaces.definition,0,0,0,0,1,1,1,3
KleeGroup_vertigo,io.vertigo.util.data,0,0,0,0,1,0,1,2
KleeGroup_vertigo,io.vertigo.database.sql.connection,0,0,0,0,0,3,1,4
KleeGroup_vertigo,io.vertigo.database.sql.mapper,0,1,0,0,0,0,1,2
KleeGroup_vertigo,io.vertigo.database.sql,0,1,0,0,0,3,1,5
KleeGroup_vertigo,io.vertigo.database.sql.statement,0,0,0,0,1,2,1,4
KleeGroup_vertigo,io.vertigo.database.sql.vendor,0,0,0,0,1,1,1,3
KleeGroup_vertigo,io.vertigo.database.timeseries,1,1,0,0,1,2,1,6
KleeGroup_vertigo,io.vertigo.database,0,0,0,0,0,0,1,1
KleeGroup_vertigo,io.vertigo.database.impl.sql.mapper,0,0,0,0,0,0,1,1
KleeGroup_vertigo,io.vertigo.database.impl.sql,0,0,0,0,1,1,1,3
KleeGroup_vertigo,io.vertigo.database.impl.sql.vendor.core,0,0,0,0,1,0,1,2
KleeGroup_vertigo,io.vertigo.database.impl.sql.vendor.h2,0,0,0,0,0,0,1,1
KleeGroup_vertigo,io.vertigo.database.impl.sql.vendor.oracle,0,0,0,0,1,0,1,2
KleeGroup_vertigo,io.vertigo.database.impl.sql.vendor.postgresql,0,0,0,0,0,0,1,1
KleeGroup_vertigo,io.vertigo.database.impl.sql.vendor.sqlserver,0,0,0,0,0,0,1,1
KleeGroup_vertigo,io.vertigo.database.impl.timeseries,0,0,0,0,0,2,1,3
KleeGroup_vertigo,io.vertigo.database.plugins.sql.connection,0,0,0,0,0,0,1,1
KleeGroup_vertigo,io.vertigo.database.plugins.sql.connection.c3p0,0,0,0,0,0,0,1,1
KleeGroup_vertigo,io.vertigo.database.plugins.sql.connection.datasource,0,0,0,0,0,0,1,1
KleeGroup_vertigo,io.vertigo.database.plugins.timeseries.fake,0,0,0,0,0,0,1,1
KleeGroup_vertigo,io.vertigo.database.plugins.timeseries.influxdb,1,0,0,0,0,1,1,3
KleeGroup_vertigo,io.vertigo.database.sql.data,0,0,0,0,0,0,1,1
KleeGroup_vertigo,io.vertigo.database.sql.vendor.h2,0,0,0,0,0,0,1,1
KleeGroup_vertigo,io.vertigo.database.sql.vendor.oracle,0,0,0,0,0,0,1,1
KleeGroup_vertigo,io.vertigo.database.sql.vendor.postgresql,0,0,0,0,0,0,1,1
KleeGroup_vertigo,io.vertigo.database.sql.vendor.sqlserver,0,0,0,0,0,0,1,1
KleeGroup_vertigo,io.vertigo.dynamo.collections,5,1,0,0,0,1,1,8
KleeGroup_vertigo,io.vertigo.dynamo.collections.metamodel,1,0,0,0,0,0,1,2
KleeGroup_vertigo,io.vertigo.dynamo.collections.model,1,1,0,0,0,0,1,3
KleeGroup_vertigo,io.vertigo.dynamo.criteria,2,1,0,0,0,0,1,4
KleeGroup_vertigo,io.vertigo.dynamo.domain.metamodel.association,5,0,0,0,0,0,1,6
KleeGroup_vertigo,io.vertigo.dynamo.domain.metamodel,18,1,0,0,0,0,1,20
KleeGroup_vertigo,io.vertigo.dynamo.domain.model,11,1,0,0,1,1,1,15
KleeGroup_vertigo,io.vertigo.dynamo.domain.util,8,1,0,0,0,1,1,11
KleeGroup_vertigo,io.vertigo.dynamo.file,1,1,0,0,0,0,1,3
KleeGroup_vertigo,io.vertigo.dynamo.file.metamodel,0,0,0,0,0,0,1,1
KleeGroup_vertigo,io.vertigo.dynamo.file.model,0,1,0,0,0,0,1,2
KleeGroup_vertigo,io.vertigo.dynamo.file.util,0,0,0,0,0,0,1,1
KleeGroup_vertigo,io.vertigo.dynamo.kvstore,0,0,0,0,0,0,1,1
KleeGroup_vertigo,io.vertigo.dynamo.search.metamodel,0,0,0,0,0,0,1,1
KleeGroup_vertigo,io.vertigo.dynamo.search.model,0,0,0,0,0,0,1,1
KleeGroup_vertigo,io.vertigo.dynamo.search,1,1,0,0,0,0,1,3
KleeGroup_vertigo,io.vertigo.dynamo.store.datastore,3,0,0,0,1,0,1,5
KleeGroup_vertigo,io.vertigo.dynamo.store.filestore,0,0,0,0,0,0,1,1
KleeGroup_vertigo,io.vertigo.dynamo.store,21,1,0,0,0,0,1,23
KleeGroup_vertigo,io.vertigo.dynamo.task.metamodel,3,0,0,0,0,0,1,4
KleeGroup_vertigo,io.vertigo.dynamo.task.model,1,1,0,0,0,0,1,3
KleeGroup_vertigo,io.vertigo.dynamo.task,1,0,0,0,0,0,1,2
KleeGroup_vertigo,io.vertigo.dynamo,1,1,0,0,0,0,1,3
KleeGroup_vertigo,io.vertigo.dynamo.impl.collections,1,0,0,0,0,0,1,2
KleeGroup_vertigo,io.vertigo.dynamo.impl.collections.facet.model,0,0,0,0,0,0,1,1
KleeGroup_vertigo,io.vertigo.dynamo.impl.collections.functions.filter,0,0,0,0,0,0,1,1
KleeGroup_vertigo,io.vertigo.dynamo.impl.collections.functions.index,1,1,0,0,0,0,1,3
KleeGroup_vertigo,io.vertigo.dynamo.impl.file,0,0,0,0,0,0,1,1
KleeGroup_vertigo,io.vertigo.dynamo.impl.file.model,0,0,0,0,0,0,1,1
KleeGroup_vertigo,io.vertigo.dynamo.impl.kvstore,0,0,0,0,0,0,1,1
KleeGroup_vertigo,io.vertigo.dynamo.impl.search,0,0,0,0,0,2,1,3
KleeGroup_vertigo,io.vertigo.dynamo.impl.store.datastore,16,0,0,0,1,0,1,18
KleeGroup_vertigo,io.vertigo.dynamo.impl.store.datastore.cache,22,1,0,0,0,1,1,25
KleeGroup_vertigo,io.vertigo.dynamo.impl.store.datastore.logical,4,1,0,0,0,0,1,6
KleeGroup_vertigo,io.vertigo.dynamo.impl.store.filestore,0,0,0,0,0,0,1,1
KleeGroup_vertigo,io.vertigo.dynamo.impl.store,3,1,0,0,0,0,1,5
KleeGroup_vertigo,io.vertigo.dynamo.impl.store.util,0,0,0,0,0,0,1,1
KleeGroup_vertigo,io.vertigo.dynamo.impl.task.proxy,0,0,0,0,0,0,1,1
KleeGroup_vertigo,io.vertigo.dynamo.impl.task,0,0,0,0,0,0,1,1
KleeGroup_vertigo,io.vertigo.dynamo.plugins.collections.lucene,0,0,0,0,0,0,1,1
KleeGroup_vertigo,io.vertigo.dynamo.plugins.environment.dsl.dynamic,0,0,0,0,0,0,1,1
KleeGroup_vertigo,io.vertigo.dynamo.plugins.environment.dsl.entity,0,0,0,0,1,0,1,2
KleeGroup_vertigo,io.vertigo.dynamo.plugins.environment,0,1,0,0,0,0,1,2
KleeGroup_vertigo,io.vertigo.dynamo.plugins.environment.loaders.eaxmi.core,0,0,0,0,0,0,1,1
KleeGroup_vertigo,io.vertigo.dynamo.plugins.environment.loaders.java,0,0,0,0,0,0,1,1
KleeGroup_vertigo,io.vertigo.dynamo.plugins.environment.loaders.kpr.definition,0,0,0,0,0,0,1,1
KleeGroup_vertigo,io.vertigo.dynamo.plugins.environment.loaders.kpr,0,0,0,0,0,0,1,1
KleeGroup_vertigo,io.vertigo.dynamo.plugins.environment.loaders.kpr.rules,0,0,0,0,1,0,1,2
KleeGroup_vertigo,io.vertigo.dynamo.plugins.environment.loaders,0,0,0,0,0,0,1,1
KleeGroup_vertigo,io.vertigo.dynamo.plugins.environment.loaders.poweramc.core,0,0,0,0,0,0,1,1
KleeGroup_vertigo,io.vertigo.dynamo.plugins.environment.loaders.xml,0,1,0,0,1,0,1,3
KleeGroup_vertigo,io.vertigo.dynamo.plugins.environment.registries.domain,0,0,0,0,0,0,1,1
KleeGroup_vertigo,io.vertigo.dynamo.plugins.environment.registries,0,0,0,0,0,0,1,1
KleeGroup_vertigo,io.vertigo.dynamo.plugins.environment.registries.file,0,0,0,0,0,0,1,1
KleeGroup_vertigo,io.vertigo.dynamo.plugins.environment.registries.search,0,0,0,0,0,0,1,1
KleeGroup_vertigo,io.vertigo.dynamo.plugins.environment.registries.task,0,0,0,0,0,0,1,1
KleeGroup_vertigo,io.vertigo.dynamo.plugins.kvstore.berkeley,0,0,0,0,0,0,1,1
KleeGroup_vertigo,io.vertigo.dynamo.plugins.kvstore.delayedmemory,0,0,0,0,0,0,1,1
KleeGroup_vertigo,io.vertigo.dynamo.plugins.search.elasticsearch,0,0,0,0,0,1,1,2
KleeGroup_vertigo,io.vertigo.dynamo.plugins.search.elasticsearch.commonshttp,0,0,0,0,0,0,1,1
KleeGroup_vertigo,io.vertigo.dynamo.plugins.search.elasticsearch.embedded,0,0,0,0,0,0,1,1
KleeGroup_vertigo,io.vertigo.dynamo.plugins.search.elasticsearch.transport,0,0,0,0,0,0,1,1
KleeGroup_vertigo,io.vertigo.dynamo.plugins.store.datastore,0,0,0,0,0,0,1,1
KleeGroup_vertigo,io.vertigo.dynamo.plugins.store.datastore.sql,0,0,0,0,0,2,1,3
KleeGroup_vertigo,io.vertigo.dynamo.plugins.store.filestore.db,0,0,0,0,0,0,1,1
KleeGroup_vertigo,io.vertigo.dynamo.plugins.store.filestore.fs,0,0,0,0,1,0,1,2
KleeGroup_vertigo,io.vertigo.dynamox.domain.constraint,0,0,0,0,1,0,1,2
KleeGroup_vertigo,io.vertigo.dynamox.domain.formatter,0,0,0,0,0,0,1,1
KleeGroup_vertigo,io.vertigo.dynamox.metric.domain,0,0,0,0,0,2,1,3
KleeGroup_vertigo,io.vertigo.dynamox.metric.task,0,0,0,0,0,1,1,2
KleeGroup_vertigo,io.vertigo.dynamox.search,0,0,0,0,0,0,1,1
KleeGroup_vertigo,io.vertigo.dynamox.search.dsl.model,0,0,0,0,1,0,1,2
KleeGroup_vertigo,io.vertigo.dynamox.search.dsl.rules,0,0,0,0,0,0,1,1
KleeGroup_vertigo,io.vertigo.dynamox.task,2,1,0,0,0,0,1,4
KleeGroup_vertigo,io.vertigo.dynamox.task.sqlserver,0,0,0,0,0,0,1,1
KleeGroup_vertigo,io.vertigo.dynamo.collections.data.domain,0,0,0,0,0,0,1,1
KleeGroup_vertigo,io.vertigo.dynamo.collections.data,0,0,0,0,0,0,1,1
KleeGroup_vertigo,io.vertigo.dynamo.criteria.data,0,0,0,0,0,0,1,1
KleeGroup_vertigo,io.vertigo.dynamo.criteria.data.movies,0,0,0,0,0,0,1,1
KleeGroup_vertigo,io.vertigo.dynamo.criteria.predicate,0,0,0,0,0,0,1,1
KleeGroup_vertigo,io.vertigo.dynamo.criteria.sql,0,0,0,0,0,0,1,1
KleeGroup_vertigo,io.vertigo.dynamo.domain.constraint,0,0,0,0,0,0,1,1
KleeGroup_vertigo,io.vertigo.dynamo.domain.data.domain,3,0,0,0,0,0,1,4
KleeGroup_vertigo,io.vertigo.dynamo.domain.data,0,0,0,0,0,0,1,1
KleeGroup_vertigo,io.vertigo.dynamo.domain,0,0,0,0,0,0,1,1
KleeGroup_vertigo,io.vertigo.dynamo.domain.formatter,0,0,0,0,0,0,1,1
KleeGroup_vertigo,io.vertigo.dynamo.environment.eaxmi,0,0,0,0,0,0,1,1
KleeGroup_vertigo,io.vertigo.dynamo.environment.java.data.domain,0,0,0,0,1,0,1,2
KleeGroup_vertigo,io.vertigo.dynamo.environment.java.data,0,0,0,0,0,0,1,1
KleeGroup_vertigo,io.vertigo.dynamo.environment.java,0,0,0,0,0,0,1,1
KleeGroup_vertigo,io.vertigo.dynamo.environment.ksp,0,0,0,0,0,0,1,1
KleeGroup_vertigo,io.vertigo.dynamo.environment.loader,0,0,0,0,0,0,1,1
KleeGroup_vertigo,io.vertigo.dynamo.environment.multi.data.domain,0,0,0,0,0,0,1,1
KleeGroup_vertigo,io.vertigo.dynamo.environment.multi.data,0,0,0,0,0,0,1,1
KleeGroup_vertigo,io.vertigo.dynamo.environment.multi,0,0,0,0,0,1,1,2
KleeGroup_vertigo,io.vertigo.dynamo.environment.oom,0,0,0,0,0,0,1,1
KleeGroup_vertigo,io.vertigo.dynamo.environment.plugins.loaders.kpr.definition,0,0,0,0,1,0,1,2
KleeGroup_vertigo,io.vertigo.dynamo.kvstore.berkeley,0,0,0,0,0,0,1,1
KleeGroup_vertigo,io.vertigo.dynamo.kvstore.data,0,0,0,0,0,0,1,1
KleeGroup_vertigo,io.vertigo.dynamo.kvstore.delayedmemory,0,0,0,0,0,0,1,1
KleeGroup_vertigo,io.vertigo.dynamo.search.data.domain,1,1,0,0,0,0,1,3
KleeGroup_vertigo,io.vertigo.dynamo.search.data,0,0,0,0,0,0,1,1
KleeGroup_vertigo,io.vertigo.dynamo.search.dynamic,0,0,0,0,0,0,1,1
KleeGroup_vertigo,io.vertigo.dynamo.search.multiindex,0,0,0,0,0,0,1,1
KleeGroup_vertigo,io.vertigo.dynamo.search.standard,0,0,0,0,0,0,1,1
KleeGroup_vertigo,io.vertigo.dynamo.search.withstore,0,0,0,0,0,1,1,2
KleeGroup_vertigo,io.vertigo.dynamo.store.cache,0,0,0,0,0,0,1,1
KleeGroup_vertigo,io.vertigo.dynamo.store.data.domain.car,2,0,0,0,0,0,1,3
KleeGroup_vertigo,io.vertigo.dynamo.store.data.domain.famille,0,0,0,0,0,0,1,1
KleeGroup_vertigo,io.vertigo.dynamo.store.data.domain.fileinfo,0,0,0,0,0,0,1,1
KleeGroup_vertigo,io.vertigo.dynamo.store.data,0,0,0,0,0,0,1,1
KleeGroup_vertigo,io.vertigo.dynamo.store.data.fileinfo,0,0,0,0,0,0,1,1
KleeGroup_vertigo,io.vertigo.dynamo.store.datastore.multistore,0,0,0,0,0,0,1,1
KleeGroup_vertigo,io.vertigo.dynamo.store.datastore.sql,0,1,0,0,0,0,1,2
KleeGroup_vertigo,io.vertigo.dynamo.store.datastore.sql.vendor.h2,0,0,0,0,0,0,1,1
KleeGroup_vertigo,io.vertigo.dynamo.store.datastore.sql.vendor.oracle,0,0,0,0,0,0,1,1
KleeGroup_vertigo,io.vertigo.dynamo.task.data.domain,0,0,0,0,0,0,1,1
KleeGroup_vertigo,io.vertigo.dynamo.task.data,0,0,0,0,0,0,1,1
KleeGroup_vertigo,io.vertigo.dynamo.task.x,0,0,0,0,0,1,1,2
KleeGroup_vertigo,io.vertigo.dynamo.plugins.collections.lucene_6_6,0,0,0,0,0,0,1,1
KleeGroup_vertigo,io.vertigo.dynamo.plugins.search.elasticsearch_5_6,0,0,0,0,0,1,1,2
KleeGroup_vertigo,io.vertigo.dynamo.plugins.search.elasticsearch_5_6.commonshttp,0,0,0,0,0,0,1,1
KleeGroup_vertigo,io.vertigo.dynamo.plugins.search.elasticsearch_5_6.embedded,0,0,0,0,0,0,1,1
KleeGroup_vertigo,io.vertigo.dynamo.plugins.search.elasticsearch_5_6.transport,0,0,0,0,0,0,1,1
KleeGroup_vertigo,io.vertigo.dynamo.search_5_6,0,0,0,0,0,0,1,1
KleeGroup_vertigo,io.vertigo.dynamo.search_5_6.dynamic,0,0,0,0,0,0,1,1
KleeGroup_vertigo,io.vertigo.dynamo.search_5_6.multiindex,0,0,0,0,0,0,1,1
KleeGroup_vertigo,io.vertigo.dynamo.search_5_6.standard,0,0,0,0,0,0,1,1
KleeGroup_vertigo,io.vertigo.dynamo.search_5_6.withstore,0,0,0,0,0,1,1,2
KleeGroup_vertigo,io.vertigo.studio.impl.masterdata,0,0,0,0,0,0,1,1
KleeGroup_vertigo,io.vertigo.studio.impl.mda,0,0,0,0,0,0,1,1
KleeGroup_vertigo,io.vertigo.studio.masterdata,0,0,0,0,0,0,1,1
KleeGroup_vertigo,io.vertigo.studio.mda,0,1,0,0,1,1,1,4
KleeGroup_vertigo,io.vertigo.studio.plugins.masterdata.json,0,0,0,0,0,0,1,1
KleeGroup_vertigo,io.vertigo.studio.plugins.mda.authorization,0,0,0,0,0,1,1,2
KleeGroup_vertigo,io.vertigo.studio.plugins.mda.authorization.model,0,0,0,0,0,0,1,1
KleeGroup_vertigo,io.vertigo.studio.plugins.mda.domain.java,0,0,0,0,0,0,1,1
KleeGroup_vertigo,io.vertigo.studio.plugins.mda.domain.java.model,0,0,0,0,0,0,1,1
KleeGroup_vertigo,io.vertigo.studio.plugins.mda.domain.java.model.masterdata,0,0,0,0,0,0,1,1
KleeGroup_vertigo,io.vertigo.studio.plugins.mda.domain.js,0,0,0,0,0,0,1,1
KleeGroup_vertigo,io.vertigo.studio.plugins.mda.domain.js.model,0,0,0,0,0,0,1,1
KleeGroup_vertigo,io.vertigo.studio.plugins.mda.domain.sql.model,0,0,0,0,1,0,1,2
KleeGroup_vertigo,io.vertigo.studio.plugins.mda.domain.sql,0,0,0,0,0,0,1,1
KleeGroup_vertigo,io.vertigo.studio.plugins.mda.domain.ts.model,0,0,0,0,0,0,1,1
KleeGroup_vertigo,io.vertigo.studio.plugins.mda.domain.ts,0,0,0,0,0,0,1,1
KleeGroup_vertigo,io.vertigo.studio.plugins.mda.file,0,0,0,0,0,0,1,1
KleeGroup_vertigo,io.vertigo.studio.plugins.mda.file.model,0,0,0,0,0,0,1,1
KleeGroup_vertigo,io.vertigo.studio.plugins.mda,0,1,0,0,0,0,1,2
KleeGroup_vertigo,io.vertigo.studio.plugins.mda.search.model,0,0,0,0,0,0,1,1
KleeGroup_vertigo,io.vertigo.studio.plugins.mda.search,0,0,0,0,0,0,1,1
KleeGroup_vertigo,io.vertigo.studio.plugins.mda.task.model,0,0,0,0,0,0,1,1
KleeGroup_vertigo,io.vertigo.studio.plugins.mda.task,0,0,0,0,0,1,1,2
KleeGroup_vertigo,io.vertigo.studio.plugins.mda.util,0,1,0,0,0,1,1,3
KleeGroup_vertigo,io.vertigo.studio.plugins.mda.webservice,0,0,0,0,0,0,1,1
KleeGroup_vertigo,io.vertigo.studio.plugins.mda.webservice.model,0,0,0,0,0,0,1,1
KleeGroup_vertigo,io.vertigo.studio,0,0,0,0,0,0,1,1
KleeGroup_vertigo,io.vertigo.studio.tools,0,1,0,0,0,0,1,2
KleeGroup_vertigo,io.vertigo.studio.ui.model,0,0,0,0,0,0,1,1
KleeGroup_vertigo,io.vertigo.studio.ui,0,0,0,0,0,0,1,1
KleeGroup_vertigo,io.vertigo.studio.data.domain,0,0,0,0,0,0,1,1
KleeGroup_vertigo,io.vertigo.studio.data,0,0,0,0,0,0,1,1
KleeGroup_vertigo,io.vertigo.studio.data.webservices,0,0,0,0,0,0,1,1
KleeGroup_vertigo,io.vertigo.vega.token,0,0,0,0,0,0,1,1
KleeGroup_vertigo,io.vertigo.vega.webservice.exception,0,0,0,0,0,0,1,1
KleeGroup_vertigo,io.vertigo.vega.webservice.metamodel,0,1,0,0,0,0,1,2
KleeGroup_vertigo,io.vertigo.vega.webservice.model,0,1,0,0,0,0,1,2
KleeGroup_vertigo,io.vertigo.vega.webservice.validation,0,1,0,0,0,0,1,2
KleeGroup_vertigo,io.vertigo.vega.webservice,1,1,0,0,1,0,1,4
KleeGroup_vertigo,io.vertigo.vega.engines.webservice.cmd,0,0,0,0,0,1,1,2
KleeGroup_vertigo,io.vertigo.vega.engines.webservice.json,1,0,0,1,0,0,1,3
KleeGroup_vertigo,io.vertigo.vega.impl.servlet.filter,0,0,0,0,1,0,1,2
KleeGroup_vertigo,io.vertigo.vega.impl.token,0,0,0,0,0,0,1,1
KleeGroup_vertigo,io.vertigo.vega.impl.webservice.catalog,0,0,0,0,1,1,1,3
KleeGroup_vertigo,io.vertigo.vega.impl.webservice.filter,0,0,0,0,0,0,1,1
KleeGroup_vertigo,io.vertigo.vega.impl.webservice.healthcheck,0,0,0,0,0,0,1,1
KleeGroup_vertigo,io.vertigo.vega.impl.webservice.servlet,0,0,0,0,0,0,1,1
KleeGroup_vertigo,io.vertigo.vega.impl.webservice,1,0,0,0,0,0,1,2
KleeGroup_vertigo,io.vertigo.vega.plugins.webservice.handler,3,1,0,0,0,0,1,5
KleeGroup_vertigo,io.vertigo.vega.plugins.webservice.handler.converter,1,0,0,0,0,0,1,2
KleeGroup_vertigo,io.vertigo.vega.plugins.webservice.handler.reader,1,0,0,0,0,0,1,2
KleeGroup_vertigo,io.vertigo.vega.plugins.webservice.scanner.annotations,0,0,0,0,0,0,1,1
KleeGroup_vertigo,io.vertigo.vega.plugins.webservice.servlet,0,0,0,0,0,0,1,1
KleeGroup_vertigo,io.vertigo.vega.plugins.webservice.webserver.sparkjava,0,0,0,0,1,0,1,2
KleeGroup_vertigo,io.vertigo.vega,0,0,0,0,0,0,1,1
KleeGroup_vertigo,io.vertigo.vega.webservice.data.domain,0,0,0,0,1,0,1,2
KleeGroup_vertigo,io.vertigo.vega.webservice.data,1,1,0,0,0,0,1,3
KleeGroup_vertigo,io.vertigo.vega.webservice.data.user,0,0,0,0,0,0,1,1
KleeGroup_vertigo,io.vertigo.vega.webservice.data.ws,1,0,0,0,1,1,1,4
knightliao_disconf,com.baidu.disconf.client.addons.properties,0,1,0,0,1,0,0,2
knightliao_disconf,com.baidu.disconf.client.common.constants,0,0,0,0,0,0,0,0
knightliao_disconf,com.baidu.disconf.client.common.model,1,1,0,0,1,0,0,3
knightliao_disconf,com.baidu.disconf.client.common.update,0,1,0,0,0,0,0,1
knightliao_disconf,com.baidu.disconf.client.config,2,1,0,0,0,0,0,3
knightliao_disconf,com.baidu.disconf.client.config.inner,2,0,0,0,0,0,0,2
knightliao_disconf,com.baidu.disconf.client.core,0,0,0,0,0,0,0,0
knightliao_disconf,com.baidu.disconf.client.core.filetype,0,0,0,0,0,0,0,0
knightliao_disconf,com.baidu.disconf.client.core.filetype.impl,0,0,0,0,0,0,0,0
knightliao_disconf,com.baidu.disconf.client.core.impl,0,0,0,0,0,0,0,0
knightliao_disconf,com.baidu.disconf.client.core.processor,1,1,0,0,0,0,0,2
knightliao_disconf,com.baidu.disconf.client.core.processor.impl,0,0,0,0,0,0,0,0
knightliao_disconf,com.baidu.disconf.client,0,0,0,0,0,0,0,0
knightliao_disconf,com.baidu.disconf.client.fetcher,0,1,0,0,0,0,0,1
knightliao_disconf,com.baidu.disconf.client.fetcher.impl,0,0,0,0,0,0,0,0
knightliao_disconf,com.baidu.disconf.client.scan.impl,0,0,0,0,0,0,0,0
knightliao_disconf,com.baidu.disconf.client.scan.inner.common,0,0,0,0,0,0,0,0
knightliao_disconf,com.baidu.disconf.client.scan.inner.dynamic.model,0,0,0,0,0,0,0,0
knightliao_disconf,com.baidu.disconf.client.scan.inner.dynamic,0,0,0,0,0,0,0,0
knightliao_disconf,com.baidu.disconf.client.scan.inner.statically.impl,0,0,0,0,0,0,0,0
knightliao_disconf,com.baidu.disconf.client.scan.inner.statically.model,0,0,0,0,0,0,0,0
knightliao_disconf,com.baidu.disconf.client.scan.inner.statically,0,0,0,0,0,0,0,0
knightliao_disconf,com.baidu.disconf.client.scan.inner.statically.strategy.impl,0,0,0,0,0,0,0,0
knightliao_disconf,com.baidu.disconf.client.scan.inner.statically.strategy,0,0,0,0,0,0,0,0
knightliao_disconf,com.baidu.disconf.client.scan,0,0,0,0,0,0,0,0
knightliao_disconf,com.baidu.disconf.client.store.aspect,0,0,0,0,0,0,0,0
knightliao_disconf,com.baidu.disconf.client.store,0,0,0,0,0,0,0,0
knightliao_disconf,com.baidu.disconf.client.store.inner,0,0,0,0,0,0,0,0
knightliao_disconf,com.baidu.disconf.client.store.processor.impl,0,0,0,0,0,0,0,0
knightliao_disconf,com.baidu.disconf.client.store.processor.model,0,0,0,0,0,0,0,0
knightliao_disconf,com.baidu.disconf.client.support,0,0,0,0,0,0,0,0
knightliao_disconf,com.baidu.disconf.client.support.registry.impl,0,0,0,0,0,0,0,0
knightliao_disconf,com.baidu.disconf.client.support.registry,0,0,0,0,0,0,0,0
knightliao_disconf,com.baidu.disconf.client.support.utils,0,0,0,0,1,0,0,1
knightliao_disconf,com.baidu.disconf.client.usertools,0,0,0,0,0,0,0,0
knightliao_disconf,com.baidu.disconf.client.usertools.impl,0,0,0,0,0,0,0,0
knightliao_disconf,com.baidu.disconf.client.watch.impl,0,0,0,0,0,0,0,0
knightliao_disconf,com.baidu.disconf.client.watch.inner,0,0,0,0,0,0,0,0
knightliao_disconf,com.baidu.disconf.client.watch,1,0,0,0,0,0,0,1
knightliao_disconf,com.baidu.disconf.core.common.constants,0,0,0,0,0,0,0,0
knightliao_disconf,com.baidu.disconf.core.common.json,0,0,0,0,0,0,0,0
knightliao_disconf,com.baidu.disconf.core.common.path,0,0,0,0,0,0,0,0
knightliao_disconf,com.baidu.disconf.core.common.restful.core,0,0,0,0,0,1,0,1
knightliao_disconf,com.baidu.disconf.core.common.restful.impl,0,0,0,0,0,1,0,1
knightliao_disconf,com.baidu.disconf.core.common.restful,0,1,0,0,0,0,0,1
knightliao_disconf,com.baidu.disconf.core.common.restful.retry.impl,0,0,0,0,0,0,0,0
knightliao_disconf,com.baidu.disconf.core.common.restful.retry,0,0,0,0,0,1,0,1
knightliao_disconf,com.baidu.disconf.core.common.restful.type,0,0,0,0,0,0,0,0
knightliao_disconf,com.baidu.disconf.core.common.utils,0,0,0,0,1,0,0,1
knightliao_disconf,com.baidu.disconf.core.common.utils.http,0,0,0,0,0,0,0,0
knightliao_disconf,com.baidu.disconf.core.common.utils.http.impl,0,0,0,0,0,0,0,0
knightliao_disconf,com.baidu.disconf.core.common.zookeeper.inner,0,0,0,0,0,0,0,0
knightliao_disconf,com.baidu.disconf.core.common.zookeeper,0,0,0,0,0,0,0,0
knightliao_disconf,org.apache.zookeeper.recipes.lock,0,0,0,0,1,0,0,1
knightliao_disconf,com.baidu.disconf.web.common.comparator,0,0,0,0,0,0,0,0
knightliao_disconf,com.baidu.disconf.web.common,0,0,0,0,0,0,0,0
knightliao_disconf,com.baidu.disconf.web.common.email,0,0,0,0,0,0,0,0
knightliao_disconf,com.baidu.disconf.web.config,0,0,0,0,0,0,0,0
knightliao_disconf,com.baidu.disconf.web.innerapi.zookeeper.impl,0,0,0,0,0,0,0,0
knightliao_disconf,com.baidu.disconf.web.innerapi.zookeeper,0,0,0,0,0,0,0,0
knightliao_disconf,com.baidu.disconf.web.service.app.bo,0,0,0,0,0,0,0,0
knightliao_disconf,com.baidu.disconf.web.service.app.dao,0,0,0,0,0,0,0,0
knightliao_disconf,com.baidu.disconf.web.service.app.dao.impl,0,0,0,0,0,0,0,0
knightliao_disconf,com.baidu.disconf.web.service.app.form,0,0,0,0,0,0,0,0
knightliao_disconf,com.baidu.disconf.web.service.app.service,0,0,0,0,0,0,0,0
knightliao_disconf,com.baidu.disconf.web.service.app.service.impl,0,0,0,0,0,0,0,0
knightliao_disconf,com.baidu.disconf.web.service.app.vo,0,0,0,0,0,0,0,0
knightliao_disconf,com.baidu.disconf.web.service.config.bo,0,0,0,0,0,0,0,0
knightliao_disconf,com.baidu.disconf.web.service.config.dao,0,0,0,0,0,0,0,0
knightliao_disconf,com.baidu.disconf.web.service.config.dao.impl,0,0,0,0,0,0,0,0
knightliao_disconf,com.baidu.disconf.web.service.config.form,0,0,0,0,0,0,0,0
knightliao_disconf,com.baidu.disconf.web.service.config.service,0,0,0,0,0,0,0,0
knightliao_disconf,com.baidu.disconf.web.service.config.service.impl,0,0,0,0,0,0,0,0
knightliao_disconf,com.baidu.disconf.web.service.config.utils,0,0,0,0,0,0,0,0
knightliao_disconf,com.baidu.disconf.web.service.config.vo,0,0,0,0,0,0,0,0
knightliao_disconf,com.baidu.disconf.web.service.env.bo,0,0,0,0,0,0,0,0
knightliao_disconf,com.baidu.disconf.web.service.env.dao,0,0,0,0,0,0,0,0
knightliao_disconf,com.baidu.disconf.web.service.env.dao.impl,0,0,0,0,0,0,0,0
knightliao_disconf,com.baidu.disconf.web.service.env.service,0,0,0,0,0,0,0,0
knightliao_disconf,com.baidu.disconf.web.service.env.service.impl,0,0,0,0,0,0,0,0
knightliao_disconf,com.baidu.disconf.web.service.env.vo,0,0,0,0,0,0,0,0
knightliao_disconf,com.baidu.disconf.web.service.role.bo,0,0,0,0,0,0,0,0
knightliao_disconf,com.baidu.disconf.web.service.role.constant,0,0,0,0,0,0,0,0
knightliao_disconf,com.baidu.disconf.web.service.role.dao.impl,0,0,0,0,0,0,0,0
knightliao_disconf,com.baidu.disconf.web.service.role.dao,0,0,0,0,0,0,0,0
knightliao_disconf,com.baidu.disconf.web.service.role.service.impl,0,0,0,0,0,0,0,0
knightliao_disconf,com.baidu.disconf.web.service.role.service,0,0,0,0,0,0,0,0
knightliao_disconf,com.baidu.disconf.web.service.roleres.bo,0,0,0,0,0,0,0,0
knightliao_disconf,com.baidu.disconf.web.service.roleres.constant,0,0,0,0,0,0,0,0
knightliao_disconf,com.baidu.disconf.web.service.roleres.dao.impl,0,0,0,0,0,0,0,0
knightliao_disconf,com.baidu.disconf.web.service.roleres.dao,0,0,0,0,0,0,0,0
knightliao_disconf,com.baidu.disconf.web.service.roleres.service.impl,0,0,0,0,0,0,0,0
knightliao_disconf,com.baidu.disconf.web.service.roleres.service,0,0,0,0,0,0,0,0
knightliao_disconf,com.baidu.disconf.web.service.sign.dao.impl,0,0,0,0,0,0,0,0
knightliao_disconf,com.baidu.disconf.web.service.sign.dao,0,0,0,0,0,0,0,0
knightliao_disconf,com.baidu.disconf.web.service.sign.form,0,0,0,0,0,0,0,0
knightliao_disconf,com.baidu.disconf.web.service.sign.service.impl,0,0,0,0,0,0,0,0
knightliao_disconf,com.baidu.disconf.web.service.sign.service,0,0,0,0,0,0,0,0
knightliao_disconf,com.baidu.disconf.web.service.sign.utils,0,0,0,0,0,0,0,0
knightliao_disconf,com.baidu.disconf.web.service.user.bo,0,0,0,0,0,0,0,0
knightliao_disconf,com.baidu.disconf.web.service.user.constant,0,0,0,0,0,0,0,0
knightliao_disconf,com.baidu.disconf.web.service.user.dao.impl,0,0,0,0,0,0,0,0
knightliao_disconf,com.baidu.disconf.web.service.user.dao,0,0,0,0,0,0,0,0
knightliao_disconf,com.baidu.disconf.web.service.user.dto,0,0,0,0,0,0,0,0
knightliao_disconf,com.baidu.disconf.web.service.user.facade.impl,0,0,0,0,0,0,0,0
knightliao_disconf,com.baidu.disconf.web.service.user.facade,0,0,0,0,0,0,0,0
knightliao_disconf,com.baidu.disconf.web.service.user.form,0,0,0,0,0,0,0,0
knightliao_disconf,com.baidu.disconf.web.service.user.service,0,1,0,0,0,0,0,1
knightliao_disconf,com.baidu.disconf.web.service.user.service.impl,0,0,0,0,0,0,0,0
knightliao_disconf,com.baidu.disconf.web.service.user.vo,0,0,0,0,0,0,0,0
knightliao_disconf,com.baidu.disconf.web.service.zookeeper.config,0,0,0,0,0,0,0,0
knightliao_disconf,com.baidu.disconf.web.service.zookeeper.dto,0,0,0,0,0,0,0,0
knightliao_disconf,com.baidu.disconf.web.service.zookeeper.form,0,0,0,0,0,0,0,0
knightliao_disconf,com.baidu.disconf.web.service.zookeeper.service.impl,0,0,0,0,0,0,0,0
knightliao_disconf,com.baidu.disconf.web.service.zookeeper.service,0,0,0,0,0,0,0,0
knightliao_disconf,com.baidu.disconf.web.tasks,0,0,0,0,0,0,0,0
knightliao_disconf,com.baidu.disconf.web.tasks.impl,0,0,0,0,0,0,0,0
knightliao_disconf,com.baidu.disconf.web.tools,0,0,0,0,0,0,0,0
knightliao_disconf,com.baidu.disconf.web.utils,0,0,0,0,0,0,0,0
knightliao_disconf,com.baidu.disconf.web.utils.email,0,0,0,0,0,0,0,0
knightliao_disconf,com.baidu.disconf.web.web.app.controller,0,0,0,0,0,0,0,0
knightliao_disconf,com.baidu.disconf.web.web.app.validator,0,0,0,0,0,0,0,0
knightliao_disconf,com.baidu.disconf.web.web.auth.constant,0,0,0,0,0,0,0,0
knightliao_disconf,com.baidu.disconf.web.web.auth.login.impl,0,0,0,0,0,0,0,0
knightliao_disconf,com.baidu.disconf.web.web.auth.login,0,0,0,0,0,0,0,0
knightliao_disconf,com.baidu.disconf.web.web.auth,0,0,0,0,0,0,0,0
knightliao_disconf,com.baidu.disconf.web.web.auth.validator,0,0,0,0,0,0,0,0
knightliao_disconf,com.baidu.disconf.web.web.config.controller,0,0,0,0,0,0,0,0
knightliao_disconf,com.baidu.disconf.web.web.config.dto,0,0,0,0,0,0,0,0
knightliao_disconf,com.baidu.disconf.web.web.config.validator,0,0,0,0,0,0,0,0
knightliao_disconf,com.baidu.disconf.web.web.env.controller,0,0,0,0,0,0,0,0
knightliao_disconf,com.baidu.disconf.web.web.zookeeper.controller,0,0,0,0,0,0,0,0
knightliao_disconf,com.baidu.disconf.web.web.zookeeper.validator,0,0,0,0,0,0,0,0
knightliao_disconf,com.baidu.dsp.common.constant,0,0,0,0,0,0,0,0
knightliao_disconf,com.baidu.dsp.common.constraint.validation,0,0,0,0,1,0,0,1
knightliao_disconf,com.baidu.dsp.common.context,0,0,0,0,0,0,0,0
knightliao_disconf,com.baidu.dsp.common.context.impl,0,0,0,0,0,0,0,0
knightliao_disconf,com.baidu.dsp.common.controller,0,0,0,0,0,0,0,0
knightliao_disconf,com.baidu.dsp.common.dao,0,0,0,0,0,0,0,0
knightliao_disconf,com.baidu.dsp.common.exception,0,0,0,0,1,0,0,1
knightliao_disconf,com.baidu.dsp.common.exception.base,0,0,0,0,0,0,0,0
knightliao_disconf,com.baidu.dsp.common.form,0,0,0,0,0,0,0,0
knightliao_disconf,com.baidu.dsp.common.handler,0,0,0,0,0,0,0,0
knightliao_disconf,com.baidu.dsp.common.interceptor.login,0,0,0,0,0,0,0,0
knightliao_disconf,com.baidu.dsp.common.interceptor.session,0,0,0,0,0,0,0,0
knightliao_disconf,com.baidu.dsp.common.interceptor,0,0,0,0,0,0,0,0
knightliao_disconf,com.baidu.dsp.common.listener,0,0,0,0,0,0,0,0
knightliao_disconf,com.baidu.dsp.common.utils,0,0,0,0,1,0,0,1
knightliao_disconf,com.baidu.dsp.common.utils.email,0,0,0,0,0,0,0,0
knightliao_disconf,com.baidu.dsp.common.vo,0,0,0,0,0,0,0,0
knightliao_disconf,com.baidu.ub.common.commons,0,0,0,0,0,0,0,0
knightliao_disconf,com.baidu.ub.common.db,0,0,0,0,0,0,0,0
knightliao_disconf,com.baidu.ub.common.dbmanage.datasource,1,0,0,0,0,0,0,1
knightliao_disconf,com.baidu.ub.common.dbmanage.monitor,0,0,0,0,0,0,0,0
knightliao_disconf,com.baidu.ub.common.dbmanage.router,1,0,0,0,0,0,0,1
knightliao_disconf,com.baidu.ub.common.dbmanage.rule,0,0,0,0,0,0,0,0
knightliao_disconf,com.baidu.unbiz.common.genericdao.bo,0,0,0,0,0,0,0,0
knightliao_disconf,com.baidu.unbiz.common.genericdao.dao,1,0,0,0,0,0,0,1
knightliao_disconf,com.baidu.unbiz.common.genericdao.mapper,1,1,0,0,0,0,0,2
knightliao_disconf,com.baidu.unbiz.common.genericdao.operator,0,0,0,0,1,0,0,1
knightliao_disconf,com.baidu.unbiz.common.genericdao.param,0,0,0,0,0,0,0,0
knightliao_disconf,com.baidu.unbiz.common.genericdao.sequence,0,0,0,0,0,0,0,0
knightliao_disconf,com.baidu.unbiz.common.genericdao.util,0,0,0,0,0,0,0,0
knightliao_hermes-jsonrpc,com.github.knightliao.hermesjsonrpc.demo.client,0,0,0,0,0,0,0,0
knightliao_hermes-jsonrpc,com.github.knightliao.hermesjsonrpc.demo,0,0,0,0,1,0,0,1
knightliao_hermes-jsonrpc,com.github.knightliao.hermesjsonrpc.demo.server,0,0,0,0,0,0,0,0
knightliao_hermes-jsonrpc,com.github.knightliao.hermesjsonrpc.client.core,0,0,0,0,0,1,0,1
knightliao_hermes-jsonrpc,com.github.knightliao.hermesjsonrpc.client.exception,0,0,0,0,0,0,0,0
knightliao_hermes-jsonrpc,com.github.knightliao.hermesjsonrpc.client.protocol.gson,0,0,0,0,0,0,0,0
knightliao_hermes-jsonrpc,com.github.knightliao.hermesjsonrpc.client.protocol.protostuff,0,0,0,0,0,0,0,0
knightliao_hermes-jsonrpc,com.github.knightliao.hermesjsonrpc.client,0,0,0,0,0,1,0,1
knightliao_hermes-jsonrpc,com.github.knightliao.hermesjsonrpc.client.selector.impl,0,0,0,0,0,0,0,0
knightliao_hermes-jsonrpc,com.github.knightliao.hermesjsonrpc.client.selector,0,0,0,0,0,1,0,1
knightliao_hermes-jsonrpc,com.github.knightliao.hermesjsonrpc.core.auth,0,0,0,0,0,0,0,0
knightliao_hermes-jsonrpc,com.github.knightliao.hermesjsonrpc.core.codec,0,0,0,0,0,0,0,0
knightliao_hermes-jsonrpc,com.github.knightliao.hermesjsonrpc.core.codec.gson,0,0,0,0,0,0,0,0
knightliao_hermes-jsonrpc,com.github.knightliao.hermesjsonrpc.core.codec.protostuff,0,0,0,0,0,0,0,0
knightliao_hermes-jsonrpc,com.github.knightliao.hermesjsonrpc.core.constant,0,0,0,0,0,0,0,0
knightliao_hermes-jsonrpc,com.github.knightliao.hermesjsonrpc.core.dto,0,0,0,0,1,0,0,1
knightliao_hermes-jsonrpc,com.github.knightliao.hermesjsonrpc.core.exception,0,0,0,0,0,0,0,0
knightliao_hermes-jsonrpc,com.github.knightliao.hermesjsonrpc.core.utils,0,0,0,0,0,0,0,0
knightliao_hermes-jsonrpc,com.github.knightliao.hermesjsonrpc.server.dto,0,0,0,0,0,0,0,0
knightliao_hermes-jsonrpc,com.github.knightliao.hermesjsonrpc.server.handler.gson,0,0,0,0,0,0,0,0
knightliao_hermes-jsonrpc,com.github.knightliao.hermesjsonrpc.server.handler,0,0,0,0,0,0,0,0
knightliao_hermes-jsonrpc,com.github.knightliao.hermesjsonrpc.server.handler.protostuff,0,0,0,0,0,0,0,0
knightliao_hermes-jsonrpc,com.github.knightliao.hermesjsonrpc.server,0,0,0,0,0,0,0,0
knightliao_hermes-jsonrpc,com.github.knightliao.hermesjsonrpc.server.secret.impl,0,0,0,0,0,0,0,0
knightliao_hermes-jsonrpc,com.github.knightliao.hermesjsonrpc.server.secret,0,0,0,0,0,0,0,0
kontalk_tigase-server,com.izforge.izpack.panels,0,0,0,0,0,0,0,0
kontalk_tigase-server,tigase.auth,2,1,0,0,1,0,0,4
kontalk_tigase-server,tigase.auth.callbacks,1,1,0,0,1,0,0,3
kontalk_tigase-server,tigase.auth.impl,1,0,0,0,0,0,0,1
kontalk_tigase-server,tigase.auth.mechanisms,3,1,0,0,0,0,0,4
kontalk_tigase-server,tigase.cluster,0,0,0,0,1,0,0,1
kontalk_tigase-server,tigase.cluster.api,0,0,0,0,1,0,0,1
kontalk_tigase-server,tigase.cluster.repo,0,0,0,0,1,0,0,1
kontalk_tigase-server,tigase.cluster.strategy,0,0,0,0,1,0,0,1
kontalk_tigase-server,tigase.cluster.strategy.cmd,0,1,0,0,0,0,0,1
kontalk_tigase-server,tigase.component,0,0,0,0,0,0,0,0
kontalk_tigase-server,tigase.component.adhoc,0,0,0,0,1,0,0,1
kontalk_tigase-server,tigase.component.exceptions,0,0,0,0,0,0,0,0
kontalk_tigase-server,tigase.component.modules,0,0,0,0,1,0,0,1
kontalk_tigase-server,tigase.component.modules.impl,0,0,0,0,0,0,0,0
kontalk_tigase-server,tigase.component.responses,0,0,0,0,0,0,0,0
kontalk_tigase-server,tigase.conf,11,1,0,0,1,0,0,13
kontalk_tigase-server,tigase.db,10,1,0,0,1,0,0,12
kontalk_tigase-server,tigase.db.comp,2,0,0,0,1,0,0,3
kontalk_tigase-server,tigase.db.derby,0,0,0,0,0,0,0,0
kontalk_tigase-server,tigase.db.jdbc,0,0,0,0,1,0,0,1
kontalk_tigase-server,tigase.db.ldap,0,0,0,0,0,0,0,0
kontalk_tigase-server,tigase.db.xml,0,0,0,0,0,0,0,0
kontalk_tigase-server,tigase.disco,2,0,0,0,0,0,0,2
kontalk_tigase-server,tigase.disteventbus.component,1,0,0,0,1,0,0,2
kontalk_tigase-server,tigase.disteventbus.component.stores,0,0,0,0,0,0,0,0
kontalk_tigase-server,tigase.disteventbus,0,0,0,0,0,0,0,0
kontalk_tigase-server,tigase.disteventbus.impl,1,1,0,0,1,0,0,3
kontalk_tigase-server,tigase.io,2,0,0,0,1,0,0,3
kontalk_tigase-server,tigase.io.jdk18,0,0,0,0,0,0,0,0
kontalk_tigase-server,tigase.jdk18,0,0,0,0,0,0,0,0
kontalk_tigase-server,tigase.kernel,3,1,0,0,1,0,0,5
kontalk_tigase-server,tigase.kernel.beans,0,0,0,0,0,0,0,0
kontalk_tigase-server,tigase.kernel.beans.config,3,0,0,0,0,0,0,3
kontalk_tigase-server,tigase.kernel.core,4,1,0,0,1,0,0,6
kontalk_tigase-server,tigase.monitor,2,1,0,0,1,0,0,4
kontalk_tigase-server,tigase.monitor.modules,1,0,0,0,1,0,0,2
kontalk_tigase-server,tigase.monitor.tasks,1,0,0,0,1,0,0,2
kontalk_tigase-server,tigase.net,0,0,0,0,1,0,0,1
kontalk_tigase-server,tigase.osgi,14,1,0,0,1,0,0,16
kontalk_tigase-server,tigase.osgi.util,0,0,0,0,0,0,0,0
kontalk_tigase-server,tigase.server,22,1,0,1,1,0,0,25
kontalk_tigase-server,tigase.server.amp.action,0,0,0,0,1,0,0,1
kontalk_tigase-server,tigase.server.amp,2,0,0,0,1,0,0,3
kontalk_tigase-server,tigase.server.amp.cond,0,0,0,0,0,0,0,0
kontalk_tigase-server,tigase.server.bosh,0,0,0,0,1,0,0,1
kontalk_tigase-server,tigase.server.ext,0,0,0,0,1,0,0,1
kontalk_tigase-server,tigase.server.ext.handlers,0,0,0,0,1,0,0,1
kontalk_tigase-server,tigase.server.ext.lb,0,0,0,0,0,0,0,0
kontalk_tigase-server,tigase.server.filters,0,0,0,0,0,0,0,0
kontalk_tigase-server,tigase.server.monitor,0,0,0,0,0,0,0,0
kontalk_tigase-server,tigase.server.script,1,0,0,0,0,0,0,1
kontalk_tigase-server,tigase.server.sreceiver,0,0,0,0,1,0,0,1
kontalk_tigase-server,tigase.server.sreceiver.sysmon,0,0,0,0,1,0,0,1
kontalk_tigase-server,tigase.server.ssender,0,0,0,0,1,0,0,1
kontalk_tigase-server,tigase.server.websocket,0,0,0,0,1,0,0,1
kontalk_tigase-server,tigase.server.xmppclient,1,1,0,0,1,0,0,3
kontalk_tigase-server,tigase.server.xmppcomponent,0,0,0,0,0,0,0,0
kontalk_tigase-server,tigase.server.xmppserver,0,0,0,0,1,0,0,1
kontalk_tigase-server,tigase.server.xmppserver.proc,0,0,0,0,1,0,0,1
kontalk_tigase-server,tigase.server.xmppsession,0,0,0,0,1,0,0,1
kontalk_tigase-server,tigase.stats,0,0,0,0,1,1,0,2
kontalk_tigase-server,tigase.sys,2,0,0,0,0,1,0,3
kontalk_tigase-server,tigase.util,12,0,0,1,1,1,0,15
kontalk_tigase-server,tigase.util.tracer,0,0,0,0,0,0,0,0
kontalk_tigase-server,tigase.vhosts.filter,0,0,0,0,0,0,0,0
kontalk_tigase-server,tigase.vhosts,1,0,0,0,1,0,0,2
kontalk_tigase-server,tigase.xmpp,3,0,0,0,1,0,0,4
kontalk_tigase-server,tigase.xmpp.impl,9,0,0,1,1,0,0,11
kontalk_tigase-server,tigase.xmpp.impl.annotation,0,0,0,0,0,0,0,0
kontalk_tigase-server,tigase.xmpp.impl.roster,10,1,0,0,1,0,0,12
kontalk_tigase-server,tigase.kernel.module1,0,0,0,0,0,0,0,0
kontalk_tigase-server,tigase.kernel.module2,0,0,0,0,0,0,0,0
KronicDeth_intellij-elixir,org.elixir_lang.eex.lexer,0,0,0,0,0,0,0,0
KronicDeth_intellij-elixir,org.elixir_lang.eex,3,1,0,0,0,0,0,4
KronicDeth_intellij-elixir,org.elixir_lang.eex.psi,1,1,0,0,1,0,0,3
KronicDeth_intellij-elixir,org.elixir_lang.eex.psi.impl,0,0,0,0,0,0,0,0
KronicDeth_intellij-elixir,org.elixir_lang.parser,0,0,0,0,0,0,0,0
KronicDeth_intellij-elixir,org.elixir_lang.psi,15,1,0,1,0,0,0,17
KronicDeth_intellij-elixir,org.elixir_lang.psi.impl,6,0,0,1,0,0,0,7
KronicDeth_intellij-elixir,org.elixir_lang.jps.builder,2,0,0,0,1,0,0,3
KronicDeth_intellij-elixir,org.elixir_lang.jps,4,1,0,0,0,0,0,5
KronicDeth_intellij-elixir,org.elixir_lang.jps.target,2,0,0,0,0,0,0,2
KronicDeth_intellij-elixir,org.elixir_lang.jps.compiler_options,1,1,0,0,0,0,0,2
KronicDeth_intellij-elixir,org.elixir_lang.jps.mix,0,0,0,0,0,0,0,0
KronicDeth_intellij-elixir,org.elixir_lang.jps.model,0,0,0,0,0,0,0,0
KronicDeth_intellij-elixir,org.elixir_lang.jps.sdk_type,0,0,0,0,0,0,0,0
KronicDeth_intellij-elixir,org.elixir_lang.annotator,0,0,0,0,1,0,0,1
KronicDeth_intellij-elixir,org.elixir_lang.annonator,0,0,0,0,0,0,0,0
KronicDeth_intellij-elixir,org.elixir_lang.application.options,0,0,0,0,0,0,0,0
KronicDeth_intellij-elixir,org.elixir_lang.beam.assembly,0,0,0,0,0,0,0,0
KronicDeth_intellij-elixir,org.elixir_lang.beam.assembly.psi,0,0,0,0,0,0,0,0
KronicDeth_intellij-elixir,org.elixir_lang.beam.assembly.psi.impl,0,0,0,0,1,0,0,1
KronicDeth_intellij-elixir,org.elixir_lang.beam.chunk,1,1,0,0,0,0,0,2
KronicDeth_intellij-elixir,org.elixir_lang.beam.decompiler,1,0,0,0,0,0,0,1
KronicDeth_intellij-elixir,org.elixir_lang.beam,3,1,0,0,1,0,0,5
KronicDeth_intellij-elixir,org.elixir_lang.beam.psi,1,0,0,0,1,0,0,2
KronicDeth_intellij-elixir,org.elixir_lang.beam.psi.impl,0,0,0,0,1,0,0,1
KronicDeth_intellij-elixir,org.elixir_lang.beam.psi.stubs,0,0,0,0,1,0,0,1
KronicDeth_intellij-elixir,org.elixir_lang.code_insight.completion.contributor,0,0,0,0,0,0,0,0
KronicDeth_intellij-elixir,org.elixir_lang.code_insight.completion.insert_handler,0,0,0,0,0,0,0,0
KronicDeth_intellij-elixir,org.elixir_lang.code_insight.highlighting.brace_matcher,0,0,0,0,0,0,0,0
KronicDeth_intellij-elixir,org.elixir_lang.code_insight.lookup.element,0,0,0,0,0,0,0,0
KronicDeth_intellij-elixir,org.elixir_lang.code_insight.lookup.element_renderer,0,0,0,0,0,0,0,0
KronicDeth_intellij-elixir,org.elixir_lang.code_style,0,0,0,0,0,0,0,0
KronicDeth_intellij-elixir,org.elixir_lang.configuration,0,0,0,0,0,0,0,0
KronicDeth_intellij-elixir,org.elixir_lang.console,0,0,0,0,0,0,0,0
KronicDeth_intellij-elixir,org.elixir_lang,9,1,0,0,1,0,0,11
KronicDeth_intellij-elixir,org.elixir_lang.credo,0,0,0,0,0,0,0,0
KronicDeth_intellij-elixir,org.elixir_lang.debugger,0,0,0,0,0,0,0,0
KronicDeth_intellij-elixir,org.elixir_lang.debugger.node,0,0,0,0,0,0,0,0
KronicDeth_intellij-elixir,org.elixir_lang.debugger.stack_frame.value,0,0,0,0,0,0,0,0
KronicDeth_intellij-elixir,org.elixir_lang.distillery.configuration.editor,0,0,0,0,0,0,0,0
KronicDeth_intellij-elixir,org.elixir_lang.distillery.configuration,0,0,0,0,0,0,0,0
KronicDeth_intellij-elixir,org.elixir_lang.eex.element_type,0,0,0,0,0,0,0,0
KronicDeth_intellij-elixir,org.elixir_lang.eex.file,3,1,0,0,0,0,0,4
KronicDeth_intellij-elixir,org.elixir_lang.eex.file.psi,2,0,0,0,0,0,0,2
KronicDeth_intellij-elixir,org.elixir_lang.eex.file.type,0,0,0,0,0,0,0,0
KronicDeth_intellij-elixir,org.elixir_lang.eex.file.view_provider,0,0,0,0,0,0,0,0
KronicDeth_intellij-elixir,org.elixir_lang.elixir.configuration.editor,0,0,0,0,0,0,0,0
KronicDeth_intellij-elixir,org.elixir_lang.elixir.configuration,0,0,0,0,0,0,0,0
KronicDeth_intellij-elixir,org.elixir_lang.erl.configuration.editor,0,0,0,0,0,0,0,0
KronicDeth_intellij-elixir,org.elixir_lang.erl.configuration,0,0,0,0,0,0,0,0
KronicDeth_intellij-elixir,org.elixir_lang.errorreport,0,0,0,0,0,0,0,0
KronicDeth_intellij-elixir,org.elixir_lang.espec.configuration.editor,0,0,0,0,0,0,0,0
KronicDeth_intellij-elixir,org.elixir_lang.espec.configuration,0,0,0,0,0,0,0,0
KronicDeth_intellij-elixir,org.elixir_lang.espec,0,0,0,0,0,0,0,0
KronicDeth_intellij-elixir,org.elixir_lang.exunit.configuration.editor,0,0,0,0,0,0,0,0
KronicDeth_intellij-elixir,org.elixir_lang.exunit.configuration,0,0,0,0,0,0,0,0
KronicDeth_intellij-elixir,org.elixir_lang.exunit,0,0,0,0,0,0,0,0
KronicDeth_intellij-elixir,org.elixir_lang.file,1,0,0,0,0,0,0,1
KronicDeth_intellij-elixir,org.elixir_lang.folding,0,0,0,0,0,0,0,0
KronicDeth_intellij-elixir,org.elixir_lang.formatter,0,0,0,0,0,0,0,0
KronicDeth_intellij-elixir,org.elixir_lang.formatter.settings,0,0,0,0,0,0,0,0
KronicDeth_intellij-elixir,org.elixir_lang.formatting,0,0,0,0,0,0,0,0
KronicDeth_intellij-elixir,org.elixir_lang.github.issues.create,0,0,0,0,0,0,0,0
KronicDeth_intellij-elixir,org.elixir_lang.grammar.parser,0,0,0,0,0,0,0,0
KronicDeth_intellij-elixir,org.elixir_lang.iex.configuration.editor,0,0,0,0,0,0,0,0
KronicDeth_intellij-elixir,org.elixir_lang.iex.configuration,0,0,0,0,0,0,0,0
KronicDeth_intellij-elixir,org.elixir_lang.iex.mix.configuration.editor,0,0,0,0,0,0,0,0
KronicDeth_intellij-elixir,org.elixir_lang.iex.mix.configuration,0,0,0,0,0,0,0,0
KronicDeth_intellij-elixir,org.elixir_lang.inspection,0,0,0,0,1,0,0,1
KronicDeth_intellij-elixir,org.elixir_lang.lexer.group,4,1,0,0,0,0,0,5
KronicDeth_intellij-elixir,org.elixir_lang.lexer,4,0,0,0,0,0,0,4
KronicDeth_intellij-elixir,org.elixir_lang.local_quick_fix,0,0,0,0,0,0,0,0
KronicDeth_intellij-elixir,org.elixir_lang.mix.configuration.editor,0,0,0,0,0,0,0,0
KronicDeth_intellij-elixir,org.elixir_lang.mix.configuration,0,0,0,0,0,0,0,0
KronicDeth_intellij-elixir,org.elixir_lang.mix.project._import,0,0,0,0,0,0,0,0
KronicDeth_intellij-elixir,org.elixir_lang.mix.project._import.step,0,0,0,0,0,0,0,0
KronicDeth_intellij-elixir,org.elixir_lang.mix.runner,0,0,0,0,0,0,0,0
KronicDeth_intellij-elixir,org.elixir_lang.mix,0,0,0,0,0,0,0,0
KronicDeth_intellij-elixir,org.elixir_lang.module,0,1,0,0,1,0,0,2
KronicDeth_intellij-elixir,org.elixir_lang.name_arity,2,1,0,0,0,0,0,3
KronicDeth_intellij-elixir,org.elixir_lang.navigation,0,0,0,0,0,0,0,0
KronicDeth_intellij-elixir,org.elixir_lang.navigation.item_presentation,8,1,0,0,1,0,0,10
KronicDeth_intellij-elixir,org.elixir_lang.navigation.item_presentation.modular,0,0,0,0,0,0,0,0
KronicDeth_intellij-elixir,org.elixir_lang.navigation.item_presentation.structure,0,0,0,0,0,0,0,0
KronicDeth_intellij-elixir,org.elixir_lang.psi.call.arguments,0,0,0,0,0,0,0,0
KronicDeth_intellij-elixir,org.elixir_lang.psi.call.arguments.star,0,0,0,0,0,0,0,0
KronicDeth_intellij-elixir,org.elixir_lang.psi.call,0,0,0,0,0,0,0,0
KronicDeth_intellij-elixir,org.elixir_lang.psi.call.name,0,0,0,0,0,0,0,0
KronicDeth_intellij-elixir,org.elixir_lang.psi.call.qualification,0,0,0,0,0,0,0,0
KronicDeth_intellij-elixir,org.elixir_lang.psi.operation,2,0,1,0,0,0,0,3
KronicDeth_intellij-elixir,org.elixir_lang.psi.operation.infix,1,0,0,0,0,0,0,1
KronicDeth_intellij-elixir,org.elixir_lang.psi.operation.not_in,1,0,0,0,0,0,0,1
KronicDeth_intellij-elixir,org.elixir_lang.psi.operation.prefix,1,0,0,0,0,0,0,1
KronicDeth_intellij-elixir,org.elixir_lang.psi.qualification,0,0,0,0,0,0,0,0
KronicDeth_intellij-elixir,org.elixir_lang.psi.scope.atom,0,0,0,0,0,0,0,0
KronicDeth_intellij-elixir,org.elixir_lang.psi.scope,0,0,0,0,0,0,0,0
KronicDeth_intellij-elixir,org.elixir_lang.psi.scope.variable,0,0,0,0,0,0,0,0
KronicDeth_intellij-elixir,org.elixir_lang.psi.stub.call,0,0,0,0,0,0,0,0
KronicDeth_intellij-elixir,org.elixir_lang.psi.stub,2,1,0,0,1,0,0,4
KronicDeth_intellij-elixir,org.elixir_lang.psi.stub.impl,0,0,0,0,0,0,0,0
KronicDeth_intellij-elixir,org.elixir_lang.psi.stub.index,0,0,0,0,0,0,0,0
KronicDeth_intellij-elixir,org.elixir_lang.psi.stub.type.call,0,0,0,0,0,0,0,0
KronicDeth_intellij-elixir,org.elixir_lang.psi.stub.type,1,0,0,0,1,0,0,2
KronicDeth_intellij-elixir,org.elixir_lang.refactoring.variable.rename,0,0,0,0,0,0,0,0
KronicDeth_intellij-elixir,org.elixir_lang.reference,1,1,0,0,0,0,0,2
KronicDeth_intellij-elixir,org.elixir_lang.reference.module,0,0,0,0,0,0,0,0
KronicDeth_intellij-elixir,org.elixir_lang.reference.resolver.atom.resolvable,0,0,0,0,0,0,0,0
KronicDeth_intellij-elixir,org.elixir_lang.reference.resolver.atom,0,0,0,0,0,0,0,0
KronicDeth_intellij-elixir,org.elixir_lang.reference.resolver,1,0,0,0,0,0,0,1
KronicDeth_intellij-elixir,org.elixir_lang.scope_processor,0,0,0,0,0,0,0,0
KronicDeth_intellij-elixir,org.elixir_lang.sdk.elixir,1,1,0,0,0,0,0,2
KronicDeth_intellij-elixir,org.elixir_lang.sdk.erlang,0,0,0,0,0,0,0,0
KronicDeth_intellij-elixir,org.elixir_lang.sdk.erlang_dependent,0,0,0,0,0,0,0,0
KronicDeth_intellij-elixir,org.elixir_lang.sdk,0,0,0,0,0,0,0,0
KronicDeth_intellij-elixir,org.elixir_lang.structure_view.element,13,1,0,0,1,0,0,15
KronicDeth_intellij-elixir,org.elixir_lang.structure_view.element.call_definition_by_name_arity,0,0,0,0,0,0,0,0
KronicDeth_intellij-elixir,org.elixir_lang.structure_view.element.modular,13,1,0,0,0,0,0,14
KronicDeth_intellij-elixir,org.elixir_lang.structure_view.element.structure,0,0,0,0,0,0,0,0
KronicDeth_intellij-elixir,org.elixir_lang.structure_view,0,0,0,0,0,0,0,0
KronicDeth_intellij-elixir,org.elixir_lang.structure_view.sorter,0,0,0,0,0,0,0,0
KronicDeth_intellij-elixir,org.elixir_lang.templates,0,0,0,0,0,0,0,0
KronicDeth_intellij-elixir,org.elixir_lang.utils,0,0,0,0,0,0,0,0
KronicDeth_intellij-elixir,org.elixir_lang.eex.lexer.look_ahead,0,0,0,0,0,0,0,0
KronicDeth_intellij-elixir,org.elixir_lang.elixir_flex_lexer.atom_start,0,0,0,0,0,0,0,0
KronicDeth_intellij-elixir,org.elixir_lang.elixir_flex_lexer,0,0,0,0,0,0,0,0
KronicDeth_intellij-elixir,org.elixir_lang.elixir_flex_lexer.group,0,0,0,0,0,0,0,0
KronicDeth_intellij-elixir,org.elixir_lang.elixir_flex_lexer.group.quote,0,0,0,0,0,0,0,0
KronicDeth_intellij-elixir,org.elixir_lang.elixir_flex_lexer.group.sigil,0,0,0,0,0,0,0,0
KronicDeth_intellij-elixir,org.elixir_lang.elixir_flex_lexer.group.valid_escape_sequence,0,0,0,0,0,0,0,0
KronicDeth_intellij-elixir,org.elixir_lang.elixir_flex_lexer.group_heredoc_end.quote,0,0,0,0,0,0,0,0
KronicDeth_intellij-elixir,org.elixir_lang.elixir_flex_lexer.group_heredoc_end.sigil.char_list,0,0,0,0,0,0,0,0
KronicDeth_intellij-elixir,org.elixir_lang.elixir_flex_lexer.group_heredoc_end.sigil.custom,0,0,0,0,0,0,0,0
KronicDeth_intellij-elixir,org.elixir_lang.elixir_flex_lexer.group_heredoc_end.sigil.regex,0,0,0,0,0,0,0,0
KronicDeth_intellij-elixir,org.elixir_lang.elixir_flex_lexer.group_heredoc_end.sigil.string,0,0,0,0,0,0,0,0
KronicDeth_intellij-elixir,org.elixir_lang.elixir_flex_lexer.group_heredoc_end.sigil,0,0,0,0,0,0,0,0
KronicDeth_intellij-elixir,org.elixir_lang.elixir_flex_lexer.group_heredoc_end.sigil.words,0,0,0,0,0,0,0,0
KronicDeth_intellij-elixir,org.elixir_lang.elixir_flex_lexer.group_heredoc_line_body,0,0,0,0,0,0,0,0
KronicDeth_intellij-elixir,org.elixir_lang.elixir_flex_lexer.group_heredoc_line_body.quote,0,0,0,0,0,0,0,0
KronicDeth_intellij-elixir,org.elixir_lang.elixir_flex_lexer.group_heredoc_line_body.sigil,0,0,0,0,0,0,0,0
KronicDeth_intellij-elixir,org.elixir_lang.elixir_flex_lexer.group_heredoc_line_start.quote,0,0,0,0,0,0,0,0
KronicDeth_intellij-elixir,org.elixir_lang.elixir_flex_lexer.group_heredoc_line_start.sigil,0,0,0,0,0,0,0,0
KronicDeth_intellij-elixir,org.elixir_lang.elixir_flex_lexer.interpolation,0,0,0,0,0,0,0,0
KronicDeth_intellij-elixir,org.elixir_lang.elixir_flex_lexer.named_sigil,0,0,0,0,0,0,0,0
KronicDeth_intellij-elixir,org.elixir_lang.elixir_flex_lexer.sigil_modifiers.group,0,0,0,0,0,0,0,0
KronicDeth_intellij-elixir,org.elixir_lang.elixir_flex_lexer.sigil_modifiers.group_heredoc_end,0,0,0,0,0,0,0,0
KronicDeth_intellij-elixir,org.elixir_lang.flex_lexer,0,0,0,0,0,0,0,0
KronicDeth_intellij-elixir,org.elixir_lang.intellij_elixir,0,1,0,0,0,0,0,1
KronicDeth_intellij-elixir,org.elixir_lang.parser_definition,0,0,0,1,0,0,0,1
KronicDeth_intellij-elixir,org.elixir_lang.parser_definition.matched_call_operation,0,0,0,0,0,0,0,0
KronicDeth_intellij-elixir,org.elixir_lang.parser_definition.matched_dot_operator_call_operation,0,0,0,0,0,0,0,0
KronicDeth_intellij-elixir,org.elixir_lang.psi.scope.call_definition_clause,0,0,0,0,0,0,0,0
KronicDeth_intellij-elixir,org.elixir_lang.reference.callable,0,0,0,0,1,0,0,1
KronicDeth_intellij-elixir,org.elixir_lang.reference.module.as,0,0,0,0,0,0,0,0
KronicDeth_intellij-elixir,org.elixir_lang.reference.module.multiple_alias,0,0,0,0,0,0,0,0
KronicDeth_intellij-elixir,org.elixir_lang.reference.module.suffix,0,0,0,0,0,0,0,0
kuali_kc,org.kuali.coeus.dc.access.kim,0,0,0,0,1,0,1,2
kuali_kc,org.kuali.coeus.dc.access.proposal,0,0,0,0,0,0,1,1
kuali_kc,org.kuali.coeus.dc.award.amntinfo,0,0,0,0,0,0,1,1
kuali_kc,org.kuali.coeus.dc,0,0,0,0,0,0,1,1
kuali_kc,org.kuali.coeus.dc.common.db,0,0,0,0,1,0,1,2
kuali_kc,org.kuali.coeus.dc.common.rice.parameter,0,0,0,0,0,0,1,1
kuali_kc,org.kuali.coeus.dc.pprole,0,0,0,0,0,0,1,1
kuali_kc,org.kuali.coeus.dc.proposalpersons,0,0,0,0,0,0,1,1
kuali_kc,org.kuali.coeus.dc.propynq,0,0,0,0,0,0,1,1
kuali_kc,org.kuali.coeus.dc.questseq,0,0,0,0,0,0,1,1
kuali_kc,org.kuali.coeus.dc.subaward.amntinfo,0,0,0,0,0,0,1,1
kuali_kc,org.kuali.coeus.dc.subaward.status,0,0,0,0,0,0,1,1
kuali_kc,org.kuali.coeus.dc.tm,0,0,0,0,0,0,1,1
kuali_kc,org.kuali.coeus.dc.updateuser,0,0,0,0,0,0,1,1
kuali_kc,org.kuali.coeus.dc.updateuser.award,0,0,0,0,0,0,1,1
kuali_kc,org.kuali.coeus.dc.updateuser.ip,0,0,0,0,0,0,1,1
kuali_kc,org.kuali.coeus.dc.updateuser.subaward,0,0,0,0,0,0,1,1
kuali_kc,org.kuali.coeus.dc.updateuser.tm,0,0,0,0,0,0,1,1
kuali_kc,co.kuali.coeus.data.migration.custom.coeus,0,0,0,0,1,0,1,2
kuali_kc,co.kuali.coeus.data.migration.custom,0,0,0,0,0,0,1,1
kuali_kc,co.kuali.coeus.data.migration,0,0,0,0,0,0,1,1
kuali_kc,co.kuali.coeus.common.impl.attachment,0,0,0,0,0,0,1,1
kuali_kc,co.kuali.coeus.reporting.web.struts.action,0,0,0,0,0,0,1,1
kuali_kc,co.kuali.coeus.reporting.web.struts.form,0,0,0,0,0,0,1,1
kuali_kc,co.kuali.coeus.sys.impl.monitor,0,0,0,0,0,0,1,1
kuali_kc,co.kuali.coeus.sys.impl.persistence,0,0,0,0,0,0,1,1
kuali_kc,co.kuali.coeus.web.jstl,0,0,0,0,0,0,1,1
kuali_kc,co.kuali.coeus.workflow,0,0,0,0,0,0,1,1
kuali_kc,org.kuali.coeus.award,0,0,0,0,0,0,1,1
kuali_kc,org.kuali.coeus.award.api,0,0,0,0,0,0,1,1
kuali_kc,org.kuali.coeus.award.dto,0,0,0,1,1,0,1,3
kuali_kc,org.kuali.coeus.award.finance,7,0,0,0,1,0,1,9
kuali_kc,org.kuali.coeus.award.finance.dao,3,1,0,0,0,0,1,5
kuali_kc,org.kuali.coeus.award.finance.dao.jpa,0,0,0,0,0,0,1,1
kuali_kc,org.kuali.coeus.award.finance.timeAndMoney.api,0,0,0,0,0,0,1,1
kuali_kc,org.kuali.coeus.award.finance.timeAndMoney.dao.jpa,0,0,0,0,0,0,1,1
kuali_kc,org.kuali.coeus.award.finance.timeAndMoney.dao,0,0,0,0,0,0,1,1
kuali_kc,org.kuali.coeus.award.finance.timeAndMoney.dto,0,0,0,0,1,0,1,2
kuali_kc,org.kuali.coeus.award.finance.timeAndMoney,0,0,0,0,0,0,1,1
kuali_kc,org.kuali.coeus.award.impl.coi,0,0,0,0,0,0,1,1
kuali_kc,org.kuali.coeus.award.security,0,0,0,0,0,0,1,1
kuali_kc,org.kuali.coeus.coi.framework,0,0,0,0,1,0,1,2
kuali_kc,org.kuali.coeus.coi.impl,0,0,0,0,0,0,1,1
kuali_kc,org.kuali.coeus.common.api.budget.rates,0,0,0,0,0,0,1,1
kuali_kc,org.kuali.coeus.common.api.document.impl,0,0,0,0,0,0,1,1
kuali_kc,org.kuali.coeus.common.api.document.service,2,1,0,0,0,0,1,4
kuali_kc,org.kuali.coeus.common.api.training.dto,0,0,0,0,0,0,1,1
kuali_kc,org.kuali.coeus.common.api.training,0,0,0,0,0,0,1,1
kuali_kc,org.kuali.coeus.common.api.type,0,0,0,0,0,0,1,1
kuali_kc,org.kuali.coeus.common.api.unit,0,0,0,0,0,0,1,1
kuali_kc,org.kuali.coeus.common.budget.framework.calculator,11,1,0,0,0,0,1,13
kuali_kc,org.kuali.coeus.common.budget.framework.copy,0,0,0,0,0,0,1,1
kuali_kc,org.kuali.coeus.common.budget.framework.core,48,1,0,0,1,0,1,51
kuali_kc,org.kuali.coeus.common.budget.framework.core.category,3,1,0,0,1,0,1,6
kuali_kc,org.kuali.coeus.common.budget.framework.distribution,3,1,0,0,0,0,1,5
kuali_kc,org.kuali.coeus.common.budget.framework.income,7,1,0,0,0,0,1,9
kuali_kc,org.kuali.coeus.common.budget.framework.lock,0,0,0,0,0,0,1,1
kuali_kc,org.kuali.coeus.common.budget.framework.nonpersonnel,10,1,0,0,1,0,1,13
kuali_kc,org.kuali.coeus.common.budget.framework.period,18,1,0,0,1,0,1,21
kuali_kc,org.kuali.coeus.common.budget.framework.personnel,18,0,0,0,0,0,1,19
kuali_kc,org.kuali.coeus.common.budget.framework.print,2,0,0,0,0,0,1,3
kuali_kc,org.kuali.coeus.common.budget.framework.query,0,0,0,0,0,0,1,1
kuali_kc,org.kuali.coeus.common.budget.framework.query.operator,0,0,0,0,0,0,1,1
kuali_kc,org.kuali.coeus.common.budget.framework.rate,6,1,0,0,0,0,1,8
kuali_kc,org.kuali.coeus.common.budget.framework.summary,2,1,0,0,0,0,1,4
kuali_kc,org.kuali.coeus.common.budget.framework.version,2,0,0,0,0,0,1,3
kuali_kc,org.kuali.coeus.common.budget.impl.calculator,7,0,0,0,0,0,1,8
kuali_kc,org.kuali.coeus.common.budget.impl.core,5,0,0,0,1,0,1,7
kuali_kc,org.kuali.coeus.common.budget.impl.core.category,3,0,0,0,0,0,1,4
kuali_kc,org.kuali.coeus.common.budget.impl.distribution,0,0,0,0,1,0,1,2
kuali_kc,org.kuali.coeus.common.budget.impl.lock,0,0,0,0,0,0,1,1
kuali_kc,org.kuali.coeus.common.budget.impl.nonpersonnel,0,0,0,0,1,0,1,2
kuali_kc,org.kuali.coeus.common.budget.impl.period,0,0,0,0,0,0,1,1
kuali_kc,org.kuali.coeus.common.budget.impl.personnel,0,0,0,0,1,0,1,2
kuali_kc,org.kuali.coeus.common.budget.impl.print,0,0,0,0,0,0,1,1
kuali_kc,org.kuali.coeus.common.budget.impl.rate,0,0,0,0,1,0,1,2
kuali_kc,org.kuali.coeus.common.budget.impl.struts,0,0,0,0,0,0,1,1
kuali_kc,org.kuali.coeus.common.budget.impl.summary,0,0,0,0,0,0,1,1
kuali_kc,org.kuali.coeus.common.committee.impl.bo,34,1,0,0,0,0,1,36
kuali_kc,org.kuali.coeus.common.committee.impl.core.datadictionary.validation,0,0,0,0,0,0,1,1
kuali_kc,org.kuali.coeus.common.committee.impl,0,0,0,0,0,0,1,1
kuali_kc,org.kuali.coeus.common.committee.impl.dao,0,0,0,0,0,0,1,1
kuali_kc,org.kuali.coeus.common.committee.impl.dao.ojb,0,0,0,0,0,0,1,1
kuali_kc,org.kuali.coeus.common.committee.impl.document.authorization,2,0,0,0,0,0,1,3
kuali_kc,org.kuali.coeus.common.committee.impl.document.authorizer,0,0,0,0,0,0,1,1
kuali_kc,org.kuali.coeus.common.committee.impl.document,0,0,0,0,0,0,1,1
kuali_kc,org.kuali.coeus.common.committee.impl.keyvalue,0,0,0,0,0,0,1,1
kuali_kc,org.kuali.coeus.common.committee.impl.lookup,0,0,0,0,0,0,1,1
kuali_kc,org.kuali.coeus.common.committee.impl.lookup.keyvalue,0,0,0,0,1,0,1,2
kuali_kc,org.kuali.coeus.common.committee.impl.meeting,13,1,0,1,0,0,1,16
kuali_kc,org.kuali.coeus.common.committee.impl.notification,0,0,0,0,1,0,1,2
kuali_kc,org.kuali.coeus.common.committee.impl.print,2,0,0,0,0,0,1,3
kuali_kc,org.kuali.coeus.common.committee.impl.print.service,0,0,0,0,0,0,1,1
kuali_kc,org.kuali.coeus.common.committee.impl.rule,0,0,0,0,0,0,1,1
kuali_kc,org.kuali.coeus.common.committee.impl.rule.event,2,0,0,0,1,0,1,4
kuali_kc,org.kuali.coeus.common.committee.impl.rules,0,0,0,0,1,0,1,2
kuali_kc,org.kuali.coeus.common.committee.impl.service,7,1,0,0,1,0,1,10
kuali_kc,org.kuali.coeus.common.committee.impl.service.impl,0,0,0,0,1,0,1,2
kuali_kc,org.kuali.coeus.common.committee.impl.web.struts.action,0,0,0,0,0,0,1,1
kuali_kc,org.kuali.coeus.common.committee.impl.web.struts.form,2,0,0,0,0,0,1,3
kuali_kc,org.kuali.coeus.common.committee.impl.web.struts.form.schedule,0,0,0,0,0,0,1,1
kuali_kc,org.kuali.coeus.common.committee.impl.web.struts.form.schedule.util,0,0,0,0,0,0,1,1
kuali_kc,org.kuali.coeus.common.framework.attachment,0,0,0,0,1,0,1,2
kuali_kc,org.kuali.coeus.common.framework.auth.docperm,0,0,0,0,0,0,1,1
kuali_kc,org.kuali.coeus.common.framework.auth,1,0,0,0,1,0,1,3
kuali_kc,org.kuali.coeus.common.framework.auth.perm,0,0,0,0,0,0,1,1
kuali_kc,org.kuali.coeus.common.framework.auth.task,1,1,0,0,1,0,1,4
kuali_kc,org.kuali.coeus.common.framework.compliance.core,19,1,0,0,0,0,1,21
kuali_kc,org.kuali.coeus.common.framework.compliance.exemption,0,0,0,0,0,0,1,1
kuali_kc,org.kuali.coeus.common.framework.contact,0,0,0,0,0,0,1,1
kuali_kc,org.kuali.coeus.common.framework.costshare,2,0,0,0,0,0,1,3
kuali_kc,org.kuali.coeus.common.framework.country,0,0,0,0,0,0,1,1
kuali_kc,org.kuali.coeus.common.framework.crrspndnt,0,0,0,0,0,0,1,1
kuali_kc,org.kuali.coeus.common.framework.custom.arg,0,0,0,0,0,0,1,1
kuali_kc,org.kuali.coeus.common.framework.custom.attr,7,1,0,0,1,0,1,10
kuali_kc,org.kuali.coeus.common.framework.custom,0,0,0,0,1,0,1,2
kuali_kc,org.kuali.coeus.common.framework.fiscalyear,0,0,0,0,0,0,1,1
kuali_kc,org.kuali.coeus.common.framework.impl,0,0,0,0,1,0,1,2
kuali_kc,org.kuali.coeus.common.framework.keyword,1,1,0,0,0,0,1,3
kuali_kc,org.kuali.coeus.common.framework.krms,0,0,0,0,1,0,1,2
kuali_kc,org.kuali.coeus.common.framework.mail,0,0,0,0,0,0,1,1
kuali_kc,org.kuali.coeus.common.framework.medusa,4,0,0,0,0,0,1,5
kuali_kc,org.kuali.coeus.common.framework.module,1,1,0,0,0,0,1,3
kuali_kc,org.kuali.coeus.common.framework.motd,0,0,0,0,0,0,1,1
kuali_kc,org.kuali.coeus.common.framework.multicampus,0,0,0,0,0,0,1,1
kuali_kc,org.kuali.coeus.common.framework.noo,0,0,0,0,0,0,1,1
kuali_kc,org.kuali.coeus.common.framework.org.audit,0,0,0,0,0,0,1,1
kuali_kc,org.kuali.coeus.common.framework.org.crrspndnt,0,0,0,0,0,0,1,1
kuali_kc,org.kuali.coeus.common.framework.org,8,1,0,0,1,0,1,11
kuali_kc,org.kuali.coeus.common.framework.org.type,0,0,0,0,0,0,1,1
kuali_kc,org.kuali.coeus.common.framework.person.attr,19,1,0,0,1,0,1,22
kuali_kc,org.kuali.coeus.common.framework.person.citi,0,0,0,0,1,0,1,2
kuali_kc,org.kuali.coeus.common.framework.person.editable,0,0,0,0,0,0,1,1
kuali_kc,org.kuali.coeus.common.framework.person,7,1,0,0,1,0,1,10
kuali_kc,org.kuali.coeus.common.framework.person.signature,0,0,0,0,0,0,1,1
kuali_kc,org.kuali.coeus.common.framework.print,11,1,0,0,1,0,1,14
kuali_kc,org.kuali.coeus.common.framework.print.stream.xml,0,1,0,0,0,0,1,2
kuali_kc,org.kuali.coeus.common.framework.print.util,4,1,0,0,0,0,1,6
kuali_kc,org.kuali.coeus.common.framework.print.watermark,0,0,0,0,1,0,1,2
kuali_kc,org.kuali.coeus.common.framework.rolodex,4,1,0,0,0,0,1,6
kuali_kc,org.kuali.coeus.common.framework.ruleengine,0,0,0,0,0,0,1,1
kuali_kc,org.kuali.coeus.common.framework.shortUrl,0,0,0,0,0,0,1,1
kuali_kc,org.kuali.coeus.common.framework.sponsor.form,0,0,0,0,0,0,1,1
kuali_kc,org.kuali.coeus.common.framework.sponsor.hierarchy,0,0,0,0,0,0,1,1
kuali_kc,org.kuali.coeus.common.framework.sponsor,3,1,0,0,1,0,1,6
kuali_kc,org.kuali.coeus.common.framework.sponsor.term,0,0,0,0,0,0,1,1
kuali_kc,org.kuali.coeus.common.framework.type,0,0,0,0,0,0,1,1
kuali_kc,org.kuali.coeus.common.framework.unit.admin,0,0,0,0,1,0,1,2
kuali_kc,org.kuali.coeus.common.framework.unit.crrspndnt,0,0,0,0,0,0,1,1
kuali_kc,org.kuali.coeus.common.framework.unit,8,1,0,0,0,0,1,10
kuali_kc,org.kuali.coeus.common.framework.version.history,8,1,0,0,0,0,1,10
kuali_kc,org.kuali.coeus.common.framework.version,0,0,0,0,0,0,1,1
kuali_kc,org.kuali.coeus.common.framework.version.sequence.associate,0,0,0,0,0,0,1,1
kuali_kc,org.kuali.coeus.common.framework.version.sequence.owner,0,0,0,0,0,0,1,1
kuali_kc,org.kuali.coeus.common.framework.version.sequence,0,0,0,0,0,0,1,1
kuali_kc,org.kuali.coeus.common.framework.workflow,0,0,0,0,0,0,1,1
kuali_kc,org.kuali.coeus.common.framework.ynq,9,1,0,0,1,0,1,12
kuali_kc,org.kuali.coeus.common.impl.attachment,0,0,0,0,1,0,1,2
kuali_kc,org.kuali.coeus.common.impl.auth.docperm,0,0,0,0,0,0,1,1
kuali_kc,org.kuali.coeus.common.impl.auth.perm,0,0,0,0,0,0,1,1
kuali_kc,org.kuali.coeus.common.impl.auth,0,0,0,0,0,0,1,1
kuali_kc,org.kuali.coeus.common.impl.auth.task,0,0,0,0,0,0,1,1
kuali_kc,org.kuali.coeus.common.impl.compliance.core,0,0,0,0,0,0,1,1
kuali_kc,org.kuali.coeus.common.impl.compliance.exemption,0,0,0,0,0,0,1,1
kuali_kc,org.kuali.coeus.common.impl.costshare,0,0,0,0,0,0,1,1
kuali_kc,org.kuali.coeus.common.impl.country,0,0,0,0,0,0,1,1
kuali_kc,org.kuali.coeus.common.impl.custom.arg,0,0,0,0,0,0,1,1
kuali_kc,org.kuali.coeus.common.impl.custom.attr,0,0,0,0,1,0,1,2
kuali_kc,org.kuali.coeus.common.impl.custom,0,0,0,0,0,0,1,1
kuali_kc,org.kuali.coeus.common.impl.editable,0,0,0,0,0,0,1,1
kuali_kc,org.kuali.coeus.common.impl.fiscalyear,0,0,0,0,0,0,1,1
kuali_kc,org.kuali.coeus.common.impl,0,0,0,0,0,0,1,1
kuali_kc,org.kuali.coeus.common.impl.keyword,0,0,0,0,0,0,1,1
kuali_kc,org.kuali.coeus.common.impl.krms,10,0,0,0,1,0,1,12
kuali_kc,org.kuali.coeus.common.impl.mail,0,0,0,0,0,0,1,1
kuali_kc,org.kuali.coeus.common.impl.medusa,0,0,0,0,0,0,1,1
kuali_kc,org.kuali.coeus.common.impl.motd,0,0,0,0,0,0,1,1
kuali_kc,org.kuali.coeus.common.impl.multicampus,0,0,0,0,0,0,1,1
kuali_kc,org.kuali.coeus.common.impl.org.crrspndnt,0,0,0,0,0,0,1,1
kuali_kc,org.kuali.coeus.common.impl.org,0,0,0,0,1,0,1,2
kuali_kc,org.kuali.coeus.common.impl.person.attr,3,0,0,0,1,0,1,5
kuali_kc,org.kuali.coeus.common.impl.person.citi,0,0,0,0,1,0,1,2
kuali_kc,org.kuali.coeus.common.impl.person,0,0,0,0,1,0,1,2
kuali_kc,org.kuali.coeus.common.impl.person.signature,0,0,0,0,1,0,1,2
kuali_kc,org.kuali.coeus.common.impl.print,0,0,0,0,0,0,1,1
kuali_kc,org.kuali.coeus.common.impl.print.watermark,0,0,0,0,1,0,1,2
kuali_kc,org.kuali.coeus.common.impl.rolodex.nonorg,0,1,0,0,0,0,1,2
kuali_kc,org.kuali.coeus.common.impl.rolodex,0,0,0,0,1,0,1,2
kuali_kc,org.kuali.coeus.common.impl.rpt,1,0,0,0,0,0,1,2
kuali_kc,org.kuali.coeus.common.impl.rpt.cust,1,1,0,0,1,0,1,4
kuali_kc,org.kuali.coeus.common.impl.security,0,0,0,0,0,0,1,1
kuali_kc,org.kuali.coeus.common.impl.shortUrl,0,0,0,0,0,0,1,1
kuali_kc,org.kuali.coeus.common.impl.sponsor.form,0,0,0,0,0,0,1,1
kuali_kc,org.kuali.coeus.common.impl.sponsor.hierarchy,1,0,0,0,1,0,1,3
kuali_kc,org.kuali.coeus.common.impl.sponsor,2,1,0,0,1,0,1,5
kuali_kc,org.kuali.coeus.common.impl.state,0,0,0,0,0,0,1,1
kuali_kc,org.kuali.coeus.common.impl.unit.admin,0,0,0,0,0,0,1,1
kuali_kc,org.kuali.coeus.common.impl.unit.crrspndnt,0,0,0,0,0,0,1,1
kuali_kc,org.kuali.coeus.common.impl.unit,0,0,0,0,1,0,1,2
kuali_kc,org.kuali.coeus.common.impl.users,0,0,0,0,0,0,1,1
kuali_kc,org.kuali.coeus.common.impl.version.history,3,0,0,0,0,0,1,4
kuali_kc,org.kuali.coeus.common.impl.version,0,0,0,0,0,0,1,1
kuali_kc,org.kuali.coeus.common.impl.workflow,0,0,0,0,0,0,1,1
kuali_kc,org.kuali.coeus.common.impl.ynq,0,0,0,0,1,0,1,2
kuali_kc,org.kuali.coeus.common.notification.impl.bo,4,1,0,0,1,0,1,7
kuali_kc,org.kuali.coeus.common.notification.impl.exception,0,0,0,0,0,0,1,1
kuali_kc,org.kuali.coeus.common.notification.impl,3,0,0,0,1,0,1,5
kuali_kc,org.kuali.coeus.common.notification.impl.lookup.keyvalue,0,0,0,0,0,0,1,1
kuali_kc,org.kuali.coeus.common.notification.impl.rule,0,0,0,0,0,0,1,1
kuali_kc,org.kuali.coeus.common.notification.impl.rule.event,0,0,0,0,0,0,1,1
kuali_kc,org.kuali.coeus.common.notification.impl.rules,0,0,0,0,0,0,1,1
kuali_kc,org.kuali.coeus.common.notification.impl.service.impl,0,0,0,0,0,0,1,1
kuali_kc,org.kuali.coeus.common.notification.impl.service,4,1,0,0,0,0,1,6
kuali_kc,org.kuali.coeus.common.permissions.impl.bo,0,1,0,0,0,0,1,2
kuali_kc,org.kuali.coeus.common.permissions.impl.lookup.keyvalue,0,0,0,0,0,0,1,1
kuali_kc,org.kuali.coeus.common.permissions.impl,0,0,0,0,0,0,1,1
kuali_kc,org.kuali.coeus.common.permissions.impl.rule.event,0,0,0,0,0,0,1,1
kuali_kc,org.kuali.coeus.common.permissions.impl.rule,0,0,0,0,0,0,1,1
kuali_kc,org.kuali.coeus.common.permissions.impl.rules,0,0,0,0,0,0,1,1
kuali_kc,org.kuali.coeus.common.permissions.impl.web.bean,0,0,0,0,0,0,1,1
kuali_kc,org.kuali.coeus.common.permissions.impl.web.struts.action,0,0,0,0,0,0,1,1
kuali_kc,org.kuali.coeus.common.permissions.impl.web.struts.form,0,0,0,0,0,0,1,1
kuali_kc,org.kuali.coeus.common.proposal.framework.mail,0,0,0,0,0,0,1,1
kuali_kc,org.kuali.coeus.common.proposal.framework.report,2,1,0,0,0,0,1,4
kuali_kc,org.kuali.coeus.common.proposal.impl.report,0,0,0,0,0,0,1,1
kuali_kc,org.kuali.coeus.common.questionnaire.framework.answer,6,1,0,0,0,0,1,8
kuali_kc,org.kuali.coeus.common.questionnaire.framework.core,5,0,0,0,1,0,1,7
kuali_kc,org.kuali.coeus.common.questionnaire.framework.print,4,1,0,0,0,0,1,6
kuali_kc,org.kuali.coeus.common.questionnaire.framework.question,2,0,0,0,1,0,1,4
kuali_kc,org.kuali.coeus.common.questionnaire.impl.answer,2,0,0,0,0,0,1,3
kuali_kc,org.kuali.coeus.common.questionnaire.impl.auth,0,0,0,0,0,0,1,1
kuali_kc,org.kuali.coeus.common.questionnaire.impl.core,0,0,0,0,1,0,1,2
kuali_kc,org.kuali.coeus.common.questionnaire.impl.print,2,0,0,0,0,0,1,3
kuali_kc,org.kuali.coeus.common.questionnaire.impl.question,0,0,0,0,0,0,1,1
kuali_kc,org.kuali.coeus.common.questionnaire.impl,0,0,0,0,1,0,1,2
kuali_kc,org.kuali.coeus.common.view.wizard.framework,1,0,0,0,0,0,1,2
kuali_kc,org.kuali.coeus.common.view.wizard.impl,0,0,0,0,0,0,1,1
kuali_kc,org.kuali.coeus.instprop.impl.admin,0,0,0,0,0,0,1,1
kuali_kc,org.kuali.coeus.instprop.impl.api.customSerializers,0,0,0,0,0,0,1,1
kuali_kc,org.kuali.coeus.instprop.impl.api.dto,0,0,0,0,0,0,1,1
kuali_kc,org.kuali.coeus.instprop.impl.api,0,0,0,0,1,0,1,2
kuali_kc,org.kuali.coeus.instprop.impl.api.service.impl,0,0,0,0,0,0,1,1
kuali_kc,org.kuali.coeus.instprop.impl.api.service,0,0,0,0,0,0,1,1
kuali_kc,org.kuali.coeus.instprop.impl.coi,0,0,0,0,0,0,1,1
kuali_kc,org.kuali.coeus.instprop.impl.security,0,0,0,0,0,0,1,1
kuali_kc,org.kuali.coeus.instprop.impl.sponsor,0,0,0,0,0,0,1,1
kuali_kc,org.kuali.coeus.irb.api.dto,0,0,0,0,0,0,1,1
kuali_kc,org.kuali.coeus.irb.api,0,0,0,0,0,0,1,1
kuali_kc,org.kuali.coeus.org.kuali.rice.kns.web.struts.action,0,0,0,0,0,0,1,1
kuali_kc,org.kuali.coeus.org.kuali.rice.krad.uif.container,0,0,0,0,1,0,1,2
kuali_kc,org.kuali.coeus.org.kuali.rice.krad.uif.control,0,0,0,0,0,0,1,1
kuali_kc,org.kuali.coeus.org.kuali.rice.krad.uif.element,0,0,0,0,0,0,1,1
kuali_kc,org.kuali.coeus.org.kuali.rice.krad.uif.lifecycle,0,0,0,0,0,0,1,1
kuali_kc,org.kuali.coeus.propdev.impl.abstrct,2,1,0,0,0,0,1,4
kuali_kc,org.kuali.coeus.propdev.impl.action,1,0,0,0,0,0,1,2
kuali_kc,org.kuali.coeus.propdev.impl.attachment,5,1,0,1,0,0,1,8
kuali_kc,org.kuali.coeus.propdev.impl.attachment.institute,0,0,0,0,1,0,1,2
kuali_kc,org.kuali.coeus.propdev.impl.auth,4,0,0,0,1,0,1,6
kuali_kc,org.kuali.coeus.propdev.impl.auth.perm,3,1,0,0,1,0,1,6
kuali_kc,org.kuali.coeus.propdev.impl.basic,0,0,0,0,0,0,1,1
kuali_kc,org.kuali.coeus.propdev.impl.budget.auth,4,0,0,0,0,0,1,5
kuali_kc,org.kuali.coeus.propdev.impl.budget,22,1,0,0,1,0,1,25
kuali_kc,org.kuali.coeus.propdev.impl.budget.core,20,1,0,0,1,0,1,23
kuali_kc,org.kuali.coeus.propdev.impl.budget.datavalidation,0,0,0,0,0,0,1,1
kuali_kc,org.kuali.coeus.propdev.impl.budget.distribution,0,0,0,0,0,0,1,1
kuali_kc,org.kuali.coeus.propdev.impl.budget.editable,3,0,0,0,0,0,1,4
kuali_kc,org.kuali.coeus.propdev.impl.budget.hierarchy,2,0,0,0,0,0,1,3
kuali_kc,org.kuali.coeus.propdev.impl.budget.modular,6,1,0,0,1,0,1,9
kuali_kc,org.kuali.coeus.propdev.impl.budget.nonpersonnel,3,0,0,0,0,0,1,4
kuali_kc,org.kuali.coeus.propdev.impl.budget.note,0,0,0,0,0,0,1,1
kuali_kc,org.kuali.coeus.propdev.impl.budget.person,3,0,0,0,0,0,1,4
kuali_kc,org.kuali.coeus.propdev.impl.budget.rate,0,0,0,0,0,0,1,1
kuali_kc,org.kuali.coeus.propdev.impl.budget.subaward,4,1,0,0,0,0,1,6
kuali_kc,org.kuali.coeus.propdev.impl.coi,0,0,0,0,0,0,1,1
kuali_kc,org.kuali.coeus.propdev.impl.copy,4,1,0,0,0,0,1,6
kuali_kc,org.kuali.coeus.propdev.impl.core,119,1,0,1,1,0,1,123
kuali_kc,org.kuali.coeus.propdev.impl.custom,3,0,0,0,1,0,1,5
kuali_kc,org.kuali.coeus.propdev.impl.dataovveride,0,0,0,0,0,0,1,1
kuali_kc,org.kuali.coeus.propdev.impl.datavalidation,2,0,0,0,0,0,1,3
kuali_kc,org.kuali.coeus.propdev.impl.deliver,0,0,0,0,0,0,1,1
kuali_kc,org.kuali.coeus.propdev.impl.docperm,2,0,0,0,1,0,1,4
kuali_kc,org.kuali.coeus.propdev.impl.editable,4,0,0,0,1,0,1,6
kuali_kc,org.kuali.coeus.propdev.impl.hierarchy,15,1,0,0,1,0,1,18
kuali_kc,org.kuali.coeus.propdev.impl.keyword,2,0,0,0,0,0,1,3
kuali_kc,org.kuali.coeus.propdev.impl.krms,0,0,0,0,0,0,1,1
kuali_kc,org.kuali.coeus.propdev.impl.location,3,0,0,0,1,0,1,5
kuali_kc,org.kuali.coeus.propdev.impl.lock,4,0,0,0,0,0,1,5
kuali_kc,org.kuali.coeus.propdev.impl.noo,0,0,0,0,0,0,1,1
kuali_kc,org.kuali.coeus.propdev.impl.notification,2,0,0,0,0,0,1,3
kuali_kc,org.kuali.coeus.propdev.impl.person,20,1,0,1,0,0,1,23
kuali_kc,org.kuali.coeus.propdev.impl.person.attachment,2,0,0,0,0,0,1,3
kuali_kc,org.kuali.coeus.propdev.impl.person.creditsplit,4,0,0,0,1,0,1,6
kuali_kc,org.kuali.coeus.propdev.impl.person.masschange,3,1,0,0,0,0,1,5
kuali_kc,org.kuali.coeus.propdev.impl.person.question,4,0,0,0,0,0,1,5
kuali_kc,org.kuali.coeus.propdev.impl.print,8,0,0,0,0,0,1,9
kuali_kc,org.kuali.coeus.propdev.impl.questionnaire,12,1,0,0,1,0,1,15
kuali_kc,org.kuali.coeus.propdev.impl.resubmit,0,0,0,0,0,0,1,1
kuali_kc,org.kuali.coeus.propdev.impl.s2s.connect,2,0,0,0,0,0,1,3
kuali_kc,org.kuali.coeus.propdev.impl.s2s,7,1,0,1,0,0,1,10
kuali_kc,org.kuali.coeus.propdev.impl.s2s.question,5,0,0,0,0,0,1,6
kuali_kc,org.kuali.coeus.propdev.impl.s2s.schedule,0,0,0,0,0,0,1,1
kuali_kc,org.kuali.coeus.propdev.impl.specialreview,10,1,0,0,1,0,1,13
kuali_kc,org.kuali.coeus.propdev.impl.sponsor,0,0,0,0,0,0,1,1
kuali_kc,org.kuali.coeus.propdev.impl.state,4,1,0,0,0,0,1,6
kuali_kc,org.kuali.coeus.propdev.impl.ynq,2,0,0,0,0,0,1,3
kuali_kc,org.kuali.coeus.propdevrest.impl.auth,0,0,0,0,0,0,1,1
kuali_kc,org.kuali.coeus.sys.framework.auth,0,0,0,0,1,0,1,2
kuali_kc,org.kuali.coeus.sys.framework.config,0,0,0,0,0,0,1,1
kuali_kc,org.kuali.coeus.sys.framework.controller,11,1,0,0,1,0,1,14
kuali_kc,org.kuali.coeus.sys.framework.controller.interceptor,0,0,0,0,1,0,1,2
kuali_kc,org.kuali.coeus.sys.framework.controller.rest.audit,0,0,0,0,0,0,1,1
kuali_kc,org.kuali.coeus.sys.framework.controller.rest.editor,0,0,0,0,0,0,1,1
kuali_kc,org.kuali.coeus.sys.framework.controller.rest,1,0,0,0,0,0,1,2
kuali_kc,org.kuali.coeus.sys.framework.dd,0,0,0,0,0,0,1,1
kuali_kc,org.kuali.coeus.sys.framework.gv,0,0,0,0,0,0,1,1
kuali_kc,org.kuali.coeus.sys.framework.keyvalue,0,0,0,0,1,0,1,2
kuali_kc,org.kuali.coeus.sys.framework.listener,0,0,0,0,0,0,1,1
kuali_kc,org.kuali.coeus.sys.framework.lookup,0,0,0,0,0,0,1,1
kuali_kc,org.kuali.coeus.sys.framework.maintenance,0,0,0,0,0,0,1,1
kuali_kc,org.kuali.coeus.sys.framework.model,9,1,0,0,1,0,1,12
kuali_kc,org.kuali.coeus.sys.framework.mq,0,0,0,0,0,0,1,1
kuali_kc,org.kuali.coeus.sys.framework.mq.rest,0,0,0,0,0,0,1,1
kuali_kc,org.kuali.coeus.sys.framework.persistence,12,1,0,0,1,0,1,15
kuali_kc,org.kuali.coeus.sys.framework.rest,0,0,0,0,1,0,1,2
kuali_kc,org.kuali.coeus.sys.framework.rule,3,0,0,0,0,0,1,4
kuali_kc,org.kuali.coeus.sys.framework.scheduling.expr,0,0,0,0,0,0,1,1
kuali_kc,org.kuali.coeus.sys.framework.scheduling,0,0,0,0,0,0,1,1
kuali_kc,org.kuali.coeus.sys.framework.scheduling.seq,0,0,0,0,0,0,1,1
kuali_kc,org.kuali.coeus.sys.framework.scheduling.util,0,0,0,0,0,0,1,1
kuali_kc,org.kuali.coeus.sys.framework.security,0,0,0,0,0,0,1,1
kuali_kc,org.kuali.coeus.sys.framework.sensitive,0,0,0,0,0,0,1,1
kuali_kc,org.kuali.coeus.sys.framework.service,0,0,0,0,0,0,1,1
kuali_kc,org.kuali.coeus.sys.framework.summary,0,0,0,0,0,0,1,1
kuali_kc,org.kuali.coeus.sys.framework.util,1,0,0,0,0,0,1,2
kuali_kc,org.kuali.coeus.sys.framework.validation,0,0,0,0,1,0,1,2
kuali_kc,org.kuali.coeus.sys.framework.view,0,0,0,0,0,0,1,1
kuali_kc,org.kuali.coeus.sys.framework.workflow,0,0,0,0,1,0,1,2
kuali_kc,org.kuali.coeus.sys.health,0,0,0,0,0,0,1,1
kuali_kc,org.kuali.coeus.sys.impl.auth,0,0,0,0,1,0,1,2
kuali_kc,org.kuali.coeus.sys.impl.controller,0,0,0,0,0,0,1,1
kuali_kc,org.kuali.coeus.sys.impl.controller.rest.audit,0,0,0,0,1,0,1,2
kuali_kc,org.kuali.coeus.sys.impl.controller.rest,0,0,0,0,0,0,1,1
kuali_kc,org.kuali.coeus.sys.impl.dd,0,0,0,0,0,0,1,1
kuali_kc,org.kuali.coeus.sys.impl.gv,0,0,0,0,0,0,1,1
kuali_kc,org.kuali.coeus.sys.impl,0,0,0,0,0,0,1,1
kuali_kc,org.kuali.coeus.sys.impl.keyvalue,0,0,0,0,0,0,1,1
kuali_kc,org.kuali.coeus.sys.impl.lock,2,0,0,0,0,0,1,3
kuali_kc,org.kuali.coeus.sys.impl.model,0,0,0,0,0,0,1,1
kuali_kc,org.kuali.coeus.sys.impl.mq,0,0,0,0,0,0,1,1
kuali_kc,org.kuali.coeus.sys.impl.mq.rest,0,0,0,0,0,0,1,1
kuali_kc,org.kuali.coeus.sys.impl.persistence,0,0,0,0,0,0,1,1
kuali_kc,org.kuali.coeus.sys.impl.rest,0,0,0,0,0,0,1,1
kuali_kc,org.kuali.coeus.sys.impl.scheduling,0,0,0,0,0,0,1,1
kuali_kc,org.kuali.coeus.sys.impl.sensitive,0,0,0,0,0,0,1,1
kuali_kc,org.kuali.coeus.sys.impl.validation,0,0,0,0,0,0,1,1
kuali_kc,org.kuali.coeus.sys.impl.vc,0,0,0,0,0,0,1,1
kuali_kc,org.kuali.coeus.sys.impl.workflow.action,0,0,0,0,0,0,1,1
kuali_kc,org.kuali.coeus.sys.impl.workflow,0,0,0,0,1,0,1,2
kuali_kc,org.kuali.kra.authorization,0,0,0,0,0,0,1,1
kuali_kc,org.kuali.kra.award.authorizer,0,0,0,0,0,0,1,1
kuali_kc,org.kuali.kra.award,79,1,0,1,1,0,1,83
kuali_kc,org.kuali.kra.award.awardhierarchy,12,1,0,0,0,0,1,14
kuali_kc,org.kuali.kra.award.awardhierarchy.sync,4,1,0,0,1,0,1,7
kuali_kc,org.kuali.kra.award.awardhierarchy.sync.helpers,3,0,0,0,0,0,1,4
kuali_kc,org.kuali.kra.award.awardhierarchy.sync.keyvalue,0,0,0,0,0,0,1,1
kuali_kc,org.kuali.kra.award.awardhierarchy.sync.service,7,1,0,0,0,0,1,9
kuali_kc,org.kuali.kra.award.budget,18,1,0,0,0,0,1,20
kuali_kc,org.kuali.kra.award.budget.calculator,3,1,0,0,0,0,1,5
kuali_kc,org.kuali.kra.award.budget.document.authorization,0,0,0,0,0,0,1,1
kuali_kc,org.kuali.kra.award.budget.document.authorizer,0,0,0,0,0,0,1,1
kuali_kc,org.kuali.kra.award.budget.document,7,1,0,0,0,0,1,9
kuali_kc,org.kuali.kra.award.budget.service.impl,0,0,0,0,0,0,1,1
kuali_kc,org.kuali.kra.award.cgb,1,0,0,0,0,0,1,2
kuali_kc,org.kuali.kra.award.commitments,6,1,0,0,0,0,1,8
kuali_kc,org.kuali.kra.award.contacts,12,1,0,1,0,0,1,15
kuali_kc,org.kuali.kra.award.customdata,3,1,0,0,0,0,1,5
kuali_kc,org.kuali.kra.award.dao,8,1,0,0,0,0,1,10
kuali_kc,org.kuali.kra.award.dao.ojb,0,0,0,0,0,0,1,1
kuali_kc,org.kuali.kra.award.detailsdates,8,1,0,0,0,0,1,10
kuali_kc,org.kuali.kra.award.document.authorization,2,1,0,0,0,0,1,4
kuali_kc,org.kuali.kra.award.document.authorizer,0,0,0,0,0,0,1,1
kuali_kc,org.kuali.kra.award.document,37,1,0,0,0,0,1,39
kuali_kc,org.kuali.kra.award.home.approvedsubawards,3,1,0,0,0,0,1,5
kuali_kc,org.kuali.kra.award.home,126,1,0,1,0,0,1,129
kuali_kc,org.kuali.kra.award.home.fundingproposal,4,0,0,0,0,0,1,5
kuali_kc,org.kuali.kra.award.home.keywords,2,0,0,0,0,0,1,3
kuali_kc,org.kuali.kra.award.lookup,2,0,0,0,1,0,1,4
kuali_kc,org.kuali.kra.award.lookup.keyvalue,6,1,0,0,1,0,1,9
kuali_kc,org.kuali.kra.award.maintenance,0,0,0,0,0,0,1,1
kuali_kc,org.kuali.kra.award.notesandattachments.attachments,3,1,0,0,0,0,1,5
kuali_kc,org.kuali.kra.award.notesandattachments.comments,2,0,0,0,0,0,1,3
kuali_kc,org.kuali.kra.award.notesandattachments.notes,3,0,0,0,0,0,1,4
kuali_kc,org.kuali.kra.award.notification,3,0,0,0,1,0,1,5
kuali_kc,org.kuali.kra.award.paymentreports.awardreports,5,1,0,0,0,0,1,7
kuali_kc,org.kuali.kra.award.paymentreports.awardreports.reporting,7,1,0,0,0,0,1,9
kuali_kc,org.kuali.kra.award.paymentreports.awardreports.reporting.service,10,1,0,0,1,0,1,13
kuali_kc,org.kuali.kra.award.paymentreports.closeout,3,1,0,0,0,0,1,5
kuali_kc,org.kuali.kra.award.paymentreports,4,1,0,0,1,0,1,7
kuali_kc,org.kuali.kra.award.paymentreports.paymentschedule,3,0,0,0,0,0,1,4
kuali_kc,org.kuali.kra.award.paymentreports.specialapproval.approvedequipment,3,1,0,0,0,0,1,5
kuali_kc,org.kuali.kra.award.paymentreports.specialapproval.foreigntravel,3,0,0,0,0,0,1,4
kuali_kc,org.kuali.kra.award.permissions,1,0,0,0,0,0,1,2
kuali_kc,org.kuali.kra.award.printing,0,0,0,0,0,0,1,1
kuali_kc,org.kuali.kra.award.printing.print,0,0,0,0,1,0,1,2
kuali_kc,org.kuali.kra.award.printing.service,0,0,0,0,0,0,1,1
kuali_kc,org.kuali.kra.award.printing.service.impl,0,0,0,0,0,0,1,1
kuali_kc,org.kuali.kra.award.printing.xmlstream,0,0,0,0,1,0,1,2
kuali_kc,org.kuali.kra.award.rule,0,0,0,0,1,0,1,2
kuali_kc,org.kuali.kra.award.rule.event,3,1,0,0,0,0,1,5
kuali_kc,org.kuali.kra.award.service,2,0,0,0,1,0,1,4
kuali_kc,org.kuali.kra.award.service.impl,2,0,0,0,1,0,1,4
kuali_kc,org.kuali.kra.award.specialreview,2,1,0,0,0,0,1,4
kuali_kc,org.kuali.kra.award.subcontracting.goalsAndExpenditures,2,0,0,0,1,0,1,4
kuali_kc,org.kuali.kra.award.subcontracting.reporting.dao,1,0,0,0,0,0,1,2
kuali_kc,org.kuali.kra.award.subcontracting.reporting,1,1,0,0,1,0,1,4
kuali_kc,org.kuali.kra.award.timeandmoney,4,1,0,0,0,0,1,6
kuali_kc,org.kuali.kra.award.version.service,2,1,0,0,0,0,1,4
kuali_kc,org.kuali.kra.award.version.service.impl,0,0,0,0,0,0,1,1
kuali_kc,org.kuali.kra.award.web.struts.action,12,0,0,0,0,0,1,13
kuali_kc,org.kuali.kra.award.web.struts.authorization,0,0,0,0,0,0,1,1
kuali_kc,org.kuali.kra.bo,21,1,0,0,1,0,1,24
kuali_kc,org.kuali.kra.bo.rule,0,0,0,0,0,0,1,1
kuali_kc,org.kuali.kra.coi.actions,5,1,0,0,1,0,1,8
kuali_kc,org.kuali.kra.coi.auth,2,1,0,0,0,0,1,4
kuali_kc,org.kuali.kra.coi.authorizer,0,0,0,0,0,0,1,1
kuali_kc,org.kuali.kra.coi.certification,3,1,0,0,0,0,1,5
kuali_kc,org.kuali.kra.coi,33,1,0,1,1,0,1,37
kuali_kc,org.kuali.kra.coi.disclosure,14,1,0,0,1,0,1,17
kuali_kc,org.kuali.kra.coi.lookup,0,0,0,0,1,0,1,2
kuali_kc,org.kuali.kra.coi.lookup.dao,0,0,0,0,0,0,1,1
kuali_kc,org.kuali.kra.coi.lookup.dao.ojb,0,0,0,0,0,0,1,1
kuali_kc,org.kuali.kra.coi.lookup.keyvalue,2,0,0,0,1,0,1,4
kuali_kc,org.kuali.kra.coi.maintenance,0,0,0,0,1,0,1,2
kuali_kc,org.kuali.kra.coi.notesandattachments,6,0,0,0,1,0,1,8
kuali_kc,org.kuali.kra.coi.notesandattachments.attachments,7,1,0,0,1,0,1,10
kuali_kc,org.kuali.kra.coi.notesandattachments.notes,2,1,0,0,0,0,1,4
kuali_kc,org.kuali.kra.coi.notification,5,0,0,0,1,0,1,7
kuali_kc,org.kuali.kra.coi.personfinancialentity,6,1,0,1,0,0,1,9
kuali_kc,org.kuali.kra.coi.print,0,0,0,0,0,0,1,1
kuali_kc,org.kuali.kra.coi.questionnaire,2,1,0,0,0,0,1,4
kuali_kc,org.kuali.kra.coi.service,2,1,0,0,0,0,1,4
kuali_kc,org.kuali.kra.coi.service.impl,0,0,0,0,0,0,1,1
kuali_kc,org.kuali.kra.committee.bo,4,1,0,0,1,0,1,7
kuali_kc,org.kuali.kra.committee.dao,0,0,0,0,0,0,1,1
kuali_kc,org.kuali.kra.committee.dao.ojb,0,0,0,0,0,0,1,1
kuali_kc,org.kuali.kra.committee.document.authorization,0,0,0,0,0,0,1,1
kuali_kc,org.kuali.kra.committee.document.authorizer,0,0,0,0,0,0,1,1
kuali_kc,org.kuali.kra.committee.document,5,1,0,0,0,0,1,7
kuali_kc,org.kuali.kra.committee.keyvalue,0,0,0,0,0,0,1,1
kuali_kc,org.kuali.kra.committee.lookup,3,0,0,0,0,0,1,4
kuali_kc,org.kuali.kra.committee.lookup.keyvalue,0,0,0,0,1,0,1,2
kuali_kc,org.kuali.kra.committee.notification,0,0,0,0,0,0,1,1
kuali_kc,org.kuali.kra.committee.print,4,0,0,0,1,0,1,6
kuali_kc,org.kuali.kra.committee.rule.event,0,0,0,0,1,0,1,2
kuali_kc,org.kuali.kra.committee.rules,0,0,0,0,1,0,1,2
kuali_kc,org.kuali.kra.committee.service,13,1,0,0,1,0,1,16
kuali_kc,org.kuali.kra.committee.service.impl,7,1,0,0,1,0,1,10
kuali_kc,org.kuali.kra.committee.web.struts.action,0,0,0,0,0,0,1,1
kuali_kc,org.kuali.kra.committee.web.struts.form,2,0,0,0,0,0,1,3
kuali_kc,org.kuali.kra.common.web.struts.form,5,0,0,0,0,0,1,6
kuali_kc,org.kuali.kra.core,0,0,0,0,0,0,1,1
kuali_kc,org.kuali.kra.dao,3,0,0,0,0,0,1,4
kuali_kc,org.kuali.kra.dao.ojb,0,0,0,0,0,0,1,1
kuali_kc,org.kuali.kra.external.award,6,1,0,0,1,0,1,9
kuali_kc,org.kuali.kra.external.award.impl,2,0,0,0,0,0,1,3
kuali_kc,org.kuali.kra.external.award.web,4,0,0,0,0,0,1,5
kuali_kc,org.kuali.kra.external.awardpayment,1,0,0,0,0,0,1,2
kuali_kc,org.kuali.kra.external.awardtype,0,0,0,0,0,0,1,1
kuali_kc,org.kuali.kra.external.budget,5,1,0,0,1,0,1,8
kuali_kc,org.kuali.kra.external.budget.impl,3,0,0,0,0,0,1,4
kuali_kc,org.kuali.kra.external.budget.service,0,0,0,0,0,0,1,1
kuali_kc,org.kuali.kra.external.budget.service.impl,0,0,0,0,0,0,1,1
kuali_kc,org.kuali.kra.external.Cfda,0,0,0,0,0,0,1,1
kuali_kc,org.kuali.kra.external.Cfda.service,0,0,0,0,0,0,1,1
kuali_kc,org.kuali.kra.external.Cfda.service.impl,0,0,0,0,0,0,1,1
kuali_kc,org.kuali.kra.external.customercreation,2,1,0,0,1,0,1,5
kuali_kc,org.kuali.kra.external.dunningcampaign,0,0,0,0,0,0,1,1
kuali_kc,org.kuali.kra.external.frequency,0,0,0,0,0,0,1,1
kuali_kc,org.kuali.kra.external,0,0,0,0,0,0,1,1
kuali_kc,org.kuali.kra.external.service,0,0,0,0,0,0,1,1
kuali_kc,org.kuali.kra.external.sponsor,3,0,0,0,1,0,1,5
kuali_kc,org.kuali.kra.external.unit.service.impl,0,0,0,0,0,0,1,1
kuali_kc,org.kuali.kra.external.unit.service,0,0,0,0,0,0,1,1
kuali_kc,org.kuali.kra.external.unit,0,0,0,0,0,0,1,1
kuali_kc,org.kuali.kra.iacuc.actions.abandon,1,0,0,0,0,0,1,2
kuali_kc,org.kuali.kra.iacuc.actions.amendrenew,7,1,0,0,1,0,1,10
kuali_kc,org.kuali.kra.iacuc.actions.approve,2,0,0,0,0,0,1,3
kuali_kc,org.kuali.kra.iacuc.actions.assignagenda,3,0,0,0,0,0,1,4
kuali_kc,org.kuali.kra.iacuc.actions.assignCmt,4,1,0,0,0,0,1,6
kuali_kc,org.kuali.kra.iacuc.actions.assignreviewers,0,0,0,0,0,0,1,1
kuali_kc,org.kuali.kra.iacuc.actions.copy,4,0,0,0,0,0,1,5
kuali_kc,org.kuali.kra.iacuc.actions.correction,2,0,0,0,0,0,1,3
kuali_kc,org.kuali.kra.iacuc.actions.correspondence,0,0,0,0,0,0,1,1
kuali_kc,org.kuali.kra.iacuc.actions.decision,4,0,0,0,1,0,1,6
kuali_kc,org.kuali.kra.iacuc.actions.delete,1,0,0,0,0,0,1,2
kuali_kc,org.kuali.kra.iacuc.actions.followup,1,0,0,0,0,0,1,2
kuali_kc,org.kuali.kra.iacuc.actions.genericactions,2,0,0,0,0,0,1,3
kuali_kc,org.kuali.kra.iacuc.actions,63,1,0,0,0,0,1,65
kuali_kc,org.kuali.kra.iacuc.actions.modifysubmission,5,0,0,0,1,0,1,7
kuali_kc,org.kuali.kra.iacuc.actions.noreview,3,0,0,0,0,0,1,4
kuali_kc,org.kuali.kra.iacuc.actions.notifycommittee,0,0,0,0,0,0,1,1
kuali_kc,org.kuali.kra.iacuc.actions.notifyiacuc,2,0,0,0,1,0,1,4
kuali_kc,org.kuali.kra.iacuc.actions.print,16,1,0,0,1,0,1,19
kuali_kc,org.kuali.kra.iacuc.actions.processBillable,0,0,0,0,0,0,1,1
kuali_kc,org.kuali.kra.iacuc.actions.request,2,0,0,0,0,0,1,3
kuali_kc,org.kuali.kra.iacuc.actions.reviewcomments,5,1,0,0,1,0,1,8
kuali_kc,org.kuali.kra.iacuc.actions.submit,11,1,0,0,1,0,1,14
kuali_kc,org.kuali.kra.iacuc.actions.table,10,1,0,0,0,0,1,12
kuali_kc,org.kuali.kra.iacuc.actions.undo,2,0,0,0,0,0,1,3
kuali_kc,org.kuali.kra.iacuc.actions.withdraw,2,0,0,0,0,0,1,3
kuali_kc,org.kuali.kra.iacuc.auth,3,0,0,1,0,0,1,5
kuali_kc,org.kuali.kra.iacuc.authorizer,0,0,0,0,0,0,1,1
kuali_kc,org.kuali.kra.iacuc.bo,0,0,0,0,0,0,1,1
kuali_kc,org.kuali.kra.iacuc.coi,0,0,0,0,0,0,1,1
kuali_kc,org.kuali.kra.iacuc.committee.bo,2,0,0,0,1,0,1,4
kuali_kc,org.kuali.kra.iacuc.committee.dao,0,0,0,0,0,0,1,1
kuali_kc,org.kuali.kra.iacuc.committee.dao.ojb,0,0,0,0,0,0,1,1
kuali_kc,org.kuali.kra.iacuc.committee.document.authorization,0,0,0,0,0,0,1,1
kuali_kc,org.kuali.kra.iacuc.committee.document.authorizer,0,0,0,0,0,0,1,1
kuali_kc,org.kuali.kra.iacuc.committee.document,0,0,0,0,0,0,1,1
kuali_kc,org.kuali.kra.iacuc.committee.keyvalue,0,0,0,0,0,0,1,1
kuali_kc,org.kuali.kra.iacuc.committee.lookup,0,0,0,0,0,0,1,1
kuali_kc,org.kuali.kra.iacuc.committee.lookup.keyvalue,0,0,1,0,0,0,1,2
kuali_kc,org.kuali.kra.iacuc.committee.meeting,6,0,0,0,1,0,1,8
kuali_kc,org.kuali.kra.iacuc.committee.print,3,0,0,0,1,0,1,5
kuali_kc,org.kuali.kra.iacuc.committee.print.service,4,0,0,0,0,0,1,5
kuali_kc,org.kuali.kra.iacuc.committee.print.service.impl,0,0,0,0,0,0,1,1
kuali_kc,org.kuali.kra.iacuc.committee.rule.event,0,0,0,0,0,0,1,1
kuali_kc,org.kuali.kra.iacuc.committee.rules,0,0,0,0,0,0,1,1
kuali_kc,org.kuali.kra.iacuc.committee.service,0,0,0,0,0,0,1,1
kuali_kc,org.kuali.kra.iacuc.committee.service.impl,0,0,1,0,0,0,1,2
kuali_kc,org.kuali.kra.iacuc.committee.web.struts.action,0,0,0,0,0,0,1,1
kuali_kc,org.kuali.kra.iacuc.committee.web.struts.form,2,0,0,0,0,0,1,3
kuali_kc,org.kuali.kra.iacuc.correspondence,4,1,0,0,1,0,1,7
kuali_kc,org.kuali.kra.iacuc.customdata,0,0,0,0,0,0,1,1
kuali_kc,org.kuali.kra.iacuc,70,1,0,1,1,0,1,74
kuali_kc,org.kuali.kra.iacuc.infrastructure,0,0,0,0,0,0,1,1
kuali_kc,org.kuali.kra.iacuc.kim.service.impl,0,0,0,0,0,0,1,1
kuali_kc,org.kuali.kra.iacuc.lookup,0,0,0,0,0,0,1,1
kuali_kc,org.kuali.kra.iacuc.maintenance,0,0,0,0,0,0,1,1
kuali_kc,org.kuali.kra.iacuc.noteattachment,6,0,0,0,1,0,1,8
kuali_kc,org.kuali.kra.iacuc.notification,3,0,0,0,1,0,1,5
kuali_kc,org.kuali.kra.iacuc.onlinereview.authorization,0,0,0,0,0,0,1,1
kuali_kc,org.kuali.kra.iacuc.onlinereview,6,0,0,0,1,0,1,8
kuali_kc,org.kuali.kra.iacuc.onlinereview.rules,0,0,0,0,0,0,1,1
kuali_kc,org.kuali.kra.iacuc.permission,0,0,0,0,0,0,1,1
kuali_kc,org.kuali.kra.iacuc.personnel,7,1,0,0,1,0,1,10
kuali_kc,org.kuali.kra.iacuc.procedures,5,0,0,0,0,0,1,6
kuali_kc,org.kuali.kra.iacuc.procedures.rule,0,0,0,0,0,0,1,1
kuali_kc,org.kuali.kra.iacuc.protocol.funding,2,1,0,0,1,0,1,5
kuali_kc,org.kuali.kra.iacuc.protocol,9,0,0,0,1,0,1,11
kuali_kc,org.kuali.kra.iacuc.protocol.location,1,0,1,0,1,0,1,4
kuali_kc,org.kuali.kra.iacuc.protocol.reference,0,0,0,0,1,0,1,2
kuali_kc,org.kuali.kra.iacuc.protocol.research,0,0,0,0,0,0,1,1
kuali_kc,org.kuali.kra.iacuc.questionnaire,2,0,0,0,0,0,1,3
kuali_kc,org.kuali.kra.iacuc.questionnaire.print,1,0,0,0,1,0,1,3
kuali_kc,org.kuali.kra.iacuc.rules,0,0,0,0,0,0,1,1
kuali_kc,org.kuali.kra.iacuc.service,0,0,0,0,0,0,1,1
kuali_kc,org.kuali.kra.iacuc.service.impl,0,0,0,0,0,0,1,1
kuali_kc,org.kuali.kra.iacuc.specialreview,9,0,0,0,1,0,1,11
kuali_kc,org.kuali.kra.iacuc.species.exception,3,0,0,0,1,0,1,5
kuali_kc,org.kuali.kra.iacuc.species.exception.rule,2,1,0,0,0,0,1,4
kuali_kc,org.kuali.kra.iacuc.species,3,0,0,0,1,0,1,5
kuali_kc,org.kuali.kra.iacuc.species.rule,2,0,0,0,0,0,1,3
kuali_kc,org.kuali.kra.iacuc.summary,2,0,0,0,1,0,1,4
kuali_kc,org.kuali.kra.iacuc.threers,5,0,0,0,1,0,1,7
kuali_kc,org.kuali.kra.iacuc.workflow,0,0,0,0,0,0,1,1
kuali_kc,org.kuali.kra.iacucrest,0,0,0,0,0,0,1,1
kuali_kc,org.kuali.kra.infrastructure,1,1,0,0,1,0,1,4
kuali_kc,org.kuali.kra.institutionalproposal.attachments,4,0,0,0,0,0,1,5
kuali_kc,org.kuali.kra.institutionalproposal.contacts,7,1,0,1,0,0,1,10
kuali_kc,org.kuali.kra.institutionalproposal.customdata,3,0,0,0,0,0,1,4
kuali_kc,org.kuali.kra.institutionalproposal.dao,0,0,0,0,0,0,1,1
kuali_kc,org.kuali.kra.institutionalproposal.dao.ojb,0,0,0,0,0,0,1,1
kuali_kc,org.kuali.kra.institutionalproposal.document.authorization,0,0,0,0,0,0,1,1
kuali_kc,org.kuali.kra.institutionalproposal.document,11,1,0,0,0,0,1,13
kuali_kc,org.kuali.kra.institutionalproposal.exception,0,0,0,0,0,0,1,1
kuali_kc,org.kuali.kra.institutionalproposal.fundedawards,0,0,0,0,0,0,1,1
kuali_kc,org.kuali.kra.institutionalproposal.home,36,1,0,0,1,0,1,39
kuali_kc,org.kuali.kra.institutionalproposal,8,1,0,0,1,0,1,11
kuali_kc,org.kuali.kra.institutionalproposal.ipreview,2,0,0,0,0,0,1,3
kuali_kc,org.kuali.kra.institutionalproposal.lookup.keyvalue,0,0,0,0,0,0,1,1
kuali_kc,org.kuali.kra.institutionalproposal.notification,0,0,0,0,0,0,1,1
kuali_kc,org.kuali.kra.institutionalproposal.printing.print,0,0,0,0,0,0,1,1
kuali_kc,org.kuali.kra.institutionalproposal.printing.service.impl,0,0,0,0,0,0,1,1
kuali_kc,org.kuali.kra.institutionalproposal.printing.service,0,0,0,0,0,0,1,1
kuali_kc,org.kuali.kra.institutionalproposal.printing.xmlstream,0,0,0,0,0,0,1,1
kuali_kc,org.kuali.kra.institutionalproposal.proposaladmindetails,7,1,0,0,0,0,1,9
kuali_kc,org.kuali.kra.institutionalproposal.proposallog.printing,0,0,0,0,0,0,1,1
kuali_kc,org.kuali.kra.institutionalproposal.proposallog,3,0,0,0,1,0,1,5
kuali_kc,org.kuali.kra.institutionalproposal.proposallog.service.impl,0,0,0,0,0,0,1,1
kuali_kc,org.kuali.kra.institutionalproposal.proposallog.service,2,1,0,0,0,0,1,4
kuali_kc,org.kuali.kra.institutionalproposal.rules,3,0,0,0,0,0,1,4
kuali_kc,org.kuali.kra.institutionalproposal.service.impl,0,0,0,0,1,0,1,2
kuali_kc,org.kuali.kra.institutionalproposal.service,7,1,0,0,0,0,1,9
kuali_kc,org.kuali.kra.institutionalproposal.specialreview,7,1,0,0,0,0,1,9
kuali_kc,org.kuali.kra.institutionalproposal.web.struts.action,0,0,0,0,0,0,1,1
kuali_kc,org.kuali.kra.institutionalproposal.web.struts.form,12,1,0,0,0,0,1,14
kuali_kc,org.kuali.kra.irb.actions.abandon,7,0,0,0,0,0,1,8
kuali_kc,org.kuali.kra.irb.actions,110,1,0,0,0,0,1,112
kuali_kc,org.kuali.kra.irb.actions.amendrenew,22,1,0,0,0,0,1,24
kuali_kc,org.kuali.kra.irb.actions.approve,7,1,0,0,0,0,1,9
kuali_kc,org.kuali.kra.irb.actions.assignagenda,3,0,0,0,0,0,1,4
kuali_kc,org.kuali.kra.irb.actions.assigncmtsched,3,0,0,0,0,0,1,4
kuali_kc,org.kuali.kra.irb.actions.assignreviewers,2,0,0,0,1,0,1,4
kuali_kc,org.kuali.kra.irb.actions.copy,4,1,0,0,0,0,1,6
kuali_kc,org.kuali.kra.irb.actions.correction,3,0,0,0,1,0,1,5
kuali_kc,org.kuali.kra.irb.actions.correspondence,5,1,0,0,1,0,1,8
kuali_kc,org.kuali.kra.irb.actions.decision,4,0,0,0,0,0,1,5
kuali_kc,org.kuali.kra.irb.actions.delete,2,0,0,0,0,0,1,3
kuali_kc,org.kuali.kra.irb.actions.expeditedapprove,4,1,0,0,0,0,1,6
kuali_kc,org.kuali.kra.irb.actions.followup,2,1,0,0,0,0,1,4
kuali_kc,org.kuali.kra.irb.actions.genericactions,7,0,0,0,0,0,1,8
kuali_kc,org.kuali.kra.irb.actions.grantexemption,3,0,0,0,0,0,1,4
kuali_kc,org.kuali.kra.irb.actions.history,0,0,0,0,0,0,1,1
kuali_kc,org.kuali.kra.irb.actions.modifysubmission,2,0,0,0,0,0,1,3
kuali_kc,org.kuali.kra.irb.actions.noreview,2,0,0,0,0,0,1,3
kuali_kc,org.kuali.kra.irb.actions.notification,2,1,0,0,1,0,1,5
kuali_kc,org.kuali.kra.irb.actions.notifycommittee,2,0,0,0,0,0,1,3
kuali_kc,org.kuali.kra.irb.actions.notifyirb,3,0,0,0,1,0,1,5
kuali_kc,org.kuali.kra.irb.actions.print,8,1,0,0,1,0,1,11
kuali_kc,org.kuali.kra.irb.actions.proccessbillable,0,0,0,0,0,0,1,1
kuali_kc,org.kuali.kra.irb.actions.request,4,0,0,0,0,0,1,5
kuali_kc,org.kuali.kra.irb.actions.reviewcomments,5,0,0,0,1,0,1,7
kuali_kc,org.kuali.kra.irb.actions.risklevel,2,0,0,0,0,0,1,3
kuali_kc,org.kuali.kra.irb.actions.submit,8,1,0,1,0,0,1,11
kuali_kc,org.kuali.kra.irb.actions.undo,7,0,0,0,0,0,1,8
kuali_kc,org.kuali.kra.irb.actions.withdraw,3,0,0,0,0,0,1,4
kuali_kc,org.kuali.kra.irb.auth,3,0,0,1,0,0,1,5
kuali_kc,org.kuali.kra.irb.authorizer,0,0,0,0,0,0,1,1
kuali_kc,org.kuali.kra.irb.coi,0,0,0,0,0,0,1,1
kuali_kc,org.kuali.kra.irb.correspondence,3,1,0,0,1,0,1,6
kuali_kc,org.kuali.kra.irb.customdata,0,0,0,0,0,0,1,1
kuali_kc,org.kuali.kra.irb.infrastructure,0,0,0,0,0,0,1,1
kuali_kc,org.kuali.kra.irb,71,1,0,1,1,0,1,75
kuali_kc,org.kuali.kra.irb.kim.service.impl,0,0,0,0,0,0,1,1
kuali_kc,org.kuali.kra.irb.noteattachment,3,1,0,1,0,0,1,6
kuali_kc,org.kuali.kra.irb.notification,6,1,0,0,1,0,1,9
kuali_kc,org.kuali.kra.irb.onlinereview.authorization,0,0,0,0,0,0,1,1
kuali_kc,org.kuali.kra.irb.onlinereview.event,0,1,0,0,0,0,1,2
kuali_kc,org.kuali.kra.irb.onlinereview,4,1,0,0,1,0,1,7
kuali_kc,org.kuali.kra.irb.onlinereview.rules,0,0,0,0,1,0,1,2
kuali_kc,org.kuali.kra.irb.permission,0,0,0,0,0,0,1,1
kuali_kc,org.kuali.kra.irb.personnel,3,1,0,0,1,0,1,6
kuali_kc,org.kuali.kra.irb.protocol.funding,8,1,0,0,1,0,1,11
kuali_kc,org.kuali.kra.irb.protocol.funding.impl,4,0,0,0,0,0,1,5
kuali_kc,org.kuali.kra.irb.protocol.location,2,0,0,0,0,0,1,3
kuali_kc,org.kuali.kra.irb.protocol,9,0,0,0,1,0,1,11
kuali_kc,org.kuali.kra.irb.protocol.participant,7,0,0,0,0,0,1,8
kuali_kc,org.kuali.kra.irb.protocol.reference,2,0,0,0,0,0,1,3
kuali_kc,org.kuali.kra.irb.protocol.research,2,0,0,0,1,0,1,4
kuali_kc,org.kuali.kra.irb.questionnaire,3,0,0,0,0,0,1,4
kuali_kc,org.kuali.kra.irb.questionnaire.print,0,0,0,0,0,0,1,1
kuali_kc,org.kuali.kra.irb.service.impl,0,0,0,0,0,0,1,1
kuali_kc,org.kuali.kra.irb.service,0,0,0,0,0,0,1,1
kuali_kc,org.kuali.kra.irb.specialreview,3,0,0,0,1,0,1,5
kuali_kc,org.kuali.kra.irb.summary,1,1,0,0,0,0,1,3
kuali_kc,org.kuali.kra.irbrest,0,0,0,0,0,0,1,1
kuali_kc,org.kuali.kra.jqueryajax,0,0,0,0,0,0,1,1
kuali_kc,org.kuali.kra.kim.bo,1,0,0,0,0,0,1,2
kuali_kc,org.kuali.kra.kim.service.impl,0,0,0,0,0,0,1,1
kuali_kc,org.kuali.kra.krms,0,0,0,0,1,0,1,2
kuali_kc,org.kuali.kra.lookup.keyvalue,7,0,0,0,1,0,1,9
kuali_kc,org.kuali.kra.lookup,0,0,0,0,0,0,1,1
kuali_kc,org.kuali.kra.maintenance,0,0,0,0,0,0,1,1
kuali_kc,org.kuali.kra.meeting,7,1,0,1,1,0,1,11
kuali_kc,org.kuali.kra.negotiations.auth,0,0,0,0,0,0,1,1
kuali_kc,org.kuali.kra.negotiations.authorizer,0,0,0,0,0,0,1,1
kuali_kc,org.kuali.kra.negotiations.bo,3,1,0,0,0,0,1,5
kuali_kc,org.kuali.kra.negotiations.customdata,1,0,0,0,0,0,1,2
kuali_kc,org.kuali.kra.negotiations.document.authorization,0,0,0,0,0,0,1,1
kuali_kc,org.kuali.kra.negotiations.document,0,0,0,0,0,0,1,1
kuali_kc,org.kuali.kra.negotiations.keyvalue,0,0,0,0,0,0,1,1
kuali_kc,org.kuali.kra.negotiations.lookup,0,0,0,0,0,0,1,1
kuali_kc,org.kuali.kra.negotiations,0,0,0,0,0,0,1,1
kuali_kc,org.kuali.kra.negotiations.notifications,2,0,0,0,0,0,1,3
kuali_kc,org.kuali.kra.negotiations.printing.print,0,0,0,0,0,0,1,1
kuali_kc,org.kuali.kra.negotiations.printing.service.impl,0,0,0,0,0,0,1,1
kuali_kc,org.kuali.kra.negotiations.printing.service,0,0,0,0,0,0,1,1
kuali_kc,org.kuali.kra.negotiations.printing.xmlstream,0,0,0,0,0,0,1,1
kuali_kc,org.kuali.kra.negotiations.rules,0,0,0,0,0,0,1,1
kuali_kc,org.kuali.kra.negotiations.service,2,1,0,0,1,0,1,5
kuali_kc,org.kuali.kra.negotiations.sorting,0,0,0,0,1,0,1,2
kuali_kc,org.kuali.kra.negotiations.web.struts.action,0,0,0,0,0,0,1,1
kuali_kc,org.kuali.kra.negotiations.web.struts.form,1,1,0,0,0,0,1,3
kuali_kc,org.kuali.kra.personmasschange.bo,6,1,0,0,0,0,1,8
kuali_kc,org.kuali.kra.personmasschange.document.authorization,0,0,0,0,0,0,1,1
kuali_kc,org.kuali.kra.personmasschange.document,5,1,0,0,0,0,1,7
kuali_kc,org.kuali.kra.personmasschange.rule.event,0,0,0,0,0,0,1,1
kuali_kc,org.kuali.kra.personmasschange.rule,0,0,0,0,0,0,1,1
kuali_kc,org.kuali.kra.personmasschange.rules,0,0,0,0,0,0,1,1
kuali_kc,org.kuali.kra.personmasschange.service,4,1,0,0,1,0,1,7
kuali_kc,org.kuali.kra.personmasschange.service.impl,2,0,0,0,1,0,1,4
kuali_kc,org.kuali.kra.personmasschange.web.struts.action,0,0,0,0,0,0,1,1
kuali_kc,org.kuali.kra.personmasschange.web.struts.form,0,1,0,0,0,0,1,2
kuali_kc,org.kuali.kra.protocol.actions.abandon,0,0,0,0,0,0,1,1
kuali_kc,org.kuali.kra.protocol.actions,59,1,0,0,1,0,1,62
kuali_kc,org.kuali.kra.protocol.actions.amendrenew,7,1,0,0,1,0,1,10
kuali_kc,org.kuali.kra.protocol.actions.approve,2,0,0,0,0,0,1,3
kuali_kc,org.kuali.kra.protocol.actions.assignagenda,3,0,0,0,0,0,1,4
kuali_kc,org.kuali.kra.protocol.actions.assignreviewers,2,0,0,0,0,0,1,3
kuali_kc,org.kuali.kra.protocol.actions.copy,3,0,0,0,0,0,1,4
kuali_kc,org.kuali.kra.protocol.actions.correction,3,0,0,0,0,0,1,4
kuali_kc,org.kuali.kra.protocol.actions.correspondence,3,0,0,0,0,0,1,4
kuali_kc,org.kuali.kra.protocol.actions.decision,3,0,0,0,1,0,1,5
kuali_kc,org.kuali.kra.protocol.actions.delete,3,0,0,0,0,0,1,4
kuali_kc,org.kuali.kra.protocol.actions.followup,3,0,0,0,0,0,1,4
kuali_kc,org.kuali.kra.protocol.actions.genericactions,5,1,0,0,0,0,1,7
kuali_kc,org.kuali.kra.protocol.actions.noreview,0,0,0,0,0,0,1,1
kuali_kc,org.kuali.kra.protocol.actions.notify,0,0,0,0,0,0,1,1
kuali_kc,org.kuali.kra.protocol.actions.notifycommittee,0,0,0,0,0,0,1,1
kuali_kc,org.kuali.kra.protocol.actions.print,8,0,0,0,1,0,1,10
kuali_kc,org.kuali.kra.protocol.actions.request,0,0,0,0,0,0,1,1
kuali_kc,org.kuali.kra.protocol.actions.reviewcomments,6,1,0,0,1,0,1,9
kuali_kc,org.kuali.kra.protocol.actions.submit,39,1,0,0,0,0,1,41
kuali_kc,org.kuali.kra.protocol.actions.undo,3,0,0,0,0,0,1,4
kuali_kc,org.kuali.kra.protocol.actions.withdraw,4,0,0,0,0,0,1,5
kuali_kc,org.kuali.kra.protocol.auth,29,1,0,0,0,0,1,31
kuali_kc,org.kuali.kra.protocol.correspondence,6,1,0,0,1,0,1,9
kuali_kc,org.kuali.kra.protocol,107,1,0,1,1,0,1,111
kuali_kc,org.kuali.kra.protocol.customdata,1,0,0,0,0,0,1,2
kuali_kc,org.kuali.kra.protocol.drools.brms,0,0,0,0,0,0,1,1
kuali_kc,org.kuali.kra.protocol.drools.util,0,0,0,0,0,0,1,1
kuali_kc,org.kuali.kra.protocol.kim.service.impl,0,0,0,0,0,0,1,1
kuali_kc,org.kuali.kra.protocol.noteattachment,5,0,0,1,0,0,1,7
kuali_kc,org.kuali.kra.protocol.notification,6,1,0,0,1,0,1,9
kuali_kc,org.kuali.kra.protocol.onlinereview.authorization,0,0,0,0,0,0,1,1
kuali_kc,org.kuali.kra.protocol.onlinereview.event,0,1,0,0,1,0,1,3
kuali_kc,org.kuali.kra.protocol.onlinereview.lookup,0,0,0,0,0,0,1,1
kuali_kc,org.kuali.kra.protocol.onlinereview,5,1,0,0,0,0,1,7
kuali_kc,org.kuali.kra.protocol.onlinereview.rules,0,0,0,0,1,0,1,2
kuali_kc,org.kuali.kra.protocol.permission,0,0,0,0,0,0,1,1
kuali_kc,org.kuali.kra.protocol.personnel,3,1,0,0,0,0,1,5
kuali_kc,org.kuali.kra.protocol.protocol.funding,6,1,0,0,1,0,1,9
kuali_kc,org.kuali.kra.protocol.protocol.funding.impl,0,0,0,0,0,0,1,1
kuali_kc,org.kuali.kra.protocol.protocol.location,2,0,0,0,0,0,1,3
kuali_kc,org.kuali.kra.protocol.protocol,12,0,0,0,0,0,1,13
kuali_kc,org.kuali.kra.protocol.protocol.reference,2,0,0,0,0,0,1,3
kuali_kc,org.kuali.kra.protocol.protocol.research,1,0,0,0,0,0,1,2
kuali_kc,org.kuali.kra.protocol.questionnaire,9,0,0,0,1,0,1,11
kuali_kc,org.kuali.kra.protocol.specialreview.impl,0,0,0,0,0,0,1,1
kuali_kc,org.kuali.kra.protocol.specialreview,2,0,0,0,0,0,1,3
kuali_kc,org.kuali.kra.protocol.summary,3,1,0,0,0,0,1,5
kuali_kc,org.kuali.kra.protocol.workflow,0,0,0,0,0,0,1,1
kuali_kc,org.kuali.kra.service,5,1,0,0,1,0,1,8
kuali_kc,org.kuali.kra.service.impl,3,0,0,0,1,0,1,5
kuali_kc,org.kuali.kra,0,0,0,0,0,0,1,1
kuali_kc,org.kuali.kra.subaward.authorizer,0,0,0,0,0,0,1,1
kuali_kc,org.kuali.kra.subaward.bo,4,1,0,0,1,0,1,7
kuali_kc,org.kuali.kra.subaward.customdata,1,0,0,0,0,0,1,2
kuali_kc,org.kuali.kra.subaward.dao,0,0,0,0,0,0,1,1
kuali_kc,org.kuali.kra.subaward.document.authorization,0,0,0,0,0,0,1,1
kuali_kc,org.kuali.kra.subaward.document.authorizer,0,0,0,0,0,0,1,1
kuali_kc,org.kuali.kra.subaward.document,5,1,0,0,0,0,1,7
kuali_kc,org.kuali.kra.subaward.fdp,0,0,0,0,0,0,1,1
kuali_kc,org.kuali.kra.subaward.lookup.keyvalue,0,0,0,0,0,0,1,1
kuali_kc,org.kuali.kra.subaward.lookup,0,0,0,0,0,0,1,1
kuali_kc,org.kuali.kra.subaward.notification,0,0,0,0,0,0,1,1
kuali_kc,org.kuali.kra.subaward.reporting.printing.print,0,0,0,0,0,0,1,1
kuali_kc,org.kuali.kra.subaward.reporting.printing.service.impl,0,0,0,0,0,0,1,1
kuali_kc,org.kuali.kra.subaward.reporting.printing.service,0,1,0,0,0,0,1,2
kuali_kc,org.kuali.kra.subaward.reporting.printing.xmlstream,0,0,0,0,0,0,1,1
kuali_kc,org.kuali.kra.subaward.reporting.web.struts.action,0,0,0,0,0,0,1,1
kuali_kc,org.kuali.kra.subaward.reporting.web.struts.form,0,0,0,0,0,0,1,1
kuali_kc,org.kuali.kra.subaward.service.impl,0,0,0,0,0,0,1,1
kuali_kc,org.kuali.kra.subaward.service,3,0,0,0,0,0,1,4
kuali_kc,org.kuali.kra.subaward,2,1,0,0,0,0,1,4
kuali_kc,org.kuali.kra.subaward.subawardrule,0,0,0,0,1,0,1,2
kuali_kc,org.kuali.kra.subaward.subawardrule.events,0,0,0,0,0,0,1,1
kuali_kc,org.kuali.kra.subaward.templateAttachments,1,0,0,0,0,0,1,2
kuali_kc,org.kuali.kra.subaward.web.struts.action,0,0,0,0,0,0,1,1
kuali_kc,org.kuali.kra.subawardReporting.printing.print,0,0,0,0,0,0,1,1
kuali_kc,org.kuali.kra.subawardReporting.printing.xmlstream,0,0,0,0,0,0,1,1
kuali_kc,org.kuali.kra.timeandmoney.authorizer,0,0,0,0,0,0,1,1
kuali_kc,org.kuali.kra.timeandmoney,11,1,0,0,1,0,1,14
kuali_kc,org.kuali.kra.timeandmoney.dao.impl,0,0,0,0,0,0,1,1
kuali_kc,org.kuali.kra.timeandmoney.dao,0,0,0,0,0,0,1,1
kuali_kc,org.kuali.kra.timeandmoney.document.authorization,0,0,0,0,0,0,1,1
kuali_kc,org.kuali.kra.timeandmoney.document.authorizer,0,0,0,0,0,0,1,1
kuali_kc,org.kuali.kra.timeandmoney.document,10,1,0,0,0,0,1,12
kuali_kc,org.kuali.kra.timeandmoney.history,0,0,0,0,0,0,1,1
kuali_kc,org.kuali.kra.timeandmoney.rule.event,3,1,0,0,0,0,1,5
kuali_kc,org.kuali.kra.timeandmoney.rules,4,0,0,0,0,0,1,5
kuali_kc,org.kuali.kra.timeandmoney.service,3,1,0,0,1,0,1,6
kuali_kc,org.kuali.kra.timeandmoney.service.impl,0,0,0,0,1,0,1,2
kuali_kc,org.kuali.kra.timeandmoney.transactions,13,1,0,0,0,0,1,15
kuali_kc,org.kuali.kra.timeandmoney.web.struts.action,0,0,0,0,0,0,1,1
kuali_kc,org.kuali.kra.web.krad,1,0,0,0,0,0,1,2
kuali_kc,org.kuali.kra.web.krad.homepage,0,0,0,0,0,0,1,1
kuali_kc,org.kuali.kra.web.struts.action,0,0,0,0,0,0,1,1
kuali_kc,org.kuali.kra.web.struts.form,0,0,0,0,0,0,1,1
kuali_kc,org.kuali.kra.workflow,0,0,0,0,0,0,1,1
kuali_kc,org.kuali.rice.kew.impl.peopleflow,0,0,0,0,0,0,1,1
kuali_kc,org.kuali.coeus.propdev.impl,0,0,0,0,0,0,1,1
kuali_kc,org.kuali.kra.budget.bo,0,0,0,0,1,0,1,2
kuali_kc,org.kuali.kra.budget.nonpersonnel,0,0,0,0,0,0,1,1
kuali_kc,org.kuali.kra.budget.rules,0,0,0,0,1,0,1,2
kuali_kc,org.kuali.kra.budget.service,0,0,0,0,0,0,1,1
kuali_kc,org.kuali.kra.committee.authorizers,0,0,0,0,0,0,1,1
kuali_kc,org.kuali.kra.committee.web.struts.form.schedule,0,0,0,0,0,0,1,1
kuali_kc,org.kuali.kra.committee.web.struts.form.schedule.util,0,0,0,0,0,0,1,1
kuali_kc,org.kuali.kra.common.notification,0,0,0,0,0,0,1,1
kuali_kc,org.kuali.kra.common.notification.rules,0,0,0,0,0,0,1,1
kuali_kc,org.kuali.kra.irb.protocol.questionnaire,0,0,0,0,0,0,1,1
kuali_kc,org.kuali.kra.proposaldevelopment.budget.service.impl,0,0,0,0,0,0,1,1
kuali_kc,org.kuali.kra.proposaldevelopment.rules,0,0,0,0,1,0,1,2
kuali_kc,org.kuali.kra.questionnaire.answer,0,0,0,0,0,0,1,1
kuali_kc,org.kuali.kra.questionnaire.question,0,0,0,0,0,0,1,1
kuali_kc,org.kuali.kra.rules,2,0,0,0,0,0,1,3
kuali_kc,org.kuali.kra.scheduling.quartz,0,0,0,0,0,0,1,1
kuali_kc,org.kuali.kra.scheduling.service,0,0,0,0,0,0,1,1
kuali_kc,org.kuali.kra.scheduling.util,0,0,0,0,0,0,1,1
kuali_kc,org.kuali.kra.service.impl.adapters,0,0,0,0,1,0,1,2
kuali_kc,org.kuali.kra.service.impl.mocks,0,0,0,0,0,0,1,1
kuali_kc,org.kuali.kra.service.impl.versioningartifacts,0,0,0,0,1,0,1,2
kuali_kc,org.kuali.org.kuali.kra.s2s.depend,0,0,0,0,0,0,1,1
kuali_kc,org.kuali.coeus.common.protocol,0,0,0,0,0,0,1,1
kuali_kc,org.kuali.coeus.org.jmock.lib.legacy,0,0,0,0,0,0,1,1
kuali_kc,org.kuali.coeus.propdev.impl.budget.calculator,0,0,0,0,0,0,1,1
kuali_kc,org.kuali.coeus.s2sgen.impl.generate.support,2,0,0,1,0,0,1,4
kuali_kc,org.kuali.coeus.sys.impl.service,0,0,0,0,0,0,1,1
kuali_kc,org.kuali.kra.budget.document,0,0,0,0,0,0,1,1
kuali_kc,org.kuali.kra.committee,0,0,0,0,0,0,1,1
kuali_kc,org.kuali.kra.common.specialreview.lookup.keyvalue,0,0,0,0,0,0,1,1
kuali_kc,org.kuali.kra.common.specialreview.rules,0,0,0,0,0,0,1,1
kuali_kc,org.kuali.kra.costshare,1,0,0,0,0,0,1,2
kuali_kc,org.kuali.kra.document,0,0,0,0,0,0,1,1
kuali_kc,org.kuali.kra.irb.protocol.summary,0,0,0,0,0,0,1,1
kuali_kc,org.kuali.kra.keyvalue,0,0,0,0,0,0,1,1
kuali_kc,org.kuali.kra.printing.util,0,0,0,0,0,0,1,1
kuali_kc,org.kuali.kra.proposaldevelopment.document,0,0,0,0,0,0,1,1
kuali_kc,org.kuali.kra.proposaldevelopment.lookup.keyvalue,0,0,0,0,1,0,1,2
kuali_kc,org.kuali.kra.proposaldevelopment,0,0,0,0,0,0,1,1
kuali_kc,org.kuali.kra.proposaldevelopment.service,0,0,0,0,0,0,1,1
kuali_kc,org.kuali.kra.proposaldevelopment.specialreview,0,0,0,0,0,0,1,1
kuali_kc,org.kuali.kra.questionnaire.print,0,0,0,0,0,0,1,1
kuali_kc,org.kuali.kra.questionnaire,0,0,0,0,0,0,1,1
kuali_kc,org.kuali.kra.reporting.service.impl,0,0,0,0,0,0,1,1
kuali_kc,org.kuali.kra.rice.integration,0,0,0,0,0,0,1,1
kuenishi_presto-riak,com.basho.riak.presto.cli,0,0,0,0,0,0,0,0
kuenishi_presto-riak,com.basho.riak.presto,0,0,0,0,1,0,0,1
kuenishi_presto-riak,com.basho.riak.presto.models,0,0,0,0,1,0,0,1
Kurento_kurento-java,org.kurento.basicroom,0,0,0,0,0,0,0,0
Kurento_kurento-java,org.kurento.client,3,1,0,1,1,0,0,6
Kurento_kurento-java,org.kurento.client.internal.client,3,1,0,0,1,0,0,5
Kurento_kurento-java,org.kurento.client.internal.client.operation,0,0,0,0,1,0,0,1
Kurento_kurento-java,org.kurento.client.internal,2,0,0,0,1,0,0,3
Kurento_kurento-java,org.kurento.client.internal.server,0,0,0,0,1,0,0,1
Kurento_kurento-java,org.kurento.client.internal.transport.jsonrpc,0,0,0,0,0,0,0,0
Kurento_kurento-java,org.kurento.client.internal.transport.serialization,1,1,0,0,0,0,0,2
Kurento_kurento-java,org.kurento.module,0,0,0,0,0,0,0,0
Kurento_kurento-java,org.kurento.commons,0,0,0,0,1,0,0,1
Kurento_kurento-java,org.kurento.commons.exception,0,0,0,0,0,0,0,0
Kurento_kurento-java,org.kurento.commons.net,0,0,0,0,0,0,0,0
Kurento_kurento-java,(default package),0,0,0,0,0,0,0,0
Kurento_kurento-java,org.kurento.repository,0,0,0,0,1,1,0,2
Kurento_kurento-java,org.kurento.jsonrpc.client,3,0,0,0,1,0,0,4
Kurento_kurento-java,org.kurento.jsonrpc,3,1,0,0,1,0,0,5
Kurento_kurento-java,org.kurento.jsonrpc.internal.client,0,0,0,0,0,0,0,0
Kurento_kurento-java,org.kurento.jsonrpc.internal,5,1,0,0,1,0,0,7
Kurento_kurento-java,org.kurento.jsonrpc.internal.ws,0,0,0,0,0,0,0,0
Kurento_kurento-java,org.kurento.jsonrpc.message,5,1,0,0,0,0,0,6
Kurento_kurento-java,org.kurento.jsonrpc.handler,0,0,0,0,0,0,0,0
Kurento_kurento-java,org.kurento.jsonrpc.internal.http,0,0,0,0,0,0,0,0
Kurento_kurento-java,org.kurento.jsonrpc.internal.server,0,0,0,0,1,0,0,1
Kurento_kurento-java,org.kurento.jsonrpc.internal.server.config,0,0,0,0,0,0,0,0
Kurento_kurento-java,org.kurento.jsonrpc.server,0,0,0,0,0,0,0,0
Kurento_kurento-java,org.kurento.repository.service.pojo,0,0,0,0,0,0,0,0
Kurento_kurento-java,org.kurento.repository.internal.http,0,0,0,0,0,1,0,1
Kurento_kurento-java,org.kurento.repository.internal,0,0,0,0,0,1,0,1
Kurento_kurento-java,org.kurento.repository.internal.repoimpl,0,0,0,0,0,0,0,0
Kurento_kurento-java,org.kurento.repository.internal.repoimpl.filesystem,0,0,0,0,0,0,0,0
Kurento_kurento-java,org.kurento.repository.internal.repoimpl.mongo,0,0,0,0,0,0,0,0
kuujo_copycat,io.atomix.agent,0,0,0,0,0,0,1,1
kuujo_copycat,io.atomix.cluster,7,1,0,0,0,6,1,15
kuujo_copycat,io.atomix.cluster.discovery,2,0,0,0,1,0,1,4
kuujo_copycat,io.atomix.cluster.impl,4,1,0,0,1,0,1,7
kuujo_copycat,io.atomix.cluster.messaging,0,0,0,0,1,4,1,6
kuujo_copycat,io.atomix.cluster.messaging.impl,8,0,0,1,1,3,1,14
kuujo_copycat,io.atomix.cluster.protocol,4,1,0,0,0,0,1,6
kuujo_copycat,io.atomix.core,1,1,0,0,1,5,1,9
kuujo_copycat,io.atomix.core.barrier,1,1,0,0,1,0,1,4
kuujo_copycat,io.atomix.core.barrier.impl,1,0,0,0,1,0,1,3
kuujo_copycat,io.atomix.core.cache,0,0,0,0,0,1,1,2
kuujo_copycat,io.atomix.core.collection,0,0,0,0,1,7,1,9
kuujo_copycat,io.atomix.core.collection.impl,0,0,0,0,1,4,1,6
kuujo_copycat,io.atomix.core.counter,1,1,0,0,1,1,1,5
kuujo_copycat,io.atomix.core.counter.impl,1,0,0,0,1,1,1,4
kuujo_copycat,io.atomix.core.election,0,1,0,0,1,3,1,6
kuujo_copycat,io.atomix.core.election.impl,0,0,0,0,1,3,1,5
kuujo_copycat,io.atomix.core.idgenerator,1,1,0,0,1,0,1,4
kuujo_copycat,io.atomix.core.idgenerator.impl,1,0,0,0,0,0,1,2
kuujo_copycat,io.atomix.core.impl,6,0,0,0,1,0,1,8
kuujo_copycat,io.atomix.core.iterator,0,0,0,0,0,0,1,1
kuujo_copycat,io.atomix.core.iterator.impl,0,0,0,0,1,0,1,2
kuujo_copycat,io.atomix.core.list,0,0,0,0,1,0,1,2
kuujo_copycat,io.atomix.core.list.impl,0,0,0,0,1,0,1,2
kuujo_copycat,io.atomix.core.lock,1,1,0,0,1,1,1,5
kuujo_copycat,io.atomix.core.lock.impl,1,0,0,0,1,3,1,6
kuujo_copycat,io.atomix.core.log,1,1,0,0,1,0,1,4
kuujo_copycat,io.atomix.core.log.impl,1,0,0,0,0,1,1,3
kuujo_copycat,io.atomix.core.map,11,1,0,1,1,9,1,24
kuujo_copycat,io.atomix.core.map.impl,7,0,0,1,1,15,1,25
kuujo_copycat,io.atomix.core.multimap,0,0,0,0,1,1,1,3
kuujo_copycat,io.atomix.core.multimap.impl,0,0,0,0,1,0,1,2
kuujo_copycat,io.atomix.core.multiset,0,0,0,0,1,0,1,2
kuujo_copycat,io.atomix.core.multiset.impl,0,0,0,0,1,0,1,2
kuujo_copycat,io.atomix.core.profile,0,1,0,0,0,0,1,2
kuujo_copycat,io.atomix.core.profile.impl,0,0,0,0,0,0,1,1
kuujo_copycat,io.atomix.core.queue,0,0,0,0,1,0,1,2
kuujo_copycat,io.atomix.core.queue.impl,0,0,0,0,1,1,1,3
kuujo_copycat,io.atomix.core.registry,0,0,0,0,0,0,1,1
kuujo_copycat,io.atomix.core.semaphore,1,1,0,0,1,3,1,7
kuujo_copycat,io.atomix.core.semaphore.impl,1,0,0,0,1,2,1,5
kuujo_copycat,io.atomix.core.set,6,1,0,0,1,5,1,14
kuujo_copycat,io.atomix.core.set.impl,2,0,0,1,0,9,1,13
kuujo_copycat,io.atomix.core.transaction,14,1,0,0,1,3,1,20
kuujo_copycat,io.atomix.core.transaction.impl,4,0,0,0,0,2,1,7
kuujo_copycat,io.atomix.core.tree,2,1,0,0,0,1,1,5
kuujo_copycat,io.atomix.core.tree.impl,1,0,0,0,1,2,1,5
kuujo_copycat,io.atomix.core.utils.config,0,0,0,0,0,0,1,1
kuujo_copycat,io.atomix.core.value,2,1,0,0,1,1,1,6
kuujo_copycat,io.atomix.core.value.impl,2,0,0,0,1,2,1,6
kuujo_copycat,io.atomix.core.workqueue,0,0,0,0,1,0,1,2
kuujo_copycat,io.atomix.core.workqueue.impl,0,0,0,0,1,0,1,2
kuujo_copycat,io.atomix.core.registry.impl,0,0,0,0,0,0,1,1
kuujo_copycat,io.atomix.core.types,0,0,0,0,0,0,1,1
kuujo_copycat,io.atomix.primitive,2,1,0,0,1,22,1,27
kuujo_copycat,io.atomix.primitive.config,0,0,0,0,0,6,1,7
kuujo_copycat,io.atomix.primitive.config.impl,0,0,0,0,0,0,1,1
kuujo_copycat,io.atomix.primitive.event,0,0,0,0,0,1,1,2
kuujo_copycat,io.atomix.primitive.event.impl,0,0,0,0,0,0,1,1
kuujo_copycat,io.atomix.primitive.impl,0,0,0,0,0,12,1,13
kuujo_copycat,io.atomix.primitive.log,0,0,0,0,1,2,1,4
kuujo_copycat,io.atomix.primitive.operation,0,0,0,0,0,1,1,2
kuujo_copycat,io.atomix.primitive.operation.impl,0,0,0,0,0,0,1,1
kuujo_copycat,io.atomix.primitive.partition,0,0,0,1,1,6,1,9
kuujo_copycat,io.atomix.primitive.partition.impl,0,0,0,0,1,2,1,4
kuujo_copycat,io.atomix.primitive.protocol.counter,0,0,0,0,0,0,1,1
kuujo_copycat,io.atomix.primitive.protocol,0,0,0,0,1,0,1,2
kuujo_copycat,io.atomix.primitive.protocol.impl,0,0,0,0,0,0,1,1
kuujo_copycat,io.atomix.primitive.protocol.map,0,0,0,0,1,2,1,4
kuujo_copycat,io.atomix.primitive.protocol.set,0,0,0,0,1,2,1,4
kuujo_copycat,io.atomix.primitive.protocol.value,0,0,0,0,0,1,1,2
kuujo_copycat,io.atomix.primitive.proxy.impl,0,0,0,0,1,2,1,4
kuujo_copycat,io.atomix.primitive.proxy,0,0,0,0,0,6,1,7
kuujo_copycat,io.atomix.primitive.serialization,0,0,0,0,0,1,1,2
kuujo_copycat,io.atomix.primitive.service,2,0,0,0,1,1,1,5
kuujo_copycat,io.atomix.primitive.service.impl,1,0,0,0,0,0,1,2
kuujo_copycat,io.atomix.primitive.session.impl,0,0,0,0,1,2,1,4
kuujo_copycat,io.atomix.primitive.session,0,0,0,0,1,6,1,8
kuujo_copycat,io.atomix.protocols.gossip,0,0,0,0,1,0,1,2
kuujo_copycat,io.atomix.protocols.gossip.counter,0,0,0,0,0,0,1,1
kuujo_copycat,io.atomix.protocols.gossip.map,0,0,0,0,1,0,1,2
kuujo_copycat,io.atomix.protocols.gossip.set,0,0,0,0,0,0,1,1
kuujo_copycat,io.atomix.protocols.gossip.value,0,0,0,0,0,0,1,1
kuujo_copycat,io.atomix.protocols.log,1,1,0,0,0,1,1,4
kuujo_copycat,io.atomix.protocols.log.impl,1,0,0,0,0,2,1,4
kuujo_copycat,io.atomix.protocols.log.partition.impl,0,0,0,0,0,2,1,3
kuujo_copycat,io.atomix.protocols.log.partition,0,1,0,0,1,2,1,5
kuujo_copycat,io.atomix.protocols.log.protocol,0,0,0,0,1,2,1,4
kuujo_copycat,io.atomix.protocols.log.roles,0,0,0,0,1,0,1,2
kuujo_copycat,io.atomix.protocols.log.serializer.impl,0,0,0,0,0,0,1,1
kuujo_copycat,io.atomix.protocols.backup.impl,0,0,0,0,0,1,1,2
kuujo_copycat,io.atomix.protocols.backup,0,1,0,0,0,1,1,3
kuujo_copycat,io.atomix.protocols.backup.partition.impl,0,0,0,0,0,2,1,3
kuujo_copycat,io.atomix.protocols.backup.partition,0,1,0,0,0,2,1,4
kuujo_copycat,io.atomix.protocols.backup.protocol,0,0,0,0,1,0,1,2
kuujo_copycat,io.atomix.protocols.backup.roles,0,0,0,0,1,0,1,2
kuujo_copycat,io.atomix.protocols.backup.serializer.impl,0,0,0,0,0,0,1,1
kuujo_copycat,io.atomix.protocols.backup.service.impl,0,0,0,0,0,1,1,2
kuujo_copycat,io.atomix.protocols.backup.session,0,0,0,0,0,0,1,1
kuujo_copycat,io.atomix.protocols.raft.cluster.impl,0,0,0,0,0,0,1,1
kuujo_copycat,io.atomix.protocols.raft.cluster,0,0,0,0,0,0,1,1
kuujo_copycat,io.atomix.protocols.raft.impl,9,1,0,0,1,1,1,13
kuujo_copycat,io.atomix.protocols.raft,9,1,0,1,1,2,1,15
kuujo_copycat,io.atomix.protocols.raft.partition.impl,0,0,0,0,1,2,1,4
kuujo_copycat,io.atomix.protocols.raft.partition,0,1,0,0,1,1,1,4
kuujo_copycat,io.atomix.protocols.raft.protocol,5,1,0,1,0,5,1,13
kuujo_copycat,io.atomix.protocols.raft.roles,0,0,0,0,1,0,1,2
kuujo_copycat,io.atomix.protocols.raft.service,3,0,0,0,0,1,1,5
kuujo_copycat,io.atomix.protocols.raft.session,7,1,0,0,1,1,1,11
kuujo_copycat,io.atomix.protocols.raft.session.impl,3,0,0,0,0,4,1,8
kuujo_copycat,io.atomix.protocols.raft.storage.log.entry,0,0,0,0,0,0,1,1
kuujo_copycat,io.atomix.protocols.raft.storage.log,0,1,0,0,0,0,1,2
kuujo_copycat,io.atomix.protocols.raft.storage,1,1,0,0,0,1,1,4
kuujo_copycat,io.atomix.protocols.raft.storage.snapshot,1,0,0,0,0,1,1,3
kuujo_copycat,io.atomix.protocols.raft.storage.system,0,0,0,0,0,0,1,1
kuujo_copycat,io.atomix.protocols.raft.utils,0,0,0,0,0,0,1,1
kuujo_copycat,io.atomix.rest,1,1,0,0,0,0,1,3
kuujo_copycat,io.atomix.rest.impl,1,0,0,0,1,3,1,6
kuujo_copycat,io.atomix.rest.resources,0,0,0,0,1,6,1,8
kuujo_copycat,io.atomix.storage.buffer,0,0,0,1,0,2,1,4
kuujo_copycat,io.atomix.storage.journal,0,0,0,0,0,0,1,1
kuujo_copycat,io.atomix.storage.journal.index,0,0,0,0,0,0,1,1
kuujo_copycat,io.atomix.storage,0,0,0,0,0,0,1,1
kuujo_copycat,io.atomix.storage.statistics,0,0,0,0,0,0,1,1
kuujo_copycat,io.atomix.utils,0,0,0,0,1,12,1,14
kuujo_copycat,io.atomix.utils.concurrent,0,0,0,1,1,13,1,16
kuujo_copycat,io.atomix.utils.config,0,0,0,0,1,4,1,6
kuujo_copycat,io.atomix.utils.event,0,0,0,0,1,10,1,12
kuujo_copycat,io.atomix.utils.logging,0,0,0,0,1,0,1,2
kuujo_copycat,io.atomix.utils.memory,0,0,0,0,1,0,1,2
kuujo_copycat,io.atomix.utils.misc,0,0,0,0,1,0,1,2
kuujo_copycat,io.atomix.utils.net,0,0,0,0,0,3,1,4
kuujo_copycat,io.atomix.utils.serializer,0,0,0,0,1,7,1,9
kuujo_copycat,io.atomix.utils.serializer.serializers,0,0,0,0,0,0,1,1
kuujo_copycat,io.atomix.utils.time,0,0,0,0,0,4,1,5
kzwang_elasticsearch-image,org.elasticsearch,0,0,0,0,0,0,0,0
kzwang_elasticsearch-image,org.elasticsearch.index.mapper.image,0,0,0,0,0,0,0,0
kzwang_elasticsearch-image,org.elasticsearch.index.query.image,0,0,0,0,1,0,0,1
kzwang_elasticsearch-image,org.elasticsearch.plugin.image,0,0,0,0,0,0,0,0
la-team_light-admin,org.lightadmin.api.config,0,0,0,0,0,0,0,0
la-team_light-admin,org.lightadmin.api.config.builder,0,0,0,0,1,3,0,4
la-team_light-admin,org.lightadmin.api.config.management.rmi,0,0,0,0,0,1,0,1
la-team_light-admin,org.lightadmin.api.config.unit,0,0,0,0,1,3,0,4
la-team_light-admin,org.lightadmin.api.config.utils,0,0,0,0,1,1,0,2
la-team_light-admin,org.lightadmin.core.config.bootstrap,0,0,0,0,0,0,0,0
la-team_light-admin,org.lightadmin.core.config.bootstrap.parsing,0,0,0,0,0,0,0,0
la-team_light-admin,org.lightadmin.core.config.bootstrap.parsing.validation,0,0,0,0,1,0,0,1
la-team_light-admin,org.lightadmin.core.config.bootstrap.scanning,0,0,0,0,0,0,0,0
la-team_light-admin,org.lightadmin.core.config.context,1,0,0,0,1,0,0,2
la-team_light-admin,org.lightadmin.core.config.domain.common,0,0,0,0,0,0,0,0
la-team_light-admin,org.lightadmin.core.config.domain.configuration,0,0,0,0,0,1,0,1
la-team_light-admin,org.lightadmin.core.config.domain.configuration.support,0,0,0,0,1,0,0,1
la-team_light-admin,org.lightadmin.core.config.domain.context,0,0,0,0,0,1,0,1
la-team_light-admin,org.lightadmin.core.config.domain,0,0,0,0,1,1,0,2
la-team_light-admin,org.lightadmin.core.config.domain.field,0,0,0,0,0,0,0,0
la-team_light-admin,org.lightadmin.core.config.domain.filter,0,0,0,0,0,0,0,0
la-team_light-admin,org.lightadmin.core.config.domain.renderer,0,0,0,0,0,0,0,0
la-team_light-admin,org.lightadmin.core.config.domain.scope,0,0,0,0,0,1,0,1
la-team_light-admin,org.lightadmin.core.config.domain.sidebar,0,0,0,0,0,0,0,0
la-team_light-admin,org.lightadmin.core.config.domain.unit,0,0,0,0,1,5,0,6
la-team_light-admin,org.lightadmin.core.config.domain.unit.handler,0,0,0,0,0,0,0,0
la-team_light-admin,org.lightadmin.core.config.domain.unit.processor,0,0,0,0,1,0,0,1
la-team_light-admin,org.lightadmin.core.config.domain.unit.visitor,0,0,0,0,1,0,0,1
la-team_light-admin,org.lightadmin.core.config,1,1,0,0,0,0,0,2
la-team_light-admin,org.lightadmin.core.config.management.jmx,0,1,0,0,0,1,0,2
la-team_light-admin,org.lightadmin.core.config.management.rmi,0,0,0,0,0,0,0,0
la-team_light-admin,org.lightadmin.core.persistence.repository,0,0,0,0,0,0,0,0
la-team_light-admin,org.lightadmin.core.persistence.repository.event,0,0,0,0,1,0,0,1
la-team_light-admin,org.lightadmin.core.persistence.repository.invoker,0,0,0,0,0,0,0,0
la-team_light-admin,org.lightadmin.core.persistence.support,0,0,0,0,0,0,0,0
la-team_light-admin,org.lightadmin.core.reporting,0,0,0,0,0,0,0,0
la-team_light-admin,org.lightadmin.core.storage,0,0,0,0,0,0,0,0
la-team_light-admin,org.lightadmin.core.storage.strategy.binary,0,0,0,0,0,0,0,0
la-team_light-admin,org.lightadmin.core.storage.strategy.file.command,0,0,0,0,1,0,0,1
la-team_light-admin,org.lightadmin.core.storage.strategy.file,0,0,0,0,0,0,0,0
la-team_light-admin,org.lightadmin.core.util,0,0,0,0,1,0,0,1
la-team_light-admin,org.lightadmin.core.view.editor,0,0,0,0,0,0,0,0
la-team_light-admin,org.lightadmin.core.view,0,0,0,0,1,0,0,1
la-team_light-admin,org.lightadmin.core.view.preparer,0,0,0,0,1,0,0,1
la-team_light-admin,org.lightadmin.core.view.preparer.support,0,0,0,0,0,0,0,0
la-team_light-admin,org.lightadmin.core.view.tags,0,0,0,0,0,0,0,0
la-team_light-admin,org.lightadmin.core.view.tags.form,0,0,0,0,0,0,0,0
la-team_light-admin,org.lightadmin.core.web,0,0,0,0,0,0,0,0
la-team_light-admin,org.lightadmin.core.web.json,0,0,0,0,1,0,0,1
la-team_light-admin,org.lightadmin.core.web.security,0,0,0,0,0,0,0,0
la-team_light-admin,org.lightadmin.core.web.support,0,0,0,0,1,0,0,1
la-team_light-admin,org.lightadmin.core.web.util,0,0,0,0,0,0,0,0
la-team_light-admin,org.lightadmin.core.config.bootstrap.parsing.configuration,0,0,0,0,0,0,0,0
la-team_light-admin,org.lightadmin.core.config.bootstrap.scanning.config,0,0,0,0,0,0,0,0
la-team_light-admin,org.lightadmin.core.context,0,0,0,0,0,0,0,0
la-team_light-admin,org.lightadmin.core.extension,0,0,0,0,0,0,0,0
la-team_light-admin,org.lightadmin.demo.config,0,0,0,0,1,1,0,2
la-team_light-admin,org.lightadmin.demo.config.listener,0,0,0,0,0,0,0,0
la-team_light-admin,org.lightadmin.demo.model,0,0,0,0,1,0,0,1
la-team_light-admin,org.lightadmin.demo.service,0,0,0,0,0,0,0,0
la-team_light-admin,org.lightadmin,0,0,0,0,1,0,0,1
la-team_light-admin,org.lightadmin.component,1,1,0,0,1,1,0,4
la-team_light-admin,org.lightadmin.data,0,0,0,0,0,0,0,0
la-team_light-admin,org.lightadmin.field,0,0,0,0,0,0,0,0
la-team_light-admin,org.lightadmin.page,1,0,0,0,1,2,0,4
la-team_light-admin,org.lightadmin.util,0,0,0,0,0,3,0,3
la-team_light-admin,org.lightadmin.config,0,0,0,0,1,1,0,2
la-team_light-admin,org.lightadmin.crudOperations.create,0,0,0,0,0,1,0,1
la-team_light-admin,org.lightadmin.crudOperations.delete,0,0,0,0,0,0,0,0
la-team_light-admin,org.lightadmin.crudOperations.edit,0,0,0,0,0,1,0,1
la-team_light-admin,org.lightadmin.page.fieldDisplay,0,0,0,0,0,0,0,0
la-team_light-admin,org.lightadmin.page.fieldDisplay.editView,0,0,0,0,0,0,0,0
la-team_light-admin,org.lightadmin.page.fieldDisplay.filter,0,0,0,0,0,0,0,0
la-team_light-admin,org.lightadmin.page.fieldDisplay.listView,0,0,0,0,1,0,0,1
la-team_light-admin,org.lightadmin.page.fieldDisplay.quickView,0,0,0,0,0,1,0,1
larsga_Duke,no.priv.garshol.duke,13,1,0,1,0,6,1,22
larsga_Duke,no.priv.garshol.duke.cleaners,3,0,0,0,1,1,1,6
larsga_Duke,no.priv.garshol.duke.comparators,3,1,0,1,1,1,1,8
larsga_Duke,no.priv.garshol.duke.databases,4,0,0,1,1,2,1,9
larsga_Duke,no.priv.garshol.duke.datasources,4,0,0,0,0,3,1,8
larsga_Duke,no.priv.garshol.duke.examples,0,0,0,0,0,0,1,1
larsga_Duke,no.priv.garshol.duke.genetic,0,0,0,0,0,1,1,2
larsga_Duke,no.priv.garshol.duke.matchers,2,0,0,0,0,2,1,5
larsga_Duke,no.priv.garshol.duke.utils,9,1,0,1,1,2,1,15
larsga_Duke,no.priv.garshol.duke.integration,0,0,0,0,0,0,1,1
larsga_Duke,no.priv.garshol.duke.databases.es,0,0,0,0,0,0,1,1
larsga_Duke,no.priv.garshol.duke.server,0,0,0,0,0,0,1,1
lejon_T-SNE-Java,com.jujutsu.tsne.barneshut,0,0,0,0,0,0,0,0
lejon_T-SNE-Java,com.jujutsu.tsne,1,0,0,0,1,0,0,2
lejon_T-SNE-Java,com.jujutsu.utils,1,1,0,0,1,0,0,3
lejon_T-SNE-Java,com.jujutsu.tsne.demos,0,0,0,0,1,0,0,1
lejon_T-SNE-Java,org.math.plot.plots,0,0,0,0,0,0,0,0
lesaint_damapping,fr.javatronic.damapping.processor,0,1,0,0,0,0,0,1
lesaint_damapping,fr.javatronic.damapping.processor.impl,0,0,0,0,1,0,0,1
lesaint_damapping,fr.javatronic.damapping.processor.impl.javaxparsing.element,0,0,0,0,1,0,0,1
lesaint_damapping,fr.javatronic.damapping.processor.impl.javaxparsing,1,0,0,0,1,0,0,2
lesaint_damapping,fr.javatronic.damapping.processor.impl.javaxparsing.generics,0,0,0,0,0,0,0,0
lesaint_damapping,fr.javatronic.damapping.processor.impl.javaxparsing.model,0,0,0,0,0,0,0,0
lesaint_damapping,fr.javatronic.damapping.processor.impl.javaxparsing.type,0,0,0,0,0,0,0,0
lesaint_damapping,fr.javatronic.damapping.processor.impl.javaxparsing.visitor,1,1,0,0,0,0,0,2
lesaint_damapping,fr.javatronic.damapping.processor.sourcegenerator,0,0,0,0,1,0,0,1
lesaint_damapping,fr.javatronic.damapping.processor.sourcegenerator.imports,0,0,0,0,1,1,0,2
lesaint_damapping,fr.javatronic.damapping.processor.sourcegenerator.writer,0,0,0,0,0,1,0,1
lesaint_damapping,fr.javatronic.damapping.processor.validator,0,0,0,0,1,0,0,1
lesaint_damapping,fr.javatronic.damapping.processor.model.constants,0,0,0,0,0,0,0,0
lesaint_damapping,fr.javatronic.damapping.processor.model,3,0,0,0,1,2,0,6
lesaint_damapping,fr.javatronic.damapping.processor.model.factory,5,1,0,0,0,3,0,9
lesaint_damapping,fr.javatronic.damapping.processor.model.function,0,0,0,0,1,0,0,1
lesaint_damapping,fr.javatronic.damapping.processor.model.impl,5,1,0,0,1,3,0,10
lesaint_damapping,fr.javatronic.damapping.processor.model.predicate,3,1,0,0,1,2,0,7
lesaint_damapping,fr.javatronic.damapping.processor.model.util,0,0,0,0,0,0,0,0
lesaint_damapping,fr.javatronic.damapping.processor.model.visitor,0,0,0,0,0,0,0,0
lesaint_damapping,fr.javatronic.damapping.util,0,0,0,0,1,0,0,1
lessthanoptimal_ejml,org.ejml.example,0,0,0,0,1,0,1,2
lessthanoptimal_ejml,org.ejml,25,1,0,0,1,0,1,28
lessthanoptimal_ejml,org.ejml.data,69,1,0,1,0,0,1,72
lessthanoptimal_ejml,org.ejml.interfaces.decomposition,4,1,0,1,0,0,1,7
lessthanoptimal_ejml,org.ejml.interfaces.linsol,0,0,0,0,1,0,1,2
lessthanoptimal_ejml,org.ejml.interfaces,0,0,0,0,0,0,1,1
lessthanoptimal_ejml,org.ejml.ops,44,1,0,0,1,0,1,47
lessthanoptimal_ejml,org.ejml.sparse,8,0,0,0,0,0,1,9
lessthanoptimal_ejml,org.ejml.dense.block,5,1,0,0,1,0,1,8
lessthanoptimal_ejml,org.ejml.dense.fixed,4,0,0,1,1,0,1,7
lessthanoptimal_ejml,org.ejml.dense.row.misc,6,1,0,0,1,0,1,9
lessthanoptimal_ejml,org.ejml.dense.row.mult,6,1,0,0,1,0,1,9
lessthanoptimal_ejml,org.ejml.dense.block.decomposition.bidiagonal,0,0,0,0,0,0,1,1
lessthanoptimal_ejml,org.ejml.dense.block.decomposition.chol,0,0,0,0,0,0,1,1
lessthanoptimal_ejml,org.ejml.dense.block.decomposition.hessenberg,0,0,0,0,0,0,1,1
lessthanoptimal_ejml,org.ejml.dense.block.decomposition.qr,3,0,0,0,0,0,1,4
lessthanoptimal_ejml,org.ejml.dense.block.linsol.chol,0,0,0,0,0,0,1,1
lessthanoptimal_ejml,org.ejml.dense.block.linsol.qr,0,0,0,0,0,0,1,1
lessthanoptimal_ejml,org.ejml.dense.row,60,1,0,1,0,0,1,63
lessthanoptimal_ejml,org.ejml.dense.row.decomposition,4,1,0,0,1,0,1,7
lessthanoptimal_ejml,org.ejml.dense.row.decomposition.bidiagonal,0,0,0,0,0,0,1,1
lessthanoptimal_ejml,org.ejml.dense.row.decomposition.chol,6,0,0,0,0,0,1,7
lessthanoptimal_ejml,org.ejml.dense.row.decomposition.eig,14,1,0,0,1,0,1,17
lessthanoptimal_ejml,org.ejml.dense.row.decomposition.eig.symm,4,0,0,0,1,0,1,6
lessthanoptimal_ejml,org.ejml.dense.row.decomposition.eig.watched,4,0,0,0,0,0,1,5
lessthanoptimal_ejml,org.ejml.dense.row.decomposition.hessenberg,3,0,0,0,0,0,1,4
lessthanoptimal_ejml,org.ejml.dense.row.decomposition.lu,6,1,0,0,1,0,1,9
lessthanoptimal_ejml,org.ejml.dense.row.decomposition.qr,9,1,0,0,0,0,1,11
lessthanoptimal_ejml,org.ejml.dense.row.decomposition.svd.implicitqr,0,1,0,0,0,0,1,2
lessthanoptimal_ejml,org.ejml.dense.row.decomposition.svd,0,0,0,0,1,0,1,2
lessthanoptimal_ejml,org.ejml.dense.row.factory,12,1,0,0,1,0,1,15
lessthanoptimal_ejml,org.ejml.dense.row.linsol,4,0,0,0,1,0,1,6
lessthanoptimal_ejml,org.ejml.dense.row.linsol.chol,7,0,0,0,1,0,1,9
lessthanoptimal_ejml,org.ejml.dense.row.linsol.lu,4,0,0,0,1,0,1,6
lessthanoptimal_ejml,org.ejml.dense.row.linsol.qr,7,0,0,1,1,0,1,10
lessthanoptimal_ejml,org.ejml.dense.row.linsol.svd,0,0,0,0,0,0,1,1
lessthanoptimal_ejml,org.ejml.generic,2,0,0,0,0,0,1,3
lessthanoptimal_ejml,org.ejml.sparse.csc,19,1,0,0,0,0,1,21
lessthanoptimal_ejml,org.ejml.sparse.csc.decomposition.chol,3,0,0,0,0,0,1,4
lessthanoptimal_ejml,org.ejml.sparse.csc.decomposition.lu,4,0,0,0,0,0,1,5
lessthanoptimal_ejml,org.ejml.sparse.csc.decomposition.qr,5,0,0,0,1,0,1,7
lessthanoptimal_ejml,org.ejml.sparse.csc.factory,16,1,0,0,0,0,1,18
lessthanoptimal_ejml,org.ejml.sparse.csc.linsol.chol,0,0,0,0,0,0,1,1
lessthanoptimal_ejml,org.ejml.sparse.csc.linsol.lu,0,0,0,0,0,0,1,1
lessthanoptimal_ejml,org.ejml.sparse.csc.linsol.qr,0,0,0,0,0,0,1,1
lessthanoptimal_ejml,org.ejml.sparse.csc.misc,6,0,0,0,1,0,1,8
lessthanoptimal_ejml,org.ejml.sparse.csc.mult,3,0,0,0,0,0,1,4
lessthanoptimal_ejml,org.ejml.sparse.triplet,2,0,0,0,0,0,1,3
lessthanoptimal_ejml,org.ejml.sparse.csc.decomposition,0,0,0,0,0,0,1,1
lessthanoptimal_ejml,org.ejml.sparse.csc.linsol,0,0,0,0,0,0,1,1
lessthanoptimal_ejml,org.ejml.dense.complex.mult,0,0,0,0,0,0,1,1
lessthanoptimal_ejml,org.ejml.dense.row.decompose.eig,0,0,0,0,0,0,1,1
lessthanoptimal_ejml,org.ejml.dense.blockd3,3,0,0,0,0,0,1,4
lessthanoptimal_ejml,org.ejml.dense.densed2.mult,0,0,0,0,0,0,1,1
lessthanoptimal_ejml,org.ejml.dense.row.decompose.bidiagonal,0,0,0,0,0,0,1,1
lessthanoptimal_ejml,org.ejml.dense.row.decompose.lu,3,0,0,0,1,0,1,5
lessthanoptimal_ejml,org.ejml.equation,2,0,0,1,0,0,1,4
lessthanoptimal_ejml,org.ejml.simple,4,1,0,0,1,0,1,7
lessthanoptimal_ejml,org.ejml.simple.ops,0,0,0,0,0,0,1,1
lessthanoptimal_ejml,org.ejml.dense.row.decompose.chol,3,0,0,0,0,0,1,4
lessthanoptimal_ejml,org.ejml.dense.row.decompose.hessenberg,0,0,0,0,0,0,1,1
lessthanoptimal_ejml,org.ejml.dense.row.decompose.qr,3,0,0,0,0,0,1,4
lessthanoptimal_ejml,org.ejml.dense.row.decompose,3,0,0,0,0,0,1,4
levigo_jbig2-imageio,org.apache.pdfbox.jbig2,4,1,0,0,0,7,0,12
levigo_jbig2-imageio,org.apache.pdfbox.jbig2.decoder.arithmetic,0,0,0,0,0,2,0,2
levigo_jbig2-imageio,org.apache.pdfbox.jbig2.decoder.huffman,0,0,0,0,0,2,0,2
levigo_jbig2-imageio,org.apache.pdfbox.jbig2.decoder.mmr,0,0,0,0,0,0,0,0
levigo_jbig2-imageio,org.apache.pdfbox.jbig2.err,0,0,0,0,0,0,0,0
levigo_jbig2-imageio,org.apache.pdfbox.jbig2.image,4,1,0,1,0,6,0,12
levigo_jbig2-imageio,org.apache.pdfbox.jbig2.io,0,0,0,0,0,5,0,5
levigo_jbig2-imageio,org.apache.pdfbox.jbig2.segments,0,0,0,0,1,7,0,8
levigo_jbig2-imageio,org.apache.pdfbox.jbig2.util.cache,3,1,0,0,0,1,0,5
levigo_jbig2-imageio,org.apache.pdfbox.jbig2.util,6,0,0,0,1,0,0,7
levigo_jbig2-imageio,org.apache.pdfbox.jbig2.util.log,1,0,0,0,0,2,0,3
libgdx_ashley,com.badlogic.ashley.core,0,0,0,1,0,0,0,1
libgdx_ashley,com.badlogic.ashley.signals,0,0,0,0,0,0,0,0
libgdx_ashley,com.badlogic.ashley.systems,0,0,0,0,1,0,0,1
libgdx_ashley,com.badlogic.ashley.utils,0,0,0,0,0,0,0,0
libgdx_ashley,com.badlogic.ashley.benchmark.artemis,0,0,0,0,0,0,0,0
libgdx_ashley,com.badlogic.ashley.benchmark.artemis.components,0,0,0,0,0,0,0,0
libgdx_ashley,com.badlogic.ashley.benchmark.artemis.systems,0,0,0,0,0,0,0,0
libgdx_ashley,com.badlogic.ashley.benchmark.ashley,0,0,0,0,0,0,0,0
libgdx_ashley,com.badlogic.ashley.benchmark.ashley.components,0,0,0,0,0,0,0,0
libgdx_ashley,com.badlogic.ashley.benchmark.ashley.systems,0,0,0,0,0,0,0,0
libgdx_ashley,com.badlogic.ashley.benchmark,0,0,0,0,0,0,0,0
libgdx_box2dlights,box2dLight,1,0,0,0,1,0,0,2
libgdx_box2dlights,shaders,1,1,0,0,0,0,0,2
libgdx_gdx-ai,com.badlogic.gdx.ai.btree,0,0,0,0,0,0,1,1
libgdx_gdx-ai,com.badlogic.gdx.ai.btree.branch,0,0,0,0,1,0,1,2
libgdx_gdx-ai,com.badlogic.gdx.ai.btree.decorator,0,0,0,0,1,0,1,2
libgdx_gdx-ai,com.badlogic.gdx.ai.btree.leaf,0,0,0,0,0,0,1,1
libgdx_gdx-ai,com.badlogic.gdx.ai.btree.utils,0,0,0,0,0,0,1,1
libgdx_gdx-ai,com.badlogic.gdx.ai,0,0,0,0,0,0,1,1
libgdx_gdx-ai,com.badlogic.gdx.ai.fma,0,0,0,0,0,0,1,1
libgdx_gdx-ai,com.badlogic.gdx.ai.fma.patterns,0,0,0,0,0,0,1,1
libgdx_gdx-ai,com.badlogic.gdx.ai.fsm,0,0,0,0,0,0,1,1
libgdx_gdx-ai,com.badlogic.gdx.ai.msg,0,0,0,0,0,0,1,1
libgdx_gdx-ai,com.badlogic.gdx.ai.pfa,0,0,0,0,0,0,1,1
libgdx_gdx-ai,com.badlogic.gdx.ai.pfa.indexed,0,0,0,0,0,0,1,1
libgdx_gdx-ai,com.badlogic.gdx.ai.sched,0,0,0,0,0,0,1,1
libgdx_gdx-ai,com.badlogic.gdx.ai.steer.behaviors,0,0,0,0,1,0,1,2
libgdx_gdx-ai,com.badlogic.gdx.ai.steer,0,0,0,0,0,0,1,1
libgdx_gdx-ai,com.badlogic.gdx.ai.steer.limiters,0,0,0,0,1,0,1,2
libgdx_gdx-ai,com.badlogic.gdx.ai.steer.proximities,0,0,0,0,0,0,1,1
libgdx_gdx-ai,com.badlogic.gdx.ai.steer.utils,0,0,0,0,0,0,1,1
libgdx_gdx-ai,com.badlogic.gdx.ai.steer.utils.paths,0,0,0,0,0,0,1,1
libgdx_gdx-ai,com.badlogic.gdx.ai.steer.utils.rays,0,0,0,0,0,0,1,1
libgdx_gdx-ai,com.badlogic.gdx.ai.utils,0,0,0,0,1,0,1,2
libgdx_gdx-ai,com.badlogic.gdx.ai.utils.random,0,0,0,0,0,0,1,1
liftsecurity_burpbuddy,burp,0,0,0,1,1,0,0,2
lightblue-platform_lightblue-core,com.redhat.lightblue.config,0,0,0,0,1,0,1,2
lightblue-platform_lightblue-core,com.redhat.lightblue,0,1,0,0,1,0,1,3
lightblue-platform_lightblue-core,com.redhat.lightblue.crud,8,1,0,1,1,0,1,12
lightblue-platform_lightblue-core,com.redhat.lightblue.assoc,0,1,0,1,1,0,1,4
lightblue-platform_lightblue-core,com.redhat.lightblue.assoc.ep,0,0,0,1,1,0,1,3
lightblue-platform_lightblue-core,com.redhat.lightblue.assoc.iterators,0,0,0,0,0,0,1,1
lightblue-platform_lightblue-core,com.redhat.lightblue.assoc.qrew,0,0,0,0,0,0,1,1
lightblue-platform_lightblue-core,com.redhat.lightblue.assoc.qrew.rules,0,0,0,0,1,1,1,3
lightblue-platform_lightblue-core,com.redhat.lightblue.assoc.scorers,0,0,0,0,0,0,1,1
lightblue-platform_lightblue-core,com.redhat.lightblue.crud.interceptors,0,0,0,0,0,0,1,1
lightblue-platform_lightblue-core,com.redhat.lightblue.crud.validator,0,0,0,0,1,0,1,2
lightblue-platform_lightblue-core,com.redhat.lightblue.crud.valuegenerators,3,0,0,0,1,0,1,5
lightblue-platform_lightblue-core,com.redhat.lightblue.eval,2,0,0,1,0,0,1,4
lightblue-platform_lightblue-core,com.redhat.lightblue.hooks,2,0,0,0,1,0,1,4
lightblue-platform_lightblue-core,com.redhat.lightblue.interceptor,5,1,0,0,0,0,1,7
lightblue-platform_lightblue-core,com.redhat.lightblue.mediator,3,0,0,0,1,0,1,5
lightblue-platform_lightblue-core,com.redhat.lightblue.mindex,0,0,0,0,0,0,1,1
lightblue-platform_lightblue-core,com.redhat.lightblue.extensions,0,0,0,0,0,0,1,1
lightblue-platform_lightblue-core,com.redhat.lightblue.extensions.synch,0,0,0,0,0,0,1,1
lightblue-platform_lightblue-core,com.redhat.lightblue.extensions.valuegenerator,0,0,0,0,0,0,1,1
lightblue-platform_lightblue-core,com.redhat.lightblue.metadata,3,1,0,1,1,0,1,7
lightblue-platform_lightblue-core,com.redhat.lightblue.metadata.constraints,2,0,0,0,1,0,1,4
lightblue-platform_lightblue-core,com.redhat.lightblue.metadata.parser,0,0,0,0,1,0,1,2
lightblue-platform_lightblue-core,com.redhat.lightblue.metadata.translator,0,0,0,0,1,0,1,2
lightblue-platform_lightblue-core,com.redhat.lightblue.metadata.types,2,0,0,1,0,0,1,4
lightblue-platform_lightblue-core,com.redhat.lightblue.savedsearch,0,0,0,0,1,0,1,2
lightblue-platform_lightblue-core,com.redhat.lightblue.query,0,0,0,1,1,1,1,4
lightblue-platform_lightblue-core,com.redhat.lightblue.query.schema,0,0,0,0,0,0,1,1
lightblue-platform_lightblue-core,com.redhat.lightblue.util,0,0,0,1,1,1,1,4
lightblue-platform_lightblue-core,com.redhat.lightblue.util.metrics,0,0,0,0,1,0,1,2
lightblue-platform_lightblue-core,com.redhat.lightblue.util.stopwatch,0,0,0,0,0,0,1,1
lightcouch_LightCouch,org.lightcouch,0,0,0,1,1,0,0,2
linkedin_Cubert,com.linkedin.cubert.analyzer.physical,0,0,0,1,0,0,1,2
linkedin_Cubert,com.linkedin.cubert.antlr4,0,0,0,1,0,0,1,2
linkedin_Cubert,com.linkedin.cubert.app,0,1,0,0,0,0,1,2
linkedin_Cubert,com.linkedin.cubert.block,21,1,0,0,0,0,1,23
linkedin_Cubert,com.linkedin.cubert.examples,0,0,0,0,1,0,1,2
linkedin_Cubert,com.linkedin.cubert.functions.builtin,3,1,0,0,0,0,1,5
linkedin_Cubert,com.linkedin.cubert.functions,3,1,0,0,0,0,1,5
linkedin_Cubert,com.linkedin.cubert.io.avro,0,0,0,0,0,0,1,1
linkedin_Cubert,com.linkedin.cubert.io,3,1,0,0,1,0,1,6
linkedin_Cubert,com.linkedin.cubert.io.rubix,14,1,0,0,0,0,1,16
linkedin_Cubert,com.linkedin.cubert.io.shuffle,0,0,0,0,0,0,1,1
linkedin_Cubert,com.linkedin.cubert.io.text,0,0,0,0,0,0,1,1
linkedin_Cubert,com.linkedin.cubert.io.virtual,0,0,0,0,0,0,1,1
linkedin_Cubert,com.linkedin.cubert.memory,4,0,0,1,0,0,1,6
linkedin_Cubert,com.linkedin.cubert.operator.aggregate,3,1,0,0,0,0,1,5
linkedin_Cubert,com.linkedin.cubert.operator,16,1,0,1,0,0,1,19
linkedin_Cubert,com.linkedin.cubert.operator.cube,3,1,0,0,0,0,1,5
linkedin_Cubert,com.linkedin.cubert.pig.piggybank.storage.avro,0,0,0,0,0,0,1,1
linkedin_Cubert,com.linkedin.cubert.plan.physical,2,0,0,0,0,0,1,3
linkedin_Cubert,com.linkedin.cubert,0,0,0,0,0,0,1,1
linkedin_Cubert,com.linkedin.cubert.utils,5,1,0,1,1,0,1,9
linkedin_gobblin,org.apache.gobblin.admin,0,0,0,0,0,0,1,1
linkedin_gobblin,org.apache.gobblin.cli,0,0,0,0,0,0,1,1
linkedin_gobblin,gobblin.configuration,0,0,0,0,0,0,1,1
linkedin_gobblin,gobblin.source.extractor,0,0,0,0,0,0,1,1
linkedin_gobblin,gobblin.source.workunit,0,0,0,0,0,0,1,1
linkedin_gobblin,org.apache.gobblin.ack,0,0,0,0,0,0,1,1
linkedin_gobblin,org.apache.gobblin.broker,2,0,0,1,0,0,1,4
linkedin_gobblin,org.apache.gobblin.broker.gobblin_scopes,0,0,0,0,0,0,1,1
linkedin_gobblin,org.apache.gobblin.broker.iface,0,0,0,0,1,0,1,2
linkedin_gobblin,org.apache.gobblin.capability,0,0,0,0,0,0,1,1
linkedin_gobblin,org.apache.gobblin.codec,0,0,0,0,0,0,1,1
linkedin_gobblin,org.apache.gobblin.commit,2,0,0,0,1,0,1,4
linkedin_gobblin,org.apache.gobblin.compat.hadoop,0,0,0,0,0,0,1,1
linkedin_gobblin,org.apache.gobblin.configuration,54,1,0,0,1,0,1,57
linkedin_gobblin,org.apache.gobblin,12,0,0,0,1,0,1,14
linkedin_gobblin,org.apache.gobblin.converter,8,1,0,1,0,0,1,11
linkedin_gobblin,org.apache.gobblin.converter.initializer,4,0,0,0,0,0,1,5
linkedin_gobblin,org.apache.gobblin.crypto,2,0,0,1,0,0,1,4
linkedin_gobblin,org.apache.gobblin.dataset.comparators,0,0,0,0,0,0,1,1
linkedin_gobblin,org.apache.gobblin.dataset,3,0,0,0,0,0,1,4
linkedin_gobblin,org.apache.gobblin.fork,9,0,0,0,0,0,1,10
linkedin_gobblin,org.apache.gobblin.initializer,0,0,0,0,0,0,1,1
linkedin_gobblin,org.apache.gobblin.metadata,24,1,0,0,0,0,1,26
linkedin_gobblin,org.apache.gobblin.password,1,0,0,0,0,0,1,2
linkedin_gobblin,org.apache.gobblin.publisher,7,1,0,0,1,0,1,10
linkedin_gobblin,org.apache.gobblin.qualitychecker.row,3,0,0,0,0,0,1,4
linkedin_gobblin,org.apache.gobblin.qualitychecker.task,2,0,0,0,0,0,1,3
linkedin_gobblin,org.apache.gobblin.recordaccess,1,0,0,0,0,0,1,2
linkedin_gobblin,org.apache.gobblin.records,5,1,0,0,1,0,1,8
linkedin_gobblin,org.apache.gobblin.runtime.api,56,1,0,1,0,0,1,59
linkedin_gobblin,org.apache.gobblin.runtime,64,1,0,1,0,0,1,67
linkedin_gobblin,org.apache.gobblin.service,0,1,0,1,0,0,1,3
linkedin_gobblin,org.apache.gobblin.source.extractor,63,1,0,0,1,0,1,66
linkedin_gobblin,org.apache.gobblin.source,10,1,0,0,1,0,1,13
linkedin_gobblin,org.apache.gobblin.source.workunit,8,1,0,0,0,0,1,10
linkedin_gobblin,org.apache.gobblin.stream,12,1,0,0,0,0,1,14
linkedin_gobblin,org.apache.gobblin.util,77,1,0,1,1,0,1,81
linkedin_gobblin,org.apache.gobblin.util.io,3,1,0,0,1,0,1,6
linkedin_gobblin,org.apache.gobblin.writer,58,1,0,1,0,0,1,61
linkedin_gobblin,org.apache.gobblin.writer.initializer,4,0,0,0,0,0,1,5
linkedin_gobblin,com.linkedin.gobblin,0,0,0,0,0,0,1,1
linkedin_gobblin,org.apache.gobblin.compat,0,0,0,0,0,0,1,1
linkedin_gobblin,org.apache.gobblin.audit.values.auditor,4,1,0,0,0,0,1,6
linkedin_gobblin,org.apache.gobblin.audit.values.policy.column,2,0,0,0,0,0,1,3
linkedin_gobblin,org.apache.gobblin.audit.values.policy.row,2,0,0,0,0,0,1,3
linkedin_gobblin,org.apache.gobblin.audit.values.sink,1,0,0,0,0,0,1,2
linkedin_gobblin,org.apache.gobblin.audit.values,0,0,0,0,0,0,1,1
linkedin_gobblin,org.apache.gobblin.aws,0,0,0,0,0,0,1,1
linkedin_gobblin,org.apache.gobblin.binary_creation,0,0,0,0,0,0,1,1
linkedin_gobblin,org.apache.gobblin.cluster,1,1,0,1,0,0,1,4
linkedin_gobblin,org.apache.gobblin.cluster.event,0,0,0,0,0,0,1,1
linkedin_gobblin,org.apache.gobblin.cluster.suite,1,1,0,0,1,0,1,4
linkedin_gobblin,org.apache.gobblin.compaction.action,0,0,0,0,0,0,1,1
linkedin_gobblin,org.apache.gobblin.compaction.audit,0,0,0,0,0,0,1,1
linkedin_gobblin,org.apache.gobblin.compaction,0,0,0,0,0,0,1,1
linkedin_gobblin,org.apache.gobblin.compaction.conditions,3,1,0,0,0,0,1,5
linkedin_gobblin,org.apache.gobblin.compaction.dataset,8,1,0,0,0,0,1,10
linkedin_gobblin,org.apache.gobblin.compaction.event,3,1,0,0,0,0,1,5
linkedin_gobblin,org.apache.gobblin.compaction.hive,0,0,0,0,0,0,1,1
linkedin_gobblin,org.apache.gobblin.compaction.hive.registration,0,0,0,0,0,0,1,1
linkedin_gobblin,org.apache.gobblin.compaction.hivebasedconstructs,0,0,0,0,0,0,1,1
linkedin_gobblin,org.apache.gobblin.compaction.listeners,2,1,0,0,1,0,1,5
linkedin_gobblin,org.apache.gobblin.compaction.mapreduce.avro,3,1,0,0,0,0,1,5
linkedin_gobblin,org.apache.gobblin.compaction.mapreduce,16,1,0,0,1,0,1,19
linkedin_gobblin,org.apache.gobblin.compaction.mapreduce.orc,0,0,0,0,1,0,1,2
linkedin_gobblin,org.apache.gobblin.compaction.parser,2,1,0,0,0,0,1,4
linkedin_gobblin,org.apache.gobblin.compaction.source,3,0,0,0,0,0,1,4
linkedin_gobblin,org.apache.gobblin.compaction.suite,2,1,0,0,0,0,1,4
linkedin_gobblin,org.apache.gobblin.compaction.verify,6,1,0,0,1,0,1,9
linkedin_gobblin,org.apache.gobblin.compaction.mapreduce.conditions,0,0,0,0,0,0,1,1
linkedin_gobblin,org.apache.gobblin.config.client,2,1,0,0,1,0,1,5
linkedin_gobblin,org.apache.gobblin.config.client.api,0,0,0,0,0,0,1,1
linkedin_gobblin,org.apache.gobblin.config.common.impl,0,0,0,0,0,0,1,1
linkedin_gobblin,org.apache.gobblin.config.store.api,0,0,0,0,1,0,1,2
linkedin_gobblin,org.apache.gobblin.config.store.deploy,0,0,0,0,1,0,1,2
linkedin_gobblin,org.apache.gobblin.config.store.hdfs,1,0,0,0,0,0,1,2
linkedin_gobblin,org.apache.gobblin.config.store.zip,0,0,0,0,0,0,1,1
linkedin_gobblin,org.apache.gobblin.config,1,1,0,0,0,0,1,3
linkedin_gobblin,gobblin.state,0,0,0,0,0,0,1,1
linkedin_gobblin,org.apache.gobblin.async,3,1,0,0,1,0,1,6
linkedin_gobblin,org.apache.gobblin.converter.avro,0,0,0,1,1,0,1,3
linkedin_gobblin,org.apache.gobblin.converter.csv,0,0,0,0,0,0,1,1
linkedin_gobblin,org.apache.gobblin.converter.filter,1,0,0,0,1,0,1,3
linkedin_gobblin,org.apache.gobblin.converter.http,0,0,0,0,0,0,1,1
linkedin_gobblin,org.apache.gobblin.converter.json,0,1,0,0,1,0,1,3
linkedin_gobblin,org.apache.gobblin.converter.objectstore,1,0,0,0,0,0,1,2
linkedin_gobblin,org.apache.gobblin.converter.serde,0,0,0,0,0,0,1,1
linkedin_gobblin,gobblin.converter.serde,0,0,0,0,0,0,1,1
linkedin_gobblin,org.apache.gobblin.converter.string,0,0,0,0,1,0,1,2
linkedin_gobblin,org.apache.gobblin.http,21,1,0,0,1,0,1,24
linkedin_gobblin,org.apache.gobblin.net,0,0,0,0,0,0,1,1
linkedin_gobblin,org.apache.gobblin.policies.avro,0,0,0,0,0,0,1,1
linkedin_gobblin,org.apache.gobblin.policies.count,0,0,0,0,0,0,1,1
linkedin_gobblin,org.apache.gobblin.policies.schema,0,0,0,0,0,0,1,1
linkedin_gobblin,org.apache.gobblin.policies.time,0,0,0,0,0,0,1,1
linkedin_gobblin,org.apache.gobblin.security.ssl,1,0,0,0,0,0,1,2
linkedin_gobblin,org.apache.gobblin.source.extractor.exception,0,0,0,0,1,0,1,2
linkedin_gobblin,org.apache.gobblin.source.extractor.extract,8,1,0,0,1,0,1,11
linkedin_gobblin,org.apache.gobblin.source.extractor.extract.restapi,0,0,0,0,0,0,1,1
linkedin_gobblin,org.apache.gobblin.source.extractor.extract.sftp,0,0,0,0,0,0,1,1
linkedin_gobblin,org.apache.gobblin.source.extractor.filebased,1,0,0,0,1,0,1,3
linkedin_gobblin,org.apache.gobblin.source.extractor.hadoop,2,0,0,0,0,0,1,3
linkedin_gobblin,org.apache.gobblin.source.extractor.partition,2,0,0,0,0,0,1,3
linkedin_gobblin,org.apache.gobblin.source.extractor.resultset,0,0,0,0,0,0,1,1
linkedin_gobblin,org.apache.gobblin.source.extractor.schema,0,0,0,0,1,0,1,2
linkedin_gobblin,org.apache.gobblin.source.extractor.utils,1,0,0,0,0,0,1,2
linkedin_gobblin,org.apache.gobblin.source.extractor.watermark,4,1,0,0,0,0,1,6
linkedin_gobblin,org.apache.gobblin.state,0,0,0,0,0,0,1,1
linkedin_gobblin,org.apache.gobblin.writer.http,0,0,0,0,0,0,1,1
linkedin_gobblin,org.apache.gobblin.writer.objectstore,1,0,0,0,0,0,1,2
linkedin_gobblin,org.apache.gobblin.writer.objectstore.response,0,0,0,0,0,0,1,1
linkedin_gobblin,org.apache.gobblin.writer.partitioner,4,0,0,0,0,0,1,5
linkedin_gobblin,org.apache.gobblin.configuration.workunit,0,0,0,0,0,0,1,1
linkedin_gobblin,org.apache.gobblin.instrumented,3,1,0,0,1,0,1,6
linkedin_gobblin,org.apache.gobblin.qualitychecker,0,0,0,0,1,0,1,2
linkedin_gobblin,org.apache.gobblin.serde,0,0,0,0,0,0,1,1
linkedin_gobblin,org.apache.gobblin.compression,2,0,0,0,0,0,1,3
linkedin_gobblin,org.apache.gobblin.instrumented.converter,3,0,0,0,0,0,1,4
linkedin_gobblin,org.apache.gobblin.instrumented.extractor,3,0,0,0,0,0,1,4
linkedin_gobblin,org.apache.gobblin.instrumented.fork,0,0,0,0,0,0,1,1
linkedin_gobblin,org.apache.gobblin.instrumented.qualitychecker,0,0,0,0,0,0,1,1
linkedin_gobblin,org.apache.gobblin.instrumented.writer,3,0,0,0,0,0,1,4
linkedin_gobblin,org.apache.gobblin.source.extractor.limiter,0,0,0,0,0,0,1,1
linkedin_gobblin,org.apache.gobblin.types,0,1,0,0,0,0,1,2
linkedin_gobblin,gobblin.data.management.conversion.hive.source,0,0,0,0,0,0,1,1
linkedin_gobblin,gobblin.data.management.copy,0,0,0,0,0,0,1,1
linkedin_gobblin,org.apache.gobblin.data.management.conversion.hive.avro,4,1,0,0,0,0,1,6
linkedin_gobblin,org.apache.gobblin.data.management.conversion.hive.converter,5,0,0,0,0,0,1,6
linkedin_gobblin,org.apache.gobblin.data.management.conversion.hive.dataset,14,1,0,0,0,0,1,16
linkedin_gobblin,org.apache.gobblin.data.management.conversion.hive.entities,4,1,0,0,1,0,1,7
linkedin_gobblin,org.apache.gobblin.data.management.conversion.hive.events,0,0,0,0,0,0,1,1
linkedin_gobblin,org.apache.gobblin.data.management.conversion.hive.extractor,0,0,0,0,0,0,1,1
linkedin_gobblin,org.apache.gobblin.data.management.conversion.hive.materializer,0,0,0,0,0,0,1,1
linkedin_gobblin,org.apache.gobblin.data.management.conversion.hive.provider,0,0,0,0,1,0,1,2
linkedin_gobblin,org.apache.gobblin.data.management.conversion.hive.publisher,7,0,0,0,0,0,1,8
linkedin_gobblin,org.apache.gobblin.data.management.conversion.hive.query,6,1,0,0,0,0,1,8
linkedin_gobblin,org.apache.gobblin.data.management.conversion.hive.source,15,0,0,0,0,0,1,16
linkedin_gobblin,org.apache.gobblin.data.management.conversion.hive.task,3,1,0,0,0,0,1,5
linkedin_gobblin,org.apache.gobblin.data.management.conversion.hive.utils,8,1,0,0,0,0,1,10
linkedin_gobblin,org.apache.gobblin.data.management.conversion.hive.watermarker,14,1,0,0,0,0,1,16
linkedin_gobblin,org.apache.gobblin.data.management.conversion.hive.writer,0,0,0,0,0,0,1,1
linkedin_gobblin,org.apache.gobblin.data.management.copy,20,1,0,1,0,0,1,23
linkedin_gobblin,org.apache.gobblin.data.management.copy.converter,2,0,0,0,0,0,1,3
linkedin_gobblin,org.apache.gobblin.data.management.copy.entities,0,0,0,0,0,0,1,1
linkedin_gobblin,org.apache.gobblin.data.management.copy.extractor,0,0,0,0,0,0,1,1
linkedin_gobblin,org.apache.gobblin.data.management.copy.hive.avro,1,0,0,0,0,0,1,2
linkedin_gobblin,org.apache.gobblin.data.management.copy.hive.filter,0,0,0,0,0,0,1,1
linkedin_gobblin,org.apache.gobblin.data.management.copy.hive,10,1,0,0,0,0,1,12
linkedin_gobblin,org.apache.gobblin.data.management.copy.predicates,0,0,0,0,0,0,1,1
linkedin_gobblin,org.apache.gobblin.data.management.copy.prioritization,0,0,0,0,0,0,1,1
linkedin_gobblin,org.apache.gobblin.data.management.copy.publisher,8,1,0,0,0,0,1,10
linkedin_gobblin,org.apache.gobblin.data.management.copy.recovery,2,0,0,0,0,0,1,3
linkedin_gobblin,org.apache.gobblin.data.management.copy.replication,0,0,0,1,0,0,1,2
linkedin_gobblin,org.apache.gobblin.data.management.copy.splitter,5,1,0,0,0,0,1,7
linkedin_gobblin,org.apache.gobblin.data.management.copy.watermark,1,0,0,0,0,0,1,2
linkedin_gobblin,org.apache.gobblin.data.management.copy.writer,6,0,0,0,0,0,1,7
linkedin_gobblin,org.apache.gobblin.data.management.dataset,1,1,0,0,1,0,1,4
linkedin_gobblin,org.apache.gobblin.data.management.hive,0,0,0,0,0,0,1,1
linkedin_gobblin,org.apache.gobblin.data.management.partition,5,1,0,0,1,0,1,8
linkedin_gobblin,org.apache.gobblin.data.management.policy,5,0,0,0,0,0,1,6
linkedin_gobblin,org.apache.gobblin.data.management.retention.action,2,0,0,0,0,0,1,3
linkedin_gobblin,org.apache.gobblin.data.management.retention.dataset,15,1,0,0,0,0,1,17
linkedin_gobblin,org.apache.gobblin.data.management.retention.dataset.finder,2,1,0,0,0,0,1,4
linkedin_gobblin,org.apache.gobblin.data.management.retention,11,1,0,0,1,0,1,14
linkedin_gobblin,org.apache.gobblin.data.management.retention.policy,10,1,0,0,0,0,1,12
linkedin_gobblin,org.apache.gobblin.data.management.retention.policy.predicates,0,0,0,0,0,0,1,1
linkedin_gobblin,org.apache.gobblin.data.management.retention.profile,3,1,0,0,1,0,1,6
linkedin_gobblin,org.apache.gobblin.data.management.retention.source,0,0,0,0,0,0,1,1
linkedin_gobblin,org.apache.gobblin.data.management.retention.version,7,1,0,0,0,0,1,9
linkedin_gobblin,org.apache.gobblin.data.management.retention.version.finder,3,0,0,0,0,0,1,4
linkedin_gobblin,org.apache.gobblin.data.management.source,0,0,0,0,1,0,1,2
linkedin_gobblin,org.apache.gobblin.data.management.trash,0,0,0,0,0,0,1,1
linkedin_gobblin,org.apache.gobblin.data.management.version,0,1,0,0,0,0,1,2
linkedin_gobblin,org.apache.gobblin.data.management.version.finder,5,1,0,0,0,0,1,7
linkedin_gobblin,org.apache.gobblin.runtime.embedded,10,1,0,0,1,0,1,13
linkedin_gobblin,org.apache.gobblin.runtime.retention,0,1,0,0,0,0,1,2
linkedin_gobblin,org.apache.gobblin.util.commit,0,1,0,0,0,0,1,2
linkedin_gobblin,org.apache.gobblin.util.request_allocation,5,1,0,1,0,0,1,8
linkedin_gobblin,org.apache.gobblin.util.schema_check,0,0,0,0,0,0,1,1
linkedin_gobblin,org.apache.gobblin.data.management.conversion.hive,6,1,0,0,0,0,1,8
linkedin_gobblin,org.apache.gobblin.data.management.conversion.hive.util,0,0,0,0,0,0,1,1
linkedin_gobblin,org.apache.gobblin.data.management,0,0,0,0,0,0,1,1
linkedin_gobblin,org.apache.gobblin.data.management.retention.integration,0,0,0,0,0,0,1,1
linkedin_gobblin,org.apache.gobblin.data.management.retention.sql,0,0,0,0,0,0,1,1
linkedin_gobblin,org.apache.gobblin.data.management.util,0,0,0,0,0,0,1,1
linkedin_gobblin,org.apache.gobblin.example.githubjsontoparquet,0,0,0,0,0,0,1,1
linkedin_gobblin,org.apache.gobblin.example.hadoop,0,0,0,0,0,0,1,1
linkedin_gobblin,org.apache.gobblin.example.hivematerializer,0,0,0,0,0,0,1,1
linkedin_gobblin,org.apache.gobblin.example.simplejson,0,0,0,0,0,0,1,1
linkedin_gobblin,org.apache.gobblin.example.wikipedia,0,0,0,0,1,0,1,2
linkedin_gobblin,gobblin.hive,0,0,0,0,0,0,1,1
linkedin_gobblin,org.apache.gobblin.hive,7,1,0,1,0,0,1,10
linkedin_gobblin,org.apache.gobblin.hive.avro,0,0,0,0,0,0,1,1
linkedin_gobblin,org.apache.gobblin.hive.metastore,5,1,0,0,0,0,1,7
linkedin_gobblin,org.apache.gobblin.hive.orc,0,0,0,0,0,0,1,1
linkedin_gobblin,org.apache.gobblin.hive.policy,2,1,0,0,0,0,1,4
linkedin_gobblin,org.apache.gobblin.hive.spec.activity,0,0,0,0,0,0,1,1
linkedin_gobblin,org.apache.gobblin.hive.spec,2,1,0,0,0,0,1,4
linkedin_gobblin,org.apache.gobblin.hive.spec.predicate,0,0,0,0,0,0,1,1
linkedin_gobblin,org.apache.gobblin.metastore.database,0,0,0,0,0,0,1,1
linkedin_gobblin,org.apache.gobblin.metastore,11,1,0,1,0,0,1,14
linkedin_gobblin,org.apache.gobblin.metastore.metadata,3,1,0,0,0,0,1,5
linkedin_gobblin,org.apache.gobblin.metastore.nameParser,0,0,0,0,0,0,1,1
linkedin_gobblin,org.apache.gobblin.metastore.predicates,1,0,0,0,0,0,1,2
linkedin_gobblin,org.apache.gobblin.metastore.util,1,0,0,0,1,0,1,3
linkedin_gobblin,org.apache.gobblin.metrics,27,1,0,1,0,0,1,30
linkedin_gobblin,org.apache.gobblin.metrics.reporter,8,0,0,1,0,0,1,10
linkedin_gobblin,org.apache.gobblin.filesystem,0,0,0,0,0,0,1,1
linkedin_gobblin,org.apache.gobblin.metrics.broker,3,0,0,0,0,0,1,4
linkedin_gobblin,org.apache.gobblin.metrics.context,2,0,0,0,0,0,1,3
linkedin_gobblin,org.apache.gobblin.metrics.context.filter,1,0,0,0,0,0,1,2
linkedin_gobblin,org.apache.gobblin.metrics.event,3,1,0,0,1,0,1,6
linkedin_gobblin,org.apache.gobblin.metrics.event.lineage,2,0,0,0,0,0,1,3
linkedin_gobblin,org.apache.gobblin.metrics.event.sla,0,0,0,0,0,0,1,1
linkedin_gobblin,org.apache.gobblin.metrics.example,0,0,0,0,0,0,1,1
linkedin_gobblin,org.apache.gobblin.metrics.metric.filter,0,0,0,0,1,0,1,2
linkedin_gobblin,org.apache.gobblin.metrics.metric,0,0,0,0,0,0,1,1
linkedin_gobblin,org.apache.gobblin.metrics.notification,3,0,0,0,0,0,1,4
linkedin_gobblin,org.apache.gobblin.metrics.reporter.util,3,1,0,0,1,0,1,6
linkedin_gobblin,org.apache.gobblin.metrics.callback,1,0,0,0,0,0,1,2
linkedin_gobblin,org.apache.gobblin.metrics.performance,0,0,0,0,0,0,1,1
linkedin_gobblin,org.apache.gobblin.azkaban,0,0,0,0,1,0,1,2
linkedin_gobblin,org.apache.gobblin.data.management.conversion.hive.validation,0,0,0,0,0,0,1,1
linkedin_gobblin,org.apache.gobblin.service.modules.orchestration,6,0,0,1,0,0,1,8
linkedin_gobblin,org.apache.gobblin.compliance.azkaban,0,0,0,0,0,0,1,1
linkedin_gobblin,org.apache.gobblin.compliance,4,1,0,0,1,0,1,7
linkedin_gobblin,org.apache.gobblin.compliance.purger,2,0,0,0,0,0,1,3
linkedin_gobblin,org.apache.gobblin.compliance.restore,0,0,0,0,1,0,1,2
linkedin_gobblin,org.apache.gobblin.compliance.retention,4,0,0,0,1,0,1,6
linkedin_gobblin,org.apache.gobblin.compliance.utils,2,1,0,0,0,0,1,4
linkedin_gobblin,org.apache.gobblin.compliance.validation,0,0,0,0,0,0,1,1
linkedin_gobblin,org.apache.gobblin.couchbase.common,0,0,0,0,0,0,1,1
linkedin_gobblin,org.apache.gobblin.couchbase.converter,0,0,0,0,0,0,1,1
linkedin_gobblin,org.apache.gobblin.couchbase.writer,0,0,0,0,0,0,1,1
linkedin_gobblin,org.apache.gobblin.couchbase,0,0,0,0,0,0,1,1
linkedin_gobblin,org.apache.gobblin.elasticsearch.typemapping,0,0,0,0,0,0,1,1
linkedin_gobblin,org.apache.gobblin.elasticsearch.writer,0,0,0,0,0,0,1,1
linkedin_gobblin,org.apache.gobblin.elasticsearch,0,0,0,0,0,0,1,1
linkedin_gobblin,org.apache.gobblin.eventhub,0,0,0,0,0,0,1,1
linkedin_gobblin,org.apache.gobblin.eventhub.writer,0,0,0,0,0,0,1,1
linkedin_gobblin,org.apache.gobblin.converter.grok,0,0,0,0,0,0,1,1
linkedin_gobblin,org.apache.gobblin.r2,3,0,0,0,1,0,1,5
linkedin_gobblin,org.apache.gobblin.utils,4,1,0,0,0,0,1,6
linkedin_gobblin,org.apache.gobblin.kafka.client,1,1,0,0,0,0,1,3
linkedin_gobblin,org.apache.gobblin.kafka.serialize,1,0,0,0,1,0,1,3
linkedin_gobblin,org.apache.gobblin.kafka.tool,0,0,0,0,0,0,1,1
linkedin_gobblin,org.apache.gobblin.kafka.writer,1,0,0,0,1,0,1,3
linkedin_gobblin,org.apache.gobblin.metrics.kafka,4,1,0,1,0,0,1,7
linkedin_gobblin,org.apache.gobblin.source.extractor.extract.kafka,4,1,0,1,0,0,1,7
linkedin_gobblin,org.apache.gobblin.kafka,1,1,0,0,1,0,1,4
linkedin_gobblin,(default package),0,0,0,0,0,0,1,1
linkedin_gobblin,org.apache.gobblin.kafka.source.extractor.extract.kafka,0,0,0,0,0,0,1,1
linkedin_gobblin,org.apache.gobblin.kafka.schemareg,3,1,0,0,0,0,1,5
linkedin_gobblin,org.apache.gobblin.source.extractor.extract.kafka.workunit.packer,1,0,0,0,0,0,1,2
linkedin_gobblin,org.apache.gobblin.metadata.provider,0,0,0,0,0,0,1,1
linkedin_gobblin,org.apache.gobblin.metadata.types,2,1,0,0,0,0,1,4
linkedin_gobblin,org.apache.gobblin.type,1,0,0,0,0,0,1,2
linkedin_gobblin,org.apache.gobblin.metrics.graphite,4,0,0,0,0,0,1,5
linkedin_gobblin,org.apache.gobblin.metrics.hadoop,0,0,0,0,0,0,1,1
linkedin_gobblin,org.apache.gobblin.metrics.influxdb,2,0,0,0,0,0,1,3
linkedin_gobblin,org.apache.gobblin.converter.parquet,0,0,0,0,0,0,1,1
linkedin_gobblin,org.apache.gobblin.converter.jdbc,5,1,0,0,0,0,1,7
linkedin_gobblin,org.apache.gobblin.source.extractor.extract.jdbc,0,0,0,0,0,0,1,1
linkedin_gobblin,org.apache.gobblin.source.jdbc,3,0,0,0,0,0,1,4
linkedin_gobblin,org.apache.gobblin.writer.commands,6,1,0,0,0,0,1,8
linkedin_gobblin,org.apache.gobblin.zuora,0,0,0,0,0,0,1,1
linkedin_gobblin,org.apache.gobblin.ingestion.google,0,0,0,0,0,0,1,1
linkedin_gobblin,org.apache.gobblin.ingestion.google.util,0,1,0,0,0,0,1,2
linkedin_gobblin,org.apache.gobblin.ingestion.google.webmaster,0,0,0,0,0,0,1,1
linkedin_gobblin,org.apache.gobblin.source.extractor.extract.google,1,1,0,0,0,0,1,3
linkedin_gobblin,org.apache.gobblin.rest,0,0,0,0,0,0,1,1
linkedin_gobblin,org.apache.gobblin.service.validator,0,0,0,0,0,0,1,1
linkedin_gobblin,org.apache.gobblin.restli,2,0,0,0,0,0,1,3
linkedin_gobblin,org.apache.gobblin.restli.throttling,3,0,0,1,0,0,1,5
linkedin_gobblin,org.apache.gobblin.util.limiter,13,1,0,1,0,0,1,16
linkedin_gobblin,org.apache.gobblin.runtime.fork,4,0,0,0,1,0,1,6
linkedin_gobblin,gobblin.runtime,0,0,0,0,0,0,1,1
linkedin_gobblin,gobblin.runtime.mapreduce,0,0,0,0,0,0,1,1
linkedin_gobblin,org.apache.gobblin.runtime.app,2,1,0,0,0,0,1,4
linkedin_gobblin,org.apache.gobblin.runtime.cli,5,1,0,0,0,0,1,7
linkedin_gobblin,org.apache.gobblin.runtime.commit,2,0,0,0,0,0,1,3
linkedin_gobblin,org.apache.gobblin.runtime.crypto,0,0,0,0,0,0,1,1
linkedin_gobblin,org.apache.gobblin.runtime.instance,9,0,0,0,0,0,1,10
linkedin_gobblin,org.apache.gobblin.runtime.instance.hadoop,0,0,0,0,0,0,1,1
linkedin_gobblin,org.apache.gobblin.runtime.instance.plugin,0,0,0,0,0,0,1,1
linkedin_gobblin,org.apache.gobblin.runtime.job,0,0,0,0,0,0,1,1
linkedin_gobblin,org.apache.gobblin.runtime.job_catalog,4,0,0,0,0,0,1,5
linkedin_gobblin,org.apache.gobblin.runtime.job_exec,3,0,0,0,0,0,1,4
linkedin_gobblin,org.apache.gobblin.runtime.job_monitor,1,0,0,0,0,0,1,2
linkedin_gobblin,org.apache.gobblin.runtime.job_spec,6,0,0,0,0,0,1,7
linkedin_gobblin,org.apache.gobblin.runtime.kafka,1,1,0,0,0,0,1,3
linkedin_gobblin,org.apache.gobblin.runtime.listeners,1,1,0,0,0,0,1,3
linkedin_gobblin,org.apache.gobblin.runtime.local,0,0,0,0,0,0,1,1
linkedin_gobblin,org.apache.gobblin.runtime.locks,2,0,0,0,0,0,1,3
linkedin_gobblin,org.apache.gobblin.runtime.mapreduce,0,0,0,0,0,0,1,1
linkedin_gobblin,org.apache.gobblin.runtime.metastore.filesystem,0,0,0,0,0,0,1,1
linkedin_gobblin,org.apache.gobblin.runtime.metastore.mysql,0,0,0,0,0,0,1,1
linkedin_gobblin,org.apache.gobblin.runtime.metrics,0,0,0,0,0,0,1,1
linkedin_gobblin,org.apache.gobblin.runtime.plugins.email,3,1,0,0,0,0,1,5
linkedin_gobblin,org.apache.gobblin.runtime.plugins,1,0,0,0,0,0,1,2
linkedin_gobblin,org.apache.gobblin.runtime.plugins.metrics,0,0,0,0,0,0,1,1
linkedin_gobblin,org.apache.gobblin.runtime.scheduler,0,0,0,0,0,0,1,1
linkedin_gobblin,org.apache.gobblin.runtime.services,0,0,0,0,0,0,1,1
linkedin_gobblin,org.apache.gobblin.runtime.spec_catalog,0,1,0,0,0,0,1,2
linkedin_gobblin,org.apache.gobblin.runtime.spec_executorInstance,0,0,0,0,0,0,1,1
linkedin_gobblin,org.apache.gobblin.runtime.spec_serde,0,0,0,0,1,0,1,2
linkedin_gobblin,org.apache.gobblin.runtime.spec_store,0,0,0,0,1,0,1,2
linkedin_gobblin,org.apache.gobblin.runtime.std,7,1,0,0,1,0,1,10
linkedin_gobblin,org.apache.gobblin.runtime.task,4,1,0,0,0,0,1,6
linkedin_gobblin,org.apache.gobblin.runtime.template,8,1,0,0,0,0,1,10
linkedin_gobblin,org.apache.gobblin.runtime.util,3,1,0,0,1,0,1,6
linkedin_gobblin,org.apache.gobblin.scheduler,0,0,0,0,0,0,1,1
linkedin_gobblin,org.apache.gobblin.service.monitoring,0,0,0,0,0,0,1,1
linkedin_gobblin,org.apache.gobblin.performance,0,0,0,0,0,0,1,1
linkedin_gobblin,org.apache.gobblin.task,4,0,0,0,0,0,1,5
linkedin_gobblin,org.apache.hadoop.fs,0,0,0,0,0,0,1,1
linkedin_gobblin,org.apache.gobblin.runtime.instance.plugin.hadoop,0,0,0,0,0,0,1,1
linkedin_gobblin,org.apache.gobblin.salesforce,0,0,0,0,0,0,1,1
linkedin_gobblin,org.apache.gobblin.service.modules.core,5,0,0,0,0,0,1,6
linkedin_gobblin,org.apache.gobblin.service.modules.dataset,5,0,0,0,0,0,1,6
linkedin_gobblin,org.apache.gobblin.service.modules.flow,10,1,0,0,0,0,1,12
linkedin_gobblin,org.apache.gobblin.service.modules.flowgraph,12,1,0,0,0,0,1,14
linkedin_gobblin,org.apache.gobblin.service.modules.flowgraph.datanodes.fs,0,0,0,0,0,0,1,1
linkedin_gobblin,org.apache.gobblin.service.modules.flowgraph.datanodes,0,0,0,0,0,0,1,1
linkedin_gobblin,org.apache.gobblin.service.modules.flowgraph.pathfinder,7,0,0,0,0,0,1,8
linkedin_gobblin,org.apache.gobblin.service.modules.restli,1,1,0,0,0,0,1,3
linkedin_gobblin,org.apache.gobblin.service.modules.scheduler,3,1,0,0,0,0,1,5
linkedin_gobblin,org.apache.gobblin.service.modules.spec,4,1,0,0,0,0,1,6
linkedin_gobblin,org.apache.gobblin.service.modules.template,6,0,0,0,0,0,1,7
linkedin_gobblin,org.apache.gobblin.service.modules.template_catalog,4,1,0,0,0,0,1,6
linkedin_gobblin,org.apache.gobblin.service.modules.topology,0,0,0,0,0,0,1,1
linkedin_gobblin,org.apache.gobblin.service.modules.utils,0,0,0,0,0,0,1,1
linkedin_gobblin,org.apache.gobblin.tunnel,1,0,0,0,0,0,1,2
linkedin_gobblin,org.apache.gobblin.exception,0,0,0,0,0,0,1,1
linkedin_gobblin,org.apache.gobblin.fsm,0,0,0,0,0,0,1,1
linkedin_gobblin,org.apache.gobblin.util.binpacking,0,0,0,0,0,0,1,1
linkedin_gobblin,org.apache.gobblin.util.callbacks,2,0,0,0,1,0,1,4
linkedin_gobblin,org.apache.gobblin.util.concurrent,1,0,0,0,0,0,1,2
linkedin_gobblin,org.apache.gobblin.util.dataset,0,0,0,0,0,0,1,1
linkedin_gobblin,org.apache.gobblin.util.deprecation,1,0,0,0,0,0,1,2
linkedin_gobblin,org.apache.gobblin.util.executors,1,0,0,0,1,0,1,3
linkedin_gobblin,org.apache.gobblin.util.filesystem,2,0,0,0,0,0,1,3
linkedin_gobblin,org.apache.gobblin.util.filters,0,0,0,0,0,0,1,1
linkedin_gobblin,org.apache.gobblin.util.guid,0,0,0,0,0,0,1,1
linkedin_gobblin,org.apache.gobblin.util.hadoop,0,0,0,0,0,0,1,1
linkedin_gobblin,org.apache.gobblin.util.http,0,0,0,0,0,0,1,1
linkedin_gobblin,org.apache.gobblin.util.iterators,0,0,0,0,0,0,1,1
linkedin_gobblin,org.apache.gobblin.util.jdbc,2,0,0,0,0,0,1,3
linkedin_gobblin,org.apache.gobblin.util.json,0,0,0,0,0,0,1,1
linkedin_gobblin,org.apache.gobblin.util.limiter.broker,3,1,0,0,0,0,1,5
linkedin_gobblin,org.apache.gobblin.util.logs,0,0,0,0,0,0,1,1
linkedin_gobblin,org.apache.gobblin.util.recordcount,2,0,0,0,0,0,1,3
linkedin_gobblin,org.apache.gobblin.util.reflection,0,0,0,0,0,0,1,1
linkedin_gobblin,org.apache.gobblin.util.retry,0,0,0,0,0,0,1,1
linkedin_gobblin,org.apache.gobblin.util.service,0,0,0,0,0,0,1,1
linkedin_gobblin,org.apache.gobblin.yarn.event,0,0,0,0,1,0,1,2
linkedin_gobblin,org.apache.gobblin.yarn,0,0,0,1,0,0,1,2
liveoak-io_liveoak,io.liveoak.keycloak.server,0,0,0,0,0,0,1,1
liveoak-io_liveoak,io.liveoak.keycloak.theme,0,0,0,0,0,0,1,1
liveoak-io_liveoak,io.liveoak.filesystem.aggregating,0,0,0,0,0,0,1,1
liveoak-io_liveoak,io.liveoak.filesystem.aggregating.extension,0,0,0,0,0,0,1,1
liveoak-io_liveoak,io.liveoak.filesystem.aggregating.service,0,0,0,0,0,0,1,1
liveoak-io_liveoak,io.liveoak.analytics,0,0,0,0,1,1,1,3
liveoak-io_liveoak,io.liveoak.application.clients,0,0,0,0,0,0,1,1
liveoak-io_liveoak,io.liveoak.application.clients.extension,0,0,0,0,0,0,1,1
liveoak-io_liveoak,io.liveoak.application.clients.service,0,0,0,0,0,0,1,1
liveoak-io_liveoak,io.liveoak.applications.templates,0,0,0,0,0,0,1,1
liveoak-io_liveoak,io.liveoak.autosetup,0,0,0,0,0,0,1,1
liveoak-io_liveoak,io.liveoak.bootstrap,0,0,0,0,0,0,1,1
liveoak-io_liveoak,io.liveoak.client,0,0,0,0,0,0,1,1
liveoak-io_liveoak,io.liveoak.client.impl,0,0,0,0,0,0,1,1
liveoak-io_liveoak,io.liveoak.client.protocol,0,0,0,0,0,0,1,1
liveoak-io_liveoak,io.liveoak.common.codec.binary,0,0,0,0,0,0,1,1
liveoak-io_liveoak,io.liveoak.common.codec,0,0,0,0,1,1,1,3
liveoak-io_liveoak,io.liveoak.common.codec.driver,0,0,0,0,0,1,1,2
liveoak-io_liveoak,io.liveoak.common.codec.form,0,0,0,0,0,0,1,1
liveoak-io_liveoak,io.liveoak.common.codec.html,0,0,0,0,0,0,1,1
liveoak-io_liveoak,io.liveoak.common.codec.json,0,0,0,0,0,0,1,1
liveoak-io_liveoak,io.liveoak.common.codec.state,0,0,0,0,0,0,1,1
liveoak-io_liveoak,io.liveoak.common,0,0,0,0,1,3,1,5
liveoak-io_liveoak,io.liveoak.common.protocol,0,0,0,0,0,0,1,1
liveoak-io_liveoak,io.liveoak.common.security,0,0,0,0,0,0,1,1
liveoak-io_liveoak,io.liveoak.common.util,0,0,0,0,1,0,1,2
liveoak-io_liveoak,io.liveoak.container.analytics,0,0,0,0,1,1,1,3
liveoak-io_liveoak,io.liveoak.container,3,0,0,1,1,3,1,9
liveoak-io_liveoak,io.liveoak.container.extension.application,3,1,0,0,1,1,1,7
liveoak-io_liveoak,io.liveoak.container.extension.application.service,0,0,0,0,0,0,1,1
liveoak-io_liveoak,io.liveoak.container.extension,4,0,0,0,1,2,1,8
liveoak-io_liveoak,io.liveoak.container.extension.service,0,0,0,0,0,0,1,1
liveoak-io_liveoak,io.liveoak.container.extension.system,2,0,0,0,1,0,1,4
liveoak-io_liveoak,io.liveoak.container.extension.system.service,3,1,0,0,0,0,1,5
liveoak-io_liveoak,io.liveoak.container.interceptor.extension,0,0,0,0,0,0,1,1
liveoak-io_liveoak,io.liveoak.container.interceptor,0,0,0,0,1,0,1,2
liveoak-io_liveoak,io.liveoak.container.protocols,1,0,0,0,0,0,1,2
liveoak-io_liveoak,io.liveoak.container.protocols.http,0,0,0,0,1,2,1,4
liveoak-io_liveoak,io.liveoak.container.protocols.local,1,1,0,0,0,0,1,3
liveoak-io_liveoak,io.liveoak.container.protocols.websocket,0,0,0,0,0,0,1,1
liveoak-io_liveoak,io.liveoak.container.resource,0,0,0,0,1,0,1,2
liveoak-io_liveoak,io.liveoak.container.server,0,0,0,0,0,0,1,1
liveoak-io_liveoak,io.liveoak.container.service,0,0,0,0,1,0,1,2
liveoak-io_liveoak,io.liveoak.container.service.bootstrap,0,0,0,0,1,0,1,2
liveoak-io_liveoak,io.liveoak.container.subscriptions,0,0,0,0,1,1,1,3
liveoak-io_liveoak,io.liveoak.container.subscriptions.resource,0,0,0,0,0,0,1,1
liveoak-io_liveoak,io.liveoak.container.tenancy,6,1,0,0,1,2,1,11
liveoak-io_liveoak,io.liveoak.container.tenancy.service,0,0,0,0,1,0,1,2
liveoak-io_liveoak,io.liveoak.container.traversal,0,0,0,0,1,1,1,3
liveoak-io_liveoak,io.liveoak.container.zero,3,1,0,0,1,0,1,6
liveoak-io_liveoak,io.liveoak.container.zero.extension,8,1,0,0,0,0,1,10
liveoak-io_liveoak,io.liveoak.container.zero.git,0,0,0,0,0,0,1,1
liveoak-io_liveoak,io.liveoak.container.zero.service,0,0,0,0,1,0,1,2
liveoak-io_liveoak,io.liveoak.container.codec,0,0,0,0,0,0,1,1
liveoak-io_liveoak,io.liveoak.container.codec.form,0,0,0,0,0,0,1,1
liveoak-io_liveoak,io.liveoak.container.codec.json,0,0,0,0,0,0,1,1
liveoak-io_liveoak,io.liveoak.container.codec.state,0,0,0,0,0,0,1,1
liveoak-io_liveoak,io.liveoak.container.mime,0,0,0,0,0,1,1,2
liveoak-io_liveoak,io.liveoak.container.resource.mapping,0,0,0,0,1,0,1,2
liveoak-io_liveoak,io.liveoak.filesystem,0,0,0,0,1,0,1,2
liveoak-io_liveoak,io.liveoak.filesystem.extension,0,0,0,0,0,0,1,1
liveoak-io_liveoak,io.liveoak.filesystem.service,0,0,0,0,0,0,1,1
liveoak-io_liveoak,io.liveoak.git,0,0,0,0,1,0,1,2
liveoak-io_liveoak,io.liveoak.git.extension,0,0,0,0,0,0,1,1
liveoak-io_liveoak,io.liveoak.git.service,0,0,0,0,0,0,1,1
liveoak-io_liveoak,io.liveoak.redirect.https,0,0,0,0,1,1,1,3
liveoak-io_liveoak,io.liveoak.redirect.https.resource,0,0,0,0,0,0,1,1
liveoak-io_liveoak,io.liveoak.interceptor.extension,0,0,0,0,0,0,1,1
liveoak-io_liveoak,io.liveoak.interceptor.service,0,0,0,0,0,0,1,1
liveoak-io_liveoak,io.liveoak.interceptor.timing,0,0,0,0,0,0,1,1
liveoak-io_liveoak,io.liveoak.jgit,0,0,0,0,0,0,1,1
liveoak-io_liveoak,io.liveoak.jgit.ssh,0,0,0,0,0,0,1,1
liveoak-io_liveoak,io.liveoak.keycloak.extension,1,0,0,0,0,0,1,2
liveoak-io_liveoak,io.liveoak.keycloak.interceptor,0,0,0,0,0,1,1,2
liveoak-io_liveoak,io.liveoak.keycloak,1,1,0,0,1,1,1,5
liveoak-io_liveoak,io.liveoak.keycloak.service,0,0,0,0,0,0,1,1
liveoak-io_liveoak,io.liveoak.mongo.config,0,0,0,0,1,1,1,3
liveoak-io_liveoak,io.liveoak.mongo.extension,0,0,0,0,0,0,1,1
liveoak-io_liveoak,io.liveoak.mongo,0,0,0,0,1,1,1,3
liveoak-io_liveoak,io.liveoak.mongo.gridfs.extension,0,0,0,0,0,0,1,1
liveoak-io_liveoak,io.liveoak.mongo.gridfs,0,0,0,0,1,0,1,2
liveoak-io_liveoak,io.liveoak.mongo.gridfs.service,0,0,0,0,0,0,1,1
liveoak-io_liveoak,io.liveoak.mongo.gridfs.util,0,0,0,0,0,0,1,1
liveoak-io_liveoak,io.liveoak.mongo.internal.extension,0,0,0,0,0,0,1,1
liveoak-io_liveoak,io.liveoak.mongo.internal,0,1,0,0,1,0,1,3
liveoak-io_liveoak,io.liveoak.mongo.launcher.config,0,0,0,0,0,0,1,1
liveoak-io_liveoak,io.liveoak.mongo.launcher,0,0,0,0,0,0,1,1
liveoak-io_liveoak,io.liveoak.mongo.launcher.extension,0,0,0,0,0,0,1,1
liveoak-io_liveoak,io.liveoak.mongo.launcher.service,0,0,0,0,0,0,1,1
liveoak-io_liveoak,io.liveoak.pgsql.data,1,1,0,0,1,3,1,7
liveoak-io_liveoak,io.liveoak.pgsql.extension,0,0,0,0,0,0,1,1
liveoak-io_liveoak,io.liveoak.pgsql.meta,1,0,0,0,1,4,1,7
liveoak-io_liveoak,io.liveoak.pgsql,0,0,0,0,1,3,1,5
liveoak-io_liveoak,io.liveoak.pgsql.sql,0,0,0,0,0,0,1,1
liveoak-io_liveoak,io.liveoak.scheduler.extension,0,0,0,0,0,0,1,1
liveoak-io_liveoak,io.liveoak.scheduler,0,0,0,0,1,0,1,2
liveoak-io_liveoak,io.liveoak.scheduler.service,0,0,0,0,0,0,1,1
liveoak-io_liveoak,io.liveoak.scripts.common,0,1,0,0,0,1,1,3
liveoak-io_liveoak,io.liveoak.scripts.libraries.manager,0,1,0,0,0,1,1,3
liveoak-io_liveoak,io.liveoak.scripts.libraries.resources,0,0,0,0,0,1,1,2
liveoak-io_liveoak,io.liveoak.scripts.objects.impl.exception,0,0,0,0,0,0,1,1
liveoak-io_liveoak,io.liveoak.scripts.objects.impl,0,0,0,0,0,2,1,3
liveoak-io_liveoak,io.liveoak.scripts.objects,0,0,0,0,1,0,1,2
liveoak-io_liveoak,io.liveoak.scripts.objects.scripting,0,0,0,0,0,1,1,2
liveoak-io_liveoak,io.liveoak.scripts.resource,0,0,0,0,1,0,1,2
liveoak-io_liveoak,io.liveoak.scripts.resourcetriggered.interceptor,0,0,0,0,0,0,1,1
liveoak-io_liveoak,io.liveoak.scripts.resourcetriggered.manager,0,0,0,0,0,0,1,1
liveoak-io_liveoak,io.liveoak.scripts.resourcetriggered.resource,0,0,0,0,1,0,1,2
liveoak-io_liveoak,io.liveoak.scripts,0,0,0,0,1,1,1,3
liveoak-io_liveoak,io.liveoak.scripts.resource.property,0,0,0,0,0,1,1,2
liveoak-io_liveoak,io.liveoak.scripts.resource.resource,0,0,0,0,0,0,1,1
liveoak-io_liveoak,io.liveoak.scripts.resource.scripting,0,0,0,0,1,1,1,3
liveoak-io_liveoak,io.liveoak.scripts.resource.scripting.resource,0,0,0,0,0,0,1,1
liveoak-io_liveoak,io.liveoak.scripts.scheduled.manager,0,0,0,0,1,1,1,3
liveoak-io_liveoak,io.liveoak.scripts.scheduled.resource,0,0,0,0,0,0,1,1
liveoak-io_liveoak,io.liveoak.scripts.scheduled,0,1,0,0,0,1,1,3
liveoak-io_liveoak,io.liveoak.security.extension,0,0,0,0,0,0,1,1
liveoak-io_liveoak,io.liveoak.security.integration,0,0,0,0,0,0,1,1
liveoak-io_liveoak,io.liveoak.security.interceptor,0,0,0,0,0,1,1,2
liveoak-io_liveoak,io.liveoak.security.service,0,0,0,0,0,0,1,1
liveoak-io_liveoak,io.liveoak.security.spi,0,0,0,0,0,0,1,1
liveoak-io_liveoak,io.liveoak.security.impl,0,0,0,0,0,0,1,1
liveoak-io_liveoak,io.liveoak.security.impl.interceptor,0,0,0,0,1,0,1,2
liveoak-io_liveoak,io.liveoak.security.policy.acl,1,0,0,0,1,0,1,3
liveoak-io_liveoak,io.liveoak.security.policy.acl.extension,0,0,0,0,0,0,1,1
liveoak-io_liveoak,io.liveoak.security.policy.acl.impl,0,0,0,0,0,0,1,1
liveoak-io_liveoak,io.liveoak.security.policy.acl.integration,1,1,0,0,0,0,1,3
liveoak-io_liveoak,io.liveoak.security.policy.acl.interceptor,0,0,0,0,0,0,1,1
liveoak-io_liveoak,io.liveoak.security.policy.acl.service,0,0,0,0,0,0,1,1
liveoak-io_liveoak,io.liveoak.security.client,0,0,0,0,1,0,1,2
liveoak-io_liveoak,io.liveoak.security.client.extension,0,0,0,0,0,0,1,1
liveoak-io_liveoak,io.liveoak.security.client.service,0,0,0,0,0,0,1,1
liveoak-io_liveoak,io.liveoak.security.policy.drools,0,0,0,0,0,0,1,1
liveoak-io_liveoak,io.liveoak.security.policy.drools.extension,0,0,0,0,0,0,1,1
liveoak-io_liveoak,io.liveoak.security.policy.drools.impl,0,0,0,0,1,0,1,2
liveoak-io_liveoak,io.liveoak.security.policy.drools.integration,0,0,0,0,1,0,1,2
liveoak-io_liveoak,io.liveoak.security.policy.drools.service,0,0,0,0,0,0,1,1
liveoak-io_liveoak,io.liveoak.security.policy.uri.extension,0,0,0,0,0,0,1,1
liveoak-io_liveoak,io.liveoak.security.policy.uri.impl,0,0,0,0,0,0,1,1
liveoak-io_liveoak,io.liveoak.security.policy.uri.integration,0,0,0,0,0,0,1,1
liveoak-io_liveoak,io.liveoak.security.policy.uri.service,0,0,0,0,0,0,1,1
liveoak-io_liveoak,io.liveoak.security.policy.uri,0,0,0,0,0,0,1,1
liveoak-io_liveoak,io.liveoak.spi,0,0,0,0,1,22,1,24
liveoak-io_liveoak,io.liveoak.spi.client,0,0,0,0,0,3,1,4
liveoak-io_liveoak,io.liveoak.spi.container,0,0,0,0,0,1,1,2
liveoak-io_liveoak,io.liveoak.spi.container.interceptor,0,0,0,0,1,2,1,4
liveoak-io_liveoak,io.liveoak.spi.exceptions,0,0,0,0,1,0,1,2
liveoak-io_liveoak,io.liveoak.spi.extension,0,0,0,0,0,0,1,1
liveoak-io_liveoak,io.liveoak.spi.resource.async,0,0,0,0,1,7,1,9
liveoak-io_liveoak,io.liveoak.spi.resource,0,0,0,0,1,1,1,3
liveoak-io_liveoak,io.liveoak.spi.resource.config,0,0,0,0,0,0,1,1
liveoak-io_liveoak,io.liveoak.spi.resource.mapper,0,0,0,0,0,0,1,1
liveoak-io_liveoak,io.liveoak.spi.security,0,0,0,0,0,1,1,2
liveoak-io_liveoak,io.liveoak.spi.state,0,0,0,0,0,16,1,17
liveoak-io_liveoak,io.liveoak.spi.util,0,0,0,0,0,0,1,1
liveoak-io_liveoak,io.liveoak.stomp.client.protocol,1,0,0,0,1,2,1,5
liveoak-io_liveoak,io.liveoak.stomp.client,1,1,0,0,1,1,1,5
liveoak-io_liveoak,io.liveoak.stomp.common,0,0,0,0,1,2,1,4
liveoak-io_liveoak,io.liveoak.stomp,0,0,0,0,0,2,1,3
liveoak-io_liveoak,io.liveoak.stomp.server,0,0,0,0,1,1,1,3
liveoak-io_liveoak,io.liveoak.stomp.server.protocol,0,0,0,0,1,0,1,2
liveoak-io_liveoak,io.liveoak.stomp.server.security,0,0,0,0,0,0,1,1
liveoak-io_liveoak,io.liveoak.ups,1,0,0,0,1,0,1,3
liveoak-io_liveoak,io.liveoak.ups.resource,1,1,0,0,1,0,1,4
liveoak-io_liveoak,io.liveoak.ups.resource.config,0,0,0,0,0,0,1,1
liveoak-io_liveoak,io.liveoak.ups.system,0,0,0,0,0,0,1,1
liveoak-io_liveoak,io.liveoak.ups.util,0,0,0,0,0,0,1,1
liveoak-io_liveoak,io.liveoak.wildfly,0,0,0,0,1,0,1,2
liveoak-io_liveoak,io.undertow.client.http,0,0,0,0,0,0,1,1
liveoak-io_liveoak,io.undertow.server.handlers.proxy,0,0,0,0,0,0,1,1
locationtech_udig-platform,docs,0,0,0,0,0,0,1,1
locationtech_udig-platform,html,0,0,0,0,1,0,1,2
locationtech_udig-platform,check,0,0,0,0,0,0,1,1
locationtech_udig-platform,org.locationtech.udig.bookmarks,1,1,0,0,0,0,1,3
locationtech_udig-platform,org.locationtech.udig.bookmarks.internal.actions,0,0,0,0,0,0,1,1
locationtech_udig-platform,org.locationtech.udig.bookmarks.internal,1,0,0,0,0,0,1,2
locationtech_udig-platform,org.locationtech.udig.bookmarks.internal.command,0,0,0,0,0,0,1,1
locationtech_udig-platform,org.locationtech.udig.bookmarks.internal.ui,0,0,0,0,0,0,1,1
locationtech_udig-platform,org.locationtech.udig.browser,0,0,0,0,1,0,1,2
locationtech_udig-platform,org.locationtech.udig.browser.internal,0,0,0,0,0,0,1,1
locationtech_udig-platform,org.locationtech.udig.browser.ui,0,0,0,0,0,0,1,1
locationtech_udig-platform,org.locationtech.udig.catalog,10,1,0,1,0,0,1,13
locationtech_udig-platform,org.locationtech.udig.catalog.document,0,0,0,0,0,0,1,1
locationtech_udig-platform,org.locationtech.udig.catalog.interceptor,1,0,0,0,0,0,1,2
locationtech_udig-platform,org.locationtech.udig.catalog.internal,3,0,0,0,1,0,1,5
locationtech_udig-platform,org.locationtech.udig.catalog.memory,3,0,0,0,1,0,1,5
locationtech_udig-platform,org.locationtech.udig.catalog.memory.internal,1,1,0,0,0,0,1,3
locationtech_udig-platform,org.locationtech.udig.catalog.moved,0,0,0,0,0,0,1,1
locationtech_udig-platform,org.locationtech.udig.catalog.objectproperty,0,0,0,0,0,0,1,1
locationtech_udig-platform,org.locationtech.udig.catalog.util,1,0,0,0,1,0,1,3
locationtech_udig-platform,org.locationtech.udig.arcgrid,0,0,0,0,0,0,1,1
locationtech_udig-platform,org.locationtech.udig.arcgrid.internal,0,0,0,0,0,0,1,1
locationtech_udig-platform,org.locationtech.udig.catalog.arcsde.internal,0,0,0,0,0,0,1,1
locationtech_udig-platform,org.locationtech.udig.catalog.internal.arcsde,0,0,0,0,0,0,1,1
locationtech_udig-platform,org.locationtech.udig.catalog.internal.arcsde.ui,0,0,0,0,0,0,1,1
locationtech_udig-platform,org.locationtech.udig.catalog.csw,0,0,0,0,1,0,1,2
locationtech_udig-platform,org.locationtech.udig.catalog.db2,0,0,0,0,0,0,1,1
locationtech_udig-platform,org.locationtech.udig.catalog.db2.internal,0,0,0,0,0,0,1,1
locationtech_udig-platform,org.locationtech.udig.catalog.internal.db2,0,0,0,0,0,0,1,1
locationtech_udig-platform,org.locationtech.udig.catalog.internal.db2.ui,0,0,0,0,0,0,1,1
locationtech_udig-platform,org.locationtech.udig.catalog.geotiff.internal,0,0,0,0,0,0,1,1
locationtech_udig-platform,org.locationtech.udig.catalog.internal.geotiff,0,0,0,0,0,0,1,1
locationtech_udig-platform,org.locationtech.udig.catalog.geotools,0,0,0,0,0,0,1,1
locationtech_udig-platform,org.locationtech.udig.catalog.geotools.data,0,0,0,0,1,0,1,2
locationtech_udig-platform,org.locationtech.udig.catalog.geotools.process,0,0,0,0,0,0,1,1
locationtech_udig-platform,org.locationtech.udig.catalog.internal.geotools,0,0,0,0,0,0,1,1
locationtech_udig-platform,org.locationtech.udig.catalog.google,0,0,0,0,0,0,1,1
locationtech_udig-platform,org.locationtech.udig.catalog.google.internal,0,0,0,0,0,0,1,1
locationtech_udig-platform,org.locationtech.udig.catalog.imageio,1,0,0,0,0,0,1,2
locationtech_udig-platform,org.locationtech.udig.catalog.imageio.internal,1,1,0,0,0,0,1,3
locationtech_udig-platform,org.locationtech.udig.catalog.jgrass.activeregion,7,0,0,0,0,0,1,8
locationtech_udig-platform,org.locationtech.udig.catalog.jgrass.activeregion.dialogs,3,1,0,0,1,0,1,6
locationtech_udig-platform,org.locationtech.udig.catalog.jgrass.core,8,1,0,0,0,0,1,10
locationtech_udig-platform,org.locationtech.udig.catalog.jgrass,7,1,0,0,0,0,1,9
locationtech_udig-platform,org.locationtech.udig.catalog.jgrass.messages,0,0,0,0,0,0,1,1
locationtech_udig-platform,org.locationtech.udig.catalog.jgrass.operations,0,0,0,0,1,0,1,2
locationtech_udig-platform,org.locationtech.udig.catalog.jgrass.utils,5,1,0,0,0,0,1,7
locationtech_udig-platform,org.locationtech.udig.catalog.jgrass.workspacecreation,0,0,0,0,0,0,1,1
locationtech_udig-platform,org.locationtech.udig.renderer.jgrass,3,0,0,0,0,0,1,4
locationtech_udig-platform,org.locationtech.udig.renderer.jgttms,0,0,0,0,0,0,1,1
locationtech_udig-platform,org.locationtech.udig.catalog.kml.core,0,0,0,0,0,0,1,1
locationtech_udig-platform,org.locationtech.udig.catalog.kml.internal,0,0,0,0,0,0,1,1
locationtech_udig-platform,org.locationtech.udig.catalog.kml.internal.ui,0,0,0,0,0,0,1,1
locationtech_udig-platform,org.locationtech.udig.catalog.kml.wizard,0,0,0,0,0,0,1,1
locationtech_udig-platform,org.locationtech.udig.catalog.internal.mysql,0,0,0,0,0,0,1,1
locationtech_udig-platform,org.locationtech.udig.catalog.internal.mysql.ui,0,0,0,0,1,0,1,2
locationtech_udig-platform,org.locationtech.udig.catalog.mysql.internal,0,0,0,0,0,0,1,1
locationtech_udig-platform,org.locationtech.udig.catalog.internal.oracle,0,0,0,0,0,0,1,1
locationtech_udig-platform,org.locationtech.udig.catalog.internal.oracle.ui,0,0,0,0,0,0,1,1
locationtech_udig-platform,org.locationtech.udig.catalog.oracle.internal,0,0,0,0,0,0,1,1
locationtech_udig-platform,org.locationtech.udig.catalog.internal.postgis,0,0,0,0,0,0,1,1
locationtech_udig-platform,org.locationtech.udig.catalog.internal.postgis.ui,2,0,0,0,1,0,1,4
locationtech_udig-platform,org.locationtech.udig.catalog.postgis.internal,0,0,0,0,0,0,1,1
locationtech_udig-platform,org.locationtech.udig.catalog.rasterings,0,0,0,0,0,0,1,1
locationtech_udig-platform,org.locationtech.udig.catalog.rasterings.internal,0,0,0,0,0,0,1,1
locationtech_udig-platform,org.locationtech.udig.catalog.internal.shp,1,1,0,0,0,0,1,3
locationtech_udig-platform,org.locationtech.udig.catalog.shp,0,0,0,0,0,0,1,1
locationtech_udig-platform,org.locationtech.udig.catalog.shp.internal,0,0,0,0,0,0,1,1
locationtech_udig-platform,org.locationtech.udig.catalog.shp.op,0,0,0,0,0,0,1,1
locationtech_udig-platform,org.locationtech.udig.catalog.shp.preferences,1,0,0,0,0,0,1,2
locationtech_udig-platform,org.locationtech.udig.catalog.teradata,0,0,0,0,0,0,1,1
locationtech_udig-platform,org.locationtech.udig.catalog.teradata.internal,0,0,0,0,0,0,1,1
locationtech_udig-platform,org.locationtech.udig.catalog.util.http,0,0,0,0,0,0,1,1
locationtech_udig-platform,org.locationtech.udig.catalog.internal.ui.actions,0,0,0,0,0,0,1,1
locationtech_udig-platform,org.locationtech.udig.catalog.internal.ui,4,0,0,0,1,0,1,6
locationtech_udig-platform,org.locationtech.udig.catalog.internal.ui.ops,0,0,0,0,0,0,1,1
locationtech_udig-platform,org.locationtech.udig.catalog.service.database,6,0,0,0,0,0,1,7
locationtech_udig-platform,org.locationtech.udig.catalog.service,0,0,0,0,0,0,1,1
locationtech_udig-platform,org.locationtech.udig.catalog.ui,19,1,0,1,0,0,1,22
locationtech_udig-platform,org.locationtech.udig.catalog.ui.export,0,0,0,0,0,0,1,1
locationtech_udig-platform,org.locationtech.udig.catalog.ui.internal,7,1,0,0,0,0,1,9
locationtech_udig-platform,org.locationtech.udig.catalog.ui.operation,0,0,0,0,0,0,1,1
locationtech_udig-platform,org.locationtech.udig.catalog.ui.preferences,0,0,0,0,0,0,1,1
locationtech_udig-platform,org.locationtech.udig.catalog.ui.property,0,0,0,0,0,0,1,1
locationtech_udig-platform,org.locationtech.udig.catalog.ui.search,3,0,0,0,0,0,1,4
locationtech_udig-platform,org.locationtech.udig.catalog.ui.wizard,3,1,0,0,1,0,1,6
locationtech_udig-platform,org.locationtech.udig.catalog.ui.workflow,8,0,0,0,0,0,1,9
locationtech_udig-platform,org.locationtech.udig.catalog.internal.wfs.ui,0,0,0,0,0,0,1,1
locationtech_udig-platform,org.locationtech.udig.catalog.internal.wfs,0,1,0,0,0,0,1,2
locationtech_udig-platform,org.locationtech.udig.catalog.wfs.internal,0,0,0,0,0,0,1,1
locationtech_udig-platform,org.locationtech.catalog.util.internal,0,0,0,0,0,0,1,1
locationtech_udig-platform,org.locationtech.udig.catalog.internal.wms.tileset,0,0,0,0,0,0,1,1
locationtech_udig-platform,org.locationtech.udig.catalog.internal.wms,1,0,0,0,0,0,1,2
locationtech_udig-platform,org.locationtech.udig.catalog.internal.wms.ui,0,0,0,0,0,0,1,1
locationtech_udig-platform,org.locationtech.udig.catalog.internal.wmsc.ui,0,0,0,0,0,0,1,1
locationtech_udig-platform,org.locationtech.udig.catalog.internal.wmsc,0,0,0,0,0,0,1,1
locationtech_udig-platform,org.locationtech.udig.catalog.wms.internal,0,0,0,0,0,0,1,1
locationtech_udig-platform,org.locationtech.udig.catalog.wms.preferences,1,1,0,0,0,0,1,3
locationtech_udig-platform,org.locationtech.udig.catalog.wmsc.server,0,1,0,1,0,0,1,3
locationtech_udig-platform,org.locationtech.udig.catalog.wmsc,0,0,0,0,0,0,1,1
locationtech_udig-platform,org.locationtech.udig.catalog.internal.wmt.tile,7,1,0,0,0,0,1,9
locationtech_udig-platform,org.locationtech.udig.catalog.internal.wmt,14,1,0,0,1,0,1,17
locationtech_udig-platform,org.locationtech.udig.catalog.internal.wmt.ui.preferences,1,0,0,0,0,0,1,2
locationtech_udig-platform,org.locationtech.udig.catalog.internal.wmt.ui.properties,3,0,0,0,0,0,1,4
locationtech_udig-platform,org.locationtech.udig.catalog.internal.wmt.ui.view,0,0,0,0,0,0,1,1
locationtech_udig-platform,org.locationtech.udig.catalog.internal.wmt.ui.wizard.controls,6,0,0,0,0,0,1,7
locationtech_udig-platform,org.locationtech.udig.catalog.internal.wmt.ui.wizard,4,0,0,0,0,0,1,5
locationtech_udig-platform,org.locationtech.udig.catalog.internal.wmt.wmtsource,18,1,0,0,0,0,1,20
locationtech_udig-platform,org.locationtech.udig.catalog.internal.wmt.wmtsource.ww,5,1,0,0,0,0,1,7
locationtech_udig-platform,org.locationtech.udig.catalog.internal.wmt.ww,3,0,0,0,0,0,1,4
locationtech_udig-platform,org.locationtech.udig.catalog.wmt.internal,0,0,0,0,0,0,1,1
locationtech_udig-platform,org.locationtech.udig.catalog.internal.worldimage,0,0,0,0,0,0,1,1
locationtech_udig-platform,org.locationtech.udig.catalog.worldimage.internal,0,0,0,0,0,0,1,1
locationtech_udig-platform,org.locationtech.udig.context,0,0,0,0,0,0,1,1
locationtech_udig-platform,org.locationtech.udig.context.internal,0,0,0,0,0,0,1,1
locationtech_udig-platform,org.locationtech.udig.ui.dialogs,0,0,0,0,0,0,1,1
locationtech_udig-platform,org.locationtech.udig.core,1,0,0,0,1,0,1,3
locationtech_udig-platform,org.locationtech.udig.core.feature,0,0,0,0,0,0,1,1
locationtech_udig-platform,org.locationtech.udig.core.filter,0,0,0,1,0,0,1,2
locationtech_udig-platform,org.locationtech.udig.core.internal,1,1,0,0,1,0,1,4
locationtech_udig-platform,org.locationtech.udig.core.jts,0,0,0,0,0,0,1,1
locationtech_udig-platform,org.locationtech.udig.core.opengis,0,0,0,0,0,0,1,1
locationtech_udig-platform,org.locationtech.udig,0,0,0,0,1,0,1,2
locationtech_udig-platform,org.locationtech.udig.document,2,1,0,0,0,0,1,4
locationtech_udig-platform,org.locationtech.udig.document.model,0,0,0,0,0,0,1,1
locationtech_udig-platform,org.locationtech.udig.document.source,2,1,0,0,0,0,1,4
locationtech_udig-platform,org.locationtech.udig.document.ui,3,0,0,0,0,0,1,4
locationtech_udig-platform,org.locationtech.udig.document.ui.internal,0,0,0,0,0,0,1,1
locationtech_udig-platform,org.locationtech.udig.feature.editor,1,0,0,0,1,0,1,3
locationtech_udig-platform,org.locationtech.udig.feature.editor.field,0,1,0,0,0,0,1,2
locationtech_udig-platform,org.locationtech.udig.feature.editor.internal,0,0,0,0,0,0,1,1
locationtech_udig-platform,org.locationtech.udig.feature.panel,1,0,0,0,0,0,1,2
locationtech_udig-platform,org.locationtech.udig.graph.internal,0,0,0,0,0,0,1,1
locationtech_udig-platform,org.locationtech.udig.image.georeferencing,0,0,0,0,0,0,1,1
locationtech_udig-platform,org.locationtech.udig.image.georeferencing.internal.i18n,0,0,0,0,0,0,1,1
locationtech_udig-platform,org.locationtech.udig.image.georeferencing.internal.preferences,0,0,0,0,0,0,1,1
locationtech_udig-platform,org.locationtech.udig.image.georeferencing.internal.process,0,0,0,0,0,0,1,1
locationtech_udig-platform,org.locationtech.udig.image.georeferencing.internal.ui,4,1,0,0,1,0,1,7
locationtech_udig-platform,org.locationtech.udig.image.georeferencing.internal.ui.coordinatepanel,2,0,0,0,0,0,1,3
locationtech_udig-platform,org.locationtech.udig.image.georeferencing.internal.ui.coordinatepanel.tools,0,0,0,0,1,0,1,2
locationtech_udig-platform,org.locationtech.udig.image.georeferencing.internal.ui.imagepanel,4,1,0,0,1,0,1,7
locationtech_udig-platform,org.locationtech.udig.image.georeferencing.internal.ui.imagepanel.tools,2,0,0,0,0,0,1,3
locationtech_udig-platform,org.locationtech.udig.image.georeferencing.internal.ui.message,0,0,0,0,0,0,1,1
locationtech_udig-platform,org.locationtech.udig.image.georeferencing.ui,0,0,0,0,0,0,1,1
locationtech_udig-platform,org.locationtech.udig.tool.info,2,1,0,0,0,0,1,4
locationtech_udig-platform,org.locationtech.udig.tool.info.internal,2,1,0,0,1,0,1,5
locationtech_udig-platform,org.locationtech.udig.tool.info.internal.display,1,0,0,0,0,0,1,2
locationtech_udig-platform,org.locationtech.udig.issues,6,1,0,0,0,0,1,8
locationtech_udig-platform,org.locationtech.udig.issues.internal.datastore,0,0,0,0,1,0,1,2
locationtech_udig-platform,org.locationtech.udig.issues.internal,4,0,0,0,1,0,1,6
locationtech_udig-platform,org.locationtech.udig.issues.internal.view,3,0,0,0,0,0,1,4
locationtech_udig-platform,org.locationtech.udig.issues.listeners,3,1,0,0,1,0,1,6
locationtech_udig-platform,org.locationtech.udig.jconsole.actions,0,0,0,0,0,0,1,1
locationtech_udig-platform,org.locationtech.udig.jconsole.java,1,0,0,0,1,0,1,3
locationtech_udig-platform,org.locationtech.udig.jconsole,3,0,0,0,0,0,1,4
locationtech_udig-platform,org.locationtech.udig.jconsole.javadoc,1,0,0,0,0,0,1,2
locationtech_udig-platform,org.locationtech.udig.jconsole.util,3,1,0,0,0,0,1,5
locationtech_udig-platform,org.locationtech.udig.legend.internal,0,0,0,0,0,0,1,1
locationtech_udig-platform,org.locationtech.udig.legend,0,0,0,0,0,0,1,1
locationtech_udig-platform,org.locationtech.udig.legend.ui.actions,0,0,0,0,0,0,1,1
locationtech_udig-platform,org.locationtech.udig.legend.ui,0,1,0,0,0,0,1,2
locationtech_udig-platform,org.locationtech.udig.libs.internal,0,0,0,0,0,0,1,1
locationtech_udig-platform,org.locationtech.udig.location,0,0,0,0,0,0,1,1
locationtech_udig-platform,org.locationtech.udig.location.internal,0,0,0,0,0,0,1,1
locationtech_udig-platform,org.locationtech.udig.location.ui,0,0,0,0,0,0,1,1
locationtech_udig-platform,org.locationtech.udig.mapgraphic,9,1,0,0,1,0,1,12
locationtech_udig-platform,org.locationtech.udig.mapgraphic.graticule,0,0,0,0,1,0,1,2
locationtech_udig-platform,org.locationtech.udig.mapgraphic.grid,0,0,0,0,1,0,1,2
locationtech_udig-platform,org.locationtech.udig.mapgraphic.internal,6,0,0,0,1,0,1,8
locationtech_udig-platform,org.locationtech.udig.mapgraphic.internal.ui,2,0,0,0,0,0,1,3
locationtech_udig-platform,org.locationtech.udig.mapgraphic.northarrow,0,0,0,0,0,0,1,1
locationtech_udig-platform,org.locationtech.udig.mapgraphic.scale,0,0,0,0,0,0,1,1
locationtech_udig-platform,org.locationtech.udig.mapgraphic.scalebar,5,1,0,0,1,0,1,8
locationtech_udig-platform,org.locationtech.udig.mapgraphic.style,2,0,0,0,1,0,1,4
locationtech_udig-platform,i18n.omsbox,0,0,0,0,0,0,1,1
locationtech_udig-platform,org.locationtech.udig.omsbox.core,4,1,0,0,0,0,1,6
locationtech_udig-platform,org.locationtech.udig.omsbox,7,1,0,0,0,0,1,9
locationtech_udig-platform,org.locationtech.udig.omsbox.processingregion,6,0,0,0,1,0,1,8
locationtech_udig-platform,org.locationtech.udig.omsbox.ui,3,0,0,0,1,0,1,5
locationtech_udig-platform,org.locationtech.udig.omsbox.utils,9,1,0,0,1,0,1,12
locationtech_udig-platform,org.locationtech.udig.omsbox.view.actions,0,0,0,0,1,0,1,2
locationtech_udig-platform,org.locationtech.udig.omsbox.view,0,1,0,0,0,0,1,2
locationtech_udig-platform,org.locationtech.udig.omsbox.view.widgets,2,0,0,0,0,0,1,3
locationtech_udig-platform,org.locationtech.udig.printing.model,0,0,0,0,1,0,1,2
locationtech_udig-platform,org.locationtech.udig.printing.model.impl,0,0,0,0,1,0,1,2
locationtech_udig-platform,org.locationtech.udig.printing.model.internal,0,0,0,0,0,0,1,1
locationtech_udig-platform,org.locationtech.udig.printing.model.util,0,0,0,0,0,0,1,1
locationtech_udig-platform,org.locationtech.udig.printing.model.provider,0,0,0,0,0,0,1,1
locationtech_udig-platform,org.locationtech.udig.printing.ui.actions,0,0,0,0,0,0,1,1
locationtech_udig-platform,org.locationtech.udig.printing.ui,5,1,0,0,0,0,1,7
locationtech_udig-platform,org.locationtech.udig.printing.ui.internal,3,1,0,0,0,0,1,5
locationtech_udig-platform,org.locationtech.udig.printing.ui.internal.editor,3,0,0,0,1,0,1,5
locationtech_udig-platform,org.locationtech.udig.printing.ui.internal.editor.commands,1,1,0,0,1,0,1,4
locationtech_udig-platform,org.locationtech.udig.printing.ui.internal.editor.figures,0,0,0,0,0,0,1,1
locationtech_udig-platform,org.locationtech.udig.printing.ui.internal.editor.parts,6,1,0,0,1,0,1,9
locationtech_udig-platform,org.locationtech.udig.printing.ui.internal.editor.policies,0,0,0,0,0,0,1,1
locationtech_udig-platform,org.locationtech.udig.printing.ui.internal.template,0,0,0,0,0,0,1,1
locationtech_udig-platform,org.locationtech.udig.printing.ui.pdf,0,0,0,0,1,0,1,2
locationtech_udig-platform,org.locationtech.udig.project,21,1,0,1,1,0,1,25
locationtech_udig-platform,org.locationtech.udig.project.command,10,1,0,0,0,0,1,12
locationtech_udig-platform,org.locationtech.udig.project.command.factory,3,0,0,0,0,0,1,4
locationtech_udig-platform,org.locationtech.udig.project.command.map,0,0,0,0,0,0,1,1
locationtech_udig-platform,org.locationtech.udig.project.command.provider,0,0,0,0,0,0,1,1
locationtech_udig-platform,org.locationtech.udig.project.element,4,0,0,0,1,0,1,6
locationtech_udig-platform,org.locationtech.udig.project.element.impl,4,0,0,0,0,0,1,5
locationtech_udig-platform,org.locationtech.udig.project.element.util,0,0,0,0,0,0,1,1
locationtech_udig-platform,org.locationtech.udig.project.geoselection,1,0,0,0,0,0,1,2
locationtech_udig-platform,org.locationtech.udig.project.interceptor,3,1,0,0,0,0,1,5
locationtech_udig-platform,org.locationtech.udig.project.internal,44,1,0,1,0,0,1,47
locationtech_udig-platform,org.locationtech.udig.project.internal.command.navigation,0,0,0,0,1,0,1,2
locationtech_udig-platform,org.locationtech.udig.project.internal.commands,2,0,0,0,0,0,1,3
locationtech_udig-platform,org.locationtech.udig.project.internal.commands.edit,3,0,0,0,1,0,1,5
locationtech_udig-platform,org.locationtech.udig.project.internal.commands.selection,3,0,0,0,1,0,1,5
locationtech_udig-platform,org.locationtech.udig.project.internal.impl,16,1,0,1,0,0,1,19
locationtech_udig-platform,org.locationtech.udig.project.internal.interceptor,5,0,0,0,1,0,1,7
locationtech_udig-platform,org.locationtech.udig.project.internal.property,0,0,0,0,0,0,1,1
locationtech_udig-platform,org.locationtech.udig.project.internal.render,26,1,0,0,1,0,1,29
locationtech_udig-platform,org.locationtech.udig.project.internal.render.impl,15,1,0,1,0,0,1,18
locationtech_udig-platform,org.locationtech.udig.project.internal.render.util,0,0,0,0,0,0,1,1
locationtech_udig-platform,org.locationtech.udig.project.internal.util,0,0,0,0,0,0,1,1
locationtech_udig-platform,org.locationtech.udig.project.memento,0,0,0,0,0,0,1,1
locationtech_udig-platform,org.locationtech.udig.project.preferences,4,1,0,0,0,0,1,6
locationtech_udig-platform,org.locationtech.udig.project.render,7,1,0,0,1,0,1,10
locationtech_udig-platform,org.locationtech.udig.project.render.displayAdapter,0,0,0,0,0,0,1,1
locationtech_udig-platform,org.locationtech.udig.project.edit.internal,0,0,0,0,0,0,1,1
locationtech_udig-platform,org.locationtech.udig.project.element.provider,0,0,0,0,0,0,1,1
locationtech_udig-platform,org.locationtech.udig.project.internal.provider,1,1,0,1,0,0,1,4
locationtech_udig-platform,org.locationtech.udig.project.internal.render.provider,1,1,0,0,1,0,1,4
locationtech_udig-platform,org.locationtech.udig.project.internal.element.extensible.impl,0,0,0,0,0,0,1,1
locationtech_udig-platform,org.locationtech.udig.project.internal.render.impl.renderercreator,0,0,0,0,0,0,1,1
locationtech_udig-platform,org.locationtech.udig.project.internal.ui.wizard,0,0,0,0,0,0,1,1
locationtech_udig-platform,org.locationtech.udig.project.ui,29,1,0,1,1,0,1,33
locationtech_udig-platform,org.locationtech.udig.project.ui.commands,11,1,0,0,1,0,1,14
locationtech_udig-platform,org.locationtech.udig.project.ui.controls,1,1,0,0,0,0,1,3
locationtech_udig-platform,org.locationtech.udig.project.ui.feature,2,1,0,0,0,0,1,4
locationtech_udig-platform,org.locationtech.udig.project.ui.internal.actions,7,1,0,0,1,0,1,10
locationtech_udig-platform,org.locationtech.udig.project.ui.internal,35,1,0,1,0,0,1,38
locationtech_udig-platform,org.locationtech.udig.project.ui.internal.adapters,0,0,0,0,1,0,1,2
locationtech_udig-platform,org.locationtech.udig.project.ui.internal.aoi,0,0,0,0,0,0,1,1
locationtech_udig-platform,org.locationtech.udig.project.ui.internal.commands.draw,4,1,0,0,1,0,1,7
locationtech_udig-platform,org.locationtech.udig.project.ui.internal.commands,0,0,0,0,0,0,1,1
locationtech_udig-platform,org.locationtech.udig.project.ui.internal.dragdrop,3,0,0,0,0,0,1,4
locationtech_udig-platform,org.locationtech.udig.project.ui.internal.handlers,0,0,0,0,0,0,1,1
locationtech_udig-platform,org.locationtech.udig.project.ui.internal.properties,0,0,0,0,1,0,1,2
locationtech_udig-platform,org.locationtech.udig.project.ui.internal.property.pages,0,0,0,0,1,0,1,2
locationtech_udig-platform,org.locationtech.udig.project.ui.internal.render.displayAdapter.impl,6,0,0,0,0,0,1,7
locationtech_udig-platform,org.locationtech.udig.project.ui.internal.tool.display,4,0,0,0,0,0,1,5
locationtech_udig-platform,org.locationtech.udig.project.ui.internal.tool.impl,0,0,0,0,0,0,1,1
locationtech_udig-platform,org.locationtech.udig.project.ui.internal.tool,0,0,0,0,0,0,1,1
locationtech_udig-platform,org.locationtech.udig.project.ui.internal.wizard,2,1,0,0,0,0,1,4
locationtech_udig-platform,org.locationtech.udig.project.ui.internal.wizard.url,0,0,0,0,0,0,1,1
locationtech_udig-platform,org.locationtech.udig.project.ui.operations,0,0,0,0,0,0,1,1
locationtech_udig-platform,org.locationtech.udig.project.ui.operations.example,0,0,0,0,0,0,1,1
locationtech_udig-platform,org.locationtech.udig.project.ui.preferences,4,1,0,0,0,0,1,6
locationtech_udig-platform,org.locationtech.udig.project.ui.properties,0,0,0,0,0,0,1,1
locationtech_udig-platform,org.locationtech.udig.project.ui.render.displayAdapter,9,1,0,0,0,0,1,11
locationtech_udig-platform,org.locationtech.udig.project.ui.render.glass,2,0,0,0,0,0,1,3
locationtech_udig-platform,org.locationtech.udig.project.ui.summary,0,0,0,0,0,0,1,1
locationtech_udig-platform,org.locationtech.udig.project.ui.tileset,0,0,0,0,0,0,1,1
locationtech_udig-platform,org.locationtech.udig.project.ui.tool,8,1,0,0,1,0,1,11
locationtech_udig-platform,org.locationtech.udig.project.ui.tool.options,1,1,0,0,0,0,1,3
locationtech_udig-platform,org.locationtech.udig.project.ui.tool.selection.provider,0,0,0,0,0,0,1,1
locationtech_udig-platform,org.locationtech.udig.project.ui.viewers,5,1,0,0,0,0,1,7
locationtech_udig-platform,org.locationtech.udig.project.ui.wizard.export,0,0,0,0,1,0,1,2
locationtech_udig-platform,org.locationtech.udig.project.ui.wizard.export.image,0,0,0,0,0,0,1,1
locationtech_udig-platform,org.locationtech.udig.project.ui.wizard.export.map,0,0,0,0,0,0,1,1
locationtech_udig-platform,org.locationtech.udig.project.ui.wizard.export.project,3,0,0,0,0,0,1,4
locationtech_udig-platform,org.locationtech.udig.project.ui.editor,0,0,0,0,0,0,1,1
locationtech_udig-platform,org.locationtech.udig.render.feature.basic.internal,0,0,0,0,0,0,1,1
locationtech_udig-platform,org.locationtech.udig.render.internal.feature.basic,0,0,0,0,0,0,1,1
locationtech_udig-platform,org.locationtech.udig.render.internal.feature.shapefile,0,0,0,0,0,0,1,1
locationtech_udig-platform,org.locationtech.udig.render.gridcoverage.basic.internal,0,0,0,0,0,0,1,1
locationtech_udig-platform,org.locationtech.udig.render.gridcoverage.tool.info.internal,0,1,0,0,0,0,1,2
locationtech_udig-platform,org.locationtech.udig.render.gridcoverage.tool.info,0,0,0,0,0,0,1,1
locationtech_udig-platform,org.locationtech.udig.render.internal.gridcoverage.basic,0,0,0,0,1,0,1,2
locationtech_udig-platform,org.locationtech.udig.render.internal.wms.basic,0,0,0,0,0,0,1,1
locationtech_udig-platform,org.locationtech.udig.render.internal.wmsc.basic,0,0,0,0,0,0,1,1
locationtech_udig-platform,org.locationtech.udig.render.wms.basic.internal,0,0,0,0,0,0,1,1
locationtech_udig-platform,org.locationtech.udig.render.wms.basic.preferences,0,0,0,0,0,0,1,1
locationtech_udig-platform,org.locationtech.udig.render.wms.basic,0,0,0,0,0,0,1,1
locationtech_udig-platform,org.locationtech.udig.render.internal.wmt.basic,0,0,0,0,0,0,1,1
locationtech_udig-platform,org.locationtech.udig.render.wmt.basic.internal,0,0,0,0,0,0,1,1
locationtech_udig-platform,org.locationtech.udig.render.wmt.basic,0,0,0,0,0,0,1,1
locationtech_udig-platform,org.locationtech.udig.socket,0,0,0,0,0,0,1,1
locationtech_udig-platform,org.locationtech.udig.style.internal,0,0,0,0,0,0,1,1
locationtech_udig-platform,org.locationtech.udig.style,0,0,0,0,0,0,1,1
locationtech_udig-platform,org.locationtech.udig.style.ui,0,0,0,0,0,0,1,1
locationtech_udig-platform,org.locationtech.udig.style.advanced.core,0,0,0,0,0,0,1,1
locationtech_udig-platform,org.locationtech.udig.style.advanced.utils,2,1,0,0,0,0,1,4
locationtech_udig-platform,org.locationtech.udig.style.advanced.common,0,0,0,0,1,0,1,2
locationtech_udig-platform,org.locationtech.udig.style.advanced.common.styleattributeclasses,1,1,0,0,0,0,1,3
locationtech_udig-platform,org.locationtech.udig.style.advanced.editorpages,0,0,0,0,0,0,1,1
locationtech_udig-platform,org.locationtech.udig.style.advanced.internal,2,0,0,0,0,0,1,3
locationtech_udig-platform,org.locationtech.udig.style.advanced.lines,0,0,0,0,0,0,1,1
locationtech_udig-platform,org.locationtech.udig.style.advanced.lines.widgets,0,0,0,0,0,0,1,1
locationtech_udig-platform,org.locationtech.udig.style.advanced.points,0,0,0,0,0,0,1,1
locationtech_udig-platform,org.locationtech.udig.style.advanced.points.widgets,0,0,0,0,0,0,1,1
locationtech_udig-platform,org.locationtech.udig.style.advanced.polygons,0,0,0,0,0,0,1,1
locationtech_udig-platform,org.locationtech.udig.style.advanced.polygons.widgets,0,0,0,0,0,0,1,1
locationtech_udig-platform,org.locationtech.udig.style.advanced,0,0,0,0,0,0,1,1
locationtech_udig-platform,org.locationtech.udig.style.advanced.raster,0,0,0,0,0,0,1,1
locationtech_udig-platform,org.locationtech.udig.style.advanced.raster.editorpages,0,0,0,0,0,0,1,1
locationtech_udig-platform,org.locationtech.udig.style.advanced.raster.internal,0,0,0,0,0,0,1,1
locationtech_udig-platform,org.locationtech.udig.style.jgrass.categories,0,0,0,0,0,0,1,1
locationtech_udig-platform,org.locationtech.udig.style.jgrass.colors,0,0,0,0,0,0,1,1
locationtech_udig-platform,org.locationtech.udig.style.jgrass.core,0,0,0,0,0,0,1,1
locationtech_udig-platform,org.locationtech.udig.style.jgrass,0,0,0,0,0,0,1,1
locationtech_udig-platform,org.locationtech.udig.style.jgrass.legend,0,0,0,0,0,0,1,1
locationtech_udig-platform,org.locationtech.udig.style.jgrass.messages,0,0,0,0,0,0,1,1
locationtech_udig-platform,org.locationtech.udig.filter,0,0,0,0,0,0,1,1
locationtech_udig-platform,org.locationtech.udig.style.cache,0,0,0,0,0,0,1,1
locationtech_udig-platform,org.locationtech.udig.style.filter,0,0,0,0,0,0,1,1
locationtech_udig-platform,org.locationtech.udig.style.sld,8,1,0,0,1,0,1,11
locationtech_udig-platform,org.locationtech.udig.style.sld.editor,7,1,0,1,0,0,1,10
locationtech_udig-platform,org.locationtech.udig.style.sld.editor.internal,4,0,0,0,0,0,1,5
locationtech_udig-platform,org.locationtech.udig.style.sld.internal,4,1,0,0,0,0,1,6
locationtech_udig-platform,org.locationtech.udig.style.sld.simple,5,0,0,0,1,0,1,7
locationtech_udig-platform,org.locationtech.udig.style.sld.raster.editor,0,0,0,0,0,0,1,1
locationtech_udig-platform,org.locationtech.udig.style.sld.raster.internal,0,0,0,0,0,0,1,1
locationtech_udig-platform,org.locationtech.udig.style.sld.raster,0,1,0,0,0,0,1,2
locationtech_udig-platform,org.locationtech.udig.style.wms.internal,0,0,0,0,0,0,1,1
locationtech_udig-platform,org.locationtech.udig.style.wms,0,0,0,0,0,0,1,1
locationtech_udig-platform,org.locationtech.udig.tools.internal,0,0,0,1,1,0,1,3
locationtech_udig-platform,org.locationtech.udig.tool.edit,0,0,0,0,1,0,1,2
locationtech_udig-platform,org.locationtech.udig.tool.edit.internal,0,0,0,0,0,0,1,1
locationtech_udig-platform,org.locationtech.udig.tools.edit,6,1,0,1,0,0,1,9
locationtech_udig-platform,org.locationtech.udig.tools.edit.activator,0,0,0,0,1,0,1,2
locationtech_udig-platform,org.locationtech.udig.tools.edit.animation,4,0,0,0,1,0,1,6
locationtech_udig-platform,org.locationtech.udig.tools.edit.behaviour.accept,0,0,0,0,0,0,1,1
locationtech_udig-platform,org.locationtech.udig.tools.edit.behaviour,0,1,0,1,1,0,1,4
locationtech_udig-platform,org.locationtech.udig.tools.edit.commands,4,1,0,1,1,0,1,8
locationtech_udig-platform,org.locationtech.udig.tools.edit.commands.selection,0,0,0,0,0,0,1,1
locationtech_udig-platform,org.locationtech.udig.tools.edit.enablement,0,0,0,0,0,0,1,1
locationtech_udig-platform,org.locationtech.udig.tools.edit.handler,0,0,0,0,0,0,1,1
locationtech_udig-platform,org.locationtech.udig.tools.edit.impl,0,0,0,0,1,0,1,2
locationtech_udig-platform,org.locationtech.udig.tools.edit.preferences,4,1,0,0,1,0,1,7
locationtech_udig-platform,org.locationtech.udig.tools.edit.support,8,1,0,1,0,0,1,11
locationtech_udig-platform,org.locationtech.udig.tools.edit.validator,0,0,0,0,1,0,1,2
locationtech_udig-platform,org.locationtech.udig.tools.options,0,0,0,0,0,0,1,1
locationtech_udig-platform,org.locationtech.udig.tool.measure,1,0,0,0,0,0,1,2
locationtech_udig-platform,org.locationtech.udig.tool.measure.internal,1,1,0,0,0,0,1,3
locationtech_udig-platform,org.locationtech.udig.tool.select,4,0,0,0,1,0,1,6
locationtech_udig-platform,org.locationtech.udig.tool.select.commands,4,0,0,0,0,0,1,5
locationtech_udig-platform,org.locationtech.udig.tool.select.internal,7,1,0,0,1,0,1,10
locationtech_udig-platform,org.locationtech.udig.tool.select.preferences,4,1,0,0,0,0,1,6
locationtech_udig-platform,org.locationtech.udig.tools,0,0,0,0,0,0,1,1
locationtech_udig-platform,org.locationtech.udig.tools.arc,0,0,0,0,0,0,1,1
locationtech_udig-platform,org.locationtech.udig.tools.arc.internal,0,0,0,0,0,0,1,1
locationtech_udig-platform,org.locationtech.udig.tools.arc.internal.beahaviour,0,0,0,0,0,0,1,1
locationtech_udig-platform,org.locationtech.udig.tools.arc.internal.presentation,0,0,0,0,0,0,1,1
locationtech_udig-platform,org.locationtech.udig.tools.feature.split,0,0,0,0,0,0,1,1
locationtech_udig-platform,org.locationtech.udig.tools.feature.util,0,0,0,0,1,0,1,2
locationtech_udig-platform,org.locationtech.udig.tools.geometry.internal.util,0,0,0,0,0,0,1,1
locationtech_udig-platform,org.locationtech.udig.tools.geometry.merge,0,0,0,0,0,0,1,1
locationtech_udig-platform,org.locationtech.udig.tools.geometry.split,0,0,0,0,0,0,1,1
locationtech_udig-platform,org.locationtech.udig.tools.geometry.trim,0,0,0,0,0,0,1,1
locationtech_udig-platform,org.locationtech.udig.tools.internal.i18n,0,0,0,0,0,0,1,1
locationtech_udig-platform,org.locationtech.udig.tools.internal.mediator,0,1,0,0,0,0,1,2
locationtech_udig-platform,org.locationtech.udig.tools.internal.ui.util,0,1,0,0,0,0,1,2
locationtech_udig-platform,org.locationtech.udig.tools.merge.internal.view,1,0,0,0,0,0,1,2
locationtech_udig-platform,org.locationtech.udig.tools.merge,1,1,0,0,1,0,1,4
locationtech_udig-platform,org.locationtech.udig.tools.parallel.internal,0,0,0,0,1,0,1,2
locationtech_udig-platform,org.locationtech.udig.tools.parallel.internal.behaviour,0,0,0,0,0,0,1,1
locationtech_udig-platform,org.locationtech.udig.tools.parallel.internal.command,0,0,0,0,0,0,1,1
locationtech_udig-platform,org.locationtech.udig.tools.parallel,0,0,0,0,0,0,1,1
locationtech_udig-platform,org.locationtech.udig.tools.parallel.view,0,0,0,0,0,0,1,1
locationtech_udig-platform,org.locationtech.udig.tools.split,0,0,0,0,0,0,1,1
locationtech_udig-platform,org.locationtech.udig.tools.trim.internal,0,0,0,0,0,0,1,1
locationtech_udig-platform,org.locationtech.udig.tools.trim,0,0,0,0,0,0,1,1
locationtech_udig-platform,org.locationtech.udig.tools.jgrass.copypath,0,0,0,0,0,0,1,1
locationtech_udig-platform,org.locationtech.udig.tools.jgrass.coverageexport,0,0,0,0,0,0,1,1
locationtech_udig-platform,org.locationtech.udig.tools.jgrass.csv,0,0,0,0,0,0,1,1
locationtech_udig-platform,org.locationtech.udig.tools.jgrass.featuremovieview,0,0,0,0,0,0,1,1
locationtech_udig-platform,org.locationtech.udig.tools.jgrass.geopaparazzi,0,0,0,0,0,0,1,1
locationtech_udig-platform,org.locationtech.udig.tools.jgrass.i18n,0,0,0,0,0,0,1,1
locationtech_udig-platform,org.locationtech.udig.tools.jgrass,0,0,0,0,0,0,1,1
locationtech_udig-platform,org.locationtech.udig.tools.jgrass.movefeatures,0,0,0,0,0,0,1,1
locationtech_udig-platform,org.locationtech.udig.tools.jgrass.navigationview,0,0,0,0,0,0,1,1
locationtech_udig-platform,org.locationtech.udig.tools.jgrass.orientationview,0,0,0,0,0,0,1,1
locationtech_udig-platform,org.locationtech.udig.tools.jgrass.profile.borrowedfromjgrasstools,0,0,0,0,0,0,1,1
locationtech_udig-platform,org.locationtech.udig.tools.jgrass.profile,0,0,0,0,0,0,1,1
locationtech_udig-platform,org.locationtech.udig.tools.jgrass.utils,0,0,0,0,0,0,1,1
locationtech_udig-platform,org.locationtech.tools.geometry.split,0,0,0,0,0,0,1,1
locationtech_udig-platform,org.locationtech.udig.tutorials.catalog.csv,0,0,0,0,0,0,1,1
locationtech_udig-platform,org.locationtech.udig.tutorials.catalog.csv.internal,0,0,0,0,0,0,1,1
locationtech_udig-platform,org.locationtech.udig.tutorials.customapp,0,0,0,0,0,0,1,1
locationtech_udig-platform,org.locationtech.udig.tutorials.distancetool,0,0,0,0,0,0,1,1
locationtech_udig-platform,org.locationtech.udig.tutorials.examples,0,0,0,0,1,0,1,2
locationtech_udig-platform,org.locationtech.udig.tutorials.examples.internal,0,0,0,0,0,0,1,1
locationtech_udig-platform,org.locationtech.udig.tutorials.celleditor,0,0,0,0,0,0,1,1
locationtech_udig-platform,org.locationtech.udig.tutorials.featureeditor,0,0,0,0,1,0,1,2
locationtech_udig-platform,org.locationtech.udig.tutorials.genericprojectelement,0,0,0,0,1,0,1,2
locationtech_udig-platform,org.locationtech.udig.tutorials.mapgraphic,0,0,0,0,0,0,1,1
locationtech_udig-platform,org.locationtech.udig.tutorials.preferredzoomlevels,0,0,0,0,1,0,1,2
locationtech_udig-platform,org.locationtech.udig.tutorials.raster,0,0,0,0,0,0,1,1
locationtech_udig-platform,org.locationtech.udig.tutorials.rcp,0,0,0,1,1,0,1,3
locationtech_udig-platform,org.locationtech.udig.tutorials.render.csv,0,0,0,0,0,0,1,1
locationtech_udig-platform,org.locationtech.udig.tutorials.shpexport,0,0,0,0,0,0,1,1
locationtech_udig-platform,org.locationtech.udig.tutorials.style.color,0,0,0,0,1,0,1,2
locationtech_udig-platform,org.locationtech.udig.tutorials.template,0,0,0,0,0,0,1,1
locationtech_udig-platform,org.locationtech.udig.tutorials.toolview,0,0,0,0,1,0,1,2
locationtech_udig-platform,org.locationtech.udig.tutorial.tool.coordinate,0,0,0,0,0,0,1,1
locationtech_udig-platform,org.locationtech.udig.tutorials.tool.coverage,0,0,0,0,0,0,1,1
locationtech_udig-platform,org.locationtech.udig.tutorials.tracking,0,0,0,0,1,0,1,2
locationtech_udig-platform,org.locationtech.udig.tutorials.tracking.glasspane,0,1,0,0,0,0,1,2
locationtech_udig-platform,org.locationtech.udig.tutorials.tracking.trackingitem,0,0,0,0,0,0,1,1
locationtech_udig-platform,org.locationtech.udig.tutorials.urladapter,0,0,0,0,0,0,1,1
locationtech_udig-platform,org.locationtech.udig.tutorials.workbench,0,0,0,0,0,0,1,1
locationtech_udig-platform,org.locationtech.udig.aoi,5,1,0,0,0,0,1,7
locationtech_udig-platform,org.locationtech.udig.internal.aoi,3,0,0,0,0,0,1,4
locationtech_udig-platform,org.locationtech.udig.internal.ui,13,1,0,1,0,0,1,16
locationtech_udig-platform,org.locationtech.udig.internal.ui.operations,3,0,0,0,0,0,1,4
locationtech_udig-platform,org.locationtech.udig.ui,13,1,0,1,0,0,1,16
locationtech_udig-platform,org.locationtech.udig.ui.action,3,0,0,0,0,0,1,4
locationtech_udig-platform,org.locationtech.udig.ui.aoi,0,0,0,0,0,0,1,1
locationtech_udig-platform,org.locationtech.udig.ui.export,0,0,0,0,0,0,1,1
locationtech_udig-platform,org.locationtech.udig.ui.filter,0,0,0,0,0,0,1,1
locationtech_udig-platform,org.locationtech.udig.ui.graphics,2,1,0,0,1,0,1,5
locationtech_udig-platform,org.locationtech.udig.ui.internal,6,1,0,0,0,0,1,8
locationtech_udig-platform,org.locationtech.udig.ui.operations,3,1,0,1,0,0,1,6
locationtech_udig-platform,org.locationtech.udig.ui.palette,0,1,0,0,0,0,1,2
locationtech_udig-platform,org.locationtech.udig.ui.preferences,2,0,0,0,1,0,1,4
locationtech_udig-platform,org.locationtech.udig.ui.properties,0,0,0,0,0,0,1,1
locationtech_udig-platform,org.locationtech.udig.validation,0,0,0,0,1,0,1,2
locationtech_udig-platform,org.locationtech.udig.validation.internal,0,0,0,0,0,0,1,1
locationtech_udig-platform,org.locationtech.udig.validation.ui,0,0,0,0,0,0,1,1
loldevs_riotapi,net.boreeas.riotapi.com.riotgames.kudos.dto,0,0,0,0,0,0,0,0
loldevs_riotapi,net.boreeas.riotapi.com.riotgames.leagues.pojo,0,0,0,0,0,0,0,0
loldevs_riotapi,net.boreeas.riotapi.com.riotgames.platform.account,0,0,0,0,0,0,0,0
loldevs_riotapi,net.boreeas.riotapi.com.riotgames.platform.account.impl,0,0,0,0,0,0,0,0
loldevs_riotapi,net.boreeas.riotapi.com.riotgames.platform.account.management,0,0,0,0,0,0,0,0
loldevs_riotapi,net.boreeas.riotapi.com.riotgames.platform.admin,0,0,0,0,0,0,0,0
loldevs_riotapi,net.boreeas.riotapi.com.riotgames.platform.broadcast,0,0,0,0,0,0,0,0
loldevs_riotapi,net.boreeas.riotapi.com.riotgames.platform.catalog.champion,0,0,0,0,0,0,0,0
loldevs_riotapi,net.boreeas.riotapi.com.riotgames.platform.catalog,0,0,0,0,0,0,0,0
loldevs_riotapi,net.boreeas.riotapi.com.riotgames.platform.catalog.icon,0,0,0,0,0,0,0,0
loldevs_riotapi,net.boreeas.riotapi.com.riotgames.platform.catalog.runes,0,0,0,0,0,0,0,0
loldevs_riotapi,net.boreeas.riotapi.com.riotgames.platform.client.dynamic.configuration,0,0,0,0,0,0,0,0
loldevs_riotapi,net.boreeas.riotapi.com.riotgames.platform.clientfacade.domain,0,0,0,0,0,0,0,0
loldevs_riotapi,net.boreeas.riotapi.com.riotgames.platform.game,0,0,0,0,1,0,0,1
loldevs_riotapi,net.boreeas.riotapi.com.riotgames.platform.game.map,0,0,0,0,0,0,0,0
loldevs_riotapi,net.boreeas.riotapi.com.riotgames.platform.game.practice,0,0,0,0,0,0,0,0
loldevs_riotapi,net.boreeas.riotapi.com.riotgames.platform.gameinvite.contract,0,0,0,0,1,0,0,1
loldevs_riotapi,net.boreeas.riotapi.com.riotgames.platform.harassment,0,0,0,0,0,0,0,0
loldevs_riotapi,net.boreeas.riotapi.com.riotgames.platform.leagues.client.dto,0,0,0,0,0,0,0,0
loldevs_riotapi,net.boreeas.riotapi.com.riotgames.platform.login,0,0,0,0,0,0,0,0
loldevs_riotapi,net.boreeas.riotapi.com.riotgames.platform.login.impl,0,0,0,0,0,0,0,0
loldevs_riotapi,net.boreeas.riotapi.com.riotgames.platform.matchmaking,0,0,0,0,1,0,0,1
loldevs_riotapi,net.boreeas.riotapi.com.riotgames.platform.messaging,0,0,0,0,0,0,0,0
loldevs_riotapi,net.boreeas.riotapi.com.riotgames.platform.reroll.pojo,0,0,0,0,0,0,0,0
loldevs_riotapi,net.boreeas.riotapi.com.riotgames.platform.statistics,0,0,0,0,1,0,0,1
loldevs_riotapi,net.boreeas.riotapi.com.riotgames.platform.statistics.team,0,0,0,0,0,0,0,0
loldevs_riotapi,net.boreeas.riotapi.com.riotgames.platform.summoner,0,0,0,0,1,0,0,1
loldevs_riotapi,net.boreeas.riotapi.com.riotgames.platform.summoner.boost,0,0,0,0,0,0,0,0
loldevs_riotapi,net.boreeas.riotapi.com.riotgames.platform.summoner.icon,0,0,0,0,0,0,0,0
loldevs_riotapi,net.boreeas.riotapi.com.riotgames.platform.summoner.masterybook,0,0,0,0,0,0,0,0
loldevs_riotapi,net.boreeas.riotapi.com.riotgames.platform.summoner.runes,0,0,0,0,0,0,0,0
loldevs_riotapi,net.boreeas.riotapi.com.riotgames.platform.summoner.spellbook,0,0,0,0,0,0,0,0
loldevs_riotapi,net.boreeas.riotapi.com.riotgames.platform.systemstate,0,0,0,0,0,0,0,0
loldevs_riotapi,net.boreeas.riotapi.com.riotgames.platform.trade.api.contract,0,0,0,0,0,0,0,0
loldevs_riotapi,net.boreeas.riotapi.com.riotgames.platform,0,0,0,0,0,0,0,0
loldevs_riotapi,net.boreeas.riotapi.com.riotgames.team.dto,0,0,0,0,0,0,0,0
loldevs_riotapi,net.boreeas.riotapi.com.riotgames.team.stats,0,0,0,0,0,0,0,0
loldevs_riotapi,net.boreeas.riotapi.com.riotgames.team,0,0,0,0,0,0,0,0
loldevs_riotapi,net.boreeas.riotapi.constants,0,0,0,0,0,0,0,0
loldevs_riotapi,net.boreeas.riotapi,0,0,0,0,1,0,0,1
loldevs_riotapi,net.boreeas.riotapi.rtmp.serialization.amf0,1,1,0,0,0,0,0,2
loldevs_riotapi,net.boreeas.riotapi.rtmp.serialization.amf3,1,0,0,0,1,0,0,2
loldevs_riotapi,net.boreeas.riotapi.rtmp.serialization,2,1,0,0,1,0,0,4
loldevs_riotapi,net.boreeas.riotapi.rtmp.serialization.flex,0,0,0,0,0,0,0,0
loldevs_riotapi,net.boreeas.riotapi.loginqueue,1,1,0,0,0,0,0,2
loldevs_riotapi,net.boreeas.riotapi.loginqueue.newlq,0,0,0,0,0,0,0,0
loldevs_riotapi,net.boreeas.riotapi.loginqueue.oldlq,1,0,0,0,0,0,0,1
loldevs_riotapi,net.boreeas.riotapi.rest,0,0,0,1,1,0,0,2
loldevs_riotapi,net.boreeas.riotapi.rest.api,0,0,0,0,0,0,0,0
loldevs_riotapi,com.gvaneyck.rtmp,0,0,0,0,0,0,0,0
loldevs_riotapi,net.boreeas.riotapi.rtmp,0,0,0,0,0,0,0,0
loldevs_riotapi,net.boreeas.riotapi.rtmp.messages,0,0,0,0,1,0,0,1
loldevs_riotapi,net.boreeas.riotapi.rtmp.messages.control,0,0,0,0,1,0,0,1
loldevs_riotapi,net.boreeas.riotapi.rtmp.services,0,0,0,0,1,0,0,1
loldevs_riotapi,net.boreeas.riotapi.spectator,1,0,0,0,1,0,0,2
loldevs_riotapi,net.boreeas.riotapi.spectator.rest,1,1,0,0,1,0,0,3
loldevs_riotapi,net.boreeas.xmpp,0,0,0,0,0,0,0,0
looly_hutool,cn.hutool,0,0,0,0,0,0,1,1
looly_hutool,cn.hutool.aop.aspects,0,0,0,0,0,0,1,1
looly_hutool,cn.hutool.aop.interceptor,0,0,0,0,0,0,1,1
looly_hutool,cn.hutool.aop,1,1,0,0,0,0,1,3
looly_hutool,cn.hutool.aop.proxy,1,0,0,0,0,0,1,2
looly_hutool,cn.hutool.bloomfilter.bitMap,0,0,0,0,0,0,1,1
looly_hutool,cn.hutool.bloomfilter,0,0,0,0,0,0,1,1
looly_hutool,cn.hutool.bloomfilter.filter,0,0,0,0,0,0,1,1
looly_hutool,cn.hutool.cache,0,0,0,0,0,0,1,1
looly_hutool,cn.hutool.cache.file,0,0,0,0,0,0,1,1
looly_hutool,cn.hutool.cache.impl,0,0,0,0,1,0,1,2
looly_hutool,cn.hutool.captcha,0,0,0,0,0,0,1,1
looly_hutool,cn.hutool.captcha.generator,0,0,0,0,0,0,1,1
looly_hutool,cn.hutool.core.annotation,0,0,0,0,0,0,1,1
looly_hutool,cn.hutool.core.bean,6,1,0,0,0,0,1,8
looly_hutool,cn.hutool.core.bean.copier,2,1,0,0,0,0,1,4
looly_hutool,cn.hutool.core.bean.copier.provider,1,0,0,0,0,0,1,2
looly_hutool,cn.hutool.core.builder,0,0,0,0,0,0,1,1
looly_hutool,cn.hutool.core.clone,0,0,0,0,0,0,1,1
looly_hutool,cn.hutool.core.codec,0,0,0,0,1,0,1,2
looly_hutool,cn.hutool.core.collection,8,1,0,0,1,0,1,11
looly_hutool,cn.hutool.core.comparator,3,0,0,0,1,0,1,5
looly_hutool,cn.hutool.core.convert,8,1,0,0,1,0,1,11
looly_hutool,cn.hutool.core.convert.impl,3,0,0,0,1,0,1,5
looly_hutool,cn.hutool.core.date,7,1,0,0,0,0,1,9
looly_hutool,cn.hutool.core.date.format,1,0,0,1,0,0,1,3
looly_hutool,cn.hutool.core.exceptions,11,1,0,0,1,0,1,14
looly_hutool,cn.hutool.core.getter,0,0,0,0,1,0,1,2
looly_hutool,cn.hutool.core.img,0,0,0,0,0,0,1,1
looly_hutool,cn.hutool.core.io,11,1,0,0,1,0,1,14
looly_hutool,cn.hutool.core.io.checksum,0,0,0,0,0,0,1,1
looly_hutool,cn.hutool.core.io.file,3,0,0,0,1,0,1,5
looly_hutool,cn.hutool.core.io.resource,3,0,0,0,0,0,1,4
looly_hutool,cn.hutool.core.io.watch,3,0,0,0,0,0,1,4
looly_hutool,cn.hutool.core.io.watch.watchers,2,0,0,0,0,0,1,3
looly_hutool,cn.hutool.core.lang,20,1,0,1,1,0,1,24
looly_hutool,cn.hutool.core.lang.caller,2,0,0,0,0,0,1,3
looly_hutool,cn.hutool.core.lang.copier,0,0,0,0,0,0,1,1
looly_hutool,cn.hutool.core.lang.func,0,0,0,0,1,0,1,2
looly_hutool,cn.hutool.core.lang.loader,0,0,0,0,0,0,1,1
looly_hutool,cn.hutool.core.lang.mutable,0,0,0,0,0,0,1,1
looly_hutool,cn.hutool.core.map,5,1,0,0,1,0,1,8
looly_hutool,cn.hutool.core.map.multi,0,0,0,0,0,0,1,1
looly_hutool,cn.hutool.core.math,0,0,0,0,0,0,1,1
looly_hutool,cn.hutool.core.net,3,0,0,0,0,0,1,4
looly_hutool,cn.hutool.core.swing.clipboard,0,0,0,0,0,0,1,1
looly_hutool,cn.hutool.core.swing,0,0,0,0,1,0,1,2
looly_hutool,cn.hutool.core.text,4,1,0,0,1,0,1,7
looly_hutool,cn.hutool.core.text.csv,0,0,0,0,0,0,1,1
looly_hutool,cn.hutool.core.text.escape,3,0,0,0,0,0,1,4
looly_hutool,cn.hutool.core.text.replacer,2,1,0,0,0,0,1,4
looly_hutool,cn.hutool.core.thread,5,1,0,0,0,0,1,7
looly_hutool,cn.hutool.core.thread.lock,0,0,0,0,0,0,1,1
looly_hutool,cn.hutool.core.thread.threadlocal,0,0,0,0,0,0,1,1
looly_hutool,cn.hutool.core.util,41,1,0,1,0,0,1,44
looly_hutool,cn.hutool.cron,1,0,0,0,0,0,1,2
looly_hutool,cn.hutool.cron.listener,1,1,0,0,0,0,1,3
looly_hutool,cn.hutool.cron.pattern,0,1,0,0,0,0,1,2
looly_hutool,cn.hutool.cron.pattern.matcher,0,0,0,0,0,0,1,1
looly_hutool,cn.hutool.cron.pattern.parser,0,0,0,0,0,0,1,1
looly_hutool,cn.hutool.cron.task,0,0,0,0,0,0,1,1
looly_hutool,cn.hutool.cron.demo,0,0,0,0,1,0,1,2
looly_hutool,cn.hutool.crypto.asymmetric,0,0,0,0,0,0,1,1
looly_hutool,cn.hutool.crypto,1,1,0,0,1,0,1,4
looly_hutool,cn.hutool.crypto.digest,0,1,0,0,0,0,1,2
looly_hutool,cn.hutool.crypto.digest.mac,0,0,0,0,0,0,1,1
looly_hutool,cn.hutool.crypto.symmetric,1,0,0,0,1,0,1,3
looly_hutool,cn.hutool.db,10,1,0,0,0,0,1,12
looly_hutool,cn.hutool.db.dialect,6,1,0,0,0,0,1,8
looly_hutool,cn.hutool.db.dialect.impl,0,0,0,0,0,0,1,1
looly_hutool,cn.hutool.db.ds,4,1,0,0,0,0,1,6
looly_hutool,cn.hutool.db.ds.c3p0,0,0,0,0,0,0,1,1
looly_hutool,cn.hutool.db.ds.dbcp,0,0,0,0,0,0,1,1
looly_hutool,cn.hutool.db.ds.druid,0,0,0,0,0,0,1,1
looly_hutool,cn.hutool.db.ds.hikari,0,0,0,0,0,0,1,1
looly_hutool,cn.hutool.db.ds.jndi,0,0,0,0,0,0,1,1
looly_hutool,cn.hutool.db.ds.pooled,0,0,0,0,0,0,1,1
looly_hutool,cn.hutool.db.ds.simple,0,0,0,0,0,0,1,1
looly_hutool,cn.hutool.db.ds.tomcat,0,0,0,0,0,0,1,1
looly_hutool,cn.hutool.db.handler,4,0,0,0,0,0,1,5
looly_hutool,cn.hutool.db.meta,0,0,0,0,0,0,1,1
looly_hutool,cn.hutool.db.nosql.mongo,0,0,0,0,0,0,1,1
looly_hutool,cn.hutool.db.nosql.redis,0,0,0,0,0,0,1,1
looly_hutool,cn.hutool.db.sql,6,1,0,0,1,0,1,9
looly_hutool,cn.hutool.db.pojo,0,0,0,0,0,0,1,1
looly_hutool,cn.hutool.dfa,0,1,0,0,0,0,1,2
looly_hutool,cn.hutool.extra.emoji,0,0,0,0,0,0,1,1
looly_hutool,cn.hutool.extra.ftp,0,0,0,0,0,0,1,1
looly_hutool,cn.hutool.extra.mail,0,0,0,0,0,0,1,1
looly_hutool,cn.hutool.extra.qrcode,0,0,0,0,0,0,1,1
looly_hutool,cn.hutool.extra.servlet.multipart,0,0,0,0,0,0,1,1
looly_hutool,cn.hutool.extra.servlet,0,0,0,0,0,0,1,1
looly_hutool,cn.hutool.extra.ssh,0,0,0,0,0,0,1,1
looly_hutool,cn.hutool.extra.template,2,1,0,0,1,0,1,5
looly_hutool,cn.hutool.extra.template.engine.beetl,1,0,0,0,0,0,1,2
looly_hutool,cn.hutool.extra.template.engine.enjoy,0,0,0,0,0,0,1,1
looly_hutool,cn.hutool.extra.template.engine.freemarker,0,0,0,0,0,0,1,1
looly_hutool,cn.hutool.extra.template.engine,1,0,0,0,0,0,1,2
looly_hutool,cn.hutool.extra.template.engine.rythm,0,0,0,0,0,0,1,1
looly_hutool,cn.hutool.extra.template.engine.thymeleaf,0,0,0,0,0,0,1,1
looly_hutool,cn.hutool.extra.template.engine.velocity,0,0,0,0,0,0,1,1
looly_hutool,cn.hutool.extra.tokenizer,1,1,0,0,1,0,1,4
looly_hutool,cn.hutool.extra.tokenizer.engine.analysis,0,0,0,0,0,0,1,1
looly_hutool,cn.hutool.extra.tokenizer.engine.ansj,0,0,0,0,0,0,1,1
looly_hutool,cn.hutool.extra.tokenizer.engine.hanlp,0,0,0,0,0,0,1,1
looly_hutool,cn.hutool.extra.tokenizer.engine.ikanalyzer,0,0,0,0,0,0,1,1
looly_hutool,cn.hutool.extra.tokenizer.engine.jcseg,0,0,0,0,0,0,1,1
looly_hutool,cn.hutool.extra.tokenizer.engine.jieba,0,0,0,0,0,0,1,1
looly_hutool,cn.hutool.extra.tokenizer.engine.mmseg,0,0,0,0,0,0,1,1
looly_hutool,cn.hutool.extra.tokenizer.engine.mynlp,0,0,0,0,0,0,1,1
looly_hutool,cn.hutool.extra.tokenizer.engine,1,0,0,0,0,0,1,2
looly_hutool,cn.hutool.extra.tokenizer.engine.word,0,0,0,0,0,0,1,1
looly_hutool,cn.hutool.http,1,1,0,0,1,0,1,4
looly_hutool,cn.hutool.http.cookie,1,1,0,0,0,0,1,3
looly_hutool,cn.hutool.http.ssl,0,0,0,0,0,0,1,1
looly_hutool,cn.hutool.http.useragent,0,0,0,0,0,0,1,1
looly_hutool,cn.hutool.http.webservice,0,0,0,0,0,0,1,1
looly_hutool,cn.hutool.json,1,0,0,1,0,0,1,3
looly_hutool,cn.hutool.json.serialize,1,1,0,0,0,0,1,3
looly_hutool,cn.hutool.json.issueIVMD5,0,0,0,0,0,0,1,1
looly_hutool,cn.hutool.log,0,1,0,0,0,0,1,2
looly_hutool,cn.hutool.log.dialect.commons,0,0,0,0,0,0,1,1
looly_hutool,cn.hutool.log.dialect.console,0,0,0,0,0,0,1,1
looly_hutool,cn.hutool.log.dialect.jboss,0,0,0,0,0,0,1,1
looly_hutool,cn.hutool.log.dialect.jdk,0,0,0,0,0,0,1,1
looly_hutool,cn.hutool.log.dialect.log4j,0,0,0,0,0,0,1,1
looly_hutool,cn.hutool.log.dialect.log4j2,0,0,0,0,0,0,1,1
looly_hutool,cn.hutool.log.dialect.slf4j,0,0,0,0,0,0,1,1
looly_hutool,cn.hutool.log.dialect.tinylog,0,0,0,0,0,0,1,1
looly_hutool,cn.hutool.log.level,0,0,0,0,0,0,1,1
looly_hutool,cn.hutool.poi.excel,1,0,0,0,1,0,1,3
looly_hutool,cn.hutool.poi.excel.cell,1,1,0,0,0,0,1,3
looly_hutool,cn.hutool.poi.excel.editors,0,0,0,0,0,0,1,1
looly_hutool,cn.hutool.poi.excel.sax,0,0,0,0,0,0,1,1
looly_hutool,cn.hutool.poi.excel.sax.handler,0,0,0,0,0,0,1,1
looly_hutool,cn.hutool.poi.excel.style,0,0,0,0,0,0,1,1
looly_hutool,cn.hutool.poi.exceptions,0,0,0,0,0,0,1,1
looly_hutool,cn.hutool.poi,0,0,0,0,0,0,1,1
looly_hutool,cn.hutool.poi.word,0,0,0,0,0,0,1,1
looly_hutool,cn.hutool.script,0,0,0,0,0,0,1,1
looly_hutool,cn.hutool.setting,0,1,0,0,1,0,1,3
looly_hutool,cn.hutool.setting.dialect,0,0,0,0,0,0,1,1
looly_hutool,cn.hutool.setting.profile,0,0,0,0,0,0,1,1
looly_hutool,cn.hutool.socket.aio,1,1,0,0,0,0,1,3
looly_hutool,cn.hutool.socket.nio,0,0,0,0,0,0,1,1
looly_hutool,cn.hutool.socket,1,0,0,0,0,0,1,2
looly_hutool,cn.hutool.socket.protocol,0,0,0,0,0,0,1,1
looly_hutool,cn.hutool.system,0,0,0,0,0,0,1,1
looly_hutool,cn.hutool.system.oshi,0,0,0,0,0,0,1,1
lucaspouzac_contiperf,org.databene.contiperf,3,0,0,0,1,3,0,7
lucaspouzac_contiperf,org.databene.contiperf.clock,0,0,0,0,0,0,0,0
lucaspouzac_contiperf,org.databene.contiperf.junit,0,0,0,1,1,0,0,2
lucaspouzac_contiperf,org.databene.contiperf.log,0,0,0,0,0,0,0,0
lucaspouzac_contiperf,org.databene.contiperf.report,2,1,0,0,0,3,0,6
lucaspouzac_contiperf,org.databene.contiperf.sensor,0,0,0,0,0,0,0,0
lucaspouzac_contiperf,org.databene.contiperf.timer,0,0,0,0,1,0,0,1
lucaspouzac_contiperf,org.databene.contiperf.util,2,1,0,0,0,2,0,5
lucaspouzac_contiperf,org.databene.profile,0,0,0,0,0,0,0,0
lucaspouzac_contiperf,org.databene.stat,0,0,0,0,0,2,0,2
LucidWorks_spark-solr,com.lucidworks.spark.example.hadoop,0,0,0,0,0,0,0,0
LucidWorks_spark-solr,com.lucidworks.spark.example.ml,0,0,0,0,0,0,0,0
LucidWorks_spark-solr,com.lucidworks.spark.example.query,0,0,0,0,0,0,0,0
LucidWorks_spark-solr,com.lucidworks.spark.example.streaming,0,0,0,0,0,0,0,0
LucidWorks_spark-solr,com.lucidworks.spark.filter,0,0,0,0,0,0,0,0
LucidWorks_spark-solr,com.lucidworks.spark.fusion,0,0,0,0,1,0,0,1
LucidWorks_spark-solr,com.lucidworks.spark.query,0,0,0,0,1,0,0,1
LucidWorks_spark-solr,com.lucidworks.spark.query.sql,0,0,0,0,0,0,0,0
LucidWorks_spark-solr,com.lucidworks.spark.rdd,0,0,0,0,0,0,0,0
LucidWorks_spark-solr,com.lucidworks.spark,0,0,0,0,1,0,0,1
LucidWorks_spark-solr,com.lucidworks.spark.util,0,0,0,0,1,0,0,1
LucidWorks_spark-solr,com.lucidworks.spark.analysis,0,0,0,0,0,0,0,0
LucidWorks_spark-solr,com.lucidworks.spark.ml.feature,0,0,0,0,0,0,0,0
LucidWorks_spark-solr,com.lucidworks.spark.solr,0,0,0,0,0,0,0,0
lumifyio_lumify,io.lumify.benchmark,0,0,0,0,0,0,1,1
lumifyio_lumify,io.lumify.core.bootstrap,12,1,0,0,0,0,1,14
lumifyio_lumify,io.lumify.core.bootstrap.lib,3,0,0,0,0,0,1,4
lumifyio_lumify,io.lumify.core.cmdline,0,0,0,0,0,0,1,1
lumifyio_lumify,io.lumify.core.config,38,1,0,0,1,0,1,41
lumifyio_lumify,io.lumify.core,1,0,0,0,0,0,1,2
lumifyio_lumify,io.lumify.core.exception,0,0,0,0,0,0,1,1
lumifyio_lumify,io.lumify.core.formula,0,0,0,0,0,0,1,1
lumifyio_lumify,io.lumify.core.ingest,5,0,0,0,1,0,1,7
lumifyio_lumify,io.lumify.core.ingest.graphProperty,4,1,0,0,0,0,1,6
lumifyio_lumify,io.lumify.core.ingest.video,7,0,0,0,0,0,1,8
lumifyio_lumify,io.lumify.core.mapreduce,0,0,0,0,0,0,1,1
lumifyio_lumify,io.lumify.core.metrics,0,0,0,0,0,0,1,1
lumifyio_lumify,io.lumify.core.model.artifactThumbnails,3,0,0,0,0,0,1,4
lumifyio_lumify,io.lumify.core.model.audit,4,1,0,0,0,0,1,6
lumifyio_lumify,io.lumify.core.model.lock,3,0,0,0,0,0,1,4
lumifyio_lumify,io.lumify.core.model.longRunningProcess,5,0,0,0,0,0,1,6
lumifyio_lumify,io.lumify.core.model.notification,4,0,0,0,0,0,1,5
lumifyio_lumify,io.lumify.core.model.ontology,16,1,0,0,0,0,1,18
lumifyio_lumify,io.lumify.core.model.properties,16,1,0,0,0,0,1,18
lumifyio_lumify,io.lumify.core.model.properties.types,12,1,0,0,0,0,1,14
lumifyio_lumify,io.lumify.core.model,0,0,0,0,0,0,1,1
lumifyio_lumify,io.lumify.core.model.termMention,16,0,0,0,0,0,1,17
lumifyio_lumify,io.lumify.core.model.textHighlighting,0,0,0,0,0,0,1,1
lumifyio_lumify,io.lumify.core.model.user,18,1,0,0,1,0,1,21
lumifyio_lumify,io.lumify.core.model.workQueue,4,1,0,0,0,0,1,6
lumifyio_lumify,io.lumify.core.model.workspace.diff,0,0,0,0,0,0,1,1
lumifyio_lumify,io.lumify.core.model.workspace,3,1,0,0,1,0,1,6
lumifyio_lumify,io.lumify.core.security,0,0,0,0,0,0,1,1
lumifyio_lumify,io.lumify.core.user,3,1,0,0,0,0,1,5
lumifyio_lumify,io.lumify.core.util,48,1,0,1,0,0,1,51
lumifyio_lumify,io.lumify.core.version,2,0,0,0,1,0,1,4
lumifyio_lumify,io.lumify.bigtable.model.notification,1,0,0,0,0,0,1,2
lumifyio_lumify,io.lumify.bigtable.model.notification.model,1,1,0,0,0,0,1,3
lumifyio_lumify,io.lumify.model.rabbitmq,0,0,0,0,0,0,1,1
lumifyio_lumify,io.lumify.securegraph.model.audit,0,0,0,0,0,0,1,1
lumifyio_lumify,io.lumify.securegraph.model.longRunningProcess,0,0,0,0,0,0,1,1
lumifyio_lumify,io.lumify.securegraph.model.ontology,0,0,0,0,0,0,1,1
lumifyio_lumify,io.lumify.securegraph.model.user,0,0,0,0,0,0,1,1
lumifyio_lumify,io.lumify.securegraph.model.workspace,0,0,0,0,0,0,1,1
lumifyio_lumify,io.lumify.sql.model,0,1,0,0,0,0,1,2
lumifyio_lumify,io.lumify.sql.model.longRunningProcess,0,0,0,0,0,0,1,1
lumifyio_lumify,io.lumify.sql.model.notification,0,0,0,0,1,0,1,2
lumifyio_lumify,io.lumify.sql.model.user,1,1,0,0,0,0,1,3
lumifyio_lumify,io.lumify.sql.model.workspace,1,0,0,0,0,0,1,2
lumifyio_lumify,io.lumify.sql,0,0,0,0,0,0,1,1
lumifyio_lumify,io.lumify.sql.web,0,0,0,0,0,0,1,1
lumifyio_lumify,io.lumify.newUserWorkspaceCopy,0,0,0,0,0,0,1,1
lumifyio_lumify,io.lumify.newUserWorkspaceSharer,0,0,0,0,0,0,1,1
lumifyio_lumify,io.lumify.yarn,0,0,0,0,0,0,1,1
lumifyio_lumify,io.lumify.mapping,0,0,0,0,0,0,1,1
lumifyio_lumify,io.lumify.mapping.predicate,0,0,0,0,0,0,1,1
lumifyio_lumify,io.lumify.mapping.xform,0,0,0,0,0,0,1,1
lumifyio_lumify,io.lumify.mapping.column,0,0,0,1,0,0,1,2
lumifyio_lumify,io.lumify.mapping.csv,0,0,0,0,0,0,1,1
lumifyio_lumify,io.lumify.dbpedia.mapreduce,0,0,0,0,0,0,1,1
lumifyio_lumify,io.lumify.dbpedia.mapreduce.model,0,0,0,0,0,0,1,1
lumifyio_lumify,io.lumify.flightTrack,0,0,0,0,0,0,1,1
lumifyio_lumify,io.lumify.friendster,0,0,0,0,0,0,1,1
lumifyio_lumify,io.lumify.gdelt,0,0,0,0,1,0,1,2
lumifyio_lumify,io.lumify.palantir.model,0,0,0,1,0,0,1,2
lumifyio_lumify,io.lumify.palantir.util,0,0,0,0,0,0,1,1
lumifyio_lumify,io.lumify.palantir,0,1,0,0,0,0,1,2
lumifyio_lumify,io.lumify.palantir.ontologyToOwl,0,0,0,0,0,0,1,1
lumifyio_lumify,io.lumify.palantir.service,0,0,0,0,0,0,1,1
lumifyio_lumify,io.lumify.palantir.sqlrunner,0,0,0,0,0,0,1,1
lumifyio_lumify,io.lumify.palantir.mr,0,0,0,0,0,0,1,1
lumifyio_lumify,io.lumify.palantir.mr.mappers,0,0,0,0,0,0,1,1
lumifyio_lumify,io.lumify.themoviedb.download,0,0,0,0,0,0,1,1
lumifyio_lumify,io.lumify.themoviedb,0,0,0,0,0,0,1,1
lumifyio_lumify,io.lumify.twitter,1,1,0,0,1,0,1,4
lumifyio_lumify,io.lumify.twitter.loaders,1,0,0,0,0,0,1,2
lumifyio_lumify,twitter4j,0,0,0,0,0,0,1,1
lumifyio_lumify,io.lumify.wikipedia,0,0,0,0,1,0,1,2
lumifyio_lumify,io.lumify.wikipedia.mapreduce,0,0,0,0,0,0,1,1
lumifyio_lumify,io.lumify.worldFactbook,0,0,0,0,0,0,1,1
lumifyio_lumify,io.lumify.gpw.local,0,0,0,0,0,0,1,1
lumifyio_lumify,io.lumify.foodTruck,0,0,0,0,0,0,1,1
lumifyio_lumify,io.lumify.gpw.util,0,0,0,0,1,0,1,2
lumifyio_lumify,io.lumify.gpw.yarn,0,0,0,0,0,0,1,1
lumifyio_lumify,io.lumify.gpw.audio,0,0,0,0,0,0,1,1
lumifyio_lumify,io.lumify.ccextractor,0,0,0,0,0,0,1,1
lumifyio_lumify,io.lumify.clavin,0,0,0,0,0,0,1,1
lumifyio_lumify,io.lumify.csv,0,0,0,0,0,0,1,1
lumifyio_lumify,io.lumify.imageMetadataExtractor,1,0,0,0,0,0,1,2
lumifyio_lumify,io.lumify.imageMetadataHelper,1,1,0,0,1,0,1,4
lumifyio_lumify,io.lumify.email,0,0,0,0,0,0,1,1
lumifyio_lumify,io.lumify.javaCodeIngest,0,0,0,0,0,0,1,1
lumifyio_lumify,io.lumify.knownEntity,0,0,0,0,0,0,1,1
lumifyio_lumify,org.arabidopsis.ahocorasick,0,0,0,0,0,0,1,1
lumifyio_lumify,io.lumify.mimeTypeOntologyMapper,0,0,0,0,0,0,1,1
lumifyio_lumify,io.lumify.opencvObjectDetector,0,0,0,0,0,0,1,1
lumifyio_lumify,io.lumify.opennlpDictionary,0,0,0,0,0,0,1,1
lumifyio_lumify,io.lumify.opennlpDictionary.model,0,0,0,0,0,0,1,1
lumifyio_lumify,io.lumify.opennlpme,0,0,0,0,0,0,1,1
lumifyio_lumify,io.lumify.phoneNumber,0,0,0,0,0,0,1,1
lumifyio_lumify,io.lumify.rdf,0,0,0,0,0,0,1,1
lumifyio_lumify,io.lumify.reindex,0,0,0,0,0,0,1,1
lumifyio_lumify,io.lumify.sphinx,0,0,0,0,0,0,1,1
lumifyio_lumify,io.lumify.gpw.video,0,0,0,0,1,0,1,2
lumifyio_lumify,io.lumify.subrip,0,0,0,0,0,0,1,1
lumifyio_lumify,io.lumify.tesseract,0,0,0,0,0,0,1,1
lumifyio_lumify,io.lumify.tikaMimeType,0,0,0,0,0,0,1,1
lumifyio_lumify,io.lumify.tikaTextExtractor,0,0,0,0,0,0,1,1
lumifyio_lumify,org.apache.tika.parser.pdf,0,0,0,0,0,0,1,1
lumifyio_lumify,com.cybozu.labs.langdetect,0,0,0,0,0,0,1,1
lumifyio_lumify,com.cybozu.labs.langdetect.util,0,0,0,0,0,0,1,1
lumifyio_lumify,io.lumify.translate,0,0,0,0,0,0,1,1
lumifyio_lumify,io.lumify.translator.bing,0,0,0,0,0,0,1,1
lumifyio_lumify,io.lumify.youtube,0,0,0,0,0,0,1,1
lumifyio_lumify,io.lumify.zipcode,0,0,0,0,0,0,1,1
lumifyio_lumify,io.lumify.zipCodeResolver,0,0,0,0,0,0,1,1
lumifyio_lumify,io.lumify.it,0,1,0,0,0,3,1,5
lumifyio_lumify,io.lumify.migrations,0,0,0,0,0,0,1,1
lumifyio_lumify,io.lumify.assignimagemr,0,0,0,0,0,0,1,1
lumifyio_lumify,io.lumify.backupRestore,0,0,0,0,0,0,1,1
lumifyio_lumify,io.lumify.tools,0,0,0,0,0,0,1,1
lumifyio_lumify,io.lumify.tools.format,2,0,0,0,0,0,1,3
lumifyio_lumify,io.lumify.lrp.yarn,0,0,0,0,0,0,1,1
lumifyio_lumify,io.lumify.reindexmr,0,0,0,0,0,0,1,1
lumifyio_lumify,io.lumify.tools.version,0,0,0,0,0,0,1,1
lumifyio_lumify,io.lumify.web.clientapi,1,0,0,0,0,3,1,5
lumifyio_lumify,io.lumify.web.clientapi.codegen,1,1,0,0,1,3,1,7
lumifyio_lumify,io.lumify.web.clientapi.model,0,0,0,1,1,4,1,7
lumifyio_lumify,io.lumify.web.clientapi.model.util,0,0,0,0,0,0,1,1
lumifyio_lumify,io.lumify.analystsNotebook.aggregateClassification,0,0,0,0,0,0,1,1
lumifyio_lumify,io.lumify.analystsNotebook,2,1,0,0,0,0,1,4
lumifyio_lumify,io.lumify.analystsNotebook.model,1,0,0,0,1,0,1,3
lumifyio_lumify,io.lumify.analystsNotebook.routes,2,1,0,0,0,0,1,4
lumifyio_lumify,io.lumify.http,0,0,0,0,0,0,1,1
lumifyio_lumify,io.lumify.web.auth.oauth,0,1,0,0,0,0,1,2
lumifyio_lumify,io.lumify.web.auth.oauth.routes,0,0,0,0,0,0,1,1
lumifyio_lumify,io.lumify.web.auth.usernameonly.routes,0,0,0,0,0,0,1,1
lumifyio_lumify,io.lumify.web.auth.usernameonly,0,0,0,0,0,0,1,1
lumifyio_lumify,io.lumify.web.auth.usernamepassword,1,1,0,0,0,0,1,3
lumifyio_lumify,io.lumify.web.auth.usernamepassword.routes,1,0,0,0,0,0,1,2
lumifyio_lumify,io.lumify.web.auth,0,0,0,0,1,0,1,2
lumifyio_lumify,io.lumify.ldap,0,0,0,0,0,0,1,1
lumifyio_lumify,io.lumify.web.changeEmail,0,0,0,0,0,0,1,1
lumifyio_lumify,io.lumify.web.changePassword,0,0,0,0,0,0,1,1
lumifyio_lumify,io.lumify.web.devTools,0,0,0,0,0,0,1,1
lumifyio_lumify,io.lumify.web.devTools.ontology,0,0,0,0,0,0,1,1
lumifyio_lumify,io.lumify.web.devTools.user,0,0,0,0,0,0,1,1
lumifyio_lumify,io.lumify.geocoder.bing,0,0,0,0,0,0,1,1
lumifyio_lumify,io.lumify.googleAnalytics,0,0,0,0,0,0,1,1
lumifyio_lumify,io.lumify.web.importExportWorkspaces,0,0,0,0,0,0,1,1
lumifyio_lumify,io.lumify.opennlpDictionary.web,0,0,0,0,0,0,1,1
lumifyio_lumify,io.lumify.termsOfUse,0,0,0,0,0,0,1,1
lumifyio_lumify,io.lumify.web,17,1,0,0,0,0,1,19
lumifyio_lumify,io.lumify.vertexMenu,0,0,0,0,0,0,1,1
lumifyio_lumify,io.lumify.web.privilegeFilters,0,0,1,0,0,0,1,2
lumifyio_lumify,io.lumify.web.routes.admin,3,0,0,0,0,0,1,4
lumifyio_lumify,io.lumify.web.routes.config,2,0,0,0,0,0,1,3
lumifyio_lumify,io.lumify.web.routes.edge,0,0,0,0,1,0,1,2
lumifyio_lumify,io.lumify.web.routes,2,0,0,0,0,0,1,3
lumifyio_lumify,io.lumify.web.routes.longRunningProcess,2,0,0,0,0,0,1,3
lumifyio_lumify,io.lumify.web.routes.notification,2,0,0,0,0,0,1,3
lumifyio_lumify,io.lumify.web.routes.ontology,0,0,0,0,0,0,1,1
lumifyio_lumify,io.lumify.web.routes.resource,2,0,0,0,0,0,1,3
lumifyio_lumify,io.lumify.web.routes.user,0,0,0,0,0,0,1,1
lumifyio_lumify,io.lumify.web.routes.vertex,0,0,0,1,1,0,1,3
lumifyio_lumify,io.lumify.web.routes.workspace,0,0,0,0,1,0,1,2
lumifyio_lumify,io.lumify.web.session,0,0,0,0,0,0,1,1
lumifyio_lumify,io.lumify.web.config,0,0,0,0,0,0,1,1
lumifyio_securegraph,org.securegraph.accumulo,0,1,0,0,1,0,0,2
lumifyio_securegraph,org.securegraph.accumulo.mapreduce,0,0,0,0,1,0,0,1
lumifyio_securegraph,org.securegraph.accumulo.serializer,0,0,0,0,0,0,0,0
lumifyio_securegraph,org.securegraph.accumulo.blueprints,0,0,0,0,1,0,0,1
lumifyio_securegraph,org.securegraph.accumulo.blueprints.io.gml,0,0,0,0,0,0,0,0
lumifyio_securegraph,org.securegraph.accumulo.blueprints.io.graphml,0,0,0,0,0,0,0,0
lumifyio_securegraph,org.securegraph.accumulo.blueprints.io.graphson,0,0,0,0,0,0,0,0
lumifyio_securegraph,org.securegraph.accumulo.blueprints.util,0,0,0,0,0,0,0,0
lumifyio_securegraph,org.securegraph.accumulo.iterator,0,0,0,0,0,0,0,0
lumifyio_securegraph,org.securegraph.accumulo.migrations,0,0,0,0,1,0,0,1
lumifyio_securegraph,org.securegraph.blueprints,0,0,0,0,1,0,0,1
lumifyio_securegraph,org.securegraph.util,3,1,0,0,1,0,0,5
lumifyio_securegraph,org.securegraph.blueprints.io.gml,0,0,0,0,0,0,0,0
lumifyio_securegraph,org.securegraph.blueprints.io.graphml,0,0,0,0,0,0,0,0
lumifyio_securegraph,org.securegraph.blueprints.io.graphson,0,0,0,0,0,0,0,0
lumifyio_securegraph,org.securegraph.cli.model,0,0,0,0,0,0,0,0
lumifyio_securegraph,org.securegraph.cli,0,1,0,0,0,0,0,1
lumifyio_securegraph,org.securegraph,6,1,0,0,1,3,0,11
lumifyio_securegraph,org.securegraph.event,0,0,0,0,0,0,0,0
lumifyio_securegraph,org.securegraph.id,0,0,0,0,0,1,0,1
lumifyio_securegraph,org.securegraph.mutation,3,1,0,0,0,1,0,5
lumifyio_securegraph,org.securegraph.path,0,0,0,0,0,0,0,0
lumifyio_securegraph,org.securegraph.property,4,0,0,0,0,0,0,4
lumifyio_securegraph,org.securegraph.query,0,0,0,1,1,1,0,3
lumifyio_securegraph,org.securegraph.search,0,0,0,0,0,1,0,1
lumifyio_securegraph,org.securegraph.type,0,1,0,0,0,1,0,2
lumifyio_securegraph,org.securegraph.elasticsearch,1,0,0,0,1,0,0,2
lumifyio_securegraph,org.securegraph.elasticsearch.helpers,1,1,0,0,0,0,0,2
lumifyio_securegraph,org.securegraph.elasticsearch.score,0,0,0,0,0,0,0,0
lumifyio_securegraph,org.securegraph.elasticsearch.utils,0,0,0,0,0,0,0,0
lumifyio_securegraph,org.securegraph.examples,0,0,0,0,0,1,0,1
lumifyio_securegraph,org.securegraph.examples.dataset,0,0,0,0,0,0,0,0
lumifyio_securegraph,org.securegraph.inmemory,0,0,0,0,0,3,0,3
lumifyio_securegraph,org.securegraph.inmemory.security,0,0,0,0,0,0,0,0
lumifyio_securegraph,org.securegraph.inmemory.util,0,0,0,0,0,0,0,0
lumifyio_securegraph,org.securegraph.accumulo.serializer.kryo,0,0,0,0,0,0,0,0
lumifyio_securegraph,org.securegraph.tools,0,0,0,0,1,0,0,1
lyogavin_Pistachio,com.yahoo.ads.pb.customization,0,0,0,0,1,0,0,1
lyogavin_Pistachio,com.yahoo.ads.pb,4,1,0,1,0,0,0,6
lyogavin_Pistachio,com.yahoo.ads.pb.exception,0,0,0,0,0,0,0,0
lyogavin_Pistachio,com.yahoo.ads.pb.helix,2,1,0,0,1,0,0,4
lyogavin_Pistachio,com.yahoo.ads.pb.kafka,0,0,0,0,1,0,0,1
lyogavin_Pistachio,com.yahoo.ads.pb.network.netty,2,0,0,0,0,0,0,2
lyogavin_Pistachio,com.yahoo.ads.pb.processor,0,0,0,0,0,0,0,0
lyogavin_Pistachio,com.yahoo.ads.pb.store,1,0,0,0,1,0,0,2
lyogavin_Pistachio,com.yahoo.ads.pb.util,0,0,0,0,0,0,0,0
lyogavin_Pistachio,com.yahoo.ads.pb.mttf,0,0,0,0,0,0,0,0
mahmoudparsian_data-algorithms-book,org.dataalgorithms.chap01.mapreduce,0,0,0,0,0,0,0,0
mahmoudparsian_data-algorithms-book,org.dataalgorithms.chap01.spark,0,0,0,0,1,0,0,1
mahmoudparsian_data-algorithms-book,org.dataalgorithms.chap01.sparkwithlambda,0,0,0,0,0,0,0,0
mahmoudparsian_data-algorithms-book,org.dataalgorithms.chap01.util,0,0,0,0,0,0,0,0
mahmoudparsian_data-algorithms-book,org.dataalgorithms.chap02.mapreduce,0,0,0,0,1,0,0,1
mahmoudparsian_data-algorithms-book,org.dataalgorithms.chap03.mapreduce,0,0,0,0,1,0,0,1
mahmoudparsian_data-algorithms-book,org.dataalgorithms.chap03.spark,0,0,0,0,0,0,0,0
mahmoudparsian_data-algorithms-book,org.dataalgorithms.chap03.sparkwithlambda,0,0,0,0,0,0,0,0
mahmoudparsian_data-algorithms-book,org.dataalgorithms.chap04.mapreduce,0,0,0,0,1,0,0,1
mahmoudparsian_data-algorithms-book,org.dataalgorithms.chap04.spark,0,0,0,0,0,0,0,0
mahmoudparsian_data-algorithms-book,org.dataalgorithms.chap04.sparkwithlambda,0,0,0,0,0,0,0,0
mahmoudparsian_data-algorithms-book,org.dataalgorithms.chap05.mapreduce,0,0,0,0,1,0,0,1
mahmoudparsian_data-algorithms-book,org.dataalgorithms.chap05.spark,0,0,0,0,0,0,0,0
mahmoudparsian_data-algorithms-book,org.dataalgorithms.chap06.memorysort,0,0,0,0,0,0,0,0
mahmoudparsian_data-algorithms-book,org.dataalgorithms.chap06,0,0,0,0,0,0,0,0
mahmoudparsian_data-algorithms-book,org.dataalgorithms.chap06.pojo,0,0,0,0,0,0,0,0
mahmoudparsian_data-algorithms-book,org.dataalgorithms.chap06.secondarysort,0,0,0,0,1,0,0,1
mahmoudparsian_data-algorithms-book,org.dataalgorithms.chap07.mapreduce,0,0,0,0,0,0,0,0
mahmoudparsian_data-algorithms-book,org.dataalgorithms.chap07.spark,0,0,0,0,0,0,0,0
mahmoudparsian_data-algorithms-book,org.dataalgorithms.chap08.mapreduce,0,0,0,0,1,0,0,1
mahmoudparsian_data-algorithms-book,org.dataalgorithms.chap08.spark,0,0,0,0,0,0,0,0
mahmoudparsian_data-algorithms-book,org.dataalgorithms.chap08.sparkwithlambda,0,0,0,0,0,0,0,0
mahmoudparsian_data-algorithms-book,org.dataalgorithms.chap09.spark,0,0,0,0,0,0,0,0
mahmoudparsian_data-algorithms-book,org.dataalgorithms.chap10.spark,0,0,0,0,0,0,0,0
mahmoudparsian_data-algorithms-book,org.dataalgorithms.chap11.projection.memorysort,0,0,0,0,0,0,0,0
mahmoudparsian_data-algorithms-book,org.dataalgorithms.chap11.projection.secondarysort,0,0,0,0,1,0,0,1
mahmoudparsian_data-algorithms-book,org.dataalgorithms.chap11.spark,0,0,0,0,0,0,0,0
mahmoudparsian_data-algorithms-book,org.dataalgorithms.chap11.statemodel,0,0,0,0,1,0,0,1
mahmoudparsian_data-algorithms-book,org.dataalgorithms.chap13.spark,0,0,0,0,0,0,0,0
mahmoudparsian_data-algorithms-book,org.dataalgorithms.chap13.sparkwithlambda,0,0,0,0,0,0,0,0
mahmoudparsian_data-algorithms-book,org.dataalgorithms.chap13.util,0,0,0,0,0,0,0,0
mahmoudparsian_data-algorithms-book,org.dataalgorithms.chap14.spark,0,0,0,0,0,0,0,0
mahmoudparsian_data-algorithms-book,org.dataalgorithms.chap14.sparkwithlambda,0,0,0,0,0,0,0,0
mahmoudparsian_data-algorithms-book,org.dataalgorithms.chap16.mapreduce,0,0,0,0,0,0,0,0
mahmoudparsian_data-algorithms-book,org.dataalgorithms.chap16.spark,0,0,0,0,0,0,0,0
mahmoudparsian_data-algorithms-book,org.dataalgorithms.chap17.mapreduce,0,0,0,0,0,0,0,0
mahmoudparsian_data-algorithms-book,org.dataalgorithms.chap17.spark,0,0,0,0,0,0,0,0
mahmoudparsian_data-algorithms-book,org.dataalgorithms.chap17.sparkwithlambda,0,0,0,0,0,0,0,0
mahmoudparsian_data-algorithms-book,org.dataalgorithms.chap22.spark,0,0,0,0,0,0,0,0
mahmoudparsian_data-algorithms-book,org.dataalgorithms.chap22.sparkwithlambda,0,0,0,0,0,0,0,0
mahmoudparsian_data-algorithms-book,org.dataalgorithms.chap23.correlation,0,0,0,0,0,0,0,0
mahmoudparsian_data-algorithms-book,org.dataalgorithms.chap23.spark,0,0,0,0,0,0,0,0
mahmoudparsian_data-algorithms-book,org.dataalgorithms.chap23.sparkwithlambda,0,0,0,0,0,0,0,0
mahmoudparsian_data-algorithms-book,org.dataalgorithms.chap24.mapreduce,0,0,0,0,1,0,0,1
mahmoudparsian_data-algorithms-book,org.dataalgorithms.chap24.spark,0,0,0,0,0,0,0,0
mahmoudparsian_data-algorithms-book,org.dataalgorithms.chap26.spark,0,0,0,0,0,0,0,0
mahmoudparsian_data-algorithms-book,org.dataalgorithms.chap28.mapreduce,0,0,0,0,0,0,0,0
mahmoudparsian_data-algorithms-book,org.dataalgorithms.chap28.spark,0,0,0,0,0,0,0,0
mahmoudparsian_data-algorithms-book,org.dataalgorithms.chap28.sparkwithlambda,0,0,0,0,0,0,0,0
mahmoudparsian_data-algorithms-book,org.dataalgorithms.chap29.combinesmallfilesbybuckets,0,0,0,0,1,0,0,1
mahmoudparsian_data-algorithms-book,org.dataalgorithms.chap29.combinesmallfilesbyhadoop,0,0,0,0,1,0,0,1
mahmoudparsian_data-algorithms-book,org.dataalgorithms.chapB01.wordcount.mapreduce,0,0,0,0,0,0,0,0
mahmoudparsian_data-algorithms-book,org.dataalgorithms.chapB01.wordcount.spark,0,0,0,0,0,0,0,0
mahmoudparsian_data-algorithms-book,org.dataalgorithms.chapB01.wordcount.sparkwithlambda,0,0,0,0,0,0,0,0
mahmoudparsian_data-algorithms-book,org.dataalgorithms.chapB01.wordcount.util,0,0,0,0,0,0,0,0
mahmoudparsian_data-algorithms-book,org.dataalgorithms.chapB02.sortedwordcount.spark,0,0,0,0,0,0,0,0
mahmoudparsian_data-algorithms-book,org.dataalgorithms.chapB03.perkeyaverage.spark,0,0,0,0,0,0,0,0
mahmoudparsian_data-algorithms-book,org.dataalgorithms.chapB03.perkeyaverage.sparkwithlambda,0,0,0,0,0,0,0,0
mahmoudparsian_data-algorithms-book,org.dataalgorithms.chapB04.rankproduct.spark,0,0,0,0,0,0,0,0
mahmoudparsian_data-algorithms-book,org.dataalgorithms.chapB04.rankproduct.sparkwithlambda,0,0,0,0,0,0,0,0
mahmoudparsian_data-algorithms-book,org.dataalgorithms.chapB04.rankproduct.util,0,0,0,0,0,0,0,0
mahmoudparsian_data-algorithms-book,org.dataalgorithms.chapB05.anagram.mapreduce,0,0,0,0,0,0,0,0
mahmoudparsian_data-algorithms-book,org.dataalgorithms.chapB05.anagram.spark,0,0,0,0,0,0,0,0
mahmoudparsian_data-algorithms-book,org.dataalgorithms.chapB05.anagram.sparkwithlambda,0,0,0,0,0,0,0,0
mahmoudparsian_data-algorithms-book,org.dataalgorithms.chapB05.anagram.util,0,0,0,0,0,0,0,0
mahmoudparsian_data-algorithms-book,org.dataalgorithms.chapB06.outlierdetection.spark,0,0,0,0,0,0,0,0
mahmoudparsian_data-algorithms-book,org.dataalgorithms.chapB07.sql,0,0,0,0,0,0,0,0
mahmoudparsian_data-algorithms-book,org.dataalgorithms.chapB08.logquery.spark,0,0,0,0,0,0,0,0
mahmoudparsian_data-algorithms-book,org.dataalgorithms.chapB09.charcount.mapreduce.basic,0,0,0,0,0,0,0,0
mahmoudparsian_data-algorithms-book,org.dataalgorithms.chapB09.charcount.mapreduce.inmapper,0,0,0,0,0,0,0,0
mahmoudparsian_data-algorithms-book,org.dataalgorithms.chapB09.charcount.mapreduce.localaggregation,0,0,0,0,0,0,0,0
mahmoudparsian_data-algorithms-book,org.dataalgorithms.chapB09.charcount.spark.basic,0,0,0,0,0,0,0,0
mahmoudparsian_data-algorithms-book,org.dataalgorithms.chapB09.charcount.spark.inmapper,0,0,0,0,0,0,0,0
mahmoudparsian_data-algorithms-book,org.dataalgorithms.chapB09.charcount.spark.localaggregation,0,0,0,0,0,0,0,0
mahmoudparsian_data-algorithms-book,org.dataalgorithms.chapB10.friendrecommendation.mapreduce,0,0,0,0,1,0,0,1
mahmoudparsian_data-algorithms-book,org.dataalgorithms.chapB10.friendrecommendation.spark,0,0,0,0,0,0,0,0
mahmoudparsian_data-algorithms-book,org.dataalgorithms.chapB11.cartesian.spark,0,0,0,0,0,0,0,0
mahmoudparsian_data-algorithms-book,org.dataalgorithms.chapB12.docwordcount.mapreduce,0,0,0,0,0,0,0,0
mahmoudparsian_data-algorithms-book,org.dataalgorithms.chapB12.docwordcount.spark,0,0,0,0,0,0,0,0
mahmoudparsian_data-algorithms-book,org.dataalgorithms.chapB12.docwordcount.sparkwithlambda,0,0,0,0,0,0,0,0
mahmoudparsian_data-algorithms-book,org.dataalgorithms.chapB12.docwordcount.util,0,0,0,0,0,0,0,0
mahmoudparsian_data-algorithms-book,org.dataalgorithms.chapB13.client,0,0,0,0,1,0,0,1
mahmoudparsian_data-algorithms-book,org.dataalgorithms.chapB14.minmax.mapreduce,0,0,0,0,0,0,0,0
mahmoudparsian_data-algorithms-book,org.dataalgorithms.chapB14.minmax.spark,0,0,0,0,0,0,0,0
mahmoudparsian_data-algorithms-book,org.dataalgorithms.machinelearning.kmeans,0,0,0,0,0,0,0,0
mahmoudparsian_data-algorithms-book,org.dataalgorithms.machinelearning.linear.OLS,0,0,0,0,0,0,0,0
mahmoudparsian_data-algorithms-book,org.dataalgorithms.machinelearning.linear.SGD,0,0,0,0,0,0,0,0
mahmoudparsian_data-algorithms-book,org.dataalgorithms.machinelearning.logistic.alcohol,0,0,0,0,0,0,0,0
mahmoudparsian_data-algorithms-book,org.dataalgorithms.machinelearning.logistic.cancer,0,0,0,0,0,0,0,0
mahmoudparsian_data-algorithms-book,org.dataalgorithms.machinelearning.logistic.spam,0,0,0,0,0,0,0,0
mahmoudparsian_data-algorithms-book,org.dataalgorithms.machinelearning.naivebayes.diabetes,0,0,0,0,0,0,0,0
mahmoudparsian_data-algorithms-book,org.dataalgorithms.machinelearning.naivebayes.tennis,0,0,0,0,0,0,0,0
mahmoudparsian_data-algorithms-book,org.dataalgorithms.util,0,0,0,0,1,0,0,1
MALfunction84_psi-probe,(default package),0,0,0,0,0,0,0,0
MALfunction84_psi-probe,psiprobe,1,1,0,0,1,0,0,3
MALfunction84_psi-probe,psiprobe.beans.accessors,0,0,0,0,1,0,0,1
MALfunction84_psi-probe,psiprobe.beans,1,0,0,0,1,2,0,4
MALfunction84_psi-probe,psiprobe.beans.stats.collectors,0,0,0,0,1,0,0,1
MALfunction84_psi-probe,psiprobe.beans.stats.listeners,0,0,0,0,1,0,0,1
MALfunction84_psi-probe,psiprobe.beans.stats.providers,0,0,0,0,1,0,0,1
MALfunction84_psi-probe,psiprobe.controllers,0,0,0,0,1,0,0,1
MALfunction84_psi-probe,psiprobe.controllers.apps,0,0,0,1,1,0,0,2
MALfunction84_psi-probe,psiprobe.controllers.certificates,0,0,0,0,0,0,0,0
MALfunction84_psi-probe,psiprobe.controllers.cluster,0,0,0,0,1,0,0,1
MALfunction84_psi-probe,psiprobe.controllers.connectors,0,0,0,0,1,0,0,1
MALfunction84_psi-probe,psiprobe.controllers.datasources,0,0,0,0,0,0,0,0
MALfunction84_psi-probe,psiprobe.controllers.deploy,0,0,0,0,1,0,0,1
MALfunction84_psi-probe,psiprobe.controllers.error,0,0,0,0,0,0,0,0
MALfunction84_psi-probe,psiprobe.controllers.filters,0,0,0,0,0,0,0,0
MALfunction84_psi-probe,psiprobe.controllers.help,0,0,0,0,1,0,0,1
MALfunction84_psi-probe,psiprobe.controllers.jsp,0,0,0,0,1,0,0,1
MALfunction84_psi-probe,psiprobe.controllers.logs,0,0,0,0,1,0,0,1
MALfunction84_psi-probe,psiprobe.controllers.oshi,0,0,0,0,0,0,0,0
MALfunction84_psi-probe,psiprobe.controllers.quickcheck,0,0,0,0,0,0,0,0
MALfunction84_psi-probe,psiprobe.controllers.servlets,0,0,0,0,0,0,0,0
MALfunction84_psi-probe,psiprobe.controllers.sessions,0,0,0,0,0,0,0,0
MALfunction84_psi-probe,psiprobe.controllers.sql,0,0,0,0,1,0,0,1
MALfunction84_psi-probe,psiprobe.controllers.system,0,0,0,0,1,0,0,1
MALfunction84_psi-probe,psiprobe.controllers.threads,0,0,0,0,1,1,0,2
MALfunction84_psi-probe,psiprobe.controllers.truststore,0,0,0,0,0,0,0,0
MALfunction84_psi-probe,psiprobe.controllers.wrapper,0,0,0,0,0,0,0,0
MALfunction84_psi-probe,psiprobe.jfreechart,0,0,0,0,0,0,0,0
MALfunction84_psi-probe,psiprobe.jsp,0,0,0,0,1,0,0,1
MALfunction84_psi-probe,psiprobe.mappers,0,0,0,0,0,0,0,0
MALfunction84_psi-probe,psiprobe.model,0,0,0,1,1,2,0,4
MALfunction84_psi-probe,psiprobe.model.certificates,0,0,0,0,0,0,0,0
MALfunction84_psi-probe,psiprobe.model.java,0,0,0,0,0,0,0,0
MALfunction84_psi-probe,psiprobe.model.jmx,0,0,0,0,1,2,0,3
MALfunction84_psi-probe,psiprobe.model.jsp,0,0,0,0,0,0,0,0
MALfunction84_psi-probe,psiprobe.model.sql,0,0,0,0,0,0,0,0
MALfunction84_psi-probe,psiprobe.model.stats,0,0,0,0,0,0,0,0
MALfunction84_psi-probe,psiprobe.model.wrapper,0,0,0,0,0,0,0,0
MALfunction84_psi-probe,psiprobe.scheduler.jobs,0,0,0,0,1,0,0,1
MALfunction84_psi-probe,psiprobe.scheduler.triggers,0,0,0,0,1,0,0,1
MALfunction84_psi-probe,psiprobe.tokenizer,0,0,0,0,1,0,0,1
MALfunction84_psi-probe,psiprobe.tools,0,0,0,0,1,4,0,5
MALfunction84_psi-probe,psiprobe.tools.logging,0,0,0,0,0,1,0,1
MALfunction84_psi-probe,psiprobe.tools.logging.catalina,0,0,0,0,0,0,0,0
MALfunction84_psi-probe,psiprobe.tools.logging.commons,0,0,0,0,0,0,0,0
MALfunction84_psi-probe,psiprobe.tools.logging.jdk,0,0,0,0,1,1,0,2
MALfunction84_psi-probe,psiprobe.tools.logging.log4j,0,0,0,0,0,0,0,0
MALfunction84_psi-probe,psiprobe.tools.logging.log4j2,0,0,0,0,0,0,0,0
MALfunction84_psi-probe,psiprobe.tools.logging.logback,0,0,0,0,0,0,0,0
MALfunction84_psi-probe,psiprobe.tools.logging.slf4jlogback,0,0,0,0,0,0,0,0
MALfunction84_psi-probe,psiprobe.tools.url,0,0,0,0,0,0,0,0
MALfunction84_psi-probe,psiprobe.rest,0,0,0,0,0,0,0,0
manuzhang_storm-benchmark,storm.benchmark.api,0,0,0,0,0,0,0,0
manuzhang_storm-benchmark,storm.benchmark.benchmarks.common,0,0,0,0,1,0,0,1
manuzhang_storm-benchmark,storm.benchmark.benchmarks,0,0,0,0,1,0,0,1
manuzhang_storm-benchmark,storm.benchmark.lib.bolt,0,0,0,0,1,0,0,1
manuzhang_storm-benchmark,storm.benchmark.lib.operation,0,0,0,0,1,0,0,1
manuzhang_storm-benchmark,storm.benchmark.lib.reducer,0,0,0,0,0,0,0,0
manuzhang_storm-benchmark,storm.benchmark.lib.spout,1,1,0,0,1,0,0,3
manuzhang_storm-benchmark,storm.benchmark.lib.spout.pageview,1,1,0,0,0,0,0,2
manuzhang_storm-benchmark,storm.benchmark.metrics,1,0,0,0,1,0,0,2
manuzhang_storm-benchmark,storm.benchmark.tools,2,1,0,0,1,0,0,4
manuzhang_storm-benchmark,storm.benchmark.tools.producer.kafka,0,0,0,0,1,0,0,1
manuzhang_storm-benchmark,storm.benchmark.util,0,0,0,0,1,0,0,1
manuzhang_storm-benchmark,storm.benchmark.lib.bolt.common,0,0,0,0,0,0,0,0
marcosvidolin_doco,com.vidolima.doco,0,0,0,0,1,0,0,1
marcosvidolin_doco,com.vidolima.doco.exception,0,0,0,0,0,0,0,0
marcosvidolin_doco,com.vidolima.doco.utils,0,0,0,0,0,0,0,0
marcusklang_wikiforia,se.lth.cs.nlp.io,0,0,0,0,1,0,0,1
marcusklang_wikiforia,se.lth.cs.nlp.mediawiki.model,0,0,0,0,0,0,0,0
marcusklang_wikiforia,se.lth.cs.nlp.mediawiki.parser,0,0,0,0,1,0,0,1
marcusklang_wikiforia,se.lth.cs.nlp.pipeline,0,0,0,0,0,0,0,0
marcusklang_wikiforia,se.lth.cs.nlp.wikiforia,0,0,0,0,0,0,0,0
marcusklang_wikiforia,se.lth.cs.nlp.wikipedia.lang,0,0,0,2,0,0,0,2
marcusklang_wikiforia,se.lth.cs.nlp.wikipedia.parser.annotation,0,0,0,0,1,0,0,1
marcusklang_wikiforia,se.lth.cs.nlp.wikipedia.parser,0,0,0,0,0,0,0,0
marcusklang_wikiforia,se.lth.cs.nlp.mediawiki,0,0,0,0,0,0,0,0
marschall_threeten-jpa,com.github.marschall.threeten.jpa,0,0,0,0,1,0,0,1
marschall_threeten-jpa,com.github.marschall.threeten.jpa.configuration,0,0,0,0,0,0,0,0
marschall_threeten-jpa,com.github.marschall.threeten.jpa.h2,0,0,0,0,1,0,0,1
marschall_threeten-jpa,com.github.marschall.threeten.jpa.h2.configuration,0,0,0,0,0,0,0,0
marschall_threeten-jpa,com.github.marschall.threeten.jpa.jdbc42.hibernate,0,0,0,0,1,0,0,1
marschall_threeten-jpa,com.github.marschall.threeten.jpa.jdbc42.hibernate.configuration,0,0,0,0,1,0,0,1
marschall_threeten-jpa,com.github.marschall.threeten.jpa.mssql.eclipselink,0,0,0,0,0,0,0,0
marschall_threeten-jpa,com.github.marschall.threeten.jpa.mssql.eclipselink.configuration,0,0,0,0,0,0,0,0
marschall_threeten-jpa,com.github.marschall.threeten.jpa.mssql.hibernate,0,0,0,0,0,0,0,0
marschall_threeten-jpa,com.github.marschall.threeten.jpa.mssql.hibernate.configuration,0,0,0,0,0,0,0,0
marschall_threeten-jpa,com.github.marschall.threeten.jpa.mssql.impl,0,0,0,0,0,0,0,0
marschall_threeten-jpa,oracle.jdbc,0,0,0,0,0,1,0,1
marschall_threeten-jpa,oracle.sql,0,0,0,0,1,0,0,1
marschall_threeten-jpa,com.github.marschall.threeten.jpa.oracle,0,0,0,0,1,0,0,1
marschall_threeten-jpa,com.github.marschall.threeten.jpa.oracle.hibernate,0,0,0,0,0,1,0,1
marschall_threeten-jpa,com.github.marschall.threeten.jpa.oracle.impl,0,0,0,0,1,1,0,2
marschall_threeten-jpa,com.github.marschall.threeten.jpa.zoned.hibernate,0,0,0,0,0,0,0,0
marschall_threeten-jpa,com.github.marschall.threeten.jpa.zoned.hibernate.configuration,0,0,0,0,0,0,0,0
martinpaljak_apdu4j,apdu4j,2,1,0,0,0,0,0,3
martinpaljak_apdu4j,apdu4j.remote,1,0,0,0,1,0,0,2
martinpaljak_apdu4j,apdu4j.providers,0,0,0,0,0,0,0,0
martinpaljak_apdu4j,apdu4j.terminals,1,0,0,0,0,0,0,1
martinpaljak_apdu4j,(default package),0,0,0,0,0,0,0,0
martinpaljak_GlobalPlatform,pro.javacard.gp,0,0,0,1,1,0,0,2
martinpaljak_GlobalPlatformPro,pro.javacard.gp,0,0,0,1,1,0,0,2
Mashape_Astronode-Broadcaster,com.mashape.astronode.broadcaster,0,0,0,0,0,0,0,0
Mashape_Astronode-Broadcaster,com.mashape.astronode.broadcaster.configuration,1,0,0,0,0,0,0,1
Mashape_Astronode-Broadcaster,com.mashape.astronode.broadcaster.io,0,0,0,0,0,0,0,0
Mashape_Astronode-Broadcaster,com.mashape.astronode.broadcaster.io.pool,0,0,0,0,0,0,0,0
Mashape_Astronode-Broadcaster,com.mashape.astronode.broadcaster.log,1,0,0,0,0,0,0,1
matiwinnetou_spring-soy-view,pl.matisoft.soy.bundle,0,0,0,0,0,0,0,0
matiwinnetou_spring-soy-view,pl.matisoft.soy.compile,0,0,0,0,0,0,0,0
matiwinnetou_spring-soy-view,pl.matisoft.soy.config,0,0,0,0,0,0,0,0
matiwinnetou_spring-soy-view,pl.matisoft.soy,1,0,0,0,1,0,0,2
matiwinnetou_spring-soy-view,pl.matisoft.soy.data.adjust,0,0,0,0,0,0,0,0
matiwinnetou_spring-soy-view,pl.matisoft.soy.data,0,0,0,0,1,0,0,1
matiwinnetou_spring-soy-view,pl.matisoft.soy.global.compile,0,0,0,0,0,0,0,0
matiwinnetou_spring-soy-view,pl.matisoft.soy.global.runtime,0,0,0,0,0,0,0,0
matiwinnetou_spring-soy-view,pl.matisoft.soy.global.runtime.resolvers,0,0,0,0,1,0,0,1
matiwinnetou_spring-soy-view,pl.matisoft.soy.holder,0,0,0,0,0,0,0,0
matiwinnetou_spring-soy-view,pl.matisoft.soy.locale,0,0,0,0,1,0,0,1
matiwinnetou_spring-soy-view,pl.matisoft.soy.render,1,0,0,0,1,0,0,2
matiwinnetou_spring-soy-view,pl.matisoft.soy.template,0,0,0,0,1,0,0,1
matiwinnetou_spring-soy-view,pl.matisoft.soy.global,0,0,0,0,0,0,0,0
matiwinnetou_spring-soy-view,pl.matisoft.soy.ajax.auth,0,0,0,0,0,0,0,0
matiwinnetou_spring-soy-view,pl.matisoft.soy.ajax.config,0,0,0,0,0,0,0,0
matiwinnetou_spring-soy-view,pl.matisoft.soy.ajax.hash,0,0,0,0,0,0,0,0
matiwinnetou_spring-soy-view,pl.matisoft.soy.ajax.process.google,0,0,0,0,0,0,0,0
matiwinnetou_spring-soy-view,pl.matisoft.soy.ajax.process,0,0,0,0,0,0,0,0
matiwinnetou_spring-soy-view,pl.matisoft.soy.ajax.process.yahoo,0,0,0,0,0,0,0,0
matiwinnetou_spring-soy-view,pl.matisoft.soy.ajax,0,0,0,0,0,0,0,0
matiwinnetou_spring-soy-view,pl.matisoft.soy.ajax.url,0,0,0,0,0,0,0,0
matiwinnetou_spring-soy-view,pl.matisoft.soy.ajax.utils,0,0,0,0,0,0,0,0
mayconbordin_streaminer,org.streaminer.stream.avg,0,0,0,0,1,0,0,1
mayconbordin_streaminer,org.streaminer.stream.cardinality,0,0,0,1,0,0,0,1
mayconbordin_streaminer,org.streaminer.stream.change,0,0,0,0,1,0,0,1
mayconbordin_streaminer,org.streaminer.stream.classifier,0,0,0,0,1,0,0,1
mayconbordin_streaminer,org.streaminer.stream.classifier.bayes,0,0,0,0,1,0,0,1
mayconbordin_streaminer,org.streaminer.stream.classifier.tree,0,0,0,0,0,0,0,0
mayconbordin_streaminer,org.streaminer.stream.clustering.birch,0,0,0,0,0,0,0,0
mayconbordin_streaminer,org.streaminer.stream.clustering,0,0,0,0,0,0,0,0
mayconbordin_streaminer,org.streaminer.stream.data,0,0,0,0,0,0,0,0
mayconbordin_streaminer,org.streaminer.stream.entropy,0,0,0,0,0,0,0,0
mayconbordin_streaminer,org.streaminer.stream.eval,0,0,0,0,0,0,0,0
mayconbordin_streaminer,org.streaminer.stream.frequency,0,0,0,1,0,0,0,1
mayconbordin_streaminer,org.streaminer.stream.frequency.decay,0,0,0,0,0,0,0,0
mayconbordin_streaminer,org.streaminer.stream.frequency.topk,0,0,0,0,0,1,0,1
mayconbordin_streaminer,org.streaminer.stream.frequency.util,0,0,0,0,1,1,0,2
mayconbordin_streaminer,org.streaminer.stream.histogram.spdt,0,0,0,0,1,0,0,1
mayconbordin_streaminer,org.streaminer.stream.learner,0,1,0,0,0,0,0,1
mayconbordin_streaminer,org.streaminer.stream.mapper,0,0,0,0,0,0,0,0
mayconbordin_streaminer,org.streaminer.stream.membership,0,0,0,1,1,0,0,2
mayconbordin_streaminer,org.streaminer.stream.misc,0,0,0,0,0,0,0,0
mayconbordin_streaminer,org.streaminer.stream.model,0,0,0,0,0,0,0,0
mayconbordin_streaminer,org.streaminer.stream.norm,0,0,0,0,0,0,0,0
mayconbordin_streaminer,org.streaminer.stream.quantile,0,0,0,0,0,0,0,0
mayconbordin_streaminer,org.streaminer.stream.quantile.rss,0,0,0,0,0,0,0,0
mayconbordin_streaminer,org.streaminer.stream.wavelet,0,0,0,0,0,0,0,0
mayconbordin_streaminer,org.streaminer.util,0,0,0,0,1,1,0,2
mayconbordin_streaminer,org.streaminer.util.distance,0,0,0,0,0,0,0,0
mayconbordin_streaminer,org.streaminer.util.distribution,0,0,0,0,0,0,0,0
mayconbordin_streaminer,org.streaminer.util.hash.factory,0,0,0,0,0,0,0,0
mayconbordin_streaminer,org.streaminer.util.hash.function,0,0,0,0,0,0,0,0
mayconbordin_streaminer,org.streaminer.util.hash,0,0,0,0,0,0,0,0
mayconbordin_streaminer,org.streaminer.util.math,0,0,0,0,0,0,0,0
mayconbordin_streaminer,org.streaminer.stream.benchmark,0,0,0,0,0,0,0,0
mcupak_beacon-of-beacons,com.dnastack.bob.persistence.api,0,0,0,0,0,1,0,1
mcupak_beacon-of-beacons,com.dnastack.bob.persistence.entity,0,0,0,0,1,1,0,2
mcupak_beacon-of-beacons,com.dnastack.bob.persistence.impl,0,0,0,0,1,0,0,1
mcupak_beacon-of-beacons,com.dnastack.bob.persistence,0,0,0,0,0,1,0,1
mcupak_beacon-of-beacons,com.dnastack.bob.rest.api,0,0,0,0,1,0,0,1
mcupak_beacon-of-beacons,com.dnastack.bob.rest.base,0,0,0,0,0,0,0,0
mcupak_beacon-of-beacons,com.dnastack.bob.rest.app,0,0,0,0,0,0,0,0
mcupak_beacon-of-beacons,com.dnastack.bob.rest.comparator,0,0,0,0,1,0,0,1
mcupak_beacon-of-beacons,com.dnastack.bob.rest.resource,0,0,0,0,1,0,0,1
mcupak_beacon-of-beacons,com.dnastack.bob.rest.util,0,0,0,0,1,0,0,1
mcupak_beacon-of-beacons,com.dnastack.bob.rest,0,0,0,0,0,0,0,0
mcupak_beacon-of-beacons,com.dnastack.bob.service.api,0,0,0,0,0,0,0,0
mcupak_beacon-of-beacons,com.dnastack.bob.service.converter.api,0,0,0,0,0,0,0,0
mcupak_beacon-of-beacons,com.dnastack.bob.service.converter.impl,0,0,0,0,1,0,0,1
mcupak_beacon-of-beacons,com.dnastack.bob.service.converter.util,0,0,0,0,0,0,0,0
mcupak_beacon-of-beacons,com.dnastack.bob.service.fetcher.api,0,0,0,0,0,0,0,0
mcupak_beacon-of-beacons,com.dnastack.bob.service.fetcher.impl,0,0,0,0,0,0,0,0
mcupak_beacon-of-beacons,com.dnastack.bob.service.fetcher.util,0,0,0,0,0,0,0,0
mcupak_beacon-of-beacons,com.dnastack.bob.service.impl,0,0,0,0,0,0,0,0
mcupak_beacon-of-beacons,com.dnastack.bob.service.lrg,0,0,0,0,0,0,0,0
mcupak_beacon-of-beacons,com.dnastack.bob.service.dto,0,0,0,0,0,0,0,0
mcupak_beacon-of-beacons,com.dnastack.bob.service.mapper.api,0,0,0,0,0,0,0,0
mcupak_beacon-of-beacons,com.dnastack.bob.service.mapper.impl,0,0,0,0,1,0,0,1
mcupak_beacon-of-beacons,com.dnastack.bob.service.parser.api,0,0,0,0,0,0,0,0
mcupak_beacon-of-beacons,com.dnastack.bob.service.parser.impl,0,0,0,0,1,0,0,1
mcupak_beacon-of-beacons,com.dnastack.bob.service.parser.util,0,0,0,0,0,0,0,0
mcupak_beacon-of-beacons,com.dnastack.bob.service.processor.api,0,0,0,0,0,0,0,0
mcupak_beacon-of-beacons,com.dnastack.bob.service.processor.impl,0,0,0,0,0,0,0,0
mcupak_beacon-of-beacons,com.dnastack.bob.service.processor.util,0,0,0,0,0,0,0,0
mcupak_beacon-of-beacons,com.dnastack.bob.service.requester.api,0,0,0,0,0,0,0,0
mcupak_beacon-of-beacons,com.dnastack.bob.service.requester.impl,0,0,0,0,1,0,0,1
mdeverdelhan_ta4j,eu.verdelhan.ta4j.analysis,0,0,0,0,0,0,1,1
mdeverdelhan_ta4j,eu.verdelhan.ta4j.analysis.criteria,0,0,0,0,0,1,1,2
mdeverdelhan_ta4j,eu.verdelhan.ta4j,5,1,0,0,0,6,1,13
mdeverdelhan_ta4j,eu.verdelhan.ta4j.indicators,4,0,0,1,1,5,1,12
mdeverdelhan_ta4j,eu.verdelhan.ta4j.indicators.bollinger,0,0,0,0,1,1,1,3
mdeverdelhan_ta4j,eu.verdelhan.ta4j.indicators.candles,0,0,0,0,1,1,1,3
mdeverdelhan_ta4j,eu.verdelhan.ta4j.indicators.helpers,6,1,0,1,1,1,1,11
mdeverdelhan_ta4j,eu.verdelhan.ta4j.indicators.ichimoku,0,0,0,0,1,0,1,2
mdeverdelhan_ta4j,eu.verdelhan.ta4j.indicators.keltner,0,0,0,0,0,0,1,1
mdeverdelhan_ta4j,eu.verdelhan.ta4j.indicators.statistics,0,0,0,0,1,1,1,3
mdeverdelhan_ta4j,eu.verdelhan.ta4j.indicators.volume,0,0,0,0,1,0,1,2
mdeverdelhan_ta4j,eu.verdelhan.ta4j.trading.rules,6,0,0,1,0,1,1,9
mdeverdelhan_ta4j,eu.verdelhan.ta4j.mocks,2,0,0,0,0,0,1,3
mdeverdelhan_ta4j,ta4jexamples.analysis,0,0,0,0,0,0,1,1
mdeverdelhan_ta4j,ta4jexamples.bots,0,0,0,0,0,0,1,1
mdeverdelhan_ta4j,ta4jexamples.indicators,0,0,0,0,0,0,1,1
mdeverdelhan_ta4j,ta4jexamples.loaders,0,0,0,0,0,1,1,2
mdeverdelhan_ta4j,ta4jexamples.logging,0,0,0,0,0,0,1,1
mdeverdelhan_ta4j,ta4jexamples,0,0,0,0,0,0,1,1
mdeverdelhan_ta4j,ta4jexamples.strategies,0,0,0,0,0,1,1,2
mdeverdelhan_ta4j,ta4jexamples.walkforward,0,0,0,0,0,0,1,1
meltmedia_dropwizard-crypto,com.meltmedia.dropwizard.crypto,0,0,0,0,1,0,0,1
meltmedia_dropwizard-crypto,com.meltmedia.dropwizard.crypto.guice,0,0,0,0,0,0,0,0
meltmedia_dropwizard-crypto,com.meltmedia.dropwizard.crypto.example,0,0,0,0,0,0,0,0
meltmedia_dropwizard-crypto,com.meltmedia.dropwizard.crypto.example.resources,0,0,0,0,0,0,0,0
mesos_storm,storm.mesos,3,0,0,0,1,0,0,4
mesos_storm,storm.mesos.resources,2,1,0,0,0,0,0,3
mesos_storm,storm.mesos.schedulers,0,0,0,0,1,0,0,1
mesos_storm,storm.mesos.shims,0,0,0,0,1,0,0,1
mesos_storm,storm.mesos.util,2,1,0,0,0,0,0,3
MesquiteProject_MesquiteCore,(default package),0,0,0,0,0,0,0,0
MesquiteProject_MesquiteCore,com.lowagie.text,6,1,0,1,0,0,0,8
MesquiteProject_MesquiteCore,com.lowagie.text.html,0,0,0,0,0,0,0,0
MesquiteProject_MesquiteCore,com.lowagie.text.html.simpleparser,0,0,0,0,0,0,0,0
MesquiteProject_MesquiteCore,com.lowagie.text.markup,1,0,0,0,0,0,0,1
MesquiteProject_MesquiteCore,com.lowagie.text.pdf,3,0,0,2,0,0,0,5
MesquiteProject_MesquiteCore,com.lowagie.text.pdf.codec,3,0,0,0,1,0,0,4
MesquiteProject_MesquiteCore,com.lowagie.text.pdf.codec.postscript,0,0,0,0,0,0,0,0
MesquiteProject_MesquiteCore,com.lowagie.text.pdf.codec.wmf,2,1,0,0,0,0,0,3
MesquiteProject_MesquiteCore,com.lowagie.text.pdf.fonts,0,0,0,0,0,0,0,0
MesquiteProject_MesquiteCore,com.lowagie.text.pdf.hyphenation,1,1,0,0,0,0,0,2
MesquiteProject_MesquiteCore,Jama,0,0,0,0,0,0,0,0
MesquiteProject_MesquiteCore,Jama.examples,0,0,0,0,0,0,0,0
MesquiteProject_MesquiteCore,Jama.util,0,0,0,0,0,0,0,0
MesquiteProject_MesquiteCore,JSci,0,0,0,0,0,0,0,0
MesquiteProject_MesquiteCore,JSci.maths,0,0,0,0,0,0,0,0
MesquiteProject_MesquiteCore,JSci.maths.statistics,0,0,0,0,0,0,0,0
MesquiteProject_MesquiteCore,pal.alignment,0,0,0,0,0,0,0,0
MesquiteProject_MesquiteCore,pal.coalescent,0,0,0,0,1,0,0,1
MesquiteProject_MesquiteCore,pal.datatype,0,0,0,0,0,0,0,0
MesquiteProject_MesquiteCore,pal.distance,0,0,0,0,0,0,0,0
MesquiteProject_MesquiteCore,pal.eval,0,0,0,0,1,0,0,1
MesquiteProject_MesquiteCore,pal.gui,0,0,0,0,0,0,0,0
MesquiteProject_MesquiteCore,pal.io,0,0,0,0,0,0,0,0
MesquiteProject_MesquiteCore,pal.math,0,0,0,0,0,0,0,0
MesquiteProject_MesquiteCore,pal.mep,0,0,0,0,0,0,0,0
MesquiteProject_MesquiteCore,pal.misc,0,0,0,0,1,0,0,1
MesquiteProject_MesquiteCore,pal.statistics,0,0,0,0,1,0,0,1
MesquiteProject_MesquiteCore,pal.substmodel,0,0,0,0,0,0,0,0
MesquiteProject_MesquiteCore,pal.tree,0,0,0,0,0,0,0,0
MesquiteProject_MesquiteCore,pal.util,0,0,0,0,1,0,0,1
MesquiteProject_MesquiteCore,corejava,0,0,0,0,0,0,0,0
MesquiteProject_MesquiteCore,edu.stanford.ejalbert,0,0,0,0,0,0,0,0
MesquiteProject_MesquiteCore,mesquite.align.aAlignIntro,0,0,0,0,0,0,0,0
MesquiteProject_MesquiteCore,mesquite.align.AlignDNAToProtein,0,0,0,0,0,0,0,0
MesquiteProject_MesquiteCore,mesquite.align.AlignScoreForTaxon,0,0,0,0,0,0,0,0
MesquiteProject_MesquiteCore,mesquite.align.AlignScoreForTaxonRC,0,0,0,0,0,0,0,0
MesquiteProject_MesquiteCore,mesquite.align.AlignSequences,0,0,0,0,0,0,0,0
MesquiteProject_MesquiteCore,mesquite.align.AlignToDropped,0,0,0,0,0,0,0,0
MesquiteProject_MesquiteCore,mesquite.align.AlignToDroppedShift,0,0,0,0,0,0,0,0
MesquiteProject_MesquiteCore,mesquite.align.ClustalAlign,0,0,0,0,0,0,0,0
MesquiteProject_MesquiteCore,mesquite.align.ColorForAlignment,0,0,0,0,0,0,0,0
MesquiteProject_MesquiteCore,mesquite.align.ColorGapsInCodingSequence,0,0,0,0,0,0,0,0
MesquiteProject_MesquiteCore,mesquite.align.ColorMisaligned,0,0,0,0,0,0,0,0
MesquiteProject_MesquiteCore,mesquite.align.lib,0,0,0,0,1,0,0,1
MesquiteProject_MesquiteCore,mesquite.align.MAFFTAlign,0,0,0,0,0,0,0,0
MesquiteProject_MesquiteCore,mesquite.align.MultiBlockSplitter,0,0,0,0,0,0,0,0
MesquiteProject_MesquiteCore,mesquite.align.MuscleAlign,0,0,0,0,0,0,0,0
MesquiteProject_MesquiteCore,mesquite.align.RemoveAllGaps,0,0,0,0,0,0,0,0
MesquiteProject_MesquiteCore,mesquite.align.ScrollToData,0,0,0,0,0,0,0,0
MesquiteProject_MesquiteCore,mesquite.align.SelectedBlockMover,0,0,0,0,0,0,0,0
MesquiteProject_MesquiteCore,mesquite.align.ShiftOtherToMatch,0,0,0,0,0,0,0,0
MesquiteProject_MesquiteCore,mesquite.align.ShiftToMinimizeStops,0,0,0,0,0,0,0,0
MesquiteProject_MesquiteCore,mesquite.align.SidePusher,0,0,0,0,0,0,0,0
MesquiteProject_MesquiteCore,mesquite.align.SimpleBlockMover,0,0,0,0,0,0,0,0
MesquiteProject_MesquiteCore,mesquite.align.ZapGaps,0,0,0,0,0,0,0,0
MesquiteProject_MesquiteCore,mesquite.align.ZapGapsRight,0,0,0,0,0,0,0,0
MesquiteProject_MesquiteCore,mesquite.ancstates.aAncStatesIntro,0,0,0,0,0,0,0,0
MesquiteProject_MesquiteCore,mesquite.ancstates.AncestralStatesAll,0,0,0,0,0,0,0,0
MesquiteProject_MesquiteCore,mesquite.ancstates.ExportAncRec,0,0,0,0,0,0,0,0
MesquiteProject_MesquiteCore,mesquite.ancstates.LabelStatesOnTree,0,0,0,0,0,0,0,0
MesquiteProject_MesquiteCore,mesquite.ancstates.lib,0,0,0,0,0,0,0,0
MesquiteProject_MesquiteCore,mesquite.ancstates.RecAncestralStates,0,0,0,0,0,0,0,0
MesquiteProject_MesquiteCore,mesquite.ancstates.ShadeStatesOnTree,0,0,0,0,0,0,0,0
MesquiteProject_MesquiteCore,mesquite.ancstates.SummarizeChanges,0,0,0,0,0,0,0,0
MesquiteProject_MesquiteCore,mesquite.ancstates.SummarizeChgOnBranches,0,0,0,0,0,0,0,0
MesquiteProject_MesquiteCore,mesquite.ancstates.SummarizeChgOverTrees,0,0,0,0,0,0,0,0
MesquiteProject_MesquiteCore,mesquite.ancstates.TraceAllCharacters,0,0,0,0,0,0,0,0
MesquiteProject_MesquiteCore,mesquite.ancstates.TraceCharacterHistory,0,0,0,0,0,0,0,0
MesquiteProject_MesquiteCore,mesquite.ancstates.TraceCharOverTrees,0,0,0,0,0,0,0,0
MesquiteProject_MesquiteCore,mesquite.ancstates.UnambigChangesAtNodes,0,0,0,0,0,0,0,0
MesquiteProject_MesquiteCore,mesquite.assoc.aAssocIntro,0,0,0,0,0,0,0,0
MesquiteProject_MesquiteCore,mesquite.assoc.ContainedAssociates,0,0,0,0,0,0,0,0
MesquiteProject_MesquiteCore,mesquite.assoc.DepContTreeWindow,0,0,0,0,0,0,0,0
MesquiteProject_MesquiteCore,mesquite.assoc.lib,0,0,0,0,1,0,0,1
MesquiteProject_MesquiteCore,mesquite.assoc.ManageAssociations,0,0,0,0,0,0,0,0
MesquiteProject_MesquiteCore,mesquite.assoc.ManageDistributionBlock,0,0,0,0,0,0,0,0
MesquiteProject_MesquiteCore,mesquite.assoc.PartitionFromAssociation,0,0,0,0,0,0,0,0
MesquiteProject_MesquiteCore,mesquite.assoc.StoredAssociations,0,0,0,0,0,0,0,0
MesquiteProject_MesquiteCore,mesquite.assoc.TaxonListAssoc,0,0,0,0,0,0,0,0
MesquiteProject_MesquiteCore,mesquite.basic.aBasicIntro,0,0,0,0,0,0,0,0
MesquiteProject_MesquiteCore,mesquite.basic.AddToTaxonNames,0,0,0,0,0,0,0,0
MesquiteProject_MesquiteCore,mesquite.basic.AssignTaxonNames,0,0,0,0,0,0,0,0
MesquiteProject_MesquiteCore,mesquite.basic.AuthorDefaults,0,0,0,0,0,0,0,0
MesquiteProject_MesquiteCore,mesquite.basic.BasicParametersExplorer,0,0,0,0,0,0,0,0
MesquiteProject_MesquiteCore,mesquite.basic.BasicStringMatcher,0,0,0,0,0,0,0,0
MesquiteProject_MesquiteCore,mesquite.basic.CondenseTaxonNames,0,0,0,0,0,0,0,0
MesquiteProject_MesquiteCore,mesquite.basic.CurrentTaxaPartition,0,0,0,0,0,0,0,0
MesquiteProject_MesquiteCore,mesquite.basic.DeleteTaxonFootnotes,0,0,0,0,0,0,0,0
MesquiteProject_MesquiteCore,mesquite.basic.DuplicateTaxa,0,0,0,0,0,0,0,0
MesquiteProject_MesquiteCore,mesquite.basic.ExamplesNavigator,0,0,0,0,0,0,0,0
MesquiteProject_MesquiteCore,mesquite.basic.GoToWebPage,0,0,0,0,0,0,0,0
MesquiteProject_MesquiteCore,mesquite.basic.ListInFileTaxonSelector,0,0,0,0,0,0,0,0
MesquiteProject_MesquiteCore,mesquite.basic.ManageArchivedTaxonNames,0,0,0,0,0,0,0,0
MesquiteProject_MesquiteCore,mesquite.basic.ManageAuthors,0,0,0,0,0,0,0,0
MesquiteProject_MesquiteCore,mesquite.basic.ManageFileComments,0,0,0,0,0,0,0,0
MesquiteProject_MesquiteCore,mesquite.basic.ManageLabelsBlock,0,0,0,0,0,0,0,0
MesquiteProject_MesquiteCore,mesquite.basic.ManageNotesBlock,0,0,0,0,0,0,0,0
MesquiteProject_MesquiteCore,mesquite.basic.ManageSetsBlock,0,0,0,0,0,0,0,0
MesquiteProject_MesquiteCore,mesquite.basic.ManageTaxaPartitions,0,0,0,0,0,0,0,0
MesquiteProject_MesquiteCore,mesquite.basic.ManageTaxaSets,0,0,0,0,0,0,0,0
MesquiteProject_MesquiteCore,mesquite.basic.MergeTaxa,0,0,0,0,0,0,0,0
MesquiteProject_MesquiteCore,mesquite.basic.MergeTaxaByName,0,0,0,0,0,0,0,0
MesquiteProject_MesquiteCore,mesquite.basic.NextProject,0,0,0,0,0,0,0,0
MesquiteProject_MesquiteCore,mesquite.basic.PrefixedStringMatcher,0,0,0,0,0,0,0,0
MesquiteProject_MesquiteCore,mesquite.basic.PrefixTaxonNameWithGroup,0,0,0,0,0,0,0,0
MesquiteProject_MesquiteCore,mesquite.basic.RawNexusBlockEditor,0,0,0,0,0,0,0,0
MesquiteProject_MesquiteCore,mesquite.basic.RemoveFromTaxonNames,0,0,0,0,0,0,0,0
MesquiteProject_MesquiteCore,mesquite.basic.RemoveTokensTaxonNames,0,0,0,0,0,0,0,0
MesquiteProject_MesquiteCore,mesquite.basic.ReplaceInTaxonNames,0,0,0,0,0,0,0,0
MesquiteProject_MesquiteCore,mesquite.basic.SearchNameTaxonSelector,0,0,0,0,0,0,0,0
MesquiteProject_MesquiteCore,mesquite.basic.ShowText,0,0,0,0,0,0,0,0
MesquiteProject_MesquiteCore,mesquite.basic.StoredTaxonPairs,0,0,0,0,0,0,0,0
MesquiteProject_MesquiteCore,mesquite.basic.SuffixTaxonNames,0,0,0,0,0,0,0,0
MesquiteProject_MesquiteCore,mesquite.basic.TaxaSelCoordinator,0,0,0,0,0,0,0,0
MesquiteProject_MesquiteCore,mesquite.basic.TextWindowMaker,0,0,0,0,0,0,0,0
MesquiteProject_MesquiteCore,mesquite.basic.TruncTaxonNames,0,0,0,0,0,0,0,0
MesquiteProject_MesquiteCore,mesquite.basic.VoucherInfoCoordinator,0,0,0,0,0,0,0,0
MesquiteProject_MesquiteCore,mesquite.basic.VoucherInfoFromFlexTable,0,0,0,0,0,0,0,0
MesquiteProject_MesquiteCore,mesquite.basic.zTokenizeTaxonNames,0,0,0,0,0,0,0,0
MesquiteProject_MesquiteCore,mesquite.basic.zzDetokenizeTaxonNames,0,0,0,0,0,0,0,0
MesquiteProject_MesquiteCore,mesquite.batchArch.aBatchArchIntro,0,0,0,0,0,0,0,0
MesquiteProject_MesquiteCore,mesquite.batchArch.BatchTemplateManager,0,0,0,0,0,0,0,0
MesquiteProject_MesquiteCore,mesquite.batchArch.ChartFromInstructions,0,0,0,0,0,0,0,0
MesquiteProject_MesquiteCore,mesquite.batchArch.ExportMatricesBatch,0,0,0,0,0,0,0,0
MesquiteProject_MesquiteCore,mesquite.batchArch.lib,0,0,0,0,0,0,0,0
MesquiteProject_MesquiteCore,mesquite.categ.aCategIntro,0,0,0,0,0,0,0,0
MesquiteProject_MesquiteCore,mesquite.categ.AmbiguityToPolym,0,0,0,0,0,0,0,0
MesquiteProject_MesquiteCore,mesquite.categ.CategVariable,0,0,0,0,0,0,0,0
MesquiteProject_MesquiteCore,mesquite.categ.ConsensusSequenceStrip,0,0,0,0,0,0,0,0
MesquiteProject_MesquiteCore,mesquite.categ.ConsensusStateForChar,0,0,0,0,0,0,0,0
MesquiteProject_MesquiteCore,mesquite.categ.lib,0,1,0,1,1,0,0,3
MesquiteProject_MesquiteCore,mesquite.categ.ManageCategoricalChars,0,0,0,0,0,0,0,0
MesquiteProject_MesquiteCore,mesquite.categ.ManageDNARNAChars,0,0,0,0,0,0,0,0
MesquiteProject_MesquiteCore,mesquite.categ.ManageProteinChars,0,0,0,0,0,0,0,0
MesquiteProject_MesquiteCore,mesquite.categ.MultistateToMissing,0,0,0,0,0,0,0,0
MesquiteProject_MesquiteCore,mesquite.categ.NumberOfStates,0,0,0,0,0,0,0,0
MesquiteProject_MesquiteCore,mesquite.categ.PolymToAmbiguity,0,0,0,0,0,0,0,0
MesquiteProject_MesquiteCore,mesquite.categ.ProportionUniqueStates,0,0,0,0,0,0,0,0
MesquiteProject_MesquiteCore,mesquite.categ.RemoveInvariant,0,0,0,0,0,0,0,0
MesquiteProject_MesquiteCore,mesquite.categ.ResolveStateAmbiguity,0,0,0,0,0,0,0,0
MesquiteProject_MesquiteCore,mesquite.categ.SmallStateNamesEditor,0,0,0,0,0,0,0,0
MesquiteProject_MesquiteCore,mesquite.categ.StateConsistencyInWindowStrip,0,0,0,0,0,0,0,0
MesquiteProject_MesquiteCore,mesquite.categ.StateConsistencyStrip,0,0,0,0,0,0,0,0
MesquiteProject_MesquiteCore,mesquite.categ.StateFrequency,0,0,0,0,0,0,0,0
MesquiteProject_MesquiteCore,mesquite.categ.StateNamesEditor,0,0,0,0,0,0,0,0
MesquiteProject_MesquiteCore,mesquite.categ.StateNamesStrip,0,0,0,0,0,0,0,0
MesquiteProject_MesquiteCore,mesquite.charMatrices.aCharMatricesIntro,0,0,0,0,0,0,0,0
MesquiteProject_MesquiteCore,mesquite.charMatrices.AddCharsFromSource,0,0,0,0,0,0,0,0
MesquiteProject_MesquiteCore,mesquite.charMatrices.AddDeleteData,0,0,0,0,0,0,0,0
MesquiteProject_MesquiteCore,mesquite.charMatrices.AlterAllMatrices,0,0,0,0,0,0,0,0
MesquiteProject_MesquiteCore,mesquite.charMatrices.AlterData,0,0,0,0,0,0,0,0
MesquiteProject_MesquiteCore,mesquite.charMatrices.AlteredMatrix,0,0,0,0,0,0,0,0
MesquiteProject_MesquiteCore,mesquite.charMatrices.AlterMatrixAsUtility,0,0,0,0,0,0,0,0
MesquiteProject_MesquiteCore,mesquite.charMatrices.AnnotPanel,0,0,0,0,0,0,0,0
MesquiteProject_MesquiteCore,mesquite.charMatrices.BasicDataWindowCoord,0,0,0,0,0,0,0,0
MesquiteProject_MesquiteCore,mesquite.charMatrices.BasicDataWindowMaker,0,0,0,0,0,0,0,0
MesquiteProject_MesquiteCore,mesquite.charMatrices.BooleanForCharInfoStrip,0,0,0,0,0,0,0,0
MesquiteProject_MesquiteCore,mesquite.charMatrices.CharGroupColor,0,0,0,0,0,0,0,0
MesquiteProject_MesquiteCore,mesquite.charMatrices.CharMatrixCoordIndep,0,0,0,0,0,0,0,0
MesquiteProject_MesquiteCore,mesquite.charMatrices.CharMatrixCoordObed,0,0,0,0,0,0,0,0
MesquiteProject_MesquiteCore,mesquite.charMatrices.CharReferenceStrip,0,0,0,0,0,0,0,0
MesquiteProject_MesquiteCore,mesquite.charMatrices.CharSelCoordinator,0,0,0,0,0,0,0,0
MesquiteProject_MesquiteCore,mesquite.charMatrices.CharSrcCoordIndep,0,0,0,0,0,0,0,0
MesquiteProject_MesquiteCore,mesquite.charMatrices.CharSrcCoordObed,0,0,0,0,0,0,0,0
MesquiteProject_MesquiteCore,mesquite.charMatrices.ColorByCharValue,0,0,0,0,0,0,0,0
MesquiteProject_MesquiteCore,mesquite.charMatrices.ColorByExcluded,0,0,0,0,0,0,0,0
MesquiteProject_MesquiteCore,mesquite.charMatrices.ColorByFootnote,0,0,0,0,0,0,0,0
MesquiteProject_MesquiteCore,mesquite.charMatrices.ColorByMatchToFirstTaxon,0,0,0,0,0,0,0,0
MesquiteProject_MesquiteCore,mesquite.charMatrices.ColorByState,0,0,0,0,0,0,0,0
MesquiteProject_MesquiteCore,mesquite.charMatrices.ColorByTaxonValue,0,0,0,0,0,0,0,0
MesquiteProject_MesquiteCore,mesquite.charMatrices.ColorCells,0,0,0,0,0,0,0,0
MesquiteProject_MesquiteCore,mesquite.charMatrices.ColorTInfo,0,0,0,0,0,0,0,0
MesquiteProject_MesquiteCore,mesquite.charMatrices.CompareMatrices,0,0,0,0,0,0,0,0
MesquiteProject_MesquiteCore,mesquite.charMatrices.CompileProcessedMatrices,0,0,0,0,0,0,0,0
MesquiteProject_MesquiteCore,mesquite.charMatrices.ConcatenateMatrices,0,0,0,0,0,0,0,0
MesquiteProject_MesquiteCore,mesquite.charMatrices.ConcatRespMatrices,0,0,0,0,0,0,0,0
MesquiteProject_MesquiteCore,mesquite.charMatrices.CondensedPatternMatrix,0,0,0,0,0,0,0,0
MesquiteProject_MesquiteCore,mesquite.charMatrices.DataPainter,0,0,0,0,0,0,0,0
MesquiteProject_MesquiteCore,mesquite.charMatrices.DataUtilityFileProcessor,0,0,0,0,0,0,0,0
MesquiteProject_MesquiteCore,mesquite.charMatrices.DifferenceInNumsForChar,0,0,0,0,0,0,0,0
MesquiteProject_MesquiteCore,mesquite.charMatrices.ExtendSelectionToWholeChars,0,0,0,0,0,0,0,0
MesquiteProject_MesquiteCore,mesquite.charMatrices.Fill,0,0,0,0,0,0,0,0
MesquiteProject_MesquiteCore,mesquite.charMatrices.ImposeIndelPattern,0,0,0,0,0,0,0,0
MesquiteProject_MesquiteCore,mesquite.charMatrices.IncludedCharBoolean,0,0,0,0,0,0,0,0
MesquiteProject_MesquiteCore,mesquite.charMatrices.lib,0,0,0,0,0,0,0,0
MesquiteProject_MesquiteCore,mesquite.charMatrices.LogMatrixDetails,0,0,0,0,0,0,0,0
MesquiteProject_MesquiteCore,mesquite.charMatrices.ManageAssumptionsBlock,0,0,0,0,0,0,0,0
MesquiteProject_MesquiteCore,mesquite.charMatrices.ManageCharacters,0,0,0,0,0,0,0,0
MesquiteProject_MesquiteCore,mesquite.charMatrices.ManageCharInclusion,0,0,0,0,0,0,0,0
MesquiteProject_MesquiteCore,mesquite.charMatrices.ManageCharModels,2,0,0,0,0,0,0,2
MesquiteProject_MesquiteCore,mesquite.charMatrices.ManageCharPartitions,0,0,0,0,0,0,0,0
MesquiteProject_MesquiteCore,mesquite.charMatrices.ManageCharsets,0,0,0,0,0,0,0,0
MesquiteProject_MesquiteCore,mesquite.charMatrices.ManageCharWeights,0,0,0,0,0,0,0,0
MesquiteProject_MesquiteCore,mesquite.charMatrices.ManageCodonPositions,0,0,0,0,0,0,0,0
MesquiteProject_MesquiteCore,mesquite.charMatrices.ManageCodonsBlock,0,0,0,0,0,0,0,0
MesquiteProject_MesquiteCore,mesquite.charMatrices.ManageDATAblock,0,0,0,0,0,0,0,0
MesquiteProject_MesquiteCore,mesquite.charMatrices.MatrixFromClipboard,0,0,0,0,0,0,0,0
MesquiteProject_MesquiteCore,mesquite.charMatrices.MatrixInfoTool,0,0,0,0,0,0,0,0
MesquiteProject_MesquiteCore,mesquite.charMatrices.MatrixSelection,0,0,0,0,0,0,0,0
MesquiteProject_MesquiteCore,mesquite.charMatrices.NoColor,0,0,0,0,0,0,0,0
MesquiteProject_MesquiteCore,mesquite.charMatrices.NumApplicableNonMissing,0,0,0,0,0,0,0,0
MesquiteProject_MesquiteCore,mesquite.charMatrices.NumApplicableNonMissingMatrix,0,0,0,0,0,0,0,0
MesquiteProject_MesquiteCore,mesquite.charMatrices.NumberForMatricesFP,0,0,0,0,0,0,0,0
MesquiteProject_MesquiteCore,mesquite.charMatrices.NumDataCellsStrip,0,0,0,0,0,0,0,0
MesquiteProject_MesquiteCore,mesquite.charMatrices.NumForCharWithChar,0,0,0,0,0,0,0,0
MesquiteProject_MesquiteCore,mesquite.charMatrices.NumIncludedMatrix,0,0,0,0,0,0,0,0
MesquiteProject_MesquiteCore,mesquite.charMatrices.NumMatricesWithDataForTaxon,0,0,0,0,0,0,0,0
MesquiteProject_MesquiteCore,mesquite.charMatrices.NumSelTaxaWithDataInMatrix,0,0,0,0,0,0,0,0
MesquiteProject_MesquiteCore,mesquite.charMatrices.NumTaxaWithDataInMatrix,0,0,0,0,0,0,0,0
MesquiteProject_MesquiteCore,mesquite.charMatrices.PercentGaps,0,0,0,0,0,0,0,0
MesquiteProject_MesquiteCore,mesquite.charMatrices.PercentMissing,0,0,0,0,0,0,0,0
MesquiteProject_MesquiteCore,mesquite.charMatrices.PopupStateSelector,0,0,0,0,0,0,0,0
MesquiteProject_MesquiteCore,mesquite.charMatrices.QuickKeySelector,0,0,0,0,0,0,0,0
MesquiteProject_MesquiteCore,mesquite.charMatrices.RandomFillCateg,0,0,0,0,0,0,0,0
MesquiteProject_MesquiteCore,mesquite.charMatrices.RandomFillWithMissing,0,0,0,0,0,0,0,0
MesquiteProject_MesquiteCore,mesquite.charMatrices.RandomModifMatrix,0,0,0,0,0,0,0,0
MesquiteProject_MesquiteCore,mesquite.charMatrices.RandomModRespMatrices,0,0,0,0,0,0,0,0
MesquiteProject_MesquiteCore,mesquite.charMatrices.RarefyMatrix,0,0,0,0,0,0,0,0
MesquiteProject_MesquiteCore,mesquite.charMatrices.RecodeCateg,0,0,0,0,0,0,0,0
MesquiteProject_MesquiteCore,mesquite.charMatrices.ReshuffleCharacter,0,0,0,0,0,0,0,0
MesquiteProject_MesquiteCore,mesquite.charMatrices.ReshuffleMatrix,0,0,0,0,0,0,0,0
MesquiteProject_MesquiteCore,mesquite.charMatrices.ReshuffleMatrixByPart,0,0,0,0,0,0,0,0
MesquiteProject_MesquiteCore,mesquite.charMatrices.ReshuffleWithinTaxa,0,0,0,0,0,0,0,0
MesquiteProject_MesquiteCore,mesquite.charMatrices.ReshuffleWTaxaByPart,0,0,0,0,0,0,0,0
MesquiteProject_MesquiteCore,mesquite.charMatrices.SaveMatricesFileProcessor,0,0,0,0,0,0,0,0
MesquiteProject_MesquiteCore,mesquite.charMatrices.SaveMatrixCopies,0,0,0,0,0,0,0,0
MesquiteProject_MesquiteCore,mesquite.charMatrices.SearchData,0,0,0,0,0,0,0,0
MesquiteProject_MesquiteCore,mesquite.charMatrices.SearchSelect,0,0,0,0,0,0,0,0
MesquiteProject_MesquiteCore,mesquite.charMatrices.SelectCharacterRanges,0,0,0,0,0,0,0,0
MesquiteProject_MesquiteCore,mesquite.charMatrices.SelectCharsWithProbP,0,0,0,0,0,0,0,0
MesquiteProject_MesquiteCore,mesquite.charMatrices.SelectDelimiting,0,0,0,0,0,0,0,0
MesquiteProject_MesquiteCore,mesquite.charMatrices.SelectDiffering,0,0,0,0,0,0,0,0
MesquiteProject_MesquiteCore,mesquite.charMatrices.SelectMatchingTaxa,0,0,0,0,0,0,0,0
MesquiteProject_MesquiteCore,mesquite.charMatrices.SelectRndCharacters,0,0,0,0,0,0,0,0
MesquiteProject_MesquiteCore,mesquite.charMatrices.SelectSame,0,0,0,0,0,0,0,0
MesquiteProject_MesquiteCore,mesquite.charMatrices.SelectSameVert,0,0,0,0,0,0,0,0
MesquiteProject_MesquiteCore,mesquite.charMatrices.SelectVariableCharacters,0,0,0,0,0,0,0,0
MesquiteProject_MesquiteCore,mesquite.charMatrices.SelSummaryStrip,0,0,0,0,0,0,0,0
MesquiteProject_MesquiteCore,mesquite.charMatrices.ShuffleStates,0,0,0,0,0,0,0,0
MesquiteProject_MesquiteCore,mesquite.charMatrices.SortChar,0,0,0,0,0,0,0,0
MesquiteProject_MesquiteCore,mesquite.charMatrices.SortsInCharList,0,0,0,0,0,0,0,0
MesquiteProject_MesquiteCore,mesquite.charMatrices.SortsManagerChar,0,0,0,0,0,0,0,0
MesquiteProject_MesquiteCore,mesquite.charMatrices.SortTaxa,0,0,0,0,0,0,0,0
MesquiteProject_MesquiteCore,mesquite.charMatrices.SprinkleMissing,0,0,0,0,0,0,0,0
MesquiteProject_MesquiteCore,mesquite.charMatrices.StoredCharacters,0,0,0,0,0,0,0,0
MesquiteProject_MesquiteCore,mesquite.charMatrices.StoredMatrices,0,0,0,0,0,0,0,0
MesquiteProject_MesquiteCore,mesquite.charMatrices.TaxonGroupColor,0,0,0,0,0,0,0,0
MesquiteProject_MesquiteCore,mesquite.charMatrices.Wand,0,0,0,0,0,0,0,0
MesquiteProject_MesquiteCore,mesquite.charMatrices.WandBlock,0,0,0,0,0,0,0,0
MesquiteProject_MesquiteCore,mesquite.charMatrices.WandChar,0,0,0,0,0,0,0,0
MesquiteProject_MesquiteCore,mesquite.charMatrices.WandTaxon,0,0,0,0,0,0,0,0
MesquiteProject_MesquiteCore,mesquite.charts.aChartsIntro,0,0,0,0,0,0,0,0
MesquiteProject_MesquiteCore,mesquite.charts.CharacterValuesChart,0,0,0,0,0,0,0,0
MesquiteProject_MesquiteCore,mesquite.charts.CharsScattergram,0,0,0,0,0,0,0,0
MesquiteProject_MesquiteCore,mesquite.charts.Histogram,0,0,0,0,0,0,0,0
MesquiteProject_MesquiteCore,mesquite.charts.ItemsBiplot,0,0,0,0,0,0,0,0
MesquiteProject_MesquiteCore,mesquite.charts.ItemValuesChart,0,0,0,0,0,0,0,0
MesquiteProject_MesquiteCore,mesquite.charts.MatrixValuesChart,0,0,0,0,0,0,0,0
MesquiteProject_MesquiteCore,mesquite.charts.NodesScattergram,0,0,0,0,0,0,0,0
MesquiteProject_MesquiteCore,mesquite.charts.Scattergram,0,0,0,0,0,0,0,0
MesquiteProject_MesquiteCore,mesquite.charts.ShowMean,0,0,0,0,0,0,0,0
MesquiteProject_MesquiteCore,mesquite.charts.ShowPercentile,0,0,0,0,0,0,0,0
MesquiteProject_MesquiteCore,mesquite.charts.ShowYEqualsX,0,0,0,0,0,0,0,0
MesquiteProject_MesquiteCore,mesquite.charts.TaxaScattergram,0,0,0,0,0,0,0,0
MesquiteProject_MesquiteCore,mesquite.charts.TaxonPairsScattergram,0,0,0,0,0,0,0,0
MesquiteProject_MesquiteCore,mesquite.charts.TaxonPairValuesChart,0,0,0,0,0,0,0,0
MesquiteProject_MesquiteCore,mesquite.charts.TaxonValuesChart,0,0,0,0,0,0,0,0
MesquiteProject_MesquiteCore,mesquite.charts.TreeBlockValues,0,0,0,0,0,0,0,0
MesquiteProject_MesquiteCore,mesquite.charts.TreesScattergram,0,0,0,0,0,0,0,0
MesquiteProject_MesquiteCore,mesquite.charts.TreeValuesChart,0,0,0,0,0,0,0,0
MesquiteProject_MesquiteCore,mesquite.coalesce.aCoalescencePkgIntro,0,0,0,0,0,0,0,0
MesquiteProject_MesquiteCore,mesquite.coalesce.AverageTreeDepth,0,0,0,0,0,0,0,0
MesquiteProject_MesquiteCore,mesquite.coalesce.CoalescenceWMigration,0,0,0,0,0,0,0,0
MesquiteProject_MesquiteCore,mesquite.coalesce.CoalescentTrees,0,0,0,0,0,0,0,0
MesquiteProject_MesquiteCore,mesquite.coalesce.ContainedCoalescence,0,0,0,0,0,0,0,0
MesquiteProject_MesquiteCore,mesquite.coalesce.ContainedCoalescSim,0,0,0,0,0,0,0,0
MesquiteProject_MesquiteCore,mesquite.coalesce.DeepCoalescencesG,0,0,0,0,0,0,0,0
MesquiteProject_MesquiteCore,mesquite.coalesce.DeepCoalescencesSp,0,0,0,0,0,0,0,0
MesquiteProject_MesquiteCore,mesquite.coalesce.DeepCoalMultLoci,0,0,0,0,0,0,0,0
MesquiteProject_MesquiteCore,mesquite.coalesce.DuplicationsExtinctionsG,0,0,0,0,0,0,0,0
MesquiteProject_MesquiteCore,mesquite.coalesce.DuplicationsExtinctionsSp,0,0,0,0,0,0,0,0
MesquiteProject_MesquiteCore,mesquite.coalesce.InsertNode,0,0,0,0,0,0,0,0
MesquiteProject_MesquiteCore,mesquite.coalesce.lib,0,0,0,0,1,0,0,1
MesquiteProject_MesquiteCore,mesquite.coalesce.LineageWidth,0,0,0,0,0,0,0,0
MesquiteProject_MesquiteCore,mesquite.coalesce.NeutralCoalescence,0,0,0,0,0,0,0,0
MesquiteProject_MesquiteCore,mesquite.coalesce.RecCoalescenceHistory,0,0,0,0,0,0,0,0
MesquiteProject_MesquiteCore,mesquite.coalesce.SlatkinMaddisonS,0,0,0,0,0,0,0,0
MesquiteProject_MesquiteCore,mesquite.coalesce.TreeDepth,0,0,0,0,0,0,0,0
MesquiteProject_MesquiteCore,mesquite.consensus.aConsensusIntro,0,0,0,0,0,0,0,0
MesquiteProject_MesquiteCore,mesquite.consensus.ConsensusTree,0,0,0,0,0,0,0,0
MesquiteProject_MesquiteCore,mesquite.consensus.lib,0,0,0,0,0,0,0,0
MesquiteProject_MesquiteCore,mesquite.consensus.MajRuleTree,0,0,0,0,0,0,0,0
MesquiteProject_MesquiteCore,mesquite.consensus.SemistrictConsensusTree,0,0,0,0,0,0,0,0
MesquiteProject_MesquiteCore,mesquite.consensus.StrictConsensusTree,0,0,0,0,0,0,0,0
MesquiteProject_MesquiteCore,mesquite.cont.aContIntro,0,0,0,0,0,0,0,0
MesquiteProject_MesquiteCore,mesquite.cont.AddCharacter,0,0,0,0,0,0,0,0
MesquiteProject_MesquiteCore,mesquite.cont.AddItem,0,0,0,0,0,0,0,0
MesquiteProject_MesquiteCore,mesquite.cont.AddNoise,0,0,0,0,0,0,0,0
MesquiteProject_MesquiteCore,mesquite.cont.AddToStates,0,0,0,0,0,0,0,0
MesquiteProject_MesquiteCore,mesquite.cont.ArcSineTransform,0,0,0,0,0,0,0,0
MesquiteProject_MesquiteCore,mesquite.cont.ContCharFrTaxonValue,0,0,0,0,0,0,0,0
MesquiteProject_MesquiteCore,mesquite.cont.DiscretizeContinuousCharacters,0,0,0,0,0,0,0,0
MesquiteProject_MesquiteCore,mesquite.cont.InverseContState,0,0,0,0,0,0,0,0
MesquiteProject_MesquiteCore,mesquite.cont.ItemsEditorForInfoPanel,0,0,0,0,0,0,0,0
MesquiteProject_MesquiteCore,mesquite.cont.ItemValueInTaxon,0,0,0,0,0,0,0,0
MesquiteProject_MesquiteCore,mesquite.cont.lib,0,0,0,0,1,0,0,1
MesquiteProject_MesquiteCore,mesquite.cont.LogTransform,0,0,0,0,0,0,0,0
MesquiteProject_MesquiteCore,mesquite.cont.ManageContChars,0,0,0,0,0,0,0,0
MesquiteProject_MesquiteCore,mesquite.cont.ManageGeogChars,0,0,0,0,0,0,0,0
MesquiteProject_MesquiteCore,mesquite.cont.MapContinuous,0,0,0,0,0,0,0,0
MesquiteProject_MesquiteCore,mesquite.cont.MeanValue,0,0,0,0,0,0,0,0
MesquiteProject_MesquiteCore,mesquite.cont.MultiplyByCharacter,0,0,0,0,0,0,0,0
MesquiteProject_MesquiteCore,mesquite.cont.MultiplyStates,0,0,0,0,0,0,0,0
MesquiteProject_MesquiteCore,mesquite.cont.NodeLocs2DPlot,0,0,0,0,0,0,0,0
MesquiteProject_MesquiteCore,mesquite.cont.PlotTree,0,0,0,0,0,0,0,0
MesquiteProject_MesquiteCore,mesquite.cont.RandomFillCont,0,0,0,0,0,0,0,0
MesquiteProject_MesquiteCore,mesquite.cont.RandomFillUniform,0,0,0,0,0,0,0,0
MesquiteProject_MesquiteCore,mesquite.cont.RemoveItem,0,0,0,0,0,0,0,0
MesquiteProject_MesquiteCore,mesquite.cont.RenameItem,0,0,0,0,0,0,0,0
MesquiteProject_MesquiteCore,mesquite.cont.SquareRootTransform,0,0,0,0,0,0,0,0
MesquiteProject_MesquiteCore,mesquite.cont.Standardize,0,0,0,0,0,0,0,0
MesquiteProject_MesquiteCore,mesquite.cont.XYMatrixToItems,0,0,0,0,0,0,0,0
MesquiteProject_MesquiteCore,mesquite.correl.aCorrelPackageIntro,0,0,0,0,0,0,0,0
MesquiteProject_MesquiteCore,mesquite.correl.CorrelationViewer,0,0,0,0,0,0,0,0
MesquiteProject_MesquiteCore,mesquite.correl.lib,0,0,0,0,1,0,0,1
MesquiteProject_MesquiteCore,mesquite.correl.Pagel94,0,0,0,0,0,0,0,0
MesquiteProject_MesquiteCore,mesquite.distance.AbsoluteDistance,0,0,0,0,0,0,0,0
MesquiteProject_MesquiteCore,mesquite.distance.aDistanceIntro,0,0,0,0,0,0,0,0
MesquiteProject_MesquiteCore,mesquite.distance.AverageOfDistances,0,0,0,0,0,0,0,0
MesquiteProject_MesquiteCore,mesquite.distance.ClusterAnalysis,0,0,0,0,0,0,0,0
MesquiteProject_MesquiteCore,mesquite.distance.DistanceContainedTaxa,0,0,0,0,0,0,0,0
MesquiteProject_MesquiteCore,mesquite.distance.ExportTaxaDistances,0,0,0,0,0,0,0,0
MesquiteProject_MesquiteCore,mesquite.distance.ExportTaxaDistancesByGroup,0,0,0,0,0,0,0,0
MesquiteProject_MesquiteCore,mesquite.distance.F81Distance,0,0,0,0,0,0,0,0
MesquiteProject_MesquiteCore,mesquite.distance.F84Distance,0,0,0,0,0,0,0,0
MesquiteProject_MesquiteCore,mesquite.distance.JukesCantorDistance,0,0,0,0,0,0,0,0
MesquiteProject_MesquiteCore,mesquite.distance.K2PDistance,0,0,0,0,0,0,0,0
MesquiteProject_MesquiteCore,mesquite.distance.lib,0,0,0,0,1,0,0,1
MesquiteProject_MesquiteCore,mesquite.distance.NodeCountDist,0,0,0,0,0,0,0,0
MesquiteProject_MesquiteCore,mesquite.distance.PatristicDistance,0,0,0,0,0,0,0,0
MesquiteProject_MesquiteCore,mesquite.distance.PDistance,0,0,0,0,0,0,0,0
MesquiteProject_MesquiteCore,mesquite.distance.SharedHistoryDistance,0,0,0,0,0,0,0,0
MesquiteProject_MesquiteCore,mesquite.distance.SharedProportionalDistance,0,0,0,0,0,0,0,0
MesquiteProject_MesquiteCore,mesquite.distance.ShowDistance,0,0,0,0,0,0,0,0
MesquiteProject_MesquiteCore,mesquite.distance.SingleLinkage,0,0,0,0,0,0,0,0
MesquiteProject_MesquiteCore,mesquite.distance.TaxaDistFromMatrixSrc,0,0,0,0,0,0,0,0
MesquiteProject_MesquiteCore,mesquite.distance.TaxonDistance,0,0,0,0,0,0,0,0
MesquiteProject_MesquiteCore,mesquite.distance.TaxonPairDistance,0,0,0,0,0,0,0,0
MesquiteProject_MesquiteCore,mesquite.distance.UncorrectedDistance,0,0,0,0,0,0,0,0
MesquiteProject_MesquiteCore,mesquite.distance.UPGMA,0,0,0,0,0,0,0,0
MesquiteProject_MesquiteCore,mesquite.diverse.aDiverseIntro,0,0,0,0,0,0,0,0
MesquiteProject_MesquiteCore,mesquite.diverse.BirthDeathTrees,0,0,0,0,0,0,0,0
MesquiteProject_MesquiteCore,mesquite.diverse.BiSSELikelihood,0,0,0,0,0,0,0,0
MesquiteProject_MesquiteCore,mesquite.diverse.BiSSELikelihoodCalculator,0,0,0,0,0,0,0,0
MesquiteProject_MesquiteCore,mesquite.diverse.BiSSELikelihoodRatio,0,0,0,0,0,0,0,0
MesquiteProject_MesquiteCore,mesquite.diverse.BiSSETreeCharSim,0,0,0,0,0,0,0,0
MesquiteProject_MesquiteCore,mesquite.diverse.CharAssocDivViewer,0,0,0,0,0,0,0,0
MesquiteProject_MesquiteCore,mesquite.diverse.CharIndepDivViewer,0,0,0,0,0,0,0,0
MesquiteProject_MesquiteCore,mesquite.diverse.ContCharSpeciation,0,0,0,0,0,0,0,0
MesquiteProject_MesquiteCore,mesquite.diverse.DivCategCharMLCalculator,0,0,0,0,0,0,0,0
MesquiteProject_MesquiteCore,mesquite.diverse.DiversCategCharLikelihood,0,0,0,0,0,0,0,0
MesquiteProject_MesquiteCore,mesquite.diverse.EvolveTreesDiversChars,0,0,0,0,0,0,0,0
MesquiteProject_MesquiteCore,mesquite.diverse.lib,0,0,0,0,1,0,0,1
MesquiteProject_MesquiteCore,mesquite.diverse.LineagesThroughTime,0,0,0,0,0,0,0,0
MesquiteProject_MesquiteCore,mesquite.diverse.SisterDiversification,0,0,0,0,0,0,0,0
MesquiteProject_MesquiteCore,mesquite.diverse.SpecExtincLikelihood,0,0,0,0,0,0,0,0
MesquiteProject_MesquiteCore,mesquite.diverse.SpecExtincMLCalculator,0,1,0,0,0,0,0,1
MesquiteProject_MesquiteCore,mesquite.dmanager.aDmanagerIntro,0,0,0,0,0,0,0,0
MesquiteProject_MesquiteCore,mesquite.dmanager.FuseTaxaMatrices,0,0,0,0,0,0,0,0
MesquiteProject_MesquiteCore,mesquite.dmanager.FuseTMSequences,0,0,0,0,0,0,0,0
MesquiteProject_MesquiteCore,mesquite.dmanager.InterchTaxonPrefixSuffix,0,0,0,0,0,0,0,0
MesquiteProject_MesquiteCore,mesquite.dmanager.KeepTaxonPrefixSuffix,0,0,0,0,0,0,0,0
MesquiteProject_MesquiteCore,mesquite.dmanager.lib,0,0,0,0,0,0,0,0
MesquiteProject_MesquiteCore,mesquite.dmanager.ProcessDataFiles,0,0,0,0,0,0,0,0
MesquiteProject_MesquiteCore,mesquite.dmanager.ProcessFile,0,0,0,0,0,0,0,0
MesquiteProject_MesquiteCore,mesquite.dmanager.RandomizeTaxonOrder,0,0,0,0,0,0,0,0
MesquiteProject_MesquiteCore,mesquite.dmanager.RemoveTaxonPrefixSuffix,0,0,0,0,0,0,0,0
MesquiteProject_MesquiteCore,mesquite.dmanager.TaxaListImportSource,0,0,0,0,0,0,0,0
MesquiteProject_MesquiteCore,mesquite.dmanager.TaxonNamesFileProcessor,0,0,0,0,0,0,0,0
MesquiteProject_MesquiteCore,mesquite.externalCommunication.lib,0,0,0,0,0,0,0,0
MesquiteProject_MesquiteCore,mesquite.genesis.aGenesisIntro,0,0,0,0,0,0,0,0
MesquiteProject_MesquiteCore,mesquite.genesis.CodePosRatesCurator,0,0,0,0,0,0,0,0
MesquiteProject_MesquiteCore,mesquite.genesis.EvolveDNAChars,0,0,0,0,0,0,0,0
MesquiteProject_MesquiteCore,mesquite.genesis.GammaCurator,0,0,0,0,0,0,0,0
MesquiteProject_MesquiteCore,mesquite.genesis.GammaInvarCurator,0,0,0,0,0,0,0,0
MesquiteProject_MesquiteCore,mesquite.genesis.InitDNASubmodels,0,0,0,0,0,0,0,0
MesquiteProject_MesquiteCore,mesquite.genesis.InvarCurator,0,0,0,0,0,0,0,0
MesquiteProject_MesquiteCore,mesquite.genesis.lib,0,0,0,1,0,0,0,1
MesquiteProject_MesquiteCore,mesquite.genesis.RateMatrixGTRCurator,0,0,0,0,0,0,0,0
MesquiteProject_MesquiteCore,mesquite.genesis.RateMatrixTiTvCurator,0,0,0,0,0,0,0,0
MesquiteProject_MesquiteCore,mesquite.genesis.SimDNAModelCurator,0,0,0,0,0,0,0,0
MesquiteProject_MesquiteCore,mesquite.genesis.StateFreqDNAEmpCurator,0,0,0,0,0,0,0,0
MesquiteProject_MesquiteCore,mesquite.genesis.StateFreqUserDNACurator,0,0,0,0,0,0,0,0
MesquiteProject_MesquiteCore,mesquite.io.aIOIntro,0,0,0,0,0,0,0,0
MesquiteProject_MesquiteCore,mesquite.io.ExportCharStateInfo,0,0,0,0,0,0,0,0
MesquiteProject_MesquiteCore,mesquite.io.ExportDescriptions,0,0,0,0,0,0,0,0
MesquiteProject_MesquiteCore,mesquite.io.ExportFusedMatrixNEXUS,0,0,0,0,0,0,0,0
MesquiteProject_MesquiteCore,mesquite.io.ExportFusedPhylip,0,0,0,0,0,0,0,0
MesquiteProject_MesquiteCore,mesquite.io.ExportNEXUSTreeFile,0,0,0,0,0,0,0,0
MesquiteProject_MesquiteCore,mesquite.io.ExportPartitionFinderDNA,0,0,0,0,0,0,0,0
MesquiteProject_MesquiteCore,mesquite.io.ExportPartitionFinderProtein,0,0,0,0,0,0,0,0
MesquiteProject_MesquiteCore,mesquite.io.ExportTreeSourceToNEXUS,0,0,0,0,0,0,0,0
MesquiteProject_MesquiteCore,mesquite.io.InterpretClustalDNA,0,0,0,0,0,0,0,0
MesquiteProject_MesquiteCore,mesquite.io.InterpretClustalProtein,0,0,0,0,0,0,0,0
MesquiteProject_MesquiteCore,mesquite.io.InterpretFastaDNA,0,0,0,0,0,0,0,0
MesquiteProject_MesquiteCore,mesquite.io.InterpretFastaProtein,0,0,0,0,0,0,0,0
MesquiteProject_MesquiteCore,mesquite.io.InterpretGenBankDNA,0,0,0,0,0,0,0,0
MesquiteProject_MesquiteCore,mesquite.io.InterpretGenBankProt,0,0,0,0,0,0,0,0
MesquiteProject_MesquiteCore,mesquite.io.InterpretMrBayesConTreeFile,0,0,0,0,0,0,0,0
MesquiteProject_MesquiteCore,mesquite.io.InterpretNBRFDNA,0,0,0,0,0,0,0,0
MesquiteProject_MesquiteCore,mesquite.io.InterpretNBRFProtein,0,0,0,0,0,0,0,0
MesquiteProject_MesquiteCore,mesquite.io.InterpretNonaHennig,0,0,0,0,0,0,0,0
MesquiteProject_MesquiteCore,mesquite.io.InterpretPhylipCat,0,0,0,0,0,0,0,0
MesquiteProject_MesquiteCore,mesquite.io.InterpretPhylipDNA,0,0,0,0,0,0,0,0
MesquiteProject_MesquiteCore,mesquite.io.InterpretPhylipProtein,0,0,0,0,0,0,0,0
MesquiteProject_MesquiteCore,mesquite.io.InterpretPhylipTreesBasic,0,0,0,0,0,0,0,0
MesquiteProject_MesquiteCore,mesquite.io.InterpretPOYDNA,0,0,0,0,0,0,0,0
MesquiteProject_MesquiteCore,mesquite.io.InterpretSimpleCat,0,0,0,0,0,0,0,0
MesquiteProject_MesquiteCore,mesquite.io.InterpretSimpleCont,0,0,0,0,0,0,0,0
MesquiteProject_MesquiteCore,mesquite.io.InterpretSimpleDNA,0,0,0,0,0,0,0,0
MesquiteProject_MesquiteCore,mesquite.io.InterpretSimpleGeog,0,0,0,0,0,0,0,0
MesquiteProject_MesquiteCore,mesquite.io.InterpretSimpleProtein,0,0,0,0,0,0,0,0
MesquiteProject_MesquiteCore,mesquite.io.InterpretTabbedCat,0,0,0,0,0,0,0,0
MesquiteProject_MesquiteCore,mesquite.io.InterpretTabbedConts,0,0,0,0,0,0,0,0
MesquiteProject_MesquiteCore,mesquite.io.InterpretTNT,0,0,0,0,0,0,0,0
MesquiteProject_MesquiteCore,mesquite.io.lib,0,0,0,0,1,0,0,1
MesquiteProject_MesquiteCore,mesquite.io.xExportConservativeNexus,0,0,0,0,0,0,0,0
MesquiteProject_MesquiteCore,mesquite.io.xExportPartitionsNEXUS,0,0,0,0,0,0,0,0
MesquiteProject_MesquiteCore,mesquite.io.xExportSimpleNexus,0,0,0,0,0,0,0,0
MesquiteProject_MesquiteCore,mesquite.iText.aiTextIntro,0,0,0,0,0,0,0,0
MesquiteProject_MesquiteCore,mesquite.jama.aJamaIntro,0,0,0,0,0,0,0,0
MesquiteProject_MesquiteCore,mesquite.jsci.aJSciIntro,0,0,0,0,0,0,0,0
MesquiteProject_MesquiteCore,mesquite.lib,17,1,0,2,0,0,0,20
MesquiteProject_MesquiteCore,mesquite.lib.characters,6,1,0,1,1,0,0,9
MesquiteProject_MesquiteCore,mesquite.lib.duties,5,0,0,1,1,0,0,7
MesquiteProject_MesquiteCore,mesquite.lib.simplicity,0,0,0,0,0,0,0,0
MesquiteProject_MesquiteCore,mesquite.lib.system,0,0,0,0,0,0,0,0
MesquiteProject_MesquiteCore,mesquite.lib.table,1,0,0,0,0,0,0,1
MesquiteProject_MesquiteCore,mesquite.lists.aListsIntro,0,0,0,0,0,0,0,0
MesquiteProject_MesquiteCore,mesquite.lists.BooleanForCharList,0,0,0,0,0,0,0,0
MesquiteProject_MesquiteCore,mesquite.lists.BooleanForTaxaList,0,0,0,0,0,0,0,0
MesquiteProject_MesquiteCore,mesquite.lists.BooleanForTreeList,0,0,0,0,0,0,0,0
MesquiteProject_MesquiteCore,mesquite.lists.CharacterList,0,0,0,0,0,0,0,0
MesquiteProject_MesquiteCore,mesquite.lists.CharacterStats,0,0,0,0,0,0,0,0
MesquiteProject_MesquiteCore,mesquite.lists.CharGroupList,0,0,0,0,0,0,0,0
MesquiteProject_MesquiteCore,mesquite.lists.CharGroupListColor,0,0,0,0,0,0,0,0
MesquiteProject_MesquiteCore,mesquite.lists.CharInclSetList,0,0,0,0,0,0,0,0
MesquiteProject_MesquiteCore,mesquite.lists.CharInclSetListNum,0,0,0,0,0,0,0,0
MesquiteProject_MesquiteCore,mesquite.lists.CharListAnnotPanel,0,0,0,0,0,0,0,0
MesquiteProject_MesquiteCore,mesquite.lists.CharListCodonPos,0,0,0,0,0,0,0,0
MesquiteProject_MesquiteCore,mesquite.lists.CharListInclusion,0,0,0,0,0,0,0,0
MesquiteProject_MesquiteCore,mesquite.lists.CharListPartition,0,0,0,0,0,0,0,0
MesquiteProject_MesquiteCore,mesquite.lists.CharListUniqueID,0,0,0,0,0,0,0,0
MesquiteProject_MesquiteCore,mesquite.lists.CharListWeights,0,0,0,0,0,0,0,0
MesquiteProject_MesquiteCore,mesquite.lists.CharNumForList,0,0,0,0,0,0,0,0
MesquiteProject_MesquiteCore,mesquite.lists.CharPartitionList,0,0,0,0,0,0,0,0
MesquiteProject_MesquiteCore,mesquite.lists.CharSetList,0,0,0,0,0,0,0,0
MesquiteProject_MesquiteCore,mesquite.lists.CharSetListNum,0,0,0,0,0,0,0,0
MesquiteProject_MesquiteCore,mesquite.lists.CharSetMembershipListAsst,0,0,0,0,0,0,0,0
MesquiteProject_MesquiteCore,mesquite.lists.CodePosSetsList,0,0,0,0,0,0,0,0
MesquiteProject_MesquiteCore,mesquite.lists.ColorTaxon,0,0,0,0,0,0,0,0
MesquiteProject_MesquiteCore,mesquite.lists.DatasetList,0,0,0,0,0,0,0,0
MesquiteProject_MesquiteCore,mesquite.lists.DatasetsListClass,0,0,0,0,0,0,0,0
MesquiteProject_MesquiteCore,mesquite.lists.DatasetsListConcatenate,0,0,0,0,0,0,0,0
MesquiteProject_MesquiteCore,mesquite.lists.DatasetsListDuplicate,0,0,0,0,0,0,0,0
MesquiteProject_MesquiteCore,mesquite.lists.DatasetsListNumChars,0,0,0,0,0,0,0,0
MesquiteProject_MesquiteCore,mesquite.lists.DatasetsListTaxa,0,0,0,0,0,0,0,0
MesquiteProject_MesquiteCore,mesquite.lists.DefaultCharOrder,0,0,0,0,0,0,0,0
MesquiteProject_MesquiteCore,mesquite.lists.DefaultTaxaOrder,0,0,0,0,0,0,0,0
MesquiteProject_MesquiteCore,mesquite.lists.lib,4,0,0,1,1,0,0,6
MesquiteProject_MesquiteCore,mesquite.lists.MarkTaxonInList,0,0,0,0,0,0,0,0
MesquiteProject_MesquiteCore,mesquite.lists.MatrixListEditable,0,0,0,0,0,0,0,0
MesquiteProject_MesquiteCore,mesquite.lists.MatrixListVisible,0,0,0,0,0,0,0,0
MesquiteProject_MesquiteCore,mesquite.lists.ModelsList,0,0,0,0,0,0,0,0
MesquiteProject_MesquiteCore,mesquite.lists.ModelsListDatatype,0,0,0,0,0,0,0,0
MesquiteProject_MesquiteCore,mesquite.lists.ModelsListParadigm,0,0,0,0,0,0,0,0
MesquiteProject_MesquiteCore,mesquite.lists.ModelsListType,0,0,0,0,0,0,0,0
MesquiteProject_MesquiteCore,mesquite.lists.ModelsListWhole,0,0,0,0,0,0,0,0
MesquiteProject_MesquiteCore,mesquite.lists.NexusBlockList,0,0,0,0,0,0,0,0
MesquiteProject_MesquiteCore,mesquite.lists.NumForCharMatrixList,0,0,0,0,0,0,0,0
MesquiteProject_MesquiteCore,mesquite.lists.NumForTaxaList,0,0,0,0,0,0,0,0
MesquiteProject_MesquiteCore,mesquite.lists.NumForTreeblockList,0,0,0,0,0,0,0,0
MesquiteProject_MesquiteCore,mesquite.lists.NumForTreeList,0,0,0,0,0,0,0,0
MesquiteProject_MesquiteCore,mesquite.lists.TaxablockList,0,0,0,0,0,0,0,0
MesquiteProject_MesquiteCore,mesquite.lists.TaxablockListNumber,0,0,0,0,0,0,0,0
MesquiteProject_MesquiteCore,mesquite.lists.TaxaListUniqueID,0,0,0,0,0,0,0,0
MesquiteProject_MesquiteCore,mesquite.lists.TaxaPartitionList,0,0,0,0,0,0,0,0
MesquiteProject_MesquiteCore,mesquite.lists.TaxaPartListNumGroups,0,0,0,0,0,0,0,0
MesquiteProject_MesquiteCore,mesquite.lists.TaxaSetListNum,0,0,0,0,0,0,0,0
MesquiteProject_MesquiteCore,mesquite.lists.TaxonGroupList,0,0,0,0,0,0,0,0
MesquiteProject_MesquiteCore,mesquite.lists.TaxonGroupListColor,0,0,0,0,0,0,0,0
MesquiteProject_MesquiteCore,mesquite.lists.TaxonGroupListNumTaxa,0,0,0,0,0,0,0,0
MesquiteProject_MesquiteCore,mesquite.lists.TaxonGroupListSymbol,0,0,0,0,0,0,0,0
MesquiteProject_MesquiteCore,mesquite.lists.TaxonGroupListSymbolSize,0,0,0,0,0,0,0,0
MesquiteProject_MesquiteCore,mesquite.lists.TaxonGroupListVisibility,0,0,0,0,0,0,0,0
MesquiteProject_MesquiteCore,mesquite.lists.TaxonList,0,0,0,0,0,0,0,0
MesquiteProject_MesquiteCore,mesquite.lists.TaxonListAnnotPanel,0,0,0,0,0,0,0,0
MesquiteProject_MesquiteCore,mesquite.lists.TaxonListArchivedName,0,0,0,0,0,0,0,0
MesquiteProject_MesquiteCore,mesquite.lists.TaxonListCurrPartition,0,0,0,0,0,0,0,0
MesquiteProject_MesquiteCore,mesquite.lists.TaxonListShowAllHasData,0,0,0,0,0,0,0,0
MesquiteProject_MesquiteCore,mesquite.lists.TaxonListVoucherCode,0,0,0,0,0,0,0,0
MesquiteProject_MesquiteCore,mesquite.lists.TaxonListVoucherDB,0,0,0,0,0,0,0,0
MesquiteProject_MesquiteCore,mesquite.lists.TaxonSetList,0,0,0,0,0,0,0,0
MesquiteProject_MesquiteCore,mesquite.lists.TreeblockList,0,0,0,0,0,0,0,0
MesquiteProject_MesquiteCore,mesquite.lists.TreeblocksListNumber,0,0,0,0,0,0,0,0
MesquiteProject_MesquiteCore,mesquite.lists.TreeblocksListTaxa,0,0,0,0,0,0,0,0
MesquiteProject_MesquiteCore,mesquite.lists.TreeListAttachment,0,0,0,0,0,0,0,0
MesquiteProject_MesquiteCore,mesquite.lists.TreeListPolyAssumption,0,0,0,0,0,0,0,0
MesquiteProject_MesquiteCore,mesquite.lists.TreeListPolys,0,0,0,0,0,0,0,0
MesquiteProject_MesquiteCore,mesquite.lists.TreeListRooted,0,0,0,0,0,0,0,0
MesquiteProject_MesquiteCore,mesquite.lists.TreesList,0,0,0,0,0,0,0,0
MesquiteProject_MesquiteCore,mesquite.lists.WeightSetList,0,0,0,0,0,0,0,0
MesquiteProject_MesquiteCore,mesquite.mb.aMBIntro,0,0,0,0,0,0,0,0
MesquiteProject_MesquiteCore,mesquite.mb.BestBayesTree,0,0,0,0,0,0,0,0
MesquiteProject_MesquiteCore,mesquite.mb.ExportForMrBayes,0,0,0,0,0,0,0,0
MesquiteProject_MesquiteCore,mesquite.mb.lib,0,0,0,0,0,0,0,0
MesquiteProject_MesquiteCore,mesquite.mb.MrBayesScore,0,0,0,0,0,0,0,0
MesquiteProject_MesquiteCore,mesquite.mb.SimplifyTaxonNames,0,0,0,0,0,0,0,0
MesquiteProject_MesquiteCore,mesquite.mb.TreesFromMrBayes,0,0,0,0,0,0,0,0
MesquiteProject_MesquiteCore,mesquite.meristic.aMeristicIntro,0,0,0,0,0,0,0,0
MesquiteProject_MesquiteCore,mesquite.meristic.InitMeristicParsimony,0,0,0,0,0,0,0,0
MesquiteProject_MesquiteCore,mesquite.meristic.lib,0,0,0,0,1,0,0,1
MesquiteProject_MesquiteCore,mesquite.meristic.ManageMeristicChars,0,0,0,0,0,0,0,0
MesquiteProject_MesquiteCore,mesquite.meristic.MerItemsEditInfo,0,0,0,0,0,0,0,0
MesquiteProject_MesquiteCore,mesquite.meristic.ParsimonyMeristicLinear,0,0,0,0,0,0,0,0
MesquiteProject_MesquiteCore,mesquite.meristic.RandomFillMeristic,0,0,0,0,0,0,0,0
MesquiteProject_MesquiteCore,mesquite,2,1,0,0,0,0,0,3
MesquiteProject_MesquiteCore,mesquite.minimal.BasicFileCoordinator,2,0,0,0,0,0,0,2
MesquiteProject_MesquiteCore,mesquite.minimal.Defaults,0,0,0,0,0,0,0,0
MesquiteProject_MesquiteCore,mesquite.minimal.DrawHierarchy,0,0,0,0,0,0,0,0
MesquiteProject_MesquiteCore,mesquite.minimal.IDsDefaults,0,0,0,0,0,0,0,0
MesquiteProject_MesquiteCore,mesquite.minimal.Installer,0,0,0,0,0,0,0,0
MesquiteProject_MesquiteCore,mesquite.minimal.InterpretNEXUS,0,0,0,0,0,0,0,0
MesquiteProject_MesquiteCore,mesquite.minimal.ManageForeignBlocks,0,0,0,0,0,0,0,0
MesquiteProject_MesquiteCore,mesquite.minimal.ManageMesquiteBlock,0,0,0,0,0,0,0,0
MesquiteProject_MesquiteCore,mesquite.minimal.ManageTaxa,0,0,0,0,0,0,0,0
MesquiteProject_MesquiteCore,mesquite.minimal.NEXUSDefaults,0,0,0,0,0,0,0,0
MesquiteProject_MesquiteCore,mesquite.minimal.OpenSpecialNEXUS,0,0,0,0,0,0,0,0
MesquiteProject_MesquiteCore,mesquite.minimal.OpenURL,0,0,0,0,0,0,0,0
MesquiteProject_MesquiteCore,mesquite.minimal.ShowEmployeeTree,0,0,0,0,0,0,0,0
MesquiteProject_MesquiteCore,mesquite.minimal.Simplicity,0,0,0,0,0,0,0,0
MesquiteProject_MesquiteCore,mesquite.minimal.StoredTaxa,0,0,0,0,0,0,0,0
MesquiteProject_MesquiteCore,mesquite.minimal.Utilities,0,0,0,0,0,0,0,0
MesquiteProject_MesquiteCore,mesquite.minimal.WindowBabysitter,0,0,0,0,0,0,0,0
MesquiteProject_MesquiteCore,mesquite.molec.AAHydrophobicity,0,0,0,0,0,0,0,0
MesquiteProject_MesquiteCore,mesquite.molec.AASize,0,0,0,0,0,0,0,0
MesquiteProject_MesquiteCore,mesquite.molec.AminoAcidProperties,0,0,0,0,0,0,0,0
MesquiteProject_MesquiteCore,mesquite.molec.aMolecIntro,0,0,0,0,0,0,0,0
MesquiteProject_MesquiteCore,mesquite.molec.AssignGeneticCode,0,0,0,0,0,0,0,0
MesquiteProject_MesquiteCore,mesquite.molec.AvgSequenceLengthMatrix,0,0,0,0,0,0,0,0
MesquiteProject_MesquiteCore,mesquite.molec.BLASTSearch,0,0,0,0,0,0,0,0
MesquiteProject_MesquiteCore,mesquite.molec.CGBiasOfTaxon,0,0,0,0,0,0,0,0
MesquiteProject_MesquiteCore,mesquite.molec.CharacterGCBias,0,0,0,0,0,0,0,0
MesquiteProject_MesquiteCore,mesquite.molec.CharListGenCodeModels,0,0,0,0,0,0,0,0
MesquiteProject_MesquiteCore,mesquite.molec.CleanUpMatrix,0,0,0,0,0,0,0,0
MesquiteProject_MesquiteCore,mesquite.molec.CodesetList,0,0,0,0,0,0,0,0
MesquiteProject_MesquiteCore,mesquite.molec.CollapseEdges,0,0,0,0,0,0,0,0
MesquiteProject_MesquiteCore,mesquite.molec.ColorByAA,0,0,0,0,0,0,0,0
MesquiteProject_MesquiteCore,mesquite.molec.ColorByNumber,0,0,0,0,0,0,0,0
MesquiteProject_MesquiteCore,mesquite.molec.ColorOddAAs,0,0,0,0,0,0,0,0
MesquiteProject_MesquiteCore,mesquite.molec.ColorTaxonByNumber,0,0,0,0,0,0,0,0
MesquiteProject_MesquiteCore,mesquite.molec.ColorTaxonByNumDataInMatrices,0,0,0,0,0,0,0,0
MesquiteProject_MesquiteCore,mesquite.molec.CompareBasesWithTaxon,0,0,0,0,0,0,0,0
MesquiteProject_MesquiteCore,mesquite.molec.ConvertToRY,0,0,0,0,0,0,0,0
MesquiteProject_MesquiteCore,mesquite.molec.CurrentGenCodeModels,0,0,0,0,0,0,0,0
MesquiteProject_MesquiteCore,mesquite.molec.FetchAndAddGenBank,0,0,0,0,0,0,0,0
MesquiteProject_MesquiteCore,mesquite.molec.FillCharSelection,0,0,0,0,0,0,0,0
MesquiteProject_MesquiteCore,mesquite.molec.FindMissing,0,0,0,0,0,0,0,0
MesquiteProject_MesquiteCore,mesquite.molec.FindPartialTriplet,0,0,0,0,0,0,0,0
MesquiteProject_MesquiteCore,mesquite.molec.FindSequence,0,0,0,0,0,0,0,0
MesquiteProject_MesquiteCore,mesquite.molec.GapsToFromMissing,0,0,0,0,0,0,0,0
MesquiteProject_MesquiteCore,mesquite.molec.GapsToMissing,0,0,0,0,0,0,0,0
MesquiteProject_MesquiteCore,mesquite.molec.GBLOCKSSelector,0,0,0,0,0,0,0,0
MesquiteProject_MesquiteCore,mesquite.molec.GCAsNumber,0,0,0,0,0,0,0,0
MesquiteProject_MesquiteCore,mesquite.molec.GenBankNumber,0,0,0,0,0,0,0,0
MesquiteProject_MesquiteCore,mesquite.molec.InitializeGenCode,0,0,0,0,0,0,0,0
MesquiteProject_MesquiteCore,mesquite.molec.lib,0,0,0,1,1,0,0,2
MesquiteProject_MesquiteCore,mesquite.molec.LocalBlaster,0,0,0,0,0,0,0,0
MesquiteProject_MesquiteCore,mesquite.molec.LowercaseEnds,0,0,0,0,0,0,0,0
MesquiteProject_MesquiteCore,mesquite.molec.MaintainClipMatch,0,0,0,0,0,0,0,0
MesquiteProject_MesquiteCore,mesquite.molec.ManageCodeSets,0,0,0,0,0,0,0,0
MesquiteProject_MesquiteCore,mesquite.molec.MatchingSequence,0,0,0,0,0,0,0,0
MesquiteProject_MesquiteCore,mesquite.molec.MeanValueLinked,0,0,0,0,0,0,0,0
MesquiteProject_MesquiteCore,mesquite.molec.MissingToGaps,0,0,0,0,0,0,0,0
MesquiteProject_MesquiteCore,mesquite.molec.MultipleAlignService,0,0,0,0,0,0,0,0
MesquiteProject_MesquiteCore,mesquite.molec.NCBIBlaster,0,0,0,0,0,0,0,0
MesquiteProject_MesquiteCore,mesquite.molec.NucleotideComplement,0,0,0,0,0,0,0,0
MesquiteProject_MesquiteCore,mesquite.molec.NumberPolyInTaxon,0,0,0,0,0,0,0,0
MesquiteProject_MesquiteCore,mesquite.molec.NumberStopsInTaxon,0,0,0,0,0,0,0,0
MesquiteProject_MesquiteCore,mesquite.molec.NumInternalGapsMatrix,0,0,0,0,0,0,0,0
MesquiteProject_MesquiteCore,mesquite.molec.NumLowerCase,0,0,0,0,0,0,0,0
MesquiteProject_MesquiteCore,mesquite.molec.NumStopCodonsMatrix,0,0,0,0,0,0,0,0
MesquiteProject_MesquiteCore,mesquite.molec.PercentGapsInTaxon,0,0,0,0,0,0,0,0
MesquiteProject_MesquiteCore,mesquite.molec.PercentLowerCase,0,0,0,0,0,0,0,0
MesquiteProject_MesquiteCore,mesquite.molec.PercentMissingInTaxon,0,0,0,0,0,0,0,0
MesquiteProject_MesquiteCore,mesquite.molec.PercentPolymorphic,0,0,0,0,0,0,0,0
MesquiteProject_MesquiteCore,mesquite.molec.PropAmbiguousInTaxon,0,0,0,0,0,0,0,0
MesquiteProject_MesquiteCore,mesquite.molec.PropInternalGaps,0,0,0,0,0,0,0,0
MesquiteProject_MesquiteCore,mesquite.molec.PropTerminalGaps,0,0,0,0,0,0,0,0
MesquiteProject_MesquiteCore,mesquite.molec.PropUnambigSites,0,0,0,0,0,0,0,0
MesquiteProject_MesquiteCore,mesquite.molec.PublicationCode,0,0,0,0,0,0,0,0
MesquiteProject_MesquiteCore,mesquite.molec.ReverseComplement,0,0,0,0,0,0,0,0
MesquiteProject_MesquiteCore,mesquite.molec.ReverseSequence,0,0,0,0,0,0,0,0
MesquiteProject_MesquiteCore,mesquite.molec.SequenceInfoEditor,0,0,0,0,0,0,0,0
MesquiteProject_MesquiteCore,mesquite.molec.SequenceLength,0,0,0,0,0,0,0,0
MesquiteProject_MesquiteCore,mesquite.molec.SiteProperty,0,0,0,0,0,0,0,0
MesquiteProject_MesquiteCore,mesquite.molec.StoredGenCodeModel,0,0,0,0,0,0,0,0
MesquiteProject_MesquiteCore,mesquite.molec.TargetSeqMatch,0,0,0,0,0,0,0,0
MesquiteProject_MesquiteCore,mesquite.molec.TaxaListHasData,0,0,0,0,0,0,0,0
MesquiteProject_MesquiteCore,mesquite.molec.TaxonGCBias,0,0,0,0,0,0,0,0
MesquiteProject_MesquiteCore,mesquite.molec.TermGapsToMissing,0,0,0,0,0,0,0,0
MesquiteProject_MesquiteCore,mesquite.molec.TermMissingToGaps,0,0,0,0,0,0,0,0
MesquiteProject_MesquiteCore,mesquite.molec.ToLowerCase,0,0,0,0,0,0,0,0
MesquiteProject_MesquiteCore,mesquite.molec.TopBlastMatches,0,0,0,0,0,0,0,0
MesquiteProject_MesquiteCore,mesquite.molec.ToUpperCase,0,0,0,0,0,0,0,0
MesquiteProject_MesquiteCore,mesquite.molec.TranslateToProtein,0,0,0,0,0,0,0,0
MesquiteProject_MesquiteCore,mesquite.molec.TrimTermPartTriplets,0,0,0,0,0,0,0,0
MesquiteProject_MesquiteCore,mesquite.opentree.CopyNewickForOpenTree,0,0,0,0,0,0,0,0
MesquiteProject_MesquiteCore,mesquite.opentree.ExemplarTaxonAssistant,0,0,0,0,0,0,0,0
MesquiteProject_MesquiteCore,mesquite.opentree.ExportTreeForOpenTree,0,0,0,0,0,0,0,0
MesquiteProject_MesquiteCore,mesquite.opentree.lib,0,0,0,0,0,0,0,0
MesquiteProject_MesquiteCore,mesquite.opentree.OpenTreeLabeller,0,0,0,0,0,0,0,0
MesquiteProject_MesquiteCore,mesquite.ornamental.aOrnamentalIntro,0,0,0,0,0,0,0,0
MesquiteProject_MesquiteCore,mesquite.ornamental.BranchNotes,0,0,0,0,0,0,0,0
MesquiteProject_MesquiteCore,mesquite.ornamental.CircularTree,0,0,0,0,0,0,0,0
MesquiteProject_MesquiteCore,mesquite.ornamental.ColorTreeByPartition,0,0,0,0,0,0,0,0
MesquiteProject_MesquiteCore,mesquite.ornamental.Constellation,0,0,0,0,0,0,0,0
MesquiteProject_MesquiteCore,mesquite.ornamental.DrawTreeAssocDoubles,0,0,0,0,0,0,0,0
MesquiteProject_MesquiteCore,mesquite.ornamental.DrawTreeAssocStrings,0,0,0,0,0,0,0,0
MesquiteProject_MesquiteCore,mesquite.ornamental.ManageAttachedNotes,0,0,0,0,0,0,0,0
MesquiteProject_MesquiteCore,mesquite.ornamental.ManageHyperlinks,0,0,0,0,0,0,0,0
MesquiteProject_MesquiteCore,mesquite.ornamental.ManagePictures,0,0,0,0,0,0,0,0
MesquiteProject_MesquiteCore,mesquite.ornamental.NodeLocsCircular,0,0,0,0,0,0,0,0
MesquiteProject_MesquiteCore,mesquite.ornamental.NodeLocsOval,0,0,0,0,0,0,0,0
MesquiteProject_MesquiteCore,mesquite.ornamental.NodeLocsUnrootedBasic,0,0,0,0,0,0,0,0
MesquiteProject_MesquiteCore,mesquite.ornamental.NodeNumbers,0,0,0,0,0,0,0,0
MesquiteProject_MesquiteCore,mesquite.ornamental.NodePositionAdjust,0,0,0,0,0,0,0,0
MesquiteProject_MesquiteCore,mesquite.ornamental.PictureWindowMaker,0,0,0,0,0,0,0,0
MesquiteProject_MesquiteCore,mesquite.ornamental.Projector,0,0,0,0,0,0,0,0
MesquiteProject_MesquiteCore,mesquite.ornamental.TaxonLink,0,0,0,0,0,0,0,0
MesquiteProject_MesquiteCore,mesquite.ornamental.UnrootedTree,0,0,0,0,0,0,0,0
MesquiteProject_MesquiteCore,mesquite.pairwise.aPairwiseIntro,0,0,0,0,0,0,0,0
MesquiteProject_MesquiteCore,mesquite.pairwise.lib,0,0,0,0,1,0,0,1
MesquiteProject_MesquiteCore,mesquite.pairwise.PairsNoChars,0,0,0,0,0,0,0,0
MesquiteProject_MesquiteCore,mesquite.pairwise.PairsOneChar,0,0,0,0,0,0,0,0
MesquiteProject_MesquiteCore,mesquite.pairwise.PairsTwoChars,0,0,0,0,0,0,0,0
MesquiteProject_MesquiteCore,mesquite.pairwise.PairwiseComparison,0,0,0,0,0,0,0,0
MesquiteProject_MesquiteCore,mesquite.pal.aPALIntro,0,0,0,0,0,0,0,0
MesquiteProject_MesquiteCore,mesquite.parsimony.aParsimonyIntro,0,0,0,0,0,0,0,0
MesquiteProject_MesquiteCore,mesquite.parsimony.CharListParsModels,0,0,0,0,0,0,0,0
MesquiteProject_MesquiteCore,mesquite.parsimony.CharStepsDifference,0,0,0,0,0,0,0,0
MesquiteProject_MesquiteCore,mesquite.parsimony.ConsistIndexChar,0,0,0,0,0,0,0,0
MesquiteProject_MesquiteCore,mesquite.parsimony.ConsistIndexMatrix,0,0,0,0,0,0,0,0
MesquiteProject_MesquiteCore,mesquite.parsimony.CurrentParsModels,0,0,0,0,0,0,0,0
MesquiteProject_MesquiteCore,mesquite.parsimony.InitCategParsimony,0,0,0,0,0,0,0,0
MesquiteProject_MesquiteCore,mesquite.parsimony.InitContParsimony,0,0,0,0,0,0,0,0
MesquiteProject_MesquiteCore,mesquite.parsimony.InitializeParsimony,0,0,0,0,0,0,0,0
MesquiteProject_MesquiteCore,mesquite.parsimony.lib,0,0,0,0,1,0,0,1
MesquiteProject_MesquiteCore,mesquite.parsimony.ManageTypesets,0,0,0,0,0,0,0,0
MesquiteProject_MesquiteCore,mesquite.parsimony.ParsAncestralStates,0,0,0,0,0,0,0,0
MesquiteProject_MesquiteCore,mesquite.parsimony.ParsCharSteps,0,0,0,0,0,0,0,0
MesquiteProject_MesquiteCore,mesquite.parsimony.ParsimonyCostMatrix,0,0,0,0,0,0,0,0
MesquiteProject_MesquiteCore,mesquite.parsimony.ParsimonyLinear,0,0,0,0,0,0,0,0
MesquiteProject_MesquiteCore,mesquite.parsimony.ParsimonyOrdered,0,0,0,0,0,0,0,0
MesquiteProject_MesquiteCore,mesquite.parsimony.ParsimonySquared,0,0,0,0,0,0,0,0
MesquiteProject_MesquiteCore,mesquite.parsimony.ParsimonyUnordered,0,0,0,0,0,0,0,0
MesquiteProject_MesquiteCore,mesquite.parsimony.RetentionIndexChar,0,0,0,0,0,0,0,0
MesquiteProject_MesquiteCore,mesquite.parsimony.RetentionIndexMatrix,0,0,0,0,0,0,0,0
MesquiteProject_MesquiteCore,mesquite.parsimony.StepMatrixCurator,0,0,0,0,0,0,0,0
MesquiteProject_MesquiteCore,mesquite.parsimony.StepsInCharacter,0,0,0,0,0,0,0,0
MesquiteProject_MesquiteCore,mesquite.parsimony.StoredParsModel,0,0,0,0,0,0,0,0
MesquiteProject_MesquiteCore,mesquite.parsimony.Treelength,0,0,0,0,0,0,0,0
MesquiteProject_MesquiteCore,mesquite.parsimony.TreelengthForMatrix,0,0,0,0,0,0,0,0
MesquiteProject_MesquiteCore,mesquite.parsimony.TypesetList,0,0,0,0,0,0,0,0
MesquiteProject_MesquiteCore,mesquite.rhetenor.aPCA,0,0,0,0,0,0,0,0
MesquiteProject_MesquiteCore,mesquite.rhetenor.aRhetenorIntro,0,0,0,0,0,0,0,0
MesquiteProject_MesquiteCore,mesquite.rhetenor.CanonicalVariates,0,0,0,0,0,0,0,0
MesquiteProject_MesquiteCore,mesquite.rhetenor.CharFromOrdinations,0,0,0,0,0,0,0,0
MesquiteProject_MesquiteCore,mesquite.rhetenor.CharLoadings,0,0,0,0,0,0,0,0
MesquiteProject_MesquiteCore,mesquite.rhetenor.CharsFromMatrices,0,0,0,0,0,0,0,0
MesquiteProject_MesquiteCore,mesquite.rhetenor.EvolutionaryPCA,0,0,0,0,0,0,0,0
MesquiteProject_MesquiteCore,mesquite.rhetenor.LandmarkDrawings,0,0,0,0,0,0,0,0
MesquiteProject_MesquiteCore,mesquite.rhetenor.lib,0,0,0,0,1,0,0,1
MesquiteProject_MesquiteCore,mesquite.rhetenor.MatricesFromOrdinations,0,0,0,0,0,0,0,0
MesquiteProject_MesquiteCore,mesquite.rhetenor.NodeLocs3DPlot,0,0,0,0,0,0,0,0
MesquiteProject_MesquiteCore,mesquite.rhetenor.PlotTree3D,0,0,0,0,0,0,0,0
MesquiteProject_MesquiteCore,mesquite.rhetenor.PrincipalComponents,0,0,0,0,0,0,0,0
MesquiteProject_MesquiteCore,mesquite.rhetenor.ShowCharLoadings,0,0,0,0,0,0,0,0
MesquiteProject_MesquiteCore,mesquite.rhetenor.wPCA,0,0,0,0,0,0,0,0
MesquiteProject_MesquiteCore,mesquite.search.AddAndRearrange,0,0,0,0,0,0,0,0
MesquiteProject_MesquiteCore,mesquite.search.aSearchIntro,0,0,0,0,0,0,0,0
MesquiteProject_MesquiteCore,mesquite.search.DistanceTreeSearch,0,0,0,0,0,0,0,0
MesquiteProject_MesquiteCore,mesquite.search.InvariantsTreeSearch,0,0,0,0,0,0,0,0
MesquiteProject_MesquiteCore,mesquite.search.lib,0,0,0,0,0,0,0,0
MesquiteProject_MesquiteCore,mesquite.search.LikelihoodTreeSearch,0,0,0,0,0,0,0,0
MesquiteProject_MesquiteCore,mesquite.search.NNIRearranger,0,0,0,0,0,0,0,0
MesquiteProject_MesquiteCore,mesquite.search.OldStyleTreeSearch,0,0,0,0,0,0,0,0
MesquiteProject_MesquiteCore,mesquite.search.OtherTreeSearch,0,0,0,0,0,0,0,0
MesquiteProject_MesquiteCore,mesquite.search.ParsimonyTreeSearch,0,0,0,0,0,0,0,0
MesquiteProject_MesquiteCore,mesquite.search.SPRRearranger,0,0,0,0,0,0,0,0
MesquiteProject_MesquiteCore,mesquite.stochchar.aStochCharIntro,0,0,0,0,0,0,0,0
MesquiteProject_MesquiteCore,mesquite.stochchar.AsymmetryLR,0,0,0,0,0,0,0,0
MesquiteProject_MesquiteCore,mesquite.stochchar.AsymmMkExplorer,0,0,0,0,0,0,0,0
MesquiteProject_MesquiteCore,mesquite.stochchar.AsymmModelCurator,0,0,0,0,0,0,0,0
MesquiteProject_MesquiteCore,mesquite.stochchar.Brownian,0,0,0,0,0,0,0,0
MesquiteProject_MesquiteCore,mesquite.stochchar.CharLikelihood,0,0,0,0,0,0,0,0
MesquiteProject_MesquiteCore,mesquite.stochchar.CharListProbModels,0,0,0,0,0,0,0,0
MesquiteProject_MesquiteCore,mesquite.stochchar.CurrentProbModels,0,0,0,0,0,0,0,0
MesquiteProject_MesquiteCore,mesquite.stochchar.CurrentProbModelsSim,0,0,0,0,0,0,0,0
MesquiteProject_MesquiteCore,mesquite.stochchar.EvolveCategChars,0,0,0,0,0,0,0,0
MesquiteProject_MesquiteCore,mesquite.stochchar.EvolveContinuous,0,0,0,0,0,0,0,0
MesquiteProject_MesquiteCore,mesquite.stochchar.GainLossRates,0,0,0,0,0,0,0,0
MesquiteProject_MesquiteCore,mesquite.stochchar.InterpretPagelFormat,0,0,0,0,0,0,0,0
MesquiteProject_MesquiteCore,mesquite.stochchar.InterpretPagelFormatM,0,0,0,0,0,0,0,0
MesquiteProject_MesquiteCore,mesquite.stochchar.lib,0,0,0,0,1,0,0,1
MesquiteProject_MesquiteCore,mesquite.stochchar.LikelihoodInCharacter,0,0,0,0,0,0,0,0
MesquiteProject_MesquiteCore,mesquite.stochchar.ManageCharModelsBlock,0,0,0,0,0,0,0,0
MesquiteProject_MesquiteCore,mesquite.stochchar.ManageProbModelSets,0,0,0,0,0,0,0,0
MesquiteProject_MesquiteCore,mesquite.stochchar.MargProbAncStates,0,0,0,0,0,0,0,0
MesquiteProject_MesquiteCore,mesquite.stochchar.Mk1Rate,0,0,0,0,0,0,0,0
MesquiteProject_MesquiteCore,mesquite.stochchar.MkModelCurator,0,0,0,0,0,0,0,0
MesquiteProject_MesquiteCore,mesquite.stochchar.ProbModelSetList,0,0,0,0,0,0,0,0
MesquiteProject_MesquiteCore,mesquite.stochchar.SimAncestralStates,0,0,0,0,0,0,0,0
MesquiteProject_MesquiteCore,mesquite.stochchar.SimCharsOnTrees,0,0,0,0,0,0,0,0
MesquiteProject_MesquiteCore,mesquite.stochchar.SimMatricesOnTrees,0,0,0,0,0,0,0,0
MesquiteProject_MesquiteCore,mesquite.stochchar.SimulatedCharacters,0,0,0,0,0,0,0,0
MesquiteProject_MesquiteCore,mesquite.stochchar.SimulatedMatrix,0,0,0,0,0,0,0,0
MesquiteProject_MesquiteCore,mesquite.stochchar.StochCharMapper,0,0,0,0,0,0,0,0
MesquiteProject_MesquiteCore,mesquite.stochchar.StoredProbModel,0,0,0,0,0,0,0,0
MesquiteProject_MesquiteCore,mesquite.stochchar.StoredProbModelSim,0,0,0,0,0,0,0,0
MesquiteProject_MesquiteCore,mesquite.stochchar.zMargLikeCateg,0,0,0,0,0,0,0,0
MesquiteProject_MesquiteCore,mesquite.thinkTrees.AlphabeticTaxonNames,0,0,0,0,0,0,0,0
MesquiteProject_MesquiteCore,mesquite.thinkTrees.InformCharBoolean,0,0,0,0,0,0,0,0
MesquiteProject_MesquiteCore,mesquite.thinkTrees.RandomlyRotate,0,0,0,0,0,0,0,0
MesquiteProject_MesquiteCore,mesquite.thinkTrees.RandomRotateToolAssistant,0,0,0,0,0,0,0,0
MesquiteProject_MesquiteCore,mesquite.tol.aTolIntro,0,0,0,0,0,0,0,0
MesquiteProject_MesquiteCore,mesquite.tol.CatalogueOfLifeURLServer,0,0,0,0,0,0,0,0
MesquiteProject_MesquiteCore,mesquite.tol.GenBankTaxonURLServer,0,0,0,0,0,0,0,0
MesquiteProject_MesquiteCore,mesquite.tol.GetToLTree,0,0,0,0,0,0,0,0
MesquiteProject_MesquiteCore,mesquite.tol.GoogleURLServer,0,0,0,0,0,0,0,0
MesquiteProject_MesquiteCore,mesquite.tol.iSpeciesURLServer,0,0,0,0,0,0,0,0
MesquiteProject_MesquiteCore,mesquite.tol.lib,2,0,0,0,1,0,0,3
MesquiteProject_MesquiteCore,mesquite.tol.SearchToLTaxon,0,0,0,0,0,0,0,0
MesquiteProject_MesquiteCore,mesquite.tol.TaxonOnWebDB,0,0,0,0,0,0,0,0
MesquiteProject_MesquiteCore,mesquite.tol.ToLURLServer,0,0,0,0,0,0,0,0
MesquiteProject_MesquiteCore,mesquite.tol.TreeBaseURLServer,0,0,0,0,0,0,0,0
MesquiteProject_MesquiteCore,mesquite.tol.uBioURLServer,0,0,0,0,0,0,0,0
MesquiteProject_MesquiteCore,mesquite.treefarm.AddSelectedTaxaToTree,0,0,0,0,0,0,0,0
MesquiteProject_MesquiteCore,mesquite.treefarm.AllRerootings,0,0,0,0,0,0,0,0
MesquiteProject_MesquiteCore,mesquite.treefarm.AllTrees,0,0,0,0,0,0,0,0
MesquiteProject_MesquiteCore,mesquite.treefarm.aTreeFarmIntro,0,0,0,0,0,0,0,0
MesquiteProject_MesquiteCore,mesquite.treefarm.AugmentTreeRandomly,0,0,0,0,0,0,0,0
MesquiteProject_MesquiteCore,mesquite.treefarm.AverageNodeAssociatedDifference,0,0,0,0,0,0,0,0
MesquiteProject_MesquiteCore,mesquite.treefarm.AvgTaxonValueAmgTrees,0,0,0,0,0,0,0,0
MesquiteProject_MesquiteCore,mesquite.treefarm.BLfromDivergenceTimes,0,0,0,0,0,0,0,0
MesquiteProject_MesquiteCore,mesquite.treefarm.BlockDirectlyFromFile,0,0,0,0,0,0,0,0
MesquiteProject_MesquiteCore,mesquite.treefarm.CladeInTree,0,0,0,0,0,0,0,0
MesquiteProject_MesquiteCore,mesquite.treefarm.CladeMatch,0,0,0,0,0,0,0,0
MesquiteProject_MesquiteCore,mesquite.treefarm.CollessImbalance,0,0,0,0,0,0,0,0
MesquiteProject_MesquiteCore,mesquite.treefarm.CompareOtherTree,0,0,0,0,0,0,0,0
MesquiteProject_MesquiteCore,mesquite.treefarm.CompareOtherTrees,0,0,0,0,0,0,0,0
MesquiteProject_MesquiteCore,mesquite.treefarm.Concat2TreeSources,0,0,0,0,0,0,0,0
MesquiteProject_MesquiteCore,mesquite.treefarm.ConcatMultTreeSources,0,0,0,0,0,0,0,0
MesquiteProject_MesquiteCore,mesquite.treefarm.ConcatTreeBlocks,0,0,0,0,0,0,0,0
MesquiteProject_MesquiteCore,mesquite.treefarm.CondensedTreeSource,0,0,0,0,0,0,0,0
MesquiteProject_MesquiteCore,mesquite.treefarm.ConsensusTreesFromBlocks,0,0,0,0,0,0,0,0
MesquiteProject_MesquiteCore,mesquite.treefarm.ConvexInTree,0,0,0,0,0,0,0,0
MesquiteProject_MesquiteCore,mesquite.treefarm.CopyTreesToNexusBlock,0,0,0,0,0,0,0,0
MesquiteProject_MesquiteCore,mesquite.treefarm.CopyTreesToSimpleFile,0,0,0,0,0,0,0,0
MesquiteProject_MesquiteCore,mesquite.treefarm.Correlation2Trees,0,0,0,0,0,0,0,0
MesquiteProject_MesquiteCore,mesquite.treefarm.CurrentTree,0,0,0,0,0,0,0,0
MesquiteProject_MesquiteCore,mesquite.treefarm.CutSelectedTaxa,0,0,0,0,0,0,0,0
MesquiteProject_MesquiteCore,mesquite.treefarm.DeleteReticulations,0,0,0,0,0,0,0,0
MesquiteProject_MesquiteCore,mesquite.treefarm.DetermModifTree,0,0,0,0,0,0,0,0
MesquiteProject_MesquiteCore,mesquite.treefarm.DuplicateTreeBlocks,0,0,0,0,0,0,0,0
MesquiteProject_MesquiteCore,mesquite.treefarm.EmailTree,0,0,0,0,0,0,0,0
MesquiteProject_MesquiteCore,mesquite.treefarm.ExtractTreeBlock,0,0,0,0,0,0,0,0
MesquiteProject_MesquiteCore,mesquite.treefarm.FAFillTreeBlock,0,0,0,0,0,0,0,0
MesquiteProject_MesquiteCore,mesquite.treefarm.FilterTreesOtherSrc,0,0,0,0,0,0,0,0
MesquiteProject_MesquiteCore,mesquite.treefarm.FractionCladesShared2Trees,0,0,0,0,0,0,0,0
MesquiteProject_MesquiteCore,mesquite.treefarm.GraftTree,0,0,0,0,0,0,0,0
MesquiteProject_MesquiteCore,mesquite.treefarm.lib,0,0,0,0,1,0,0,1
MesquiteProject_MesquiteCore,mesquite.treefarm.MakeRerootings,0,0,0,0,0,0,0,0
MesquiteProject_MesquiteCore,mesquite.treefarm.ModTreesOtherSource,0,0,0,0,0,0,0,0
MesquiteProject_MesquiteCore,mesquite.treefarm.MRPMatrices,0,0,0,0,0,0,0,0
MesquiteProject_MesquiteCore,mesquite.treefarm.NNAssocValues,0,0,0,0,0,0,0,0
MesquiteProject_MesquiteCore,mesquite.treefarm.NodeDepth,0,0,0,0,0,0,0,0
MesquiteProject_MesquiteCore,mesquite.treefarm.NoiseToBranchLengths,0,0,0,0,0,0,0,0
MesquiteProject_MesquiteCore,mesquite.treefarm.NumSPRRearrangements,0,0,0,0,0,0,0,0
MesquiteProject_MesquiteCore,mesquite.treefarm.NumTopologyCongruent,0,0,0,0,0,0,0,0
MesquiteProject_MesquiteCore,mesquite.treefarm.NumTreesMatchingCriterion,0,0,0,0,0,0,0,0
MesquiteProject_MesquiteCore,mesquite.treefarm.OutgroupRoot,0,0,0,0,0,0,0,0
MesquiteProject_MesquiteCore,mesquite.treefarm.ProbRndTreeModifier,0,0,0,0,0,0,0,0
MesquiteProject_MesquiteCore,mesquite.treefarm.RandomBranchMoves,0,0,0,0,0,0,0,0
MesquiteProject_MesquiteCore,mesquite.treefarm.RandomlyModifiedTrees,0,0,0,0,0,0,0,0
MesquiteProject_MesquiteCore,mesquite.treefarm.RandomModifTree,0,0,0,0,0,0,0,0
MesquiteProject_MesquiteCore,mesquite.treefarm.RandomResolve,0,0,0,0,0,0,0,0
MesquiteProject_MesquiteCore,mesquite.treefarm.RarefyTree,0,0,0,0,0,0,0,0
MesquiteProject_MesquiteCore,mesquite.treefarm.RearrangedTree,0,0,0,0,0,0,0,0
MesquiteProject_MesquiteCore,mesquite.treefarm.ReinterpretBranchLabels,0,0,0,0,0,0,0,0
MesquiteProject_MesquiteCore,mesquite.treefarm.RemoveAllBranchLabels,0,0,0,0,0,0,0,0
MesquiteProject_MesquiteCore,mesquite.treefarm.ReshuffleTaxa,0,0,0,0,0,0,0,0
MesquiteProject_MesquiteCore,mesquite.treefarm.SelectTaxaInSameClade,0,0,0,0,0,0,0,0
MesquiteProject_MesquiteCore,mesquite.treefarm.SharedClades2Trees,0,0,0,0,0,0,0,0
MesquiteProject_MesquiteCore,mesquite.treefarm.SharedPartitions2Trees,0,0,0,0,0,0,0,0
MesquiteProject_MesquiteCore,mesquite.treefarm.SortTaxaByTree,0,0,0,0,0,0,0,0
MesquiteProject_MesquiteCore,mesquite.treefarm.SplitFrequencies,0,0,0,0,0,0,0,0
MesquiteProject_MesquiteCore,mesquite.treefarm.TaxonValueFromTree,0,0,0,0,0,0,0,0
MesquiteProject_MesquiteCore,mesquite.treefarm.TerminalInstability,0,0,0,0,0,0,0,0
MesquiteProject_MesquiteCore,mesquite.treefarm.TopologyCongruent,0,0,0,0,0,0,0,0
MesquiteProject_MesquiteCore,mesquite.treefarm.TreeSatisfiesValue,0,0,0,0,0,0,0,0
MesquiteProject_MesquiteCore,mesquite.treefarm.TreeTotalPathLength,0,0,0,0,0,0,0,0
MesquiteProject_MesquiteCore,mesquite.trees.AddTaxaToTree,0,0,0,0,0,0,0,0
MesquiteProject_MesquiteCore,mesquite.trees.AllBranchLengthsOne,0,0,0,0,0,0,0,0
MesquiteProject_MesquiteCore,mesquite.trees.AllUnassignBrLengths1,0,0,0,0,0,0,0,0
MesquiteProject_MesquiteCore,mesquite.trees.AlterLengths,0,0,0,0,0,0,0,0
MesquiteProject_MesquiteCore,mesquite.trees.AlterTrees,0,0,0,0,0,0,0,0
MesquiteProject_MesquiteCore,mesquite.trees.ArcTree,0,0,0,0,0,0,0,0
MesquiteProject_MesquiteCore,mesquite.trees.aTreesIntro,0,0,0,0,0,0,0,0
MesquiteProject_MesquiteCore,mesquite.trees.AverageTreeValue,0,0,0,0,0,0,0,0
MesquiteProject_MesquiteCore,mesquite.trees.BallsNSticks,0,0,0,0,0,0,0,0
MesquiteProject_MesquiteCore,mesquite.trees.BasicDrawTaxonNames,0,0,0,0,0,0,0,0
MesquiteProject_MesquiteCore,mesquite.trees.BasicTreeDrawCoordinator,0,0,0,0,0,0,0,0
MesquiteProject_MesquiteCore,mesquite.trees.BasicTreeWindowCoord,0,0,0,0,0,0,0,0
MesquiteProject_MesquiteCore,mesquite.trees.BasicTreeWindowMaker,0,0,0,0,0,0,0,0
MesquiteProject_MesquiteCore,mesquite.trees.BLFromNodeAgeConstraints,0,0,0,0,0,0,0,0
MesquiteProject_MesquiteCore,mesquite.trees.BooleanTreeValue,0,0,0,0,0,0,0,0
MesquiteProject_MesquiteCore,mesquite.trees.BranchInfo,0,0,0,0,0,0,0,0
MesquiteProject_MesquiteCore,mesquite.trees.BranchLengthFromRoot,0,0,0,0,0,0,0,0
MesquiteProject_MesquiteCore,mesquite.trees.BranchLengthsAdjust,0,0,0,0,0,0,0,0
MesquiteProject_MesquiteCore,mesquite.trees.ClearBranchNames,0,0,0,0,0,0,0,0
MesquiteProject_MesquiteCore,mesquite.trees.CollapseZeroToPolys,0,0,0,0,0,0,0,0
MesquiteProject_MesquiteCore,mesquite.trees.ColorBranches,0,0,0,0,0,0,0,0
MesquiteProject_MesquiteCore,mesquite.trees.ColorTaxonByAssigned,0,0,0,0,0,0,0,0
MesquiteProject_MesquiteCore,mesquite.trees.ColorTaxonByPartition,0,0,0,0,0,0,0,0
MesquiteProject_MesquiteCore,mesquite.trees.ConstrainNodeAge,0,0,0,0,0,0,0,0
MesquiteProject_MesquiteCore,mesquite.trees.DeassignBranchLengths,0,0,0,0,0,0,0,0
MesquiteProject_MesquiteCore,mesquite.trees.DefaultTrees,0,0,0,0,0,0,0,0
MesquiteProject_MesquiteCore,mesquite.trees.DefiniteTreeSource,0,0,0,0,0,0,0,0
MesquiteProject_MesquiteCore,mesquite.trees.DependentTreeWindow,0,0,0,0,0,0,0,0
MesquiteProject_MesquiteCore,mesquite.trees.DiagonalDrawTree,0,0,0,0,0,0,0,0
MesquiteProject_MesquiteCore,mesquite.trees.DifferenceInNumsForTree,0,0,0,0,0,0,0,0
MesquiteProject_MesquiteCore,mesquite.trees.EqualRatesMarkovSp,0,0,0,0,0,0,0,0
MesquiteProject_MesquiteCore,mesquite.trees.EquiprobableTrees,0,0,0,0,0,0,0,0
MesquiteProject_MesquiteCore,mesquite.trees.LabelBranchLengths,0,0,0,0,0,0,0,0
MesquiteProject_MesquiteCore,mesquite.trees.lib,1,0,0,0,1,0,0,2
MesquiteProject_MesquiteCore,mesquite.trees.ListedTreeBlocks,0,0,0,0,0,0,0,0
MesquiteProject_MesquiteCore,mesquite.trees.ManageTrees,0,0,0,0,0,0,0,0
MesquiteProject_MesquiteCore,mesquite.trees.ManyTreesFromFile,0,0,0,0,0,0,0,0
MesquiteProject_MesquiteCore,mesquite.trees.MirrorTreeWindowMaker,0,0,0,0,0,0,0,0
MesquiteProject_MesquiteCore,mesquite.trees.MultiTreeWindowMaker,0,0,0,0,0,0,0,0
MesquiteProject_MesquiteCore,mesquite.trees.NegativeToZeroBL,0,0,0,0,0,0,0,0
MesquiteProject_MesquiteCore,mesquite.trees.NoColorForTaxon,0,0,0,0,0,0,0,0
MesquiteProject_MesquiteCore,mesquite.trees.NodeLocsStandard,0,0,0,0,0,0,0,0
MesquiteProject_MesquiteCore,mesquite.trees.NodeNamer,0,0,0,0,0,0,0,0
MesquiteProject_MesquiteCore,mesquite.trees.NumAttachedToTree,0,0,0,0,0,0,0,0
MesquiteProject_MesquiteCore,mesquite.trees.NumberOfTaxa,0,0,0,0,0,0,0,0
MesquiteProject_MesquiteCore,mesquite.trees.NumFor2CharCurrentTree,0,0,0,0,0,0,0,0
MesquiteProject_MesquiteCore,mesquite.trees.NumForCharCurrentTree,0,0,0,0,0,0,0,0
MesquiteProject_MesquiteCore,mesquite.trees.NumForCharOnTree,0,0,0,0,0,0,0,0
MesquiteProject_MesquiteCore,mesquite.trees.NumForCharRespTree,0,0,0,0,0,0,0,0
MesquiteProject_MesquiteCore,mesquite.trees.NumForMatCurrentTree,0,0,0,0,0,0,0,0
MesquiteProject_MesquiteCore,mesquite.trees.NumForNodesWithChar,0,0,0,0,0,0,0,0
MesquiteProject_MesquiteCore,mesquite.trees.NumForNodesWithCharHist,0,0,0,0,0,0,0,0
MesquiteProject_MesquiteCore,mesquite.trees.NumForNodesWithMat,0,0,0,0,0,0,0,0
MesquiteProject_MesquiteCore,mesquite.trees.NumForTreeCladeValue,0,0,0,0,0,0,0,0
MesquiteProject_MesquiteCore,mesquite.trees.NumForTreeSelNodeValue,0,0,0,0,0,0,0,0
MesquiteProject_MesquiteCore,mesquite.trees.NumForTreeWith2Chars,0,0,0,0,0,0,0,0
MesquiteProject_MesquiteCore,mesquite.trees.NumForTreeWithChar,0,0,0,0,0,0,0,0
MesquiteProject_MesquiteCore,mesquite.trees.NumsForNodesBrLengths,0,0,0,0,0,0,0,0
MesquiteProject_MesquiteCore,mesquite.trees.ObedientTreeWindow,0,0,0,0,0,0,0,0
MesquiteProject_MesquiteCore,mesquite.trees.OtherTreeBlocks,0,0,0,0,0,0,0,0
MesquiteProject_MesquiteCore,mesquite.trees.RatioLongestBranches,0,0,0,0,0,0,0,0
MesquiteProject_MesquiteCore,mesquite.trees.ResolvePolytomiesToZero,0,0,0,0,0,0,0,0
MesquiteProject_MesquiteCore,mesquite.trees.ScaleBranchLengths,0,0,0,0,0,0,0,0
MesquiteProject_MesquiteCore,mesquite.trees.ScaleSelBranchLengths,0,0,0,0,0,0,0,0
MesquiteProject_MesquiteCore,mesquite.trees.SearchForBetterTree,0,0,0,0,0,0,0,0
MesquiteProject_MesquiteCore,mesquite.trees.SearchTreeToolAssistant,0,0,0,0,0,0,0,0
MesquiteProject_MesquiteCore,mesquite.trees.SelectBranches,0,0,0,0,0,0,0,0
MesquiteProject_MesquiteCore,mesquite.trees.SelectTaxaInClade,0,0,0,0,0,0,0,0
MesquiteProject_MesquiteCore,mesquite.trees.SetAssumptionDefault,0,0,0,0,0,0,0,0
MesquiteProject_MesquiteCore,mesquite.trees.SetAssumptionHard,0,0,0,0,0,0,0,0
MesquiteProject_MesquiteCore,mesquite.trees.SetAssumptionSoft,0,0,0,0,0,0,0,0
MesquiteProject_MesquiteCore,mesquite.trees.SetBranchLengths,0,0,0,0,0,0,0,0
MesquiteProject_MesquiteCore,mesquite.trees.SetBranchLengthsFromNames,0,0,0,0,0,0,0,0
MesquiteProject_MesquiteCore,mesquite.trees.SetBranchLengthsIfLessThan,0,0,0,0,0,0,0,0
MesquiteProject_MesquiteCore,mesquite.trees.SetSelBranchLengths,0,0,0,0,0,0,0,0
MesquiteProject_MesquiteCore,mesquite.trees.SetToArbitrarySymmetrical,0,0,0,0,0,0,0,0
MesquiteProject_MesquiteCore,mesquite.trees.SetToLadderized,0,0,0,0,0,0,0,0
MesquiteProject_MesquiteCore,mesquite.trees.SetToRooted,0,0,0,0,0,0,0,0
MesquiteProject_MesquiteCore,mesquite.trees.SetToUnrooted,0,0,0,0,0,0,0,0
MesquiteProject_MesquiteCore,mesquite.trees.SetTreeDefaults,0,0,0,0,0,0,0,0
MesquiteProject_MesquiteCore,mesquite.trees.ShadeNumbersOnTree,0,0,0,0,0,0,0,0
MesquiteProject_MesquiteCore,mesquite.trees.ShowTreeInList,0,0,0,0,0,0,0,0
MesquiteProject_MesquiteCore,mesquite.trees.SimulatedTreeBlocks,0,0,0,0,0,0,0,0
MesquiteProject_MesquiteCore,mesquite.trees.SimulateTree,0,0,0,0,0,0,0,0
MesquiteProject_MesquiteCore,mesquite.trees.SquareLineTree,0,0,0,0,0,0,0,0
MesquiteProject_MesquiteCore,mesquite.trees.SquareTree,0,0,0,0,0,0,0,0
MesquiteProject_MesquiteCore,mesquite.trees.StoredTreeBlocks,0,0,0,0,0,0,0,0
MesquiteProject_MesquiteCore,mesquite.trees.StoredTrees,0,0,0,0,0,0,0,0
MesquiteProject_MesquiteCore,mesquite.trees.TreeInfoValues,0,0,0,0,0,0,0,0
MesquiteProject_MesquiteCore,mesquite.trees.TreeLegendMaker,0,0,0,0,0,0,0,0
MesquiteProject_MesquiteCore,mesquite.trees.TreeNotesMaker,0,0,0,0,0,0,0,0
MesquiteProject_MesquiteCore,mesquite.trees.TreeOfContext,0,0,0,0,0,0,0,0
MesquiteProject_MesquiteCore,mesquite.trees.TreeValueUsingMatrix,0,0,0,0,0,0,0,0
MesquiteProject_MesquiteCore,mesquite.trees.Ultrametricize,0,0,0,0,0,0,0,0
MesquiteProject_MesquiteCore,mesquite.trees.UtilityCoordinator,0,0,0,0,0,0,0,0
MesquiteProject_MesquiteCore,mesquite.trees.ValuesAtNodes,0,0,0,0,0,0,0,0
MesquiteProject_MesquiteCore,mesquite.trunk,4,1,0,0,1,0,0,6
MesquiteProject_MesquiteCore,org.apache.hivemind.util,0,0,0,0,0,0,0,0
MesquiteProject_MesquiteCore,start,0,0,0,0,0,0,0,0
metricminer-msr_metricminer2,org.repodriller.domain,4,1,0,0,1,3,0,9
metricminer-msr_metricminer2,org.repodriller.filter.commit,3,0,0,0,0,0,0,3
metricminer-msr_metricminer2,org.repodriller.filter.diff,0,0,0,0,0,0,0,0
metricminer-msr_metricminer2,org.repodriller.filter.range,0,1,0,0,0,2,0,3
metricminer-msr_metricminer2,org.repodriller.persistence.csv,0,0,0,0,0,0,0,0
metricminer-msr_metricminer2,org.repodriller.persistence,0,0,0,0,0,0,0,0
metricminer-msr_metricminer2,org.repodriller,4,1,0,0,1,2,0,8
metricminer-msr_metricminer2,org.repodriller.scm,3,0,0,0,1,4,0,8
metricminer-msr_metricminer2,org.repodriller.util,2,1,0,0,0,0,0,3
metricminer-msr_metricminer2,org.repodriller.integration,0,0,0,0,1,1,0,2
metricminer-msr_metricminer2,org.repodriller.memory,0,0,0,0,0,0,0,0
metricminer-msr_metricminer2,org.repodriller.scm.git,0,0,0,0,0,1,0,1
metricminer-msr_metricminer2,org.repodriller.scm.subversion,0,0,0,0,0,0,0,0
meyerjp3_psychometrics,com.itemanalysis.psychometrics.data,0,0,0,0,0,0,0,0
meyerjp3_psychometrics,com.itemanalysis.psychometrics.distribution,0,0,0,0,1,0,0,1
meyerjp3_psychometrics,com.itemanalysis.psychometrics.exceptions,0,0,0,0,0,0,0,0
meyerjp3_psychometrics,com.itemanalysis.psychometrics.histogram,0,0,0,0,0,0,0,0
meyerjp3_psychometrics,com.itemanalysis.psychometrics.quadrature,0,0,0,0,0,1,0,1
meyerjp3_psychometrics,com.itemanalysis.psychometrics.statistics,0,0,0,0,1,1,0,2
meyerjp3_psychometrics,com.itemanalysis.psychometrics.texttable,0,0,0,0,0,0,0,0
meyerjp3_psychometrics,com.itemanalysis.psychometrics.utils,0,0,0,0,0,0,0,0
meyerjp3_psychometrics,com.itemanalysis.psychometrics.classicalitemanalysis,0,0,0,0,1,0,0,1
meyerjp3_psychometrics,com.itemanalysis.psychometrics.cmh,0,0,0,0,0,0,0,0
meyerjp3_psychometrics,com.itemanalysis.psychometrics.reliability,0,0,0,0,1,0,0,1
meyerjp3_psychometrics,com.itemanalysis.psychometrics.scaling,0,0,0,0,1,0,0,1
meyerjp3_psychometrics,com.itemanalysis.psychometrics.factoranalysis,0,0,0,0,1,0,0,1
meyerjp3_psychometrics,com.itemanalysis.psychometrics.polycor,0,0,0,0,1,0,0,1
meyerjp3_psychometrics,com.itemanalysis.psychometrics.mixture,0,0,0,0,1,0,0,1
meyerjp3_psychometrics,com.itemanalysis.psychometrics.irt.equating,0,0,0,0,1,0,0,1
meyerjp3_psychometrics,com.itemanalysis.psychometrics.irt.estimation,2,0,0,1,1,1,0,5
meyerjp3_psychometrics,com.itemanalysis.psychometrics.irt.model,2,1,0,0,0,0,0,3
meyerjp3_psychometrics,com.itemanalysis.psychometrics.irt.simulation,1,0,0,0,0,0,0,1
meyerjp3_psychometrics,com.itemanalysis.psychometrics,0,0,0,0,0,0,0,0
meyerjp3_psychometrics,com.itemanalysis.psychometrics.irt,0,0,0,0,0,0,0,0
meyerjp3_psychometrics,com.itemanalysis.psychometrics.kernel,0,0,0,0,0,0,0,0
meyerjp3_psychometrics,com.itemanalysis.psychometrics.analysis,0,0,0,0,0,0,0,0
meyerjp3_psychometrics,com.itemanalysis.psychometrics.optimization,0,0,0,0,1,0,0,1
meyerjp3_psychometrics,com.itemanalysis.psychometrics.uncmin,0,0,0,0,1,0,0,1
michaelklishin_hop,com.rabbitmq.http.client,0,0,0,0,1,0,0,1
michaelklishin_hop,com.rabbitmq.http.client.domain,0,0,0,1,1,0,0,2
michaelwittig_java-q,info.michaelwittig.javaq.connector.impl,1,0,0,0,0,2,0,3
michaelwittig_java-q,info.michaelwittig.javaq,0,0,0,0,0,4,0,4
michaelwittig_java-q,info.michaelwittig.javaq.connector.impl.cmd,1,1,0,0,1,1,0,4
michaelwittig_java-q,info.michaelwittig.javaq.connector,0,0,0,0,1,1,0,2
michaelwittig_java-q,info.michaelwittig.javaq.query,0,0,0,0,1,2,0,3
michaelwittig_java-q,info.michaelwittig.javaq.query.column,0,0,0,0,1,1,0,2
michaelwittig_java-q,info.michaelwittig.javaq.query.column.impl,1,0,0,0,0,2,0,3
michaelwittig_java-q,info.michaelwittig.javaq.query.filter,0,0,0,0,0,0,0,0
michaelwittig_java-q,info.michaelwittig.javaq.query.filter.impl,1,1,0,0,0,1,0,3
michaelwittig_java-q,info.michaelwittig.javaq.query.group,0,0,0,0,0,0,0,0
michaelwittig_java-q,info.michaelwittig.javaq.query.group.impl,0,0,0,0,0,0,0,0
michaelwittig_java-q,info.michaelwittig.javaq.query.impl,0,1,0,0,0,3,0,4
michaelwittig_java-q,info.michaelwittig.javaq.query.type.impl,1,1,0,0,1,0,0,3
michaelwittig_java-q,info.michaelwittig.javaq.query.type,0,0,0,0,0,0,0,0
michaelwittig_java-q,info.michaelwittig.javaq.query.value.impl,1,0,0,0,0,2,0,3
michaelwittig_java-q,info.michaelwittig.javaq.query.value,0,0,0,0,0,0,0,0
michaelwittig_java-q,kx,0,0,0,0,0,2,0,2
michaelwittig_java-q,info.michaelwittig.javaq.demo,0,0,0,0,0,1,0,1
michaelwittig_java-q,info.michaelwittig.javaq.demo.tabledefinition,0,0,0,0,0,0,0,0
micromata_javaapiforkml,de.micromata.opengis.kml.v_2_2_0,1,0,0,1,0,3,0,5
micromata_javaapiforkml,de.micromata.opengis.kml.v_2_2_0.atom,0,0,0,0,0,2,0,2
micromata_javaapiforkml,de.micromata.opengis.kml.v_2_2_0.gx,1,1,0,0,1,1,0,4
micromata_javaapiforkml,de.micromata.opengis.kml.v_2_2_0.xal,0,0,0,2,0,1,0,3
micromata_javaapiforkml,de.micromata.jak,0,0,0,0,0,2,0,2
micromata_javaapiforkml,de.micromata.jak.examples,0,0,0,0,1,0,0,1
micromata_javaapiforkml,de.micromata.jak.incubator,0,0,0,0,1,0,0,1
micromata_javaapiforkml,de.micromata.jak.internal,0,0,0,0,0,0,0,0
micromata_javaapiforkml,de.micromata.jak.jugh,0,0,0,0,0,0,0,0
Microsoft_AppInsights-Java,com.microsoft.applicationinsights.agent.internal,0,0,0,0,1,0,0,1
Microsoft_AppInsights-Java,com.microsoft.applicationinsights.agent.internal.config,0,0,0,0,0,0,0,0
Microsoft_AppInsights-Java,com.microsoft.applicationinsights.agent.internal.config.builder,0,0,0,0,0,0,0,0
Microsoft_AppInsights-Java,com.microsoft.applicationinsights.agent.internal.model,1,0,0,0,0,0,0,1
Microsoft_AppInsights-Java,com.microsoft.applicationinsights.agent.internal.sdk,1,1,0,0,0,0,0,2
Microsoft_AppInsights-Java,com.microsoft.applicationinsights.internal.logger,0,0,0,0,0,0,0,0
Microsoft_AppInsights-Java,com.microsoft.applicationinsights.autoconfigure,0,0,0,0,0,0,0,0
Microsoft_AppInsights-Java,com.microsoft.applicationinsights.autoconfigure.conditionals,0,0,0,0,0,0,0,0
Microsoft_AppInsights-Java,com.microsoft.applicationinsights.autoconfigure.HeartBeatProvider,0,0,0,0,0,0,0,0
Microsoft_AppInsights-Java,com.microsoft.applicationinsights.autoconfigure.helpers,0,0,0,0,0,0,0,0
Microsoft_AppInsights-Java,com.microsoft.applicationinsights.autoconfigure.initializer,0,0,0,0,0,0,0,0
Microsoft_AppInsights-Java,com.microsoft.applicationinsights.exceptions,0,0,0,0,0,0,0,0
Microsoft_AppInsights-Java,com.microsoft.applicationinsights.collectd,0,0,0,0,0,0,0,0
Microsoft_AppInsights-Java,com.microsoft.applicationinsights.collectd.internal,0,0,0,0,0,0,0,0
Microsoft_AppInsights-Java,com.microsoft.applicationinsights.channel.concrete.inprocess,0,0,0,0,0,0,0,0
Microsoft_AppInsights-Java,com.microsoft.applicationinsights.channel.concrete.nop,0,0,0,0,0,0,0,0
Microsoft_AppInsights-Java,com.microsoft.applicationinsights.channel.concrete,0,0,0,0,0,0,0,0
Microsoft_AppInsights-Java,com.microsoft.applicationinsights.channel,0,1,0,0,0,0,0,1
Microsoft_AppInsights-Java,com.microsoft.applicationinsights.common,0,0,0,0,0,0,0,0
Microsoft_AppInsights-Java,com.microsoft.applicationinsights.extensibility.context,0,0,0,0,0,0,0,0
Microsoft_AppInsights-Java,com.microsoft.applicationinsights.extensibility,1,0,1,0,1,0,0,3
Microsoft_AppInsights-Java,com.microsoft.applicationinsights.extensibility.initializer,0,0,0,0,1,0,0,1
Microsoft_AppInsights-Java,com.microsoft.applicationinsights.extensibility.initializer.docker,0,0,0,0,0,0,0,0
Microsoft_AppInsights-Java,com.microsoft.applicationinsights.extensibility.initializer.docker.internal,0,0,0,0,1,0,0,1
Microsoft_AppInsights-Java,com.microsoft.applicationinsights.internal.agent,0,0,0,0,1,0,0,1
Microsoft_AppInsights-Java,com.microsoft.applicationinsights.internal.annotation,0,0,0,0,0,0,0,0
Microsoft_AppInsights-Java,com.microsoft.applicationinsights.internal.channel.common,1,0,0,1,0,0,0,2
Microsoft_AppInsights-Java,com.microsoft.applicationinsights.internal.channel,1,1,0,0,1,0,0,3
Microsoft_AppInsights-Java,com.microsoft.applicationinsights.internal.channel.sampling,0,0,0,0,0,0,0,0
Microsoft_AppInsights-Java,com.microsoft.applicationinsights.internal.channel.samplingV2,0,0,0,0,0,0,0,0
Microsoft_AppInsights-Java,com.microsoft.applicationinsights.internal.channel.simplehttp,0,0,0,0,0,0,0,0
Microsoft_AppInsights-Java,com.microsoft.applicationinsights.internal.channel.stdout,0,0,0,0,0,0,0,0
Microsoft_AppInsights-Java,com.microsoft.applicationinsights.internal.config,1,1,0,1,1,0,0,4
Microsoft_AppInsights-Java,com.microsoft.applicationinsights.internal.config.connection,1,0,0,0,0,0,0,1
Microsoft_AppInsights-Java,com.microsoft.applicationinsights.internal.heartbeat,0,0,0,0,0,0,0,0
Microsoft_AppInsights-Java,com.microsoft.applicationinsights.internal.jmx,0,0,0,0,0,0,0,0
Microsoft_AppInsights-Java,com.microsoft.applicationinsights.internal.perfcounter,1,1,0,1,0,0,0,3
Microsoft_AppInsights-Java,com.microsoft.applicationinsights.internal.perfcounter.jvm,0,0,0,0,0,0,0,0
Microsoft_AppInsights-Java,com.microsoft.applicationinsights.internal.processor,0,0,0,0,1,0,0,1
Microsoft_AppInsights-Java,com.microsoft.applicationinsights.internal.quickpulse,0,0,0,0,0,0,0,0
Microsoft_AppInsights-Java,com.microsoft.applicationinsights.internal.reflect,0,0,0,0,0,0,0,0
Microsoft_AppInsights-Java,com.microsoft.applicationinsights.internal.schemav2,1,1,0,0,1,0,0,3
Microsoft_AppInsights-Java,com.microsoft.applicationinsights.internal.shutdown,0,0,0,0,0,0,0,0
Microsoft_AppInsights-Java,com.microsoft.applicationinsights.internal.system,0,0,0,0,0,0,0,0
Microsoft_AppInsights-Java,com.microsoft.applicationinsights.internal.util,0,0,0,0,1,0,0,1
Microsoft_AppInsights-Java,com.microsoft.applicationinsights.telemetry,1,0,0,1,0,0,0,2
Microsoft_AppInsights-Java,com.microsoft.applicationinsights,2,1,0,0,1,0,0,4
Microsoft_AppInsights-Java,com.microsoft.applicationinsights.internal.channel.inprocess,0,0,0,0,0,0,0,0
Microsoft_AppInsights-Java,com.microsoft.applicationinsights.internal.common,0,0,0,0,1,0,0,1
Microsoft_AppInsights-Java,com.microsoft.applicationinsights.internal.shared,0,0,0,0,1,0,0,1
Microsoft_AppInsights-Java,com.microsoft.applicationinsights.log4j.v1_2,0,0,0,0,0,0,0,0
Microsoft_AppInsights-Java,com.microsoft.applicationinsights.log4j.v1_2.internal,0,0,0,0,0,0,0,0
Microsoft_AppInsights-Java,com.microsoft.applicationinsights.log4j.v2,0,0,0,0,0,0,0,0
Microsoft_AppInsights-Java,com.microsoft.applicationinsights.log4j.v2.internal,0,0,0,0,0,0,0,0
Microsoft_AppInsights-Java,com.microsoft.applicationinsights.logback,0,0,0,0,0,0,0,0
Microsoft_AppInsights-Java,com.microsoft.applicationinsights.logback.internal,0,0,0,0,0,0,0,0
Microsoft_AppInsights-Java,helloworld,0,0,0,0,0,0,0,0
Microsoft_AppInsights-Java,com.microsoft.applicationinsights.controller,0,0,0,0,0,0,0,0
Microsoft_AppInsights-Java,com.microsoft.applicationinsights.core.volume,0,0,0,0,0,0,0,0
Microsoft_AppInsights-Java,com.microsoft.ajl.simplecalc,0,0,0,1,0,0,0,1
Microsoft_AppInsights-Java,com.microsoft.ajl.simplecalc.model,0,0,0,0,0,0,0,0
Microsoft_AppInsights-Java,com.microsoft.ajl.simple,0,0,0,0,1,0,0,1
Microsoft_AppInsights-Java,com,0,0,0,0,0,0,0,0
Microsoft_AppInsights-Java,com.springapp.mvc,0,0,0,0,1,0,0,1
Microsoft_AppInsights-Java,com.springapp.mvc.extensions,0,0,0,0,0,0,0,0
Microsoft_AppInsights-Java,com.microsoft.applicationinsights.web.spring,0,0,0,0,0,0,0,0
Microsoft_AppInsights-Java,com.microsoft.applicationinsights.web.extensibility.initializers,0,0,0,0,0,0,0,0
Microsoft_AppInsights-Java,com.microsoft.applicationinsights.web.extensibility.modules,0,0,0,0,1,0,0,1
Microsoft_AppInsights-Java,com.microsoft.applicationinsights.web.internal,8,1,0,0,1,0,0,10
Microsoft_AppInsights-Java,com.microsoft.applicationinsights.web.internal.cookies,3,0,0,0,0,0,0,3
Microsoft_AppInsights-Java,com.microsoft.applicationinsights.web.internal.correlation,4,0,0,0,0,0,0,4
Microsoft_AppInsights-Java,com.microsoft.applicationinsights.web.internal.correlation.tracecontext,0,0,0,0,0,0,0,0
Microsoft_AppInsights-Java,com.microsoft.applicationinsights.web.internal.httputils,1,1,0,0,0,0,0,2
Microsoft_AppInsights-Java,com.microsoft.applicationinsights.web.internal.perfcounter,0,0,0,0,0,0,0,0
Microsoft_AppInsights-Java,com.microsoft.applicationinsights.web.javaee,0,0,0,0,0,0,0,0
Microsoft_AppInsights-Java,com.microsoft.applicationinsights.web.spring.internal,0,0,0,0,0,0,0,0
Microsoft_AppInsights-Java,com.microsoft.applicationinsights.web.struts,0,0,0,0,0,0,0,0
Microsoft_AppInsights-Java,com.microsoft.applicationinsights.web.internal.correlation.mocks,0,0,0,0,0,0,0,0
Microsoft_AppInsights-Java,com.microsoft.applicationinsights.web.utils,5,1,0,0,1,0,0,7
Microsoft_AppInsights-Java,com.microsoft.applicationinsights.web.internal.auto,0,0,0,0,0,0,0,0
mifmif_Generex,com.mifmif.common.regex,0,0,0,0,1,0,0,1
mifmif_Generex,com.mifmif.common.regex.util,0,0,0,0,0,0,0,0
MightyPirates_OpenComputers,li.cil.oc.api,0,1,0,0,1,0,0,2
MightyPirates_OpenComputers,li.cil.oc.api.component,0,0,0,0,1,0,0,1
MightyPirates_OpenComputers,li.cil.oc.api.detail,0,0,0,0,1,0,0,1
MightyPirates_OpenComputers,li.cil.oc.api.driver,0,0,0,0,1,0,0,1
MightyPirates_OpenComputers,li.cil.oc.api.driver.item,0,0,0,0,1,0,0,1
MightyPirates_OpenComputers,li.cil.oc.api.event,0,0,0,1,0,0,0,1
MightyPirates_OpenComputers,li.cil.oc.api.fs,0,0,0,0,1,0,0,1
MightyPirates_OpenComputers,li.cil.oc.api.internal,0,1,0,1,1,0,0,3
MightyPirates_OpenComputers,li.cil.oc.api.machine,1,1,0,0,1,0,0,3
MightyPirates_OpenComputers,li.cil.oc.api.manual,0,0,0,0,1,0,0,1
MightyPirates_OpenComputers,li.cil.oc.api.nanomachines,0,0,0,0,1,0,0,1
MightyPirates_OpenComputers,li.cil.oc.api.network,1,0,0,1,1,0,0,3
MightyPirates_OpenComputers,li.cil.oc.api.prefab,0,0,0,1,1,0,0,2
MightyPirates_OpenComputers,li.cil.oc.api.util,0,0,0,0,0,0,0,0
MightyPirates_OpenComputers,li.cil.oc.common.asm,0,1,0,0,0,0,0,1
MightyPirates_OpenComputers,li.cil.oc.common.asm.template,0,0,0,0,1,0,0,1
MightyPirates_OpenComputers,li.cil.oc.util,0,0,0,0,0,0,0,0
MightyPirates_OpenComputers,lordfokas.stargatetech2.api.bus,0,0,0,0,1,0,0,1
MightyPirates_OpenComputers,lordfokas.stargatetech2.api,0,0,0,0,0,0,0,0
MightyPirates_OpenComputers,lordfokas.stargatetech2.api.stargate,0,0,0,0,0,0,0,0
MightyPirates_OpenComputers,lordfokas.stargatetech2.api.world,0,0,0,0,0,0,0,0
MightyPirates_OpenComputers,li.cil.oc.client.renderer.font,0,0,0,0,0,0,0,0
MightyPirates_OpenComputers,li.cil.oc.integration.appeng,0,0,0,0,0,0,0,0
MightyPirates_OpenComputers,li.cil.oc.integration.bloodmagic,0,0,0,0,0,0,0,0
MightyPirates_OpenComputers,li.cil.oc.integration.buildcraft.tiles,0,0,0,0,0,0,0,0
MightyPirates_OpenComputers,li.cil.oc.integration.buildcraft.transport,0,0,0,0,0,0,0,0
MightyPirates_OpenComputers,li.cil.oc.integration.cofh.energy,0,0,0,0,1,0,0,1
MightyPirates_OpenComputers,li.cil.oc.integration.cofh.tileentity,0,0,0,0,1,0,0,1
MightyPirates_OpenComputers,li.cil.oc.integration.cofh.transport,0,0,0,0,1,0,0,1
MightyPirates_OpenComputers,li.cil.oc.integration.computercraft,0,0,0,0,0,0,0,0
MightyPirates_OpenComputers,li.cil.oc.integration.enderstorage,0,0,0,0,0,0,0,0
MightyPirates_OpenComputers,li.cil.oc.integration.forestry,0,0,0,0,1,0,0,1
MightyPirates_OpenComputers,li.cil.oc.integration.gregtech,0,0,0,0,0,0,0,0
MightyPirates_OpenComputers,li.cil.oc.integration.ic2,0,0,0,0,1,0,0,1
MightyPirates_OpenComputers,li.cil.oc.integration,0,0,0,0,0,0,0,0
MightyPirates_OpenComputers,li.cil.oc.integration.mystcraft,0,0,0,0,0,0,0,0
MightyPirates_OpenComputers,li.cil.oc.integration.railcraft,0,0,0,0,0,0,0,0
MightyPirates_OpenComputers,li.cil.oc.integration.rotarycraft,0,0,0,0,0,0,0,0
MightyPirates_OpenComputers,li.cil.oc.integration.thaumcraft,0,0,0,0,0,0,0,0
MightyPirates_OpenComputers,li.cil.oc.integration.thermalexpansion,0,0,0,0,0,0,0,0
MightyPirates_OpenComputers,li.cil.oc.integration.tmechworks,0,0,0,0,0,0,0,0
MightyPirates_OpenComputers,li.cil.oc.integration.vanilla,0,0,0,0,1,0,0,1
MightyPirates_OpenComputers,li.cil.oc.server.machine,0,0,0,0,0,0,0,0
migzai_irc-api,com.ircclouds.irc.api,0,1,0,0,1,2,0,4
migzai_irc-api,com.ircclouds.irc.api.commands,0,1,0,0,0,0,0,1
migzai_irc-api,com.ircclouds.irc.api.comms,0,0,0,0,1,0,0,1
migzai_irc-api,com.ircclouds.irc.api.ctcp,0,0,0,0,1,0,0,1
migzai_irc-api,com.ircclouds.irc.api.domain,1,1,0,0,1,4,0,7
migzai_irc-api,com.ircclouds.irc.api.domain.messages,0,1,0,0,1,4,0,6
migzai_irc-api,com.ircclouds.irc.api.domain.messages.interfaces,0,0,0,0,1,0,0,1
migzai_irc-api,com.ircclouds.irc.api.filters,0,0,0,0,0,0,0,0
migzai_irc-api,com.ircclouds.irc.api.listeners,0,0,0,0,0,3,0,3
migzai_irc-api,com.ircclouds.irc.api.negotiators.api,0,0,0,0,0,0,0,0
migzai_irc-api,com.ircclouds.irc.api.negotiators.capabilities,0,0,0,0,0,0,0,0
migzai_irc-api,com.ircclouds.irc.api.negotiators,0,0,0,0,1,0,0,1
migzai_irc-api,com.ircclouds.irc.api.om,0,0,0,0,0,1,0,1
migzai_irc-api,com.ircclouds.irc.api.state,0,0,0,0,1,2,0,3
migzai_irc-api,com.ircclouds.irc.api.utils,1,0,0,0,1,0,0,2
migzai_irc-api,nl.dannyvanheumen.nio,0,0,0,0,0,0,0,0
migzai_irc-api,com.ircclouds.irc.api,0,1,0,0,1,2,0,4
migzai_irc-api,com.ircclouds.irc.api.commands,0,1,0,0,0,0,0,1
migzai_irc-api,com.ircclouds.irc.api.comms,0,0,0,0,1,0,0,1
migzai_irc-api,com.ircclouds.irc.api.ctcp,0,0,0,0,1,0,0,1
migzai_irc-api,com.ircclouds.irc.api.domain,1,1,0,0,1,4,0,7
migzai_irc-api,com.ircclouds.irc.api.domain.messages,0,1,0,0,1,4,0,6
migzai_irc-api,com.ircclouds.irc.api.domain.messages.interfaces,0,0,0,0,1,0,0,1
migzai_irc-api,com.ircclouds.irc.api.filters,0,0,0,0,0,0,0,0
migzai_irc-api,com.ircclouds.irc.api.listeners,0,0,0,0,0,3,0,3
migzai_irc-api,com.ircclouds.irc.api.negotiators.api,0,0,0,0,0,0,0,0
migzai_irc-api,com.ircclouds.irc.api.negotiators.capabilities,0,0,0,0,0,0,0,0
migzai_irc-api,com.ircclouds.irc.api.negotiators,0,0,0,0,1,0,0,1
migzai_irc-api,com.ircclouds.irc.api.om,0,0,0,0,0,1,0,1
migzai_irc-api,com.ircclouds.irc.api.state,0,0,0,0,1,2,0,3
migzai_irc-api,com.ircclouds.irc.api.utils,1,0,0,0,1,0,0,2
migzai_irc-api,nl.dannyvanheumen.nio,0,0,0,0,0,0,0,0
mikvor_money-conversion,info.javaperformance.money,0,0,0,0,1,0,0,1
mikvor_money-conversion,info.javaperformance.money.performance,0,0,0,0,0,0,0,0
mimno_Mallet,cc.mallet.classify,9,0,0,1,0,13,1,24
mimno_Mallet,cc.mallet.classify.constraints.ge,2,0,0,0,1,2,1,6
mimno_Mallet,cc.mallet.classify.constraints.pr,0,0,0,0,0,1,1,2
mimno_Mallet,cc.mallet.classify.evaluate,1,1,0,0,1,1,1,5
mimno_Mallet,cc.mallet.classify.examples,0,0,0,0,0,0,1,1
mimno_Mallet,cc.mallet.classify.tui,0,0,0,0,1,3,1,5
mimno_Mallet,cc.mallet.cluster,2,0,0,0,1,3,1,7
mimno_Mallet,cc.mallet.cluster.clustering_scorer,0,0,0,0,0,0,1,1
mimno_Mallet,cc.mallet.cluster.evaluate,0,0,0,0,0,0,1,1
mimno_Mallet,cc.mallet.cluster.examples,0,0,0,0,0,1,1,2
mimno_Mallet,cc.mallet.cluster.iterator,0,0,0,0,0,0,1,1
mimno_Mallet,cc.mallet.cluster.neighbor_evaluator,1,0,0,0,0,4,1,6
mimno_Mallet,cc.mallet.cluster.tui,0,0,0,0,0,2,1,3
mimno_Mallet,cc.mallet.cluster.util,2,1,0,0,0,1,1,5
mimno_Mallet,cc.mallet.examples,0,0,0,0,0,1,1,2
mimno_Mallet,cc.mallet.extract,6,1,0,1,0,2,1,11
mimno_Mallet,cc.mallet.extract.pipe,0,0,0,0,0,0,1,1
mimno_Mallet,cc.mallet.fst,6,0,0,1,0,10,1,18
mimno_Mallet,cc.mallet.fst.confidence,3,0,0,0,0,2,1,6
mimno_Mallet,cc.mallet.fst.semi_supervised.constraints,0,0,0,0,1,2,1,4
mimno_Mallet,cc.mallet.fst.semi_supervised,0,0,0,0,1,4,1,6
mimno_Mallet,cc.mallet.fst.semi_supervised.pr,0,0,0,0,0,1,1,2
mimno_Mallet,cc.mallet.fst.semi_supervised.pr.constraints,0,0,0,0,0,0,1,1
mimno_Mallet,cc.mallet.fst.semi_supervised.tui,0,0,0,0,0,0,1,1
mimno_Mallet,cc.mallet.optimize,2,1,0,0,0,3,1,7
mimno_Mallet,cc.mallet.pipe,18,1,0,1,0,10,1,31
mimno_Mallet,cc.mallet.pipe.iterator,13,1,0,0,1,1,1,17
mimno_Mallet,cc.mallet.pipe.tsf,0,0,0,0,1,1,1,3
mimno_Mallet,cc.mallet.regression,0,0,0,0,0,1,1,2
mimno_Mallet,cc.mallet.regression.tui,0,0,0,0,0,0,1,1
mimno_Mallet,cc.mallet.share.casutton.ner,0,0,0,0,0,0,1,1
mimno_Mallet,cc.mallet.share.mccallum.ner,0,0,0,0,0,0,1,1
mimno_Mallet,cc.mallet.share.upenn,0,0,0,0,0,1,1,2
mimno_Mallet,cc.mallet.share.upenn.ner,0,0,0,0,0,0,1,1
mimno_Mallet,cc.mallet.share.weili.ner.enron,0,0,0,0,0,0,1,1
mimno_Mallet,cc.mallet.share.weili.ner,0,0,0,0,0,0,1,1
mimno_Mallet,cc.mallet.topics,0,0,0,1,1,3,1,6
mimno_Mallet,cc.mallet.topics.tui,0,0,0,0,1,1,1,3
mimno_Mallet,cc.mallet.types,12,1,0,1,1,35,1,51
mimno_Mallet,cc.mallet.util,16,1,0,1,1,11,1,31
mimno_Mallet,cc.mallet.util.search,0,0,0,0,0,0,1,1
MinecraftForge_FernFlower,org.jetbrains.java.decompiler.code.cfg,14,1,0,0,0,0,1,16
MinecraftForge_FernFlower,org.jetbrains.java.decompiler.code,9,1,0,0,1,0,1,12
MinecraftForge_FernFlower,org.jetbrains.java.decompiler.code.interpreter,2,0,0,0,0,0,1,3
MinecraftForge_FernFlower,org.jetbrains.java.decompiler.main,38,1,0,0,0,0,1,40
MinecraftForge_FernFlower,org.jetbrains.java.decompiler.main.collectors,12,1,0,0,0,0,1,14
MinecraftForge_FernFlower,org.jetbrains.java.decompiler.main.decompiler,0,0,0,0,0,0,1,1
MinecraftForge_FernFlower,org.jetbrains.java.decompiler.main.extern,9,1,0,0,0,0,1,11
MinecraftForge_FernFlower,org.jetbrains.java.decompiler.main.rels,13,1,0,0,1,0,1,16
MinecraftForge_FernFlower,org.jetbrains.java.decompiler.modules.code,4,0,0,0,0,0,1,5
MinecraftForge_FernFlower,org.jetbrains.java.decompiler.modules.decompiler,15,1,0,0,0,0,1,17
MinecraftForge_FernFlower,org.jetbrains.java.decompiler.modules.decompiler.decompose,5,1,0,0,1,0,1,8
MinecraftForge_FernFlower,org.jetbrains.java.decompiler.modules.decompiler.deobfuscator,4,0,0,0,0,0,1,5
MinecraftForge_FernFlower,org.jetbrains.java.decompiler.modules.decompiler.exps,28,1,0,0,0,0,1,30
MinecraftForge_FernFlower,org.jetbrains.java.decompiler.modules.decompiler.sforms,4,1,0,0,0,0,1,6
MinecraftForge_FernFlower,org.jetbrains.java.decompiler.modules.decompiler.stats,13,1,0,0,0,0,1,15
MinecraftForge_FernFlower,org.jetbrains.java.decompiler.modules.decompiler.vars,3,1,0,0,0,0,1,5
MinecraftForge_FernFlower,org.jetbrains.java.decompiler.modules.renamer,4,0,0,0,0,0,1,5
MinecraftForge_FernFlower,org.jetbrains.java.decompiler.struct.attr,7,1,0,0,0,0,1,9
MinecraftForge_FernFlower,org.jetbrains.java.decompiler.struct.consts,3,1,0,0,0,0,1,5
MinecraftForge_FernFlower,org.jetbrains.java.decompiler.struct,12,1,0,0,0,0,1,14
MinecraftForge_FernFlower,org.jetbrains.java.decompiler.struct.gen,12,1,0,0,0,0,1,14
MinecraftForge_FernFlower,org.jetbrains.java.decompiler.struct.gen.generics,3,0,0,0,0,0,1,4
MinecraftForge_FernFlower,org.jetbrains.java.decompiler.struct.lazy,3,0,0,0,0,0,1,4
MinecraftForge_FernFlower,org.jetbrains.java.decompiler.struct.match,4,1,0,0,0,0,1,6
MinecraftForge_FernFlower,org.jetbrains.java.decompiler.util,29,1,0,0,1,0,1,32
MinecraftForge_FernFlower,org.jetbrains.java.decompiler,0,0,0,0,0,0,1,1
MinecraftForge_FernFlower,pkg,0,0,0,1,1,0,1,3
MinecraftForge_FernFlower,pkg.res,0,0,0,0,0,0,1,1
MinecraftForge_FernFlower,(default package),0,0,0,1,1,0,1,3
MinecraftForge_FernFlower,ext,0,0,0,0,0,0,1,1
MinecraftForge_FernFlower,java11,0,0,0,0,0,0,1,1
MinecraftForge_FernFlower,java9,0,0,0,0,0,0,1,1
MinecraftForge_FernFlower,decompiler,0,0,0,0,1,0,1,2
mklemm_jaxb2-rich-contract-plugin,com.kscs.util.jaxb,0,0,0,1,1,0,0,2
mklemm_jaxb2-rich-contract-plugin,com.kscs.util.plugins.xjc.base,0,0,0,0,0,0,0,0
mklemm_jaxb2-rich-contract-plugin,com.kscs.util.plugins.xjc,0,0,0,1,1,0,0,2
mklemm_jaxb2-rich-contract-plugin,com.kscs.util.plugins.xjc.codemodel,0,0,0,0,0,0,0,0
mklemm_jaxb2-rich-contract-plugin,com.kscs.util.plugins.xjc.outline,0,0,0,0,1,0,0,1
mklemm_jaxb2-rich-contract-plugin,com.kscs.util.jaxb.bindings,0,0,0,0,0,0,0,0
mklemm_jaxb2-rich-contract-plugin,com.kscs.util.jaxb._interface,0,0,0,0,0,0,0,0
mohitsoni_marathon-client,mesosphere.marathon.client,0,0,0,0,0,0,0,0
mohitsoni_marathon-client,mesosphere.marathon.client.model.v2,0,0,0,0,1,0,0,1
mohitsoni_marathon-client,mesosphere.marathon.client.utils,0,0,0,0,0,0,0,0
mongobee_mongobee,com.github.mongobee.changeset,0,0,0,0,0,0,0,0
mongobee_mongobee,com.github.mongobee.dao,0,0,0,0,1,0,0,1
mongobee_mongobee,com.github.mongobee.exception,0,0,0,0,0,0,0,0
mongobee_mongobee,com.github.mongobee,0,0,0,0,0,0,0,0
mongobee_mongobee,com.github.mongobee.utils,0,0,0,0,1,0,0,1
mongobee_mongobee,com.github.mongobee.resources,0,0,0,0,0,0,0,0
mono_sharpen,sharpen.core,0,0,0,1,1,0,0,2
mono_sharpen,sharpen.core.csharp.ast,0,0,0,1,0,1,0,2
mono_sharpen,sharpen.core.csharp,0,0,0,0,0,1,0,1
mono_sharpen,sharpen.core.framework,0,0,0,0,1,0,0,1
mono_sharpen,sharpen.core.internal,0,0,0,0,0,0,0,0
mono_sharpen,sharpen.core.io,0,0,0,0,0,1,0,1
mono_sharpen,sharpen.util,0,0,0,0,0,0,0,0
mooso_azure-tables-hadoop,com.microsoft.hadoop.azure,0,0,0,0,1,0,0,1
mooso_azure-tables-hadoop,com.microsoft.hadoop.azure.examples,0,0,0,0,0,0,0,0
mooso_azure-tables-hadoop,com.microsoft.hadoop.azure.hive,0,0,0,0,1,0,0,1
mooso_azure-tables-hadoop,com.microsoft.hadoop.azure.oldinterface,0,0,0,0,0,0,0,0
mooso_azure-tables-hadoop,com.microsoft.hadoop.azure.partitioners,0,0,0,0,0,0,0,0
mpetazzoni_ttorrent,com.turn.ttorrent.bcodec,0,0,0,0,0,1,1,2
mpetazzoni_ttorrent,(default package),0,0,0,0,0,0,1,1
mpetazzoni_ttorrent,com.turn.ttorrent.cli,0,0,0,0,0,0,1,1
mpetazzoni_ttorrent,com.turn.ttorrent.common,1,0,0,0,1,1,1,4
mpetazzoni_ttorrent,com.turn.ttorrent.common.creation,0,0,0,0,1,0,1,2
mpetazzoni_ttorrent,com.turn.ttorrent.common.protocol,0,0,0,0,1,0,1,2
mpetazzoni_ttorrent,com.turn.ttorrent.common.protocol.http,0,0,0,0,0,1,1,2
mpetazzoni_ttorrent,com.turn.ttorrent.common.protocol.udp,0,0,0,0,0,0,1,1
mpetazzoni_ttorrent,com.turn.ttorrent,1,1,0,0,1,0,1,4
mpetazzoni_ttorrent,com.turn.ttorrent.network,1,1,0,0,1,0,1,4
mpetazzoni_ttorrent,com.turn.ttorrent.network.keyProcessors,1,0,0,0,1,0,1,3
mpetazzoni_ttorrent,com.turn.ttorrent.client.announce,0,0,0,0,1,0,1,2
mpetazzoni_ttorrent,com.turn.ttorrent.client,3,1,0,0,1,1,1,7
mpetazzoni_ttorrent,com.turn.ttorrent.tracker,2,0,0,0,1,0,1,4
mpetazzoni_ttorrent,com.turn.ttorrent.client.network,0,0,0,0,1,0,1,2
mpetazzoni_ttorrent,com.turn.ttorrent.client.peer,0,0,0,0,1,1,1,3
mpetazzoni_ttorrent,com.turn.ttorrent.client.storage,2,1,0,0,1,0,1,5
mpetazzoni_ttorrent,com.turn.ttorrent.client.strategy,0,0,0,0,1,1,1,3
mrniko_redisson,org.redisson.api.annotation,0,0,0,0,0,0,1,1
mrniko_redisson,org.redisson.api,8,1,0,1,1,14,1,26
mrniko_redisson,org.redisson.api.condition,0,0,0,0,0,0,1,1
mrniko_redisson,org.redisson.api.executor,0,0,0,0,0,0,1,1
mrniko_redisson,org.redisson.api.listener,0,0,0,0,1,0,1,2
mrniko_redisson,org.redisson.api.map.event,0,0,0,0,1,1,1,3
mrniko_redisson,org.redisson.api.map,0,0,0,0,0,0,1,1
mrniko_redisson,org.redisson.api.mapreduce,0,0,0,0,1,2,1,4
mrniko_redisson,org.redisson,41,1,0,2,1,14,1,60
mrniko_redisson,org.redisson.cache,16,1,0,1,1,0,1,20
mrniko_redisson,org.redisson.client,4,1,0,0,1,3,1,10
mrniko_redisson,org.redisson.client.codec,0,0,0,0,1,0,1,2
mrniko_redisson,org.redisson.client.handler,2,0,0,0,1,0,1,4
mrniko_redisson,org.redisson.client.protocol,6,1,0,0,1,1,1,10
mrniko_redisson,org.redisson.client.protocol.convertor,2,0,0,0,0,0,1,3
mrniko_redisson,org.redisson.client.protocol.decoder,0,0,0,1,0,2,1,4
mrniko_redisson,org.redisson.client.protocol.pubsub,0,0,0,0,0,0,1,1
mrniko_redisson,org.redisson.cluster,2,0,0,0,0,0,1,3
mrniko_redisson,org.redisson.codec,0,0,0,1,1,0,1,3
mrniko_redisson,org.redisson.command,3,0,0,0,1,3,1,8
mrniko_redisson,org.redisson.config,9,1,0,0,1,4,1,16
mrniko_redisson,org.redisson.connection,5,1,0,0,1,4,1,12
mrniko_redisson,org.redisson.connection.balancer,6,1,0,0,1,1,1,10
mrniko_redisson,org.redisson.connection.decoder,0,0,0,0,0,0,1,1
mrniko_redisson,org.redisson.connection.pool,0,0,0,0,1,0,1,2
mrniko_redisson,org.redisson.eviction,2,1,0,0,0,0,1,4
mrniko_redisson,org.redisson.executor,12,0,0,1,1,2,1,17
mrniko_redisson,org.redisson.executor.params,0,0,0,0,0,0,1,1
mrniko_redisson,org.redisson.jcache.bean,0,0,0,0,0,0,1,1
mrniko_redisson,org.redisson.jcache.configuration,0,0,0,0,0,0,1,1
mrniko_redisson,org.redisson.jcache,0,0,0,0,1,0,1,2
mrniko_redisson,org.redisson.liveobject.condition,0,0,0,0,1,1,1,3
mrniko_redisson,org.redisson.liveobject.core,0,0,0,0,1,0,1,2
mrniko_redisson,org.redisson.liveobject,1,0,0,0,0,1,1,3
mrniko_redisson,org.redisson.liveobject.misc,0,0,0,0,0,0,1,1
mrniko_redisson,org.redisson.liveobject.resolver,1,1,0,0,1,1,1,5
mrniko_redisson,org.redisson.mapreduce,0,0,0,0,0,2,1,3
mrniko_redisson,org.redisson.misc,16,1,0,0,1,5,1,24
mrniko_redisson,org.redisson.pubsub,1,1,0,0,1,0,1,4
mrniko_redisson,org.redisson.reactive,2,0,0,0,1,1,1,5
mrniko_redisson,org.redisson.remote,4,0,0,0,1,1,1,7
mrniko_redisson,org.redisson.rx,2,0,0,1,1,1,1,6
mrniko_redisson,org.redisson.spring.cache,0,0,0,0,1,0,1,2
mrniko_redisson,org.redisson.spring.misc,0,0,0,0,0,0,1,1
mrniko_redisson,org.redisson.spring.session.config,0,0,0,0,0,0,1,1
mrniko_redisson,org.redisson.spring.session,0,0,0,0,1,1,1,3
mrniko_redisson,org.redisson.spring.support,0,0,0,0,1,0,1,2
mrniko_redisson,org.redisson.spring.transaction,0,0,0,0,1,0,1,2
mrniko_redisson,org.redisson.transaction,9,1,0,0,1,0,1,12
mrniko_redisson,org.redisson.transaction.operation.bucket,2,0,0,0,1,0,1,4
mrniko_redisson,org.redisson.transaction.operation,2,0,0,0,0,0,1,3
mrniko_redisson,org.redisson.transaction.operation.map,2,0,0,0,0,0,1,3
mrniko_redisson,org.redisson.transaction.operation.set,2,1,0,0,0,0,1,4
mrniko_redisson,org.redisson.hibernate,0,0,0,0,1,0,1,2
mrniko_redisson,org.redisson.mybatis,0,0,0,0,0,0,1,1
mrniko_redisson,org.redisson.spring.starter,0,0,0,0,0,0,1,1
mrniko_redisson,org.redisson.spring.data.connection,0,0,0,1,1,2,1,5
mrniko_redisson,org.redisson.tomcat,0,0,0,1,1,1,1,4
mscharhag_oleaster,com.mscharhag.oleaster.examples,0,0,0,0,1,0,0,1
mscharhag_oleaster,com.mscharhag.oleaster.matcher.matchers,0,0,0,0,1,1,0,2
mscharhag_oleaster,com.mscharhag.oleaster.matcher.matchers.datetime,0,0,0,0,0,1,0,1
mscharhag_oleaster,com.mscharhag.oleaster.matcher,0,0,0,0,0,0,0,0
mscharhag_oleaster,com.mscharhag.oleaster.matcher.util,0,0,0,0,0,1,0,1
mscharhag_oleaster,com.mscharhag.oleaster.runner,0,0,0,0,1,0,0,1
mscharhag_oleaster,com.mscharhag.oleaster.runner.suite,0,0,0,0,0,0,0,0
mstahv_maddon,org.vaadin.viritin.button,0,0,0,0,1,0,0,1
mstahv_maddon,org.vaadin.viritin.components,0,0,0,0,0,0,0,0
mstahv_maddon,org.vaadin.viritin.fields,0,0,0,0,1,0,0,1
mstahv_maddon,org.vaadin.viritin.fluency.event,0,0,0,0,0,0,0,0
mstahv_maddon,org.vaadin.viritin.fluency.server,0,0,0,0,0,0,0,0
mstahv_maddon,org.vaadin.viritin.fluency.ui,0,0,0,0,1,0,0,1
mstahv_maddon,org.vaadin.viritin.form,0,0,0,0,0,0,0,0
mstahv_maddon,org.vaadin.viritin.grid,0,0,0,0,0,0,0,0
mstahv_maddon,org.vaadin.viritin.label,0,0,0,0,0,0,0,0
mstahv_maddon,org.vaadin.viritin.layouts,0,0,0,0,1,0,0,1
mstahv_maddon,org.vaadin.viritin,2,1,0,1,1,0,0,5
mstahv_maddon,org.vaadin.viritin.navigator,0,0,0,0,0,0,0,0
mstahv_maddon,org.vaadin.viritin.ui,0,0,0,0,0,0,0,0
mstahv_maddon,org.vaadin.viritin.util,0,0,0,0,1,0,0,1
mstahv_maddon,org.vaadin.viritin.it,0,0,0,0,1,0,0,1
mstahv_maddon,org.vaadin.viritin.it.examples,0,0,0,0,0,0,0,0
mstahv_maddon,org.vaadin.viritin.it.issues,0,0,0,0,1,0,0,1
mstahv_maddon,org.vaadin.viritin.it.locale,0,0,0,0,0,0,0,0
mstahv_maddon,org.vaadin.addonhelpers,0,0,0,0,0,0,0,0
mstahv_maddon,org.vaadin.viritinv7,4,0,0,1,1,0,0,6
mstahv_maddon,org.vaadin.viritinv7.fields,4,1,0,1,1,0,0,7
mstahv_maddon,org.vaadin.viritinv7.fields.config,0,0,0,0,0,0,0,0
mstahv_maddon,org.vaadin.viritinv7.fluency.data,0,0,0,0,1,0,0,1
mstahv_maddon,org.vaadin.viritinv7.fluency.event,0,0,0,0,1,0,0,1
mstahv_maddon,org.vaadin.viritinv7.fluency.ui,0,0,0,0,1,0,0,1
mstahv_maddon,org.vaadin.viritinv7.form,2,1,0,0,1,0,0,4
mstahv_maddon,org.vaadin.viritinv7.grid,0,0,0,0,1,0,0,1
mstahv_maddon,org.vaadin.viritinv7.grid.utils,0,0,0,0,0,0,0,0
mstahv_maddon,org.vaadin.viritinv7.label,0,0,0,0,0,0,0,0
mstahv_maddon,org.vaadin.viritin.it.aspect,0,0,0,0,0,0,0,0
mstahv_maddon,org.vaadin.viritinv7.examples,0,0,0,0,0,0,0,0
mstahv_maddon,org.vaadin.viritinv7.locale,0,0,0,0,0,0,0,0
mucommander_mucommander,org.apache.tools.bzip2,0,0,0,0,0,0,1,1
mucommander_mucommander,com.mucommander.commons.file.archiver,0,0,0,0,0,0,1,1
mucommander_mucommander,com.mucommander.commons.collections,0,0,0,0,0,0,1,1
mucommander_mucommander,com.mucommander.commons.conf,0,0,0,1,0,0,1,2
mucommander_mucommander,com.mucommander.commons.file,11,1,0,1,0,0,1,14
mucommander_mucommander,com.mucommander.commons.file.archive,2,0,0,0,0,0,1,3
mucommander_mucommander,com.mucommander.commons.file.compat,0,0,0,0,0,0,1,1
mucommander_mucommander,com.mucommander.commons.file.connection,0,0,0,0,0,0,1,1
mucommander_mucommander,com.mucommander.commons.file.filter,5,0,0,1,0,0,1,7
mucommander_mucommander,com.mucommander.commons.file.icon,2,0,0,0,0,0,1,3
mucommander_mucommander,com.mucommander.commons.file.icon.impl,0,0,0,0,0,0,1,1
mucommander_mucommander,com.mucommander.commons.file.osgi,0,0,0,0,0,0,1,1
mucommander_mucommander,com.mucommander.commons.file.protocol,1,0,0,0,0,0,1,2
mucommander_mucommander,com.mucommander.commons.file.protocol.local,4,0,0,0,1,0,1,6
mucommander_mucommander,com.mucommander.commons.file.util,3,1,0,0,1,0,1,6
mucommander_mucommander,com.mucommander.commons.io.base64,0,0,0,0,0,0,1,1
mucommander_mucommander,com.mucommander.commons.io,0,0,0,1,1,0,1,3
mucommander_mucommander,com.mucommander.commons.io.bom,0,0,0,0,0,0,1,1
mucommander_mucommander,com.mucommander.commons.io.compound,0,0,0,0,1,0,1,2
mucommander_mucommander,com.mucommander.commons.io.security,0,0,0,0,0,0,1,1
mucommander_mucommander,com.mucommander.commons.runtime,0,0,0,0,0,0,1,1
mucommander_mucommander,com.mucommander.commons.util,0,0,0,0,1,0,1,2
mucommander_mucommander,com.mucommander.commons.util.ui.border,0,0,0,0,0,0,1,1
mucommander_mucommander,com.mucommander.commons.util.ui.button,0,0,0,0,0,0,1,1
mucommander_mucommander,com.mucommander.commons.util.ui.combobox,0,0,0,0,0,0,1,1
mucommander_mucommander,com.mucommander.commons.util.ui.dialog,0,0,0,0,0,0,1,1
mucommander_mucommander,com.mucommander.commons.util.ui.helper,0,0,0,0,0,0,1,1
mucommander_mucommander,com.mucommander.commons.util.ui.layout,0,0,0,0,1,0,1,2
mucommander_mucommander,com.mucommander.commons.util.ui.text,0,0,0,0,0,0,1,1
mucommander_mucommander,com.mucommander,35,1,0,0,1,0,1,38
mucommander_mucommander,com.mucommander.auth,11,0,0,0,0,0,1,12
mucommander_mucommander,com.mucommander.bonjour,2,0,0,0,0,0,1,3
mucommander_mucommander,com.mucommander.bookmark,21,1,0,0,1,0,1,24
mucommander_mucommander,com.mucommander.bookmark.file,2,0,0,0,0,0,1,3
mucommander_mucommander,com.mucommander.cache,0,0,0,0,0,0,1,1
mucommander_mucommander,com.mucommander.command,0,0,0,0,0,0,1,1
mucommander_mucommander,com.mucommander.core,10,1,0,0,1,0,1,13
mucommander_mucommander,com.mucommander.desktop,7,1,0,0,1,0,1,10
mucommander_mucommander,com.mucommander.desktop.gnome,0,0,0,0,0,0,1,1
mucommander_mucommander,com.mucommander.desktop.kde,0,0,0,0,0,0,1,1
mucommander_mucommander,com.mucommander.desktop.openvms,0,0,0,0,0,0,1,1
mucommander_mucommander,com.mucommander.desktop.osx,0,0,0,0,0,0,1,1
mucommander_mucommander,com.mucommander.desktop.windows,0,0,0,0,0,0,1,1
mucommander_mucommander,com.mucommander.desktop.xfce,0,0,0,0,0,0,1,1
mucommander_mucommander,com.mucommander.extension,0,0,0,0,0,0,1,1
mucommander_mucommander,com.mucommander.job,6,1,0,0,1,0,1,9
mucommander_mucommander,com.mucommander.job.impl,5,1,0,0,1,0,1,8
mucommander_mucommander,com.mucommander.job.ui,1,0,0,0,0,0,1,2
mucommander_mucommander,com.mucommander.shell,3,0,0,0,0,0,1,4
mucommander_mucommander,com.mucommander.snapshot,5,1,0,0,0,0,1,7
mucommander_mucommander,com.mucommander.ui.action,11,1,0,0,0,0,1,13
mucommander_mucommander,com.mucommander.ui.action.impl,20,1,0,1,1,0,1,24
mucommander_mucommander,com.mucommander.ui.autocomplete,2,1,0,0,0,0,1,4
mucommander_mucommander,com.mucommander.ui.autocomplete.completers,2,1,0,0,0,0,1,4
mucommander_mucommander,com.mucommander.ui.autocomplete.completers.services,0,0,0,0,0,0,1,1
mucommander_mucommander,com.mucommander.ui.button,6,0,0,0,1,0,1,8
mucommander_mucommander,com.mucommander.ui.chooser,0,0,0,0,1,0,1,2
mucommander_mucommander,com.mucommander.ui.combobox,1,0,0,0,0,0,1,2
mucommander_mucommander,com.mucommander.ui.dialog.about,0,0,0,0,0,0,1,1
mucommander_mucommander,com.mucommander.ui.dialog.auth,4,0,0,0,0,0,1,5
mucommander_mucommander,com.mucommander.ui.dialog.bookmark,0,0,0,0,0,0,1,1
mucommander_mucommander,com.mucommander.ui.dialog.customization,0,0,0,0,0,0,1,1
mucommander_mucommander,com.mucommander.ui.dialog.debug,3,0,0,0,0,0,1,4
mucommander_mucommander,com.mucommander.ui.dialog.file,14,1,0,1,0,0,1,17
mucommander_mucommander,com.mucommander.ui.dialog.help,0,0,0,0,0,0,1,1
mucommander_mucommander,com.mucommander.ui.dialog,2,1,0,0,0,0,1,4
mucommander_mucommander,com.mucommander.ui.dialog.pref.component,1,1,0,0,0,0,1,3
mucommander_mucommander,com.mucommander.ui.dialog.pref.general,4,0,0,0,0,0,1,5
mucommander_mucommander,com.mucommander.ui.dialog.pref,1,1,0,0,0,0,1,3
mucommander_mucommander,com.mucommander.ui.dialog.pref.theme,0,0,0,0,0,0,1,1
mucommander_mucommander,com.mucommander.ui.dialog.server,3,0,0,0,0,0,1,4
mucommander_mucommander,com.mucommander.ui.dialog.shell,0,0,0,0,0,0,1,1
mucommander_mucommander,com.mucommander.ui.dialog.shutdown,3,0,0,0,0,0,1,4
mucommander_mucommander,com.mucommander.ui.dialog.startup,0,0,0,0,0,0,1,1
mucommander_mucommander,com.mucommander.ui.dialog.tab,0,0,0,0,0,0,1,1
mucommander_mucommander,com.mucommander.ui.dnd,2,1,0,0,0,0,1,4
mucommander_mucommander,com.mucommander.ui.event,8,1,0,0,1,0,1,11
mucommander_mucommander,com.mucommander.ui.icon,15,1,0,0,1,0,1,18
mucommander_mucommander,com.mucommander.ui.layout,2,0,0,0,0,0,1,3
mucommander_mucommander,com.mucommander.ui.list,2,0,0,0,1,0,1,4
mucommander_mucommander,com.mucommander.ui.macosx,2,0,0,0,1,0,1,4
mucommander_mucommander,com.mucommander.ui.main.commandbar,2,0,0,0,0,0,1,3
mucommander_mucommander,com.mucommander.ui.main,71,1,0,0,1,0,1,74
mucommander_mucommander,com.mucommander.ui.main.frame,2,0,0,0,0,0,1,3
mucommander_mucommander,com.mucommander.ui.main.menu,2,0,0,0,0,0,1,3
mucommander_mucommander,com.mucommander.ui.main.osgi,3,1,0,0,0,0,1,5
mucommander_mucommander,com.mucommander.ui.main.quicklist,4,0,0,0,1,0,1,6
mucommander_mucommander,com.mucommander.ui.main.table,16,1,0,0,0,0,1,18
mucommander_mucommander,com.mucommander.ui.main.tabs,4,1,0,0,0,0,1,6
mucommander_mucommander,com.mucommander.ui.main.toolbar,2,0,0,0,0,0,1,3
mucommander_mucommander,com.mucommander.ui.main.tree,4,0,0,0,0,0,1,5
mucommander_mucommander,com.mucommander.ui.notifier,2,1,0,0,0,0,1,4
mucommander_mucommander,com.mucommander.ui.popup,0,0,0,0,0,0,1,1
mucommander_mucommander,com.mucommander.ui.progress,0,0,0,0,0,0,1,1
mucommander_mucommander,com.mucommander.ui.quicklist.item,3,0,0,0,1,0,1,5
mucommander_mucommander,com.mucommander.ui.quicklist,3,0,0,0,0,0,1,4
mucommander_mucommander,com.mucommander.ui.quicksearch,0,0,0,0,0,0,1,1
mucommander_mucommander,com.mucommander.ui.table,0,0,0,0,0,0,1,1
mucommander_mucommander,com.mucommander.ui.tabs,0,0,0,0,1,0,1,2
mucommander_mucommander,com.mucommander.ui.text,1,1,0,0,0,0,1,3
mucommander_mucommander,com.mucommander.ui.theme,5,1,0,0,0,0,1,7
mucommander_mucommander,com.mucommander.ui.viewer,4,0,0,0,0,0,1,5
mucommander_mucommander,com.mucommander.ui.viewer.image,0,0,0,0,0,0,1,1
mucommander_mucommander,com.mucommander.ui.viewer.text,3,0,0,0,0,0,1,4
mucommander_mucommander,com.mucommander.utils,3,1,0,0,0,0,1,5
mucommander_mucommander,com.mucommander.xml,0,0,0,0,0,0,1,1
mucommander_mucommander,com.mucommander.ui.encoding,0,0,0,0,0,0,1,1
mucommander_mucommander,com.mucommander.commons.file.archive.ar,0,0,0,0,0,0,1,1
mucommander_mucommander,com.mucommander.commons.file.archive.bzip2,0,0,0,0,0,0,1,1
mucommander_mucommander,com.mucommander.commons.file.archive.gzip,0,0,0,0,0,0,1,1
mucommander_mucommander,com.mucommander.commons.file.archive.iso,0,0,0,0,0,0,1,1
mucommander_mucommander,com.mucommander.commons.file.archive.libguestfs,0,0,0,0,0,0,1,1
mucommander_mucommander,com.mucommander.commons.file.archive.lst,0,0,0,0,0,0,1,1
mucommander_mucommander,com.mucommander.commons.file.archive.rar,0,0,0,0,0,0,1,1
mucommander_mucommander,com.mucommander.commons.file.archive.sevenzip,0,0,0,0,1,0,1,2
mucommander_mucommander,com.mucommander.commons.file.archive.sevenzip.provider.Common,1,1,0,0,1,0,1,4
mucommander_mucommander,com.mucommander.commons.file.archive.sevenzip.provider.SevenZip.Archive.Common,0,0,0,0,1,0,1,2
mucommander_mucommander,com.mucommander.commons.file.archive.sevenzip.provider.SevenZip.Archive,1,1,0,0,0,0,1,3
mucommander_mucommander,com.mucommander.commons.file.archive.sevenzip.provider.SevenZip.Archive.SevenZip,0,0,0,0,0,0,1,1
mucommander_mucommander,com.mucommander.commons.file.archive.sevenzip.provider.SevenZip,4,1,0,0,1,0,1,7
mucommander_mucommander,com.mucommander.commons.file.archive.sevenzip.provider.SevenZip.Common,1,0,0,0,0,0,1,2
mucommander_mucommander,com.mucommander.commons.file.archive.sevenzip.provider.SevenZip.Compression.Branch,0,0,0,0,0,0,1,1
mucommander_mucommander,com.mucommander.commons.file.archive.sevenzip.provider.SevenZip.Compression.Copy,0,0,0,0,0,0,1,1
mucommander_mucommander,com.mucommander.commons.file.archive.sevenzip.provider.SevenZip.Compression.LZ,0,0,0,0,0,0,1,1
mucommander_mucommander,com.mucommander.commons.file.archive.sevenzip.provider.SevenZip.Compression.LZMA,2,0,0,0,0,0,1,3
mucommander_mucommander,com.mucommander.commons.file.archive.sevenzip.provider.SevenZip.Compression.RangeCoder,1,1,0,0,0,0,1,3
mucommander_mucommander,com.mucommander.commons.file.archive.tar,0,0,0,0,0,0,1,1
mucommander_mucommander,com.mucommander.commons.file.archive.tar.provider,0,0,0,0,0,0,1,1
mucommander_mucommander,com.mucommander.commons.file.archive.zip,0,0,0,0,0,0,1,1
mucommander_mucommander,com.mucommander.commons.file.archive.zip.provider,0,0,0,0,0,0,1,1
mucommander_mucommander,com.mucommander.conf,0,0,0,0,0,0,1,1
mucommander_mucommander,com.mucommander.io.backup,0,0,0,0,0,0,1,1
mucommander_mucommander,com.mucommander.process,0,1,0,0,0,0,1,2
mucommander_mucommander,com.mucommander.protocol.ui,0,0,0,0,0,0,1,1
mucommander_mucommander,com.mucommander.commons.file.protocol.ftp,0,0,0,0,1,0,1,2
mucommander_mucommander,com.mucommander.commons.file.protocol.hadoop,0,0,0,0,1,0,1,2
mucommander_mucommander,com.mucommander.commons.file.protocol.http,0,0,0,0,1,0,1,2
mucommander_mucommander,com.mucommander.commons.file.protocol.nfs,0,0,0,0,1,0,1,2
mucommander_mucommander,com.mucommander.commons.file.protocol.ovirt,0,0,0,0,0,0,1,1
mucommander_mucommander,com.mucommander.commons.file.protocol.registry,0,0,0,0,0,0,1,1
mucommander_mucommander,com.mucommander.commons.file.protocol.s3,0,0,0,0,1,0,1,2
mucommander_mucommander,com.mucommander.commons.file.protocol.sftp,0,0,0,0,1,0,1,2
mucommander_mucommander,com.mucommander.commons.file.protocol.smb,0,0,0,0,1,0,1,2
mucommander_mucommander,com.mucommander.commons.file.protocol.vsphere,0,0,0,0,1,0,1,2
mucommander_mucommander,com.mucommander.text,0,1,0,0,0,0,1,2
mulesoft-labs_rhinodo,org.mule.tools.rhinodo.api,0,0,0,0,0,0,0,0
mulesoft-labs_rhinodo,org.mule.tools.rhinodo.impl.console,0,0,0,0,0,0,0,0
mulesoft-labs_rhinodo,org.mule.tools.rhinodo.impl,0,0,0,0,1,0,0,1
mulesoft-labs_rhinodo,org.mule.tools.rhinodo.main,0,0,0,0,0,0,0,0
mulesoft-labs_rhinodo,org.mule.tools.rhinodo.maven,0,0,0,0,0,0,0,0
mulesoft-labs_rhinodo,org.mule.tools.rhinodo.node,0,0,0,0,0,0,0,0
mulesoft-labs_rhinodo,org.mule.tools.rhinodo.node.child_process,0,0,0,0,0,0,0,0
mulesoft-labs_rhinodo,org.mule.tools.rhinodo.node.fs,0,0,0,0,1,0,0,1
mulesoft-labs_rhinodo,org.mule.tools.rhinodo.node.process.console,0,0,0,0,0,0,0,0
mulesoft-labs_rhinodo,org.mule.tools.rhinodo.node.process,0,0,0,0,0,0,0,0
mulesoft-labs_rhinodo,org.mule.tools.rhinodo.node.timer,0,0,0,0,0,0,0,0
mulesoft-labs_rhinodo,org.mule.tools.rhinodo.node.vm,0,0,0,0,0,0,0,0
mulesoft-labs_rhinodo,org.mule.tools.rhinodo.rhino,0,0,0,0,1,0,0,1
mulesoft-labs_rhinodo,org.mule.tools.rhinodo.tools,0,0,0,0,0,0,0,0
mulesoft_jaxrs-to-raml,org.raml.jaxrs.model,0,0,0,0,1,0,0,1
mulesoft_jaxrs-to-raml,org.raml.jaxrs.parser.analyzers,0,0,0,0,1,0,0,1
mulesoft_jaxrs-to-raml,org.raml.jaxrs.parser.gatherers,0,0,0,0,0,0,0,0
mulesoft_jaxrs-to-raml,org.raml.jaxrs.parser,0,0,0,0,0,0,0,0
mulesoft_jaxrs-to-raml,org.raml.jaxrs.parser.model,0,0,0,0,1,0,0,1
mulesoft_jaxrs-to-raml,org.raml.jaxrs.parser.source,0,0,0,0,1,0,0,1
mulesoft_jaxrs-to-raml,org.raml.jaxrs.parser.util,0,0,0,0,0,0,0,0
mulesoft_jaxrs-to-raml,org.raml.jaxrs.examples.delete,0,0,0,0,0,0,0,0
mulesoft_jaxrs-to-raml,org.raml.jaxrs.examples.get,0,0,0,0,0,0,0,0
mulesoft_jaxrs-to-raml,org.raml.jaxrs.examples.head,0,0,0,0,0,0,0,0
mulesoft_jaxrs-to-raml,org.raml.jaxrs.examples.path,0,0,0,0,1,0,0,1
mulesoft_jaxrs-to-raml,org.raml.jaxrs.examples.post,0,0,0,0,0,0,0,0
mulesoft_jaxrs-to-raml,org.raml.jaxrs.examples.put,0,0,0,0,0,0,0,0
mulesoft_jaxrs-to-raml,org.raml.jaxrs.examples.resources,0,0,0,0,1,0,0,1
mulesoft_jaxrs-to-raml,org.raml.jaxrs.examples,0,0,0,0,0,0,0,0
mulesoft_jaxrs-to-raml,org.raml.jaxrs.cli,0,0,0,0,0,0,0,0
mulesoft_jaxrs-to-raml,org.raml.jaxrs.converter,0,0,0,0,0,0,0,0
mulesoft_jaxrs-to-raml,org.raml.jaxrs.converter.model,0,0,0,0,0,0,0,0
mulesoft_jaxrs-to-raml,org.raml.jaxrs.raml.core,0,1,0,0,0,0,0,1
mulesoft_jaxrs-to-raml,org.raml.jaxrs.examples.annotations,0,0,0,0,1,0,0,1
mulesoft_jaxrs-to-raml,org.raml.jaxrs.examples.multipart,0,0,0,0,0,0,0,0
mulesoft_jaxrs-to-raml,org.raml.jaxrs.examples.ramlexamples,0,0,0,0,0,0,0,0
mulesoft_jaxrs-to-raml,org.raml.jaxrs.examples.types,0,0,0,0,0,0,0,0
mulesoft_jaxrs-to-raml,org.raml.jaxrs.plugin,0,0,0,0,0,0,0,0
mulesoft_jaxrs-to-raml,org.raml.api,0,0,0,0,1,0,0,1
mulesoft_jaxrs-to-raml,org.raml.emitter,0,0,0,0,0,0,0,0
mulesoft_jaxrs-to-raml,org.raml.emitter.plugins,0,0,0,0,0,0,0,0
mulesoft_jaxrs-to-raml,org.raml.jaxrs.emitters,0,0,0,0,0,0,0,0
mulesoft_jaxrs-to-raml,org.raml.jaxrs.handlers,0,0,0,0,1,0,0,1
mulesoft_jaxrs-to-raml,org.raml.jaxrs.plugins,0,0,0,0,0,0,0,0
mulesoft_jaxrs-to-raml,org.raml.jaxrs.types,0,0,0,0,1,0,0,1
mulesoft_jaxrs-to-raml,server.zoo,0,0,0,0,0,1,0,1
mulesoft_jaxrs-to-raml,org.raml.jaxrs.features,0,0,0,0,0,0,0,0
mulesoft_jaxrs-to-raml,features.model,0,0,0,0,0,0,0,0
mulesoft_jaxrs-to-raml,example.model,0,0,0,1,1,2,0,4
mulesoft_jaxrs-to-raml,example.resources,0,0,0,0,0,1,0,1
mulesoft_jaxrs-to-raml,example.support,0,0,0,0,1,0,0,1
mulesoft_jaxrs-to-raml,server.multipart,0,0,0,0,0,0,0,0
mulesoft_jaxrs-to-raml,example.resource,0,0,0,0,0,0,0,0
mulesoft_jaxrs-to-raml,server.humanity,0,0,0,0,0,1,0,1
mulesoft_jaxrs-to-raml,example.types,0,0,0,0,1,1,0,2
mulesoft_jaxrs-to-raml,example.references,0,0,0,0,1,0,0,1
mulesoft_jaxrs-to-raml,server.search,0,0,0,0,0,0,0,0
mulesoft_jaxrs-to-raml,example.scalar,0,0,0,0,0,0,0,0
mulesoft_jaxrs-to-raml,server.tracks,0,0,0,0,0,0,0,0
mulesoft_jaxrs-to-raml,example.jsonschema,0,0,0,0,0,0,0,0
mulesoft_jaxrs-to-raml,server.raml08,0,0,0,0,0,0,0,0
mulesoft_jaxrs-to-raml,example.simpleraml08,0,0,0,0,1,0,0,1
mulesoft_jaxrs-to-raml,server.hr,0,0,0,0,0,0,0,0
mulesoft_jaxrs-to-raml,example.xmlschema,0,0,0,0,1,0,0,1
mulesoft_jaxrs-to-raml,example.torture,0,0,0,0,1,0,0,1
mulesoft_jaxrs-to-raml,org.raml.jaxrs.generator.builders,0,0,0,0,1,0,0,1
mulesoft_jaxrs-to-raml,org.raml.jaxrs.generator.builders.extensions,0,0,0,0,0,0,0,0
mulesoft_jaxrs-to-raml,org.raml.jaxrs.generator.builders.extensions.resources,0,0,0,0,0,0,0,0
mulesoft_jaxrs-to-raml,org.raml.jaxrs.generator.builders.resources,0,0,0,0,0,0,0,0
mulesoft_jaxrs-to-raml,org.raml.jaxrs.generator,2,1,0,0,1,0,0,4
mulesoft_jaxrs-to-raml,org.raml.jaxrs.generator.extension,0,0,0,0,0,0,0,0
mulesoft_jaxrs-to-raml,org.raml.jaxrs.generator.extension.resources.api,0,0,0,0,0,0,0,0
mulesoft_jaxrs-to-raml,org.raml.jaxrs.generator.extension.resources,0,0,0,0,1,0,0,1
mulesoft_jaxrs-to-raml,org.raml.jaxrs.generator.ramltypes,0,0,0,0,1,0,0,1
mulesoft_jaxrs-to-raml,org.raml.jaxrs.generator.v08,0,0,0,0,1,0,0,1
mulesoft_jaxrs-to-raml,org.raml.jaxrs.generator.v10,4,1,0,0,1,0,0,6
mulesoft_jaxrs-to-raml,org.raml.jaxrs.generator.v10.types,2,0,0,0,0,0,0,2
mulesoft_jaxrs-to-raml,org.raml.jaxrs.generator.matchers,0,0,0,0,1,0,0,1
mulesoft_jaxrs-to-raml,org.raml.jaxrs.generator.utils,1,1,0,0,0,0,0,2
mulesoft_jaxrs-to-raml,org.raml.jaxrs.ramltojaxrs,0,0,0,0,0,0,0,0
mulesoft_jaxrs-to-raml,org.raml.jaxrs.codegen.maven,0,0,0,0,0,0,0,0
mulesoft_jaxrs-to-raml,org.raml.utilities.builder,0,0,0,0,0,0,0,0
mulesoft_jaxrs-to-raml,org.raml.utilities.contract,0,0,0,0,0,0,0,0
mulesoft_jaxrs-to-raml,org.raml.utilities.format,0,0,0,0,0,0,0,0
mulesoft_jaxrs-to-raml,org.raml.utilities.iterables,0,0,0,0,0,0,0,0
mulesoft_jaxrs-to-raml,org.raml.utilities.matchers,0,0,0,0,0,0,0,0
mulesoft_jaxrs-to-raml,org.raml.utilities.tuples,0,0,0,0,0,0,0,0
mulesoft_jaxrs-to-raml,org.raml.utilities.types,0,0,0,0,0,0,0,0
mulesoft_raml-for-jax-rs,org.raml.jaxrs.model,0,0,0,0,1,0,0,1
mulesoft_raml-for-jax-rs,org.raml.jaxrs.parser.analyzers,0,0,0,0,1,0,0,1
mulesoft_raml-for-jax-rs,org.raml.jaxrs.parser.gatherers,0,0,0,0,0,0,0,0
mulesoft_raml-for-jax-rs,org.raml.jaxrs.parser,0,0,0,0,0,0,0,0
mulesoft_raml-for-jax-rs,org.raml.jaxrs.parser.model,0,0,0,0,1,0,0,1
mulesoft_raml-for-jax-rs,org.raml.jaxrs.parser.source,0,0,0,0,1,0,0,1
mulesoft_raml-for-jax-rs,org.raml.jaxrs.parser.util,0,0,0,0,0,0,0,0
mulesoft_raml-for-jax-rs,org.raml.jaxrs.examples.delete,0,0,0,0,0,0,0,0
mulesoft_raml-for-jax-rs,org.raml.jaxrs.examples.get,0,0,0,0,0,0,0,0
mulesoft_raml-for-jax-rs,org.raml.jaxrs.examples.head,0,0,0,0,0,0,0,0
mulesoft_raml-for-jax-rs,org.raml.jaxrs.examples.path,0,0,0,0,1,0,0,1
mulesoft_raml-for-jax-rs,org.raml.jaxrs.examples.post,0,0,0,0,0,0,0,0
mulesoft_raml-for-jax-rs,org.raml.jaxrs.examples.put,0,0,0,0,0,0,0,0
mulesoft_raml-for-jax-rs,org.raml.jaxrs.examples.resources,0,0,0,0,1,0,0,1
mulesoft_raml-for-jax-rs,org.raml.jaxrs.examples,0,0,0,0,0,0,0,0
mulesoft_raml-for-jax-rs,org.raml.jaxrs.cli,0,0,0,0,0,0,0,0
mulesoft_raml-for-jax-rs,org.raml.jaxrs.converter,0,0,0,0,0,0,0,0
mulesoft_raml-for-jax-rs,org.raml.jaxrs.converter.model,0,0,0,0,0,0,0,0
mulesoft_raml-for-jax-rs,org.raml.jaxrs.raml.core,0,1,0,0,0,0,0,1
mulesoft_raml-for-jax-rs,org.raml.jaxrs.examples.annotations,0,0,0,0,1,0,0,1
mulesoft_raml-for-jax-rs,org.raml.jaxrs.examples.multipart,0,0,0,0,0,0,0,0
mulesoft_raml-for-jax-rs,org.raml.jaxrs.examples.ramlexamples,0,0,0,0,0,0,0,0
mulesoft_raml-for-jax-rs,org.raml.jaxrs.examples.types,0,0,0,0,0,0,0,0
mulesoft_raml-for-jax-rs,org.raml.jaxrs.plugin,0,0,0,0,0,0,0,0
mulesoft_raml-for-jax-rs,org.raml.api,0,0,0,0,1,0,0,1
mulesoft_raml-for-jax-rs,org.raml.emitter,0,0,0,0,0,0,0,0
mulesoft_raml-for-jax-rs,org.raml.emitter.plugins,0,0,0,0,0,0,0,0
mulesoft_raml-for-jax-rs,org.raml.jaxrs.emitters,0,0,0,0,0,0,0,0
mulesoft_raml-for-jax-rs,org.raml.jaxrs.handlers,0,0,0,0,1,0,0,1
mulesoft_raml-for-jax-rs,org.raml.jaxrs.plugins,0,0,0,0,0,0,0,0
mulesoft_raml-for-jax-rs,org.raml.jaxrs.types,0,0,0,0,1,0,0,1
mulesoft_raml-for-jax-rs,server.zoo,0,0,0,0,0,1,0,1
mulesoft_raml-for-jax-rs,org.raml.jaxrs.features,0,0,0,0,0,0,0,0
mulesoft_raml-for-jax-rs,features.model,0,0,0,0,0,0,0,0
mulesoft_raml-for-jax-rs,example.model,0,0,0,1,1,2,0,4
mulesoft_raml-for-jax-rs,example.resources,0,0,0,0,0,1,0,1
mulesoft_raml-for-jax-rs,example.support,0,0,0,0,1,0,0,1
mulesoft_raml-for-jax-rs,server.multipart,0,0,0,0,0,0,0,0
mulesoft_raml-for-jax-rs,example.resource,0,0,0,0,0,0,0,0
mulesoft_raml-for-jax-rs,server.humanity,0,0,0,0,0,1,0,1
mulesoft_raml-for-jax-rs,example.types,0,0,0,0,1,1,0,2
mulesoft_raml-for-jax-rs,example.references,0,0,0,0,1,0,0,1
mulesoft_raml-for-jax-rs,server.search,0,0,0,0,0,0,0,0
mulesoft_raml-for-jax-rs,example.scalar,0,0,0,0,0,0,0,0
mulesoft_raml-for-jax-rs,server.tracks,0,0,0,0,0,0,0,0
mulesoft_raml-for-jax-rs,example.jsonschema,0,0,0,0,0,0,0,0
mulesoft_raml-for-jax-rs,server.raml08,0,0,0,0,0,0,0,0
mulesoft_raml-for-jax-rs,example.simpleraml08,0,0,0,0,1,0,0,1
mulesoft_raml-for-jax-rs,server.hr,0,0,0,0,0,0,0,0
mulesoft_raml-for-jax-rs,example.xmlschema,0,0,0,0,1,0,0,1
mulesoft_raml-for-jax-rs,example.torture,0,0,0,0,1,0,0,1
mulesoft_raml-for-jax-rs,org.raml.jaxrs.generator.builders,0,0,0,0,1,0,0,1
mulesoft_raml-for-jax-rs,org.raml.jaxrs.generator.builders.extensions,0,0,0,0,0,0,0,0
mulesoft_raml-for-jax-rs,org.raml.jaxrs.generator.builders.extensions.resources,0,0,0,0,0,0,0,0
mulesoft_raml-for-jax-rs,org.raml.jaxrs.generator.builders.resources,0,0,0,0,0,0,0,0
mulesoft_raml-for-jax-rs,org.raml.jaxrs.generator,2,1,0,0,1,0,0,4
mulesoft_raml-for-jax-rs,org.raml.jaxrs.generator.extension,0,0,0,0,0,0,0,0
mulesoft_raml-for-jax-rs,org.raml.jaxrs.generator.extension.resources.api,0,0,0,0,0,0,0,0
mulesoft_raml-for-jax-rs,org.raml.jaxrs.generator.extension.resources,0,0,0,0,1,0,0,1
mulesoft_raml-for-jax-rs,org.raml.jaxrs.generator.ramltypes,0,0,0,0,1,0,0,1
mulesoft_raml-for-jax-rs,org.raml.jaxrs.generator.v08,0,0,0,0,1,0,0,1
mulesoft_raml-for-jax-rs,org.raml.jaxrs.generator.v10,4,1,0,0,1,0,0,6
mulesoft_raml-for-jax-rs,org.raml.jaxrs.generator.v10.types,2,0,0,0,0,0,0,2
mulesoft_raml-for-jax-rs,org.raml.jaxrs.generator.matchers,0,0,0,0,1,0,0,1
mulesoft_raml-for-jax-rs,org.raml.jaxrs.generator.utils,1,1,0,0,0,0,0,2
mulesoft_raml-for-jax-rs,org.raml.jaxrs.ramltojaxrs,0,0,0,0,0,0,0,0
mulesoft_raml-for-jax-rs,org.raml.jaxrs.codegen.maven,0,0,0,0,0,0,0,0
mulesoft_raml-for-jax-rs,org.raml.utilities.builder,0,0,0,0,0,0,0,0
mulesoft_raml-for-jax-rs,org.raml.utilities.contract,0,0,0,0,0,0,0,0
mulesoft_raml-for-jax-rs,org.raml.utilities.format,0,0,0,0,0,0,0,0
mulesoft_raml-for-jax-rs,org.raml.utilities.iterables,0,0,0,0,0,0,0,0
mulesoft_raml-for-jax-rs,org.raml.utilities.matchers,0,0,0,0,0,0,0,0
mulesoft_raml-for-jax-rs,org.raml.utilities.tuples,0,0,0,0,0,0,0,0
mulesoft_raml-for-jax-rs,org.raml.utilities.types,0,0,0,0,0,0,0,0
mulesoft_raml-jaxrs-codegen,org.raml.jaxrs.codegen.core,0,0,0,0,1,0,0,1
mulesoft_raml-jaxrs-codegen,raml.jaxrs.eclipse.plugin,0,0,0,0,0,0,0,0
mulesoft_raml-jaxrs-codegen,org.raml.jaxrs.example.impl,0,0,0,0,0,0,0,0
mulesoft_raml-jaxrs-codegen,org.raml.jaxrs.example,0,0,0,0,0,0,0,0
mulesoft_raml-jaxrs-codegen,org.raml.jaxrs.codegen.maven,0,0,0,0,0,0,0,0
my2iu_Jinq,ch.epfl.labos.iu.orm.queryll2.path,1,0,0,0,1,2,0,4
my2iu_Jinq,ch.epfl.labos.iu.orm.queryll2.symbolic,1,1,0,1,0,2,0,5
my2iu_Jinq,com.user00.thunk,0,0,0,0,0,0,0,0
my2iu_Jinq,org.jinq.orm.internal,0,0,0,0,0,0,0,0
my2iu_Jinq,org.jinq.orm.stream,0,0,0,0,0,3,0,3
my2iu_Jinq,org.jinq.tuples,0,0,0,0,0,3,0,3
my2iu_Jinq,org.jinq.hibernate,0,0,0,0,1,1,0,2
my2iu_Jinq,org.jinq.hibernate.transform,0,0,0,0,0,0,0,0
my2iu_Jinq,org.jinq.jooq,0,0,0,0,1,0,0,1
my2iu_Jinq,org.jinq.jooq.querygen,0,0,0,0,0,0,0,0
my2iu_Jinq,org.jinq.jooq.transform,0,0,0,0,1,0,0,1
my2iu_Jinq,org.jinq.jpa,0,1,0,0,1,3,0,5
my2iu_Jinq,org.jinq.jpa.jpqlquery,0,0,0,1,0,2,0,3
my2iu_Jinq,org.jinq.jpa.transform,0,0,0,1,0,3,0,4
my2iu_Jinq,(default package),0,0,0,0,0,0,0,0
mybatis_cdi,(default package),0,0,0,0,0,0,0,0
mybatis_cdi,org.mybatis.cdi,0,0,0,0,1,0,0,1
nathantippy_jFASTStages,com.ociweb.jpgRaster.j2r,1,0,0,0,1,0,1,3
nathantippy_jFASTStages,com.ociweb.jpgRaster,2,1,0,0,1,0,1,5
nathantippy_jFASTStages,com.ociweb.jpgRaster.r2j,1,0,0,0,1,0,1,3
nathantippy_jFASTStages,com.ociweb.logtelemetry,0,0,0,0,0,1,1,2
nathantippy_jFASTStages,com.ociweb.pronghorn.network,16,1,0,1,1,7,1,27
nathantippy_jFASTStages,com.ociweb.pronghorn,4,0,0,0,0,0,1,5
nathantippy_jFASTStages,com.ociweb.pronghorn.code,3,0,0,0,1,1,1,6
nathantippy_jFASTStages,com.ociweb.pronghorn.components.ingestion.csv,0,0,0,0,1,0,1,2
nathantippy_jFASTStages,com.ociweb.pronghorn.components.ingestion.metaMessageUtil,0,1,0,0,0,0,1,2
nathantippy_jFASTStages,com.ociweb.pronghorn.network.config,7,1,0,0,1,1,1,11
nathantippy_jFASTStages,com.ociweb.pronghorn.network.http,6,0,0,0,1,6,1,14
nathantippy_jFASTStages,com.ociweb.pronghorn.network.module,10,0,0,0,1,2,1,14
nathantippy_jFASTStages,com.ociweb.pronghorn.network.mqtt,0,0,0,0,1,0,1,2
nathantippy_jFASTStages,com.ociweb.pronghorn.network.schema,1,1,0,0,1,1,1,5
nathantippy_jFASTStages,com.ociweb.pronghorn.network.twitter,2,0,0,0,0,0,1,3
nathantippy_jFASTStages,com.ociweb.pronghorn.neural,0,0,0,0,0,0,1,1
nathantippy_jFASTStages,com.ociweb.pronghorn.stage.blocking,0,0,0,0,1,0,1,2
nathantippy_jFASTStages,com.ociweb.pronghorn.stage.encrypt,1,0,0,0,0,0,1,2
nathantippy_jFASTStages,com.ociweb.pronghorn.stage.file,1,1,0,0,1,3,1,7
nathantippy_jFASTStages,com.ociweb.pronghorn.stage.file.schema,0,0,0,0,1,1,1,3
nathantippy_jFASTStages,com.ociweb.pronghorn.stage.filter,0,0,0,0,1,1,1,3
nathantippy_jFASTStages,com.ociweb.pronghorn.stage.generator,5,0,0,0,0,0,1,6
nathantippy_jFASTStages,com.ociweb.pronghorn.stage.generator.protoBufInterface,0,0,0,0,0,0,1,1
nathantippy_jFASTStages,com.ociweb.pronghorn.stage.math,0,0,0,0,1,1,1,3
nathantippy_jFASTStages,com.ociweb.pronghorn.stage.memory,0,0,0,0,0,0,1,1
nathantippy_jFASTStages,com.ociweb.pronghorn.stage.monitor,6,1,0,0,0,2,1,10
nathantippy_jFASTStages,com.ociweb.pronghorn.stage.phast,3,0,0,0,1,1,1,6
nathantippy_jFASTStages,com.ociweb.pronghorn.stage,10,1,0,0,1,2,1,15
nathantippy_jFASTStages,com.ociweb.pronghorn.stage.route,2,0,0,0,0,0,1,3
nathantippy_jFASTStages,com.ociweb.pronghorn.stage.scheduling,22,1,0,0,1,9,1,34
nathantippy_jFASTStages,com.ociweb.pronghorn.stage.stream,0,0,0,0,0,0,1,1
nathantippy_jFASTStages,com.ociweb.pronghorn.util,6,1,0,1,1,6,1,16
nathantippy_jFASTStages,com.ociweb.pronghorn.util.columns,0,0,0,0,1,0,1,2
nathantippy_jFASTStages,com.ociweb.pronghorn.columns,0,0,0,0,0,0,1,1
nathantippy_jFASTStages,com.ociweb.pronghorn.example,0,0,0,0,0,0,1,1
nathantippy_jFASTStages,com.ociweb.pronghorn.pipe,14,1,0,1,1,24,1,42
nathantippy_jFASTStages,com.ociweb.pronghorn.stage.network,0,0,0,0,1,3,1,5
nathantippy_jFASTStages,com.ociweb.pronghorn.stage.network.schema,0,0,0,0,0,0,1,1
nathantippy_jFASTStages,com.ociweb.json.decode,0,1,0,0,0,1,1,3
nathantippy_jFASTStages,com.ociweb.json.encode.function,0,0,0,0,1,2,1,4
nathantippy_jFASTStages,com.ociweb.json.encode,0,0,0,0,0,2,1,3
nathantippy_jFASTStages,com.ociweb.json,0,0,0,0,0,0,1,1
nathantippy_jFASTStages,com.ociweb.pronghorn.pipe.proxy,0,0,0,0,1,0,1,2
nathantippy_jFASTStages,com.ociweb.pronghorn.pipe.schema.generator,0,0,0,0,0,0,1,1
nathantippy_jFASTStages,com.ociweb.pronghorn.pipe.schema.loader,4,0,0,0,0,3,1,8
nathantippy_jFASTStages,com.ociweb.pronghorn.pipe.stream,3,0,0,0,1,0,1,5
nathantippy_jFASTStages,com.ociweb.pronghorn.pipe.token,2,1,0,0,0,3,1,7
nathantippy_jFASTStages,com.ociweb.pronghorn.pipe.util,3,0,0,0,1,1,1,6
nathantippy_jFASTStages,com.ociweb.pronghorn.pipe.util.build,0,0,0,0,1,3,1,5
nathantippy_jFASTStages,com.ociweb.pronghorn.pipe.util.hash,0,0,0,0,0,1,1,2
nathantippy_jFASTStages,com.ociweb.pronghorn.struct,3,0,0,0,1,3,1,8
nathantippy_jFASTStages,com.ociweb.pronghorn.util.field,0,0,0,0,1,0,1,2
nathantippy_jFASTStages,com.ociweb.pronghorn.util.ma,0,0,0,0,1,0,1,2
nathantippy_jFASTStages,com.ociweb.pronghorn.util.math,0,0,0,0,1,0,1,2
nathantippy_jFASTStages,com.ociweb.pronghorn.util.parse,3,0,0,0,1,3,1,8
nathantippy_jFASTStages,com.ociweb.pronghorn.util.primitive,0,0,0,0,1,0,1,2
nathantippy_jFASTStages,com.ociweb.pronghorn.util.search,0,0,0,0,0,0,1,1
nathantippy_jFASTStages,com.ociweb.pronghorn.util.template,0,0,0,0,1,1,1,3
nathantippy_jFASTStages,com.ociweb.json.parse,0,0,0,0,0,0,1,1
nathantippy_jFASTStages,com.ociweb.pronghorn.pipe.build,0,0,0,0,0,1,1,2
nathantippy_jFASTStages,com.ociweb.pronghorn.pipe.template,0,0,0,0,0,0,1,1
nathantippy_jFASTStages,$,0,0,0,0,1,2,1,4
nathantippy_jFASTStages,com.ociweb,0,0,0,0,1,1,1,3
nativelibs4java_BridJ,com.nativelibs4java.bridj.example,0,0,0,0,0,0,0,0
nativelibs4java_BridJ,org.bridj,13,1,0,2,0,1,0,17
nativelibs4java_BridJ,(default package),0,0,0,0,0,0,0,0
nativelibs4java_BridJ,com.example.hellojni,0,0,0,0,0,0,0,0
nativelibs4java_BridJ,com.example.HelloJni,0,0,0,0,0,0,0,0
nativelibs4java_BridJ,org.bridj.demos,0,0,0,0,0,0,0,0
nativelibs4java_BridJ,org.bridj.cpp.com,0,0,0,1,1,0,0,2
nativelibs4java_BridJ,org.bridj.cpp.com.shell,0,0,0,0,1,0,0,1
nativelibs4java_BridJ,org.bridj.cpp,6,0,0,0,1,1,0,8
nativelibs4java_BridJ,org.bridj.cpp.mfc,0,0,0,0,1,0,0,1
nativelibs4java_BridJ,org.bridj.cpp.std,4,0,0,0,0,0,0,4
nativelibs4java_BridJ,org.bridj.demangling,4,0,0,0,0,1,0,5
nativelibs4java_BridJ,org.bridj.dyncall,0,0,0,0,0,0,0,0
nativelibs4java_BridJ,org.bridj.func,0,0,0,0,0,0,0,0
nativelibs4java_BridJ,org.bridj.jawt,1,1,0,0,1,0,0,3
nativelibs4java_BridJ,org.bridj.objc,2,0,0,0,0,0,0,2
nativelibs4java_BridJ,org.bridj.util,7,1,0,0,1,0,0,9
nativelibs4java_BridJ,org.bridj.examples,0,0,0,0,0,0,0,0
naver_ngrinder,liquibase.database.core,0,0,0,0,0,0,1,1
naver_ngrinder,org.hibernate.dialect,0,0,0,0,0,0,1,1
naver_ngrinder,org.ngrinder.agent.controller,0,0,0,0,1,0,1,2
naver_ngrinder,org.ngrinder.agent.model,1,0,0,0,0,0,1,2
naver_ngrinder,org.ngrinder.agent.repository,0,0,0,0,0,0,1,1
naver_ngrinder,org.ngrinder.agent.service,7,1,0,0,0,0,1,9
naver_ngrinder,org.ngrinder.agent.store,1,0,0,0,0,0,1,2
naver_ngrinder,org.ngrinder.common.constant,0,0,0,0,0,0,1,1
naver_ngrinder,org.ngrinder.common.controller,0,0,0,0,0,0,1,1
naver_ngrinder,org.ngrinder.common.model,3,0,0,0,0,0,1,4
naver_ngrinder,org.ngrinder.common.service,0,0,0,0,0,0,1,1
naver_ngrinder,org.ngrinder.common.util,19,1,0,1,1,0,1,23
naver_ngrinder,org.ngrinder.home.controller,0,0,0,0,0,0,1,1
naver_ngrinder,org.ngrinder.home.model,0,0,0,0,0,0,1,1
naver_ngrinder,org.ngrinder.home.service,0,0,0,0,0,0,1,1
naver_ngrinder,org.ngrinder.infra.config,31,1,0,0,1,0,1,34
naver_ngrinder,org.ngrinder.infra.hazelcast,3,1,0,0,0,0,1,5
naver_ngrinder,org.ngrinder.infra.hazelcast.task,0,0,0,0,0,0,1,1
naver_ngrinder,org.ngrinder.infra.hazelcast.topic.listener,0,0,0,0,0,0,1,1
naver_ngrinder,org.ngrinder.infra.hazelcast.topic.message,0,0,0,0,0,0,1,1
naver_ngrinder,org.ngrinder.infra.hazelcast.topic.subscriber,0,0,0,0,0,0,1,1
naver_ngrinder,org.ngrinder.infra.init,4,0,0,0,1,0,1,6
naver_ngrinder,org.ngrinder.infra.interceptor,0,0,0,0,0,0,1,1
naver_ngrinder,org.ngrinder.infra.logger,0,0,0,0,0,0,1,1
naver_ngrinder,org.ngrinder.infra.plugin.extension,0,0,0,0,0,0,1,1
naver_ngrinder,org.ngrinder.infra.plugin,3,1,0,0,0,0,1,5
naver_ngrinder,org.ngrinder.infra.report,0,0,0,0,0,0,1,1
naver_ngrinder,org.ngrinder.infra.schedule,0,0,0,0,0,0,1,1
naver_ngrinder,org.ngrinder.infra.servlet,0,0,0,0,0,0,1,1
naver_ngrinder,org.ngrinder.infra.spring,6,0,0,0,1,0,1,8
naver_ngrinder,org.ngrinder.infra.spring.listener,0,0,0,0,0,0,1,1
naver_ngrinder,org.ngrinder.infra.transaction,0,0,0,0,0,0,1,1
naver_ngrinder,org.ngrinder.operation.cotroller,0,0,0,0,1,0,1,2
naver_ngrinder,org.ngrinder.operation.service,0,1,0,0,0,0,1,2
naver_ngrinder,org.ngrinder.packages,1,0,0,0,0,0,1,2
naver_ngrinder,org.ngrinder.region.model,0,0,0,0,0,0,1,1
naver_ngrinder,org.ngrinder.region.service,1,0,0,0,0,0,1,2
naver_ngrinder,org.ngrinder.script.controller,0,0,0,0,1,0,1,2
naver_ngrinder,org.ngrinder.script.handler,2,1,0,0,0,0,1,4
naver_ngrinder,org.ngrinder.script.model,1,0,0,0,0,0,1,2
naver_ngrinder,org.ngrinder.script.repository,6,1,0,0,0,0,1,8
naver_ngrinder,org.ngrinder.script.service,6,1,0,0,0,0,1,8
naver_ngrinder,org.ngrinder.security,7,0,0,0,0,0,1,8
naver_ngrinder,org.ngrinder.starter,0,0,0,0,0,0,1,1
naver_ngrinder,org.ngrinder.user.controller,0,0,0,0,0,0,1,1
naver_ngrinder,org.ngrinder.user.repository,0,0,0,0,0,0,1,1
naver_ngrinder,org.ngrinder.user.service,23,1,0,0,0,0,1,25
naver_ngrinder,org.springframework.security.crypto.password,0,0,0,0,0,0,1,1
naver_ngrinder,org.ngrinder,0,0,0,0,1,0,1,2
naver_ngrinder,org.ngrinder.operation,0,0,0,0,0,0,1,1
naver_ngrinder,org.ngrinder.user.model,0,0,0,0,0,0,1,1
naver_ngrinder,net.grinder,19,1,0,0,0,0,1,21
naver_ngrinder,net.grinder.communication,0,0,0,0,0,0,1,1
naver_ngrinder,net.grinder.console.communication,1,0,0,0,0,0,1,2
naver_ngrinder,net.grinder.console,0,1,0,0,0,0,1,2
naver_ngrinder,net.grinder.console.model,0,0,0,0,1,0,1,2
naver_ngrinder,net.grinder.engine.agent,5,0,0,0,1,0,1,7
naver_ngrinder,net.grinder.engine.common,0,0,0,0,0,0,1,1
naver_ngrinder,net.grinder.engine.communication,3,0,0,0,0,0,1,4
naver_ngrinder,net.grinder.engine.console,0,0,0,0,0,0,1,1
naver_ngrinder,net.grinder.engine.controller,0,0,0,0,0,0,1,1
naver_ngrinder,net.grinder.lang,1,0,0,0,0,0,1,2
naver_ngrinder,net.grinder.lang.groovy,0,0,0,0,0,0,1,1
naver_ngrinder,net.grinder.lang.jython,0,0,0,0,0,0,1,1
naver_ngrinder,net.grinder.message.console,0,0,0,0,0,0,1,1
naver_ngrinder,net.grinder.util,18,1,0,0,1,0,1,21
naver_ngrinder,org.ngrinder.common.constants,0,0,0,0,0,0,1,1
naver_ngrinder,org.ngrinder.common.exception,0,0,0,0,0,0,1,1
naver_ngrinder,org.ngrinder.extension,1,1,0,0,1,0,1,4
naver_ngrinder,org.ngrinder.infra,8,0,0,0,1,0,1,10
naver_ngrinder,org.ngrinder.model,4,1,0,0,1,0,1,7
naver_ngrinder,org.ngrinder.monitor.agent,3,1,0,0,0,0,1,5
naver_ngrinder,org.ngrinder.monitor.collector,6,0,0,0,0,0,1,7
naver_ngrinder,org.ngrinder.monitor.controller.model,1,0,0,0,0,0,1,2
naver_ngrinder,org.ngrinder.monitor.domain,0,0,0,0,0,0,1,1
naver_ngrinder,org.ngrinder.monitor,0,0,0,0,0,0,1,1
naver_ngrinder,org.ngrinder.monitor.mxbean.core,0,0,0,0,0,0,1,1
naver_ngrinder,org.ngrinder.monitor.mxbean,1,1,0,0,0,0,1,3
naver_ngrinder,org.ngrinder.monitor.share.domain,3,0,0,0,0,0,1,4
naver_ngrinder,org.ngrinder.service,0,0,0,0,1,0,1,2
naver_ngrinder,net.grinder.engine.process,0,0,0,0,0,0,1,1
naver_ngrinder,net.grinder.script,0,0,0,0,0,0,1,1
naver_ngrinder,net.grinder.scriptengine.exception,0,0,0,0,0,0,1,1
naver_ngrinder,net.grinder.scriptengine.groovy,0,0,0,0,1,0,1,2
naver_ngrinder,net.grinder.scriptengine.groovy.junit,0,0,0,0,1,0,1,2
naver_ngrinder,net.grinder.scriptengine.jython,0,0,0,0,0,0,1,1
naver_ngrinder,org.ngrinder.dns,0,0,0,0,1,0,1,2
naver_ngrinder,org.ngrinder.recorder,0,0,0,0,0,0,1,1
naver_ngrinder,org.ngrinder.sm,0,0,0,0,0,0,1,1
naver_volley-extensions,com.navercorp.volleyextensions.cache.disk,0,0,0,0,0,0,0,0
naver_volley-extensions,com.navercorp.volleyextensions.cache.universalimageloader.disc,0,0,0,0,0,0,0,0
naver_volley-extensions,com.navercorp.volleyextensions.cache.universalimageloader.disc.impl,0,0,0,0,1,0,0,1
naver_volley-extensions,com.navercorp.volleyextensions.cache.universalimageloader.disc.naming,0,0,0,0,0,0,0,0
naver_volley-extensions,com.navercorp.volleyextensions.cache.universalimageloader.memory.impl,0,0,0,0,1,0,0,1
naver_volley-extensions,com.navercorp.volleyextensions.cache.universalimageloader.memory,0,0,0,0,0,0,0,0
naver_volley-extensions,com.navercorp.volleyextensions.util,0,0,0,0,0,0,0,0
naver_volley-extensions,com.navercorp.volleyextensions.request,0,0,0,0,1,0,0,1
naver_volley-extensions,com.navercorp.volleyextensions.mock,0,0,0,0,0,0,0,0
naver_volley-extensions,com.navercorp.volleyextensions.robolectric,0,0,0,0,0,0,0,0
naver_volley-extensions,com.navercorp.volleyextensions.view,0,0,0,0,0,0,0,0
naver_volley-extensions,com.navercorp.volleyextensions.volleyer.builder,0,0,0,0,0,0,0,0
naver_volley-extensions,com.navercorp.volleyextensions.volleyer,1,1,0,0,1,0,0,3
naver_volley-extensions,com.navercorp.volleyextensions.volleyer.exception,0,0,0,0,0,0,0,0
naver_volley-extensions,com.navercorp.volleyextensions.volleyer.factory,1,1,0,0,1,0,0,3
naver_volley-extensions,com.navercorp.volleyextensions.volleyer.http,1,1,0,0,1,0,0,3
naver_volley-extensions,com.navercorp.volleyextensions.volleyer.multipart,1,0,0,0,0,0,0,1
naver_volley-extensions,com.navercorp.volleyextensions.volleyer.multipart.stack,0,0,0,0,0,0,0,0
naver_volley-extensions,com.navercorp.volleyextensions.volleyer.request.creator,0,0,0,0,0,0,0,0
naver_volley-extensions,com.navercorp.volleyextensions.volleyer.request.executor,0,0,0,0,0,0,0,0
naver_volley-extensions,com.navercorp.volleyextensions.volleyer.request,0,0,0,0,0,0,0,0
naver_volley-extensions,com.navercorp.volleyextensions.volleyer.response.parser,0,0,0,0,1,0,0,1
naver_volley-extensions,com.navercorp.volleyextensions.volleyer.util,0,0,0,0,1,0,0,1
naver_volley-extensions,com.navercorp.volleyextensions.volleyer.mock,0,0,0,0,0,0,0,0
needle4j_needle4j,org.needle4j.common,0,0,0,0,1,0,0,1
needle4j_needle4j,org.needle4j.configuration,9,1,0,0,1,0,0,11
needle4j_needle4j,org.needle4j.db.configuration,0,0,0,0,1,0,0,1
needle4j_needle4j,org.needle4j.db,14,1,0,0,1,0,0,16
needle4j_needle4j,org.needle4j.db.operation,2,0,0,0,1,0,0,3
needle4j_needle4j,org.needle4j.db.operation.h2,0,0,0,0,0,0,0,0
needle4j_needle4j,org.needle4j.db.operation.hsql,1,0,0,0,0,0,0,1
needle4j_needle4j,org.needle4j.db.transaction,0,0,0,0,0,0,0,0
needle4j_needle4j,org.needle4j.injection,9,0,0,1,1,0,0,11
needle4j_needle4j,org.needle4j.junit,1,0,0,0,1,0,0,2
needle4j_needle4j,org.needle4j.mock,5,0,0,0,1,0,0,6
needle4j_needle4j,org.needle4j,3,1,0,0,1,0,0,5
needle4j_needle4j,org.needle4j.postconstruct,0,0,0,0,1,0,0,1
needle4j_needle4j,org.needle4j.predicate,0,0,0,0,0,0,0,0
needle4j_needle4j,org.needle4j.processor,0,0,0,0,0,0,0,0
needle4j_needle4j,org.needle4j.reflection,10,1,0,0,0,0,0,11
needle4j_needle4j,org.needle4j.injection.cdi.instance,0,0,0,0,1,0,0,1
needle4j_needle4j,org.needle4j.injection.constuctor,2,0,0,0,0,0,0,2
needle4j_needle4j,org.needle4j.injection.inheritance,0,0,0,0,1,0,0,1
needle4j_needle4j,org.needle4j.injection.method,0,0,0,0,0,0,0,0
needle4j_needle4j,org.needle4j.junit.builder,0,0,0,0,1,0,0,1
needle4j_needle4j,org.needle4j.postconstruct.injection,0,0,0,0,0,0,0,0
neo4j-contrib_cypher-dsl,org.neo4j.cypherdsl,2,0,0,0,0,4,0,6
neo4j-contrib_cypher-dsl,org.neo4j.cypherdsl.expression,0,0,0,0,1,3,0,4
neo4j-contrib_cypher-dsl,org.neo4j.cypherdsl.grammar,1,0,0,0,0,3,0,4
neo4j-contrib_cypher-dsl,org.neo4j.cypherdsl.query,2,1,0,0,0,3,0,6
neo4j-contrib_cypher-dsl,org.neo4j.cypherdsl.query.clause,2,1,0,0,0,0,0,3
neo4j-contrib_cypher-dsl,org.neo4j.cypherdsl.query.neo4j,0,0,0,0,0,0,0,0
neo4j-contrib_cypher-dsl,org.neo4j.cypherdsl.querydsl,0,0,0,0,1,0,0,1
neo4j-contrib_cypher-dsl,org.neo4j.cypherdsl.result,0,0,0,0,0,0,0,0
neo4j-contrib_graph-collections,org.neo4j.collections.btree,0,0,0,0,1,0,0,1
neo4j-contrib_graph-collections,org.neo4j.collections,0,0,0,0,0,0,0,0
neo4j-contrib_graph-collections,org.neo4j.collections.graphdb,1,1,0,1,1,0,0,4
neo4j-contrib_graph-collections,org.neo4j.collections.graphdb.impl,1,0,0,1,1,0,0,3
neo4j-contrib_graph-collections,org.neo4j.collections.graphdb.traversal,0,0,0,0,0,0,0,0
neo4j-contrib_graph-collections,org.neo4j.collections.graphdb.traversal.impl,0,0,0,0,0,0,0,0
neo4j-contrib_graph-collections,org.neo4j.collections.indexedrelationship,0,0,0,0,1,0,0,1
neo4j-contrib_graph-collections,org.neo4j.collections.indexprovider,0,0,0,0,1,0,0,1
neo4j-contrib_graph-collections,org.neo4j.collections.list,0,0,0,0,1,0,0,1
neo4j-contrib_graph-collections,org.neo4j.collections.radixtree,0,0,0,0,0,0,0,0
neo4j-contrib_graph-collections,org.neo4j.collections.rtree,0,0,0,0,1,0,0,1
neo4j-contrib_graph-collections,org.neo4j.collections.rtree.filter,0,0,0,0,1,0,0,1
neo4j-contrib_graph-collections,org.neo4j.collections.sortedtree,0,0,0,0,1,0,0,1
neo4j-contrib_graph-collections,org.neo4j.collections.timeline,0,0,0,0,0,0,0,0
neo4j-contrib_graph-collections,org.neo4j.collections.treemap,0,0,0,0,0,0,0,0
neo4j-contrib_graph-collections,org.neo4j.kernel.impl.transaction,0,0,0,0,0,0,0,0
neo4j_neo4j-ogm,(default package),0,0,0,0,0,0,0,0
neo4j_neo4j-ogm,org.neo4j.ogm.compiler,0,0,0,0,0,0,0,0
neo4j_neo4j-ogm,org.neo4j.ogm.config,8,1,0,0,0,4,0,13
neo4j_neo4j-ogm,org.neo4j.ogm.driver,0,0,0,0,1,2,0,3
neo4j_neo4j-ogm,org.neo4j.ogm.exception,0,0,0,0,0,0,0,0
neo4j_neo4j-ogm,org.neo4j.ogm.model,0,0,0,0,1,6,0,7
neo4j_neo4j-ogm,org.neo4j.ogm.request,0,0,0,0,1,5,0,6
neo4j_neo4j-ogm,org.neo4j.ogm.response,0,0,0,0,0,1,0,1
neo4j_neo4j-ogm,org.neo4j.ogm.response.model,0,0,0,0,1,0,0,1
neo4j_neo4j-ogm,org.neo4j.ogm.result.adapter,0,0,0,0,0,0,0,0
neo4j_neo4j-ogm,org.neo4j.ogm.spi,0,0,0,0,0,0,0,0
neo4j_neo4j-ogm,org.neo4j.ogm.support,0,0,0,0,1,0,0,1
neo4j_neo4j-ogm,org.neo4j.ogm.transaction,0,0,0,0,0,4,0,4
neo4j_neo4j-ogm,org.neo4j.ogm.types.adapter,0,0,0,0,0,0,0,0
neo4j_neo4j-ogm,org.neo4j.ogm.types.spatial,0,0,0,0,0,0,0,0
neo4j_neo4j-ogm,org.neo4j.ogm.types,0,0,0,0,0,0,0,0
neo4j_neo4j-ogm,org.neo4j.ogm.drivers.bolt.driver,3,0,0,0,1,1,0,5
neo4j_neo4j-ogm,org.neo4j.ogm.drivers.bolt.request,0,0,0,0,0,0,0,0
neo4j_neo4j-ogm,org.neo4j.ogm.drivers.bolt.response,0,0,0,0,1,0,0,1
neo4j_neo4j-ogm,org.neo4j.ogm.drivers.bolt.transaction,0,0,0,0,0,0,0,0
neo4j_neo4j-ogm,org.neo4j.ogm.drivers.bolt.types.adapter,0,0,0,0,0,0,0,0
neo4j_neo4j-ogm,org.neo4j.ogm.drivers.bolt.types,0,0,0,0,0,0,0,0
neo4j_neo4j-ogm,org.neo4j.ogm.annotation,0,0,0,0,0,0,0,0
neo4j_neo4j-ogm,org.neo4j.ogm.annotation.typeconversion,0,0,0,0,0,0,0,0
neo4j_neo4j-ogm,org.neo4j.ogm.autoindex,4,0,0,0,1,0,0,5
neo4j_neo4j-ogm,org.neo4j.ogm.context,5,1,0,1,1,9,0,17
neo4j_neo4j-ogm,org.neo4j.ogm.cypher,7,1,0,0,0,6,0,14
neo4j_neo4j-ogm,org.neo4j.ogm.cypher.compiler.builders.node,0,0,0,0,0,0,0,0
neo4j_neo4j-ogm,org.neo4j.ogm.cypher.compiler.builders.statement,0,0,0,0,1,1,0,2
neo4j_neo4j-ogm,org.neo4j.ogm.cypher.compiler,0,0,0,0,1,3,0,4
neo4j_neo4j-ogm,org.neo4j.ogm.cypher.function,0,0,0,0,1,1,0,2
neo4j_neo4j-ogm,org.neo4j.ogm.cypher.query,0,0,0,0,1,5,0,6
neo4j_neo4j-ogm,org.neo4j.ogm.exception.core,0,0,0,0,1,0,0,1
neo4j_neo4j-ogm,org.neo4j.ogm.id,0,0,0,0,0,0,0,0
neo4j_neo4j-ogm,org.neo4j.ogm.metadata,15,1,0,1,1,6,0,24
neo4j_neo4j-ogm,org.neo4j.ogm.metadata.reflect,3,0,0,1,1,0,0,5
neo4j_neo4j-ogm,org.neo4j.ogm.metadata.schema,0,1,0,0,1,0,0,2
neo4j_neo4j-ogm,org.neo4j.ogm.session.delegates,0,0,0,0,1,6,0,7
neo4j_neo4j-ogm,org.neo4j.ogm.session,19,1,0,0,1,19,0,40
neo4j_neo4j-ogm,org.neo4j.ogm.session.event,0,0,0,0,0,0,0,0
neo4j_neo4j-ogm,org.neo4j.ogm.session.request,6,1,0,0,1,1,0,9
neo4j_neo4j-ogm,org.neo4j.ogm.session.request.strategy,0,0,0,0,1,4,0,5
neo4j_neo4j-ogm,org.neo4j.ogm.session.request.strategy.impl,0,0,0,0,1,5,0,6
neo4j_neo4j-ogm,org.neo4j.ogm.session.transaction,0,0,0,0,0,1,0,1
neo4j_neo4j-ogm,org.neo4j.ogm.session.transaction.support,0,0,0,0,0,0,0,0
neo4j_neo4j-ogm,org.neo4j.ogm.typeconversion,5,1,0,1,1,1,0,9
neo4j_neo4j-ogm,org.neo4j.ogm.utils,3,1,0,0,0,0,0,4
neo4j_neo4j-ogm,org.neo4j.ogm.metadata.schema.generics,0,0,0,0,0,0,0,0
neo4j_neo4j-ogm,org.neo4j.ogm.metadata.schema.inheritance,0,0,0,0,0,0,0,0
neo4j_neo4j-ogm,org.neo4j.ogm.metadata.schema.simple,0,0,0,0,1,0,0,1
neo4j_neo4j-ogm,org.neo4j.ogm.drivers.embedded.driver,2,0,0,0,0,1,0,3
neo4j_neo4j-ogm,org.neo4j.ogm.drivers.embedded.extension,0,0,0,0,0,0,0,0
neo4j_neo4j-ogm,org.neo4j.ogm.drivers.embedded.request,0,0,0,0,0,0,0,0
neo4j_neo4j-ogm,org.neo4j.ogm.drivers.embedded.response,0,0,0,0,1,0,0,1
neo4j_neo4j-ogm,org.neo4j.ogm.drivers.embedded.transaction,0,0,0,0,0,0,0,0
neo4j_neo4j-ogm,org.neo4j.ogm.drivers.embedded.types.adapter,0,0,0,0,0,0,0,0
neo4j_neo4j-ogm,org.neo4j.ogm.drivers.embedded.types,0,0,0,0,0,0,0,0
neo4j_neo4j-ogm,org.neo4j.ogm.drivers.http.driver,5,0,0,0,0,0,0,5
neo4j_neo4j-ogm,org.neo4j.ogm.drivers.http.request,0,0,0,0,1,0,0,1
neo4j_neo4j-ogm,org.neo4j.ogm.drivers.http.response,0,0,0,0,1,0,0,1
neo4j_neo4j-ogm,org.neo4j.ogm.drivers.http.transaction,0,0,0,0,0,0,0,0
neo4j_neo4j-ogm,org.neo4j.ogm,0,0,0,0,0,1,0,1
neo4j_neo4j-ogm,org.neo4j.ogm.domain.annotations.ids,0,0,0,0,1,0,0,1
neo4j_neo4j-ogm,org.neo4j.ogm.domain.annotations,0,0,0,0,0,0,0,0
neo4j_neo4j-ogm,org.neo4j.ogm.domain.autoindex,0,0,0,0,1,0,0,1
neo4j_neo4j-ogm,org.neo4j.ogm.domain.autoindex.invalid,0,0,0,0,0,0,0,0
neo4j_neo4j-ogm,org.neo4j.ogm.domain.autoindex.valid,0,0,0,0,0,0,0,0
neo4j_neo4j-ogm,org.neo4j.ogm.domain.bike,0,0,0,0,0,0,0,0
neo4j_neo4j-ogm,org.neo4j.ogm.domain.blog,0,0,0,0,0,0,0,0
neo4j_neo4j-ogm,org.neo4j.ogm.domain.canonical,0,0,0,0,0,0,0,0
neo4j_neo4j-ogm,org.neo4j.ogm.domain.canonical.hierarchies,0,0,0,0,0,0,0,0
neo4j_neo4j-ogm,org.neo4j.ogm.domain.cineasts.annotated,0,0,0,0,1,0,0,1
neo4j_neo4j-ogm,org.neo4j.ogm.domain.cineasts.minimum,0,0,0,0,0,0,0,0
neo4j_neo4j-ogm,org.neo4j.ogm.domain.cineasts.partial,0,0,0,0,1,0,0,1
neo4j_neo4j-ogm,org.neo4j.ogm.domain.cineasts.plain,0,0,1,0,0,0,0,1
neo4j_neo4j-ogm,org.neo4j.ogm.domain.companies.annotated,0,0,0,0,0,0,0,0
neo4j_neo4j-ogm,org.neo4j.ogm.domain.companies.partial,0,0,0,0,0,0,0,0
neo4j_neo4j-ogm,org.neo4j.ogm.domain.concurrency,0,0,0,0,0,0,0,0
neo4j_neo4j-ogm,org.neo4j.ogm.domain.convertible.bytes,0,0,0,0,0,0,0,0
neo4j_neo4j-ogm,org.neo4j.ogm.domain.convertible.date,0,0,0,0,0,0,0,0
neo4j_neo4j-ogm,org.neo4j.ogm.domain.convertible.enums,0,0,0,0,0,0,0,0
neo4j_neo4j-ogm,org.neo4j.ogm.domain.convertible.numbers,0,0,0,0,0,0,0,0
neo4j_neo4j-ogm,org.neo4j.ogm.domain.convertible.parametrized,0,0,0,0,0,0,0,0
neo4j_neo4j-ogm,org.neo4j.ogm.domain.drink,0,0,0,0,0,0,0,0
neo4j_neo4j-ogm,org.neo4j.ogm.domain.education,0,0,0,0,0,0,0,0
neo4j_neo4j-ogm,org.neo4j.ogm.domain.election,0,0,0,0,0,0,0,0
neo4j_neo4j-ogm,org.neo4j.ogm.domain.entityMapping,0,0,0,0,0,0,0,0
neo4j_neo4j-ogm,org.neo4j.ogm.domain.entityMapping.iterables,0,0,0,0,0,0,0,0
neo4j_neo4j-ogm,org.neo4j.ogm.domain.filesystem,0,0,0,0,0,0,0,0
neo4j_neo4j-ogm,org.neo4j.ogm.domain.food.converter,0,0,0,0,0,0,0,0
neo4j_neo4j-ogm,org.neo4j.ogm.domain.food.entities.notScanned,0,0,0,0,0,0,0,0
neo4j_neo4j-ogm,org.neo4j.ogm.domain.food.entities.scanned,0,0,0,0,0,0,0,0
neo4j_neo4j-ogm,org.neo4j.ogm.domain.forum.activity,0,0,0,0,0,0,0,0
neo4j_neo4j-ogm,org.neo4j.ogm.domain.forum,0,0,0,0,1,0,0,1
neo4j_neo4j-ogm,org.neo4j.ogm.domain.friendships,0,0,0,0,0,0,0,0
neo4j_neo4j-ogm,org.neo4j.ogm.domain.generic_hierarchy,0,0,0,0,1,0,0,1
neo4j_neo4j-ogm,org.neo4j.ogm.domain.generic_hierarchy.relationship,0,0,0,0,0,0,0,0
neo4j_neo4j-ogm,org.neo4j.ogm.domain.gh368,0,0,0,0,0,0,0,0
neo4j_neo4j-ogm,org.neo4j.ogm.domain.gh385,0,0,0,0,1,0,0,1
neo4j_neo4j-ogm,org.neo4j.ogm.domain.gh492,0,0,0,0,0,0,0,0
neo4j_neo4j-ogm,org.neo4j.ogm.domain.gh576,0,0,0,0,0,0,0,0
neo4j_neo4j-ogm,org.neo4j.ogm.domain.gh609,0,0,0,0,0,0,0,0
neo4j_neo4j-ogm,org.neo4j.ogm.domain.gh619.base,0,0,0,0,0,0,0,0
neo4j_neo4j-ogm,org.neo4j.ogm.domain.gh619.model,0,0,0,0,0,0,0,0
neo4j_neo4j-ogm,org.neo4j.ogm.domain.gh640,0,0,0,0,0,0,0,0
neo4j_neo4j-ogm,org.neo4j.ogm.domain.gh641,0,0,0,0,0,0,0,0
neo4j_neo4j-ogm,org.neo4j.ogm.domain.gh656,0,0,0,0,0,0,0,0
neo4j_neo4j-ogm,org.neo4j.ogm.domain.hierarchy.conflicting,0,0,0,0,0,0,0,0
neo4j_neo4j-ogm,org.neo4j.ogm.domain.hierarchy.domain.annotated,0,0,0,0,1,0,0,1
neo4j_neo4j-ogm,org.neo4j.ogm.domain.hierarchy.domain.custom_id,0,0,0,0,0,0,0,0
neo4j_neo4j-ogm,org.neo4j.ogm.domain.hierarchy.domain.people,0,0,0,0,0,0,0,0
neo4j_neo4j-ogm,org.neo4j.ogm.domain.hierarchy.domain.plain,0,0,0,0,1,0,0,1
neo4j_neo4j-ogm,org.neo4j.ogm.domain.hierarchy.domain.trans,0,0,0,0,1,0,0,1
neo4j_neo4j-ogm,org.neo4j.ogm.domain.hierarchy.dualRelation,0,0,0,0,0,0,0,0
neo4j_neo4j-ogm,org.neo4j.ogm.domain.hierarchy.relations,0,0,0,0,0,0,0,0
neo4j_neo4j-ogm,org.neo4j.ogm.domain.ingredients,0,0,0,0,0,0,0,0
neo4j_neo4j-ogm,org.neo4j.ogm.domain.invalid.ids,0,0,0,0,1,0,0,1
neo4j_neo4j-ogm,org.neo4j.ogm.domain.knowledge,0,0,0,0,0,0,0,0
neo4j_neo4j-ogm,org.neo4j.ogm.domain.linkedlist,0,0,0,0,0,0,0,0
neo4j_neo4j-ogm,org.neo4j.ogm.domain.locking,0,0,0,0,1,0,0,1
neo4j_neo4j-ogm,org.neo4j.ogm.domain.lockinginvalid,0,0,0,0,0,0,0,0
neo4j_neo4j-ogm,org.neo4j.ogm.domain.mappings,0,0,0,0,0,0,0,0
neo4j_neo4j-ogm,org.neo4j.ogm.domain.meetup,0,0,0,0,0,0,0,0
neo4j_neo4j-ogm,org.neo4j.ogm.domain.music,0,0,0,0,0,0,0,0
neo4j_neo4j-ogm,org.neo4j.ogm.domain.nested,0,0,0,0,0,0,0,0
neo4j_neo4j-ogm,org.neo4j.ogm.domain.pets,0,0,0,0,0,0,0,0
neo4j_neo4j-ogm,org.neo4j.ogm.domain.pizza,0,0,0,0,1,0,0,1
neo4j_neo4j-ogm,org.neo4j.ogm.domain.policy,0,0,0,0,0,0,0,0
neo4j_neo4j-ogm,org.neo4j.ogm.domain.postload,0,0,0,0,0,0,0,0
neo4j_neo4j-ogm,org.neo4j.ogm.domain.properties,0,0,0,0,1,0,0,1
neo4j_neo4j-ogm,org.neo4j.ogm.domain.props,0,0,0,0,0,0,0,0
neo4j_neo4j-ogm,org.neo4j.ogm.domain.restaurant,0,0,0,0,0,0,0,0
neo4j_neo4j-ogm,org.neo4j.ogm.domain.satellites,0,0,0,0,0,0,0,0
neo4j_neo4j-ogm,org.neo4j.ogm.domain.simple,0,0,0,0,0,0,0,0
neo4j_neo4j-ogm,org.neo4j.ogm.domain.simpleNetwork.abstractions,0,0,0,0,0,0,0,0
neo4j_neo4j-ogm,org.neo4j.ogm.domain.simpleNetwork.classes,0,0,0,0,0,0,0,0
neo4j_neo4j-ogm,org.neo4j.ogm.domain.simpleNetwork.interfaces,0,0,0,0,0,0,0,0
neo4j_neo4j-ogm,org.neo4j.ogm.domain.social,0,0,0,0,1,0,0,1
neo4j_neo4j-ogm,org.neo4j.ogm.domain.spies,0,0,0,0,0,0,0,0
neo4j_neo4j-ogm,org.neo4j.ogm.domain.travel,0,0,0,0,0,0,0,0
neo4j_neo4j-ogm,org.neo4j.ogm.domain.tree,0,0,0,0,0,0,0,0
neo4j_neo4j-ogm,org.neo4j.ogm.domain.typed_relationships,0,0,0,0,0,0,0,0
neo4j_neo4j-ogm,org.neo4j.ogm.domain.types,0,0,0,0,0,0,0,0
neo4j_neo4j-ogm,org.neo4j.ogm.domain.versioned_rel,0,0,0,0,0,0,0,0
neo4j_neo4j-ogm,org.neo4j.ogm.drivers,0,0,0,0,1,3,0,4
neo4j_neo4j-ogm,org.neo4j.ogm.drivers.bolt,0,0,0,0,0,0,0,0
neo4j_neo4j-ogm,org.neo4j.ogm.persistence.authentication,0,0,0,0,0,0,0,0
neo4j_neo4j-ogm,org.neo4j.ogm.persistence,0,0,0,0,0,0,0,0
neo4j_neo4j-ogm,org.neo4j.ogm.persistence.examples.bike,0,0,0,0,0,0,0,0
neo4j_neo4j-ogm,org.neo4j.ogm.persistence.examples.blog,0,0,0,0,0,0,0,0
neo4j_neo4j-ogm,org.neo4j.ogm.persistence.examples.canonical,0,0,0,0,0,0,0,0
neo4j_neo4j-ogm,org.neo4j.ogm.persistence.examples.cineasts.annotated,0,0,0,0,1,0,0,1
neo4j_neo4j-ogm,org.neo4j.ogm.persistence.examples.cineasts.partial,0,0,0,0,0,0,0,0
neo4j_neo4j-ogm,org.neo4j.ogm.persistence.examples.companies,0,0,0,0,0,0,0,0
neo4j_neo4j-ogm,org.neo4j.ogm.persistence.examples.convertible,0,0,0,0,0,0,0,0
neo4j_neo4j-ogm,org.neo4j.ogm.persistence.examples.drink,0,0,0,0,0,0,0,0
neo4j_neo4j-ogm,org.neo4j.ogm.persistence.examples.education,0,0,0,0,0,0,0,0
neo4j_neo4j-ogm,org.neo4j.ogm.persistence.examples.election,0,0,0,0,0,0,0,0
neo4j_neo4j-ogm,org.neo4j.ogm.persistence.examples.friendships,0,0,0,0,0,0,0,0
neo4j_neo4j-ogm,org.neo4j.ogm.persistence.examples.hierarchy.dualRelationships,0,0,0,0,0,0,0,0
neo4j_neo4j-ogm,org.neo4j.ogm.persistence.examples.ingredients,0,0,0,0,0,0,0,0
neo4j_neo4j-ogm,org.neo4j.ogm.persistence.examples.linkedlist,0,0,0,0,0,0,0,0
neo4j_neo4j-ogm,org.neo4j.ogm.persistence.examples.locking,0,0,0,0,0,0,0,0
neo4j_neo4j-ogm,org.neo4j.ogm.persistence.examples.meetup,0,0,0,0,0,0,0,0
neo4j_neo4j-ogm,org.neo4j.ogm.persistence.examples.music,0,0,0,0,0,1,0,1
neo4j_neo4j-ogm,org.neo4j.ogm.persistence.examples.numbers,0,0,0,0,0,0,0,0
neo4j_neo4j-ogm,org.neo4j.ogm.persistence.examples.pets,0,0,0,0,0,0,0,0
neo4j_neo4j-ogm,org.neo4j.ogm.persistence.examples.pizza,0,0,0,0,0,0,0,0
neo4j_neo4j-ogm,org.neo4j.ogm.persistence.examples.restaurant,0,0,0,0,0,0,0,0
neo4j_neo4j-ogm,org.neo4j.ogm.persistence.examples.satellite,0,0,0,0,0,1,0,1
neo4j_neo4j-ogm,org.neo4j.ogm.persistence.examples.simpleNetwork,0,0,0,0,0,0,0,0
neo4j_neo4j-ogm,org.neo4j.ogm.persistence.examples.social,0,0,0,0,0,0,0,0
neo4j_neo4j-ogm,org.neo4j.ogm.persistence.examples.spies,0,0,0,0,0,0,0,0
neo4j_neo4j-ogm,org.neo4j.ogm.persistence.examples.stage.edges,1,0,0,0,0,0,0,1
neo4j_neo4j-ogm,org.neo4j.ogm.persistence.examples.stage.nodes,1,1,0,0,0,0,0,2
neo4j_neo4j-ogm,org.neo4j.ogm.persistence.examples.tree,0,0,0,0,0,0,0,0
neo4j_neo4j-ogm,org.neo4j.ogm.persistence.identity,0,0,0,0,0,0,0,0
neo4j_neo4j-ogm,org.neo4j.ogm.persistence.model,0,0,0,0,1,0,0,1
neo4j_neo4j-ogm,org.neo4j.ogm.persistence.postload,0,0,0,0,0,0,0,0
neo4j_neo4j-ogm,org.neo4j.ogm.persistence.relationships.direct.aa,0,0,0,0,0,0,0,0
neo4j_neo4j-ogm,org.neo4j.ogm.persistence.relationships.direct.aaa,0,0,0,0,0,0,0,0
neo4j_neo4j-ogm,org.neo4j.ogm.persistence.relationships.direct.aabb,0,0,0,0,0,0,0,0
neo4j_neo4j-ogm,org.neo4j.ogm.persistence.relationships.direct.ab,0,0,0,0,0,0,0,0
neo4j_neo4j-ogm,org.neo4j.ogm.persistence.relationships.direct.abb,0,0,0,0,0,0,0,0
neo4j_neo4j-ogm,org.neo4j.ogm.persistence.relationships,0,0,0,0,1,0,0,1
neo4j_neo4j-ogm,org.neo4j.ogm.persistence.relationships.transitive.aabb,0,0,0,0,0,0,0,0
neo4j_neo4j-ogm,org.neo4j.ogm.persistence.relationships.transitive.ab,0,0,0,0,0,0,0,0
neo4j_neo4j-ogm,org.neo4j.ogm.persistence.relationships.transitive.abb,0,0,0,0,0,0,0,0
neo4j_neo4j-ogm,org.neo4j.ogm.persistence.session.capability,0,0,0,0,1,2,0,3
neo4j_neo4j-ogm,org.neo4j.ogm.persistence.session.events,0,0,0,0,0,0,0,0
neo4j_neo4j-ogm,org.neo4j.ogm.persistence.session.lifecycle,0,0,0,0,0,1,0,1
neo4j_neo4j-ogm,org.neo4j.ogm.persistence.session.mappingContext,0,0,0,0,0,1,0,1
neo4j_neo4j-ogm,org.neo4j.ogm.persistence.transaction,0,0,0,0,0,2,0,2
neo4j_neo4j-ogm,org.neo4j.ogm.persistence.types,0,0,0,0,0,0,0,0
neo4j_neo4j-ogm,org.neo4j.ogm.persistence.types.convertible,0,0,0,0,0,1,0,1
neo4j_neo4j-ogm,org.neo4j.ogm.persistence.types.properties,0,0,0,0,0,0,0,0
neo4j_neo4j-ogm,org.neo4j.ogm.persistence.types.nativetypes,0,0,0,0,0,2,0,2
neo4j_neo4j-ogm,org.neo4j.ogm.persistence.types.nativetypes.filter,0,0,0,0,0,1,0,1
NetApp_NetApp-Hadoop-NFS-Connector,org.apache.hadoop.fs.nfs,1,0,0,0,1,0,0,2
NetApp_NetApp-Hadoop-NFS-Connector,org.apache.hadoop.fs.nfs.mount,0,0,0,0,0,0,0,0
NetApp_NetApp-Hadoop-NFS-Connector,org.apache.hadoop.fs.nfs.portmap,0,0,0,0,0,0,0,0
NetApp_NetApp-Hadoop-NFS-Connector,org.apache.hadoop.fs.nfs.rpc,0,0,0,0,0,0,0,0
NetApp_NetApp-Hadoop-NFS-Connector,org.apache.hadoop.fs.nfs.stream,0,0,0,0,1,0,0,1
NetApp_NetApp-Hadoop-NFS-Connector,org.apache.hadoop.fs.nfs.tools,0,0,0,0,0,0,0,0
NetApp_NetApp-Hadoop-NFS-Connector,org.apache.hadoop.fs.nfs.topology,1,1,0,0,1,0,0,3
NetApp_NetApp-Hadoop-NFS-Connector,org.apache.hadoop.nfs.nfs3,0,0,0,0,0,0,0,0
NetApp_NetApp-Hadoop-NFS-Connector,org.apache.hadoop.fs.contract,0,0,0,0,0,0,0,0
NetApp_NetApp-Hadoop-NFS-Connector,org.apache.hadoop.fs,0,1,0,0,0,0,0,1
netceteragroup_valdr-bean-validation,com.github.valdr,2,0,0,0,0,0,0,2
netceteragroup_valdr-bean-validation,com.github.valdr.cli,1,1,0,0,0,0,0,2
netceteragroup_valdr-bean-validation,com.github.valdr.decorator,0,0,0,0,0,0,0,0
netceteragroup_valdr-bean-validation,com.github.valdr.serializer,1,1,0,0,0,0,0,2
netceteragroup_valdr-bean-validation,com.github.valdr.thirdparty.spring,0,0,0,0,0,0,0,0
netceteragroup_valdr-bean-validation,com.github.valdr.model.a,0,0,0,0,0,0,0,0
netceteragroup_valdr-bean-validation,com.github.valdr.model.b,0,0,0,0,0,0,0,0
netceteragroup_valdr-bean-validation,com.github.valdr.model.c,0,0,0,0,0,0,0,0
netceteragroup_valdr-bean-validation,com.github.valdr.model.d,0,0,0,0,0,0,0,0
netceteragroup_valdr-bean-validation,com.github.valdr.model.e,0,0,0,0,0,0,0,0
netceteragroup_valdr-bean-validation,com.github.valdr.model.f,0,0,0,0,0,0,0,0
netceteragroup_valdr-bean-validation,com.github.valdr.model.g,0,0,0,0,0,0,0,0
netceteragroup_valdr-bean-validation,com.github.valdr.model.h,0,0,0,0,0,0,0,0
netceteragroup_valdr-bean-validation,com.github.valdr.model.i,0,0,0,0,0,0,0,0
netceteragroup_valdr-bean-validation,com.github.valdr.util,0,0,0,0,0,0,0,0
netceteragroup_valdr-bean-validation,com.github.valdr.demo.model,0,0,0,0,0,0,0,0
Netflix_spectator,com.netflix.spectator.agent,0,0,0,0,0,0,0,0
Netflix_spectator,com.netflix.spectator.perf,0,0,0,0,1,0,0,1
Netflix_spectator,com.netflix.spectator.api,4,1,0,1,0,0,0,6
Netflix_spectator,com.netflix.spectator.api.histogram,0,0,0,0,0,0,0,0
Netflix_spectator,com.netflix.spectator.api.patterns,3,0,0,0,0,0,0,3
Netflix_spectator,com.netflix.spectator.impl,4,1,0,0,1,0,0,6
Netflix_spectator,com.netflix.spectator.impl.matcher,1,0,0,0,0,0,0,1
Netflix_spectator,com.netflix.spectator.aws,0,0,0,0,0,0,0,0
Netflix_spectator,com.netflix.spectator.aws2,0,0,0,0,0,0,0,0
Netflix_spectator,com.netflix.spectator.gc,0,0,0,0,0,0,0,0
Netflix_spectator,com.netflix.spectator.ipc,0,0,0,0,1,0,0,1
Netflix_spectator,com.netflix.spectator.ipc.http,0,1,0,0,0,0,0,1
Netflix_spectator,com.netflix.spectator.ipcservlet,0,0,0,0,0,0,0,0
Netflix_spectator,com.netflix.spectator.jvm,0,0,0,0,0,0,0,0
Netflix_spectator,com.netflix.spectator.log4j,0,0,0,0,1,0,0,1
Netflix_spectator,com.netflix.spectator.placeholders,0,0,0,0,0,0,0,0
Netflix_spectator,com.netflix.spectator.sandbox,0,0,0,0,0,0,0,0
Netflix_spectator,com.netflix.spectator.spark,0,0,0,0,0,0,0,0
Netflix_spectator,com.netflix.spectator.nflx.governator,0,0,0,0,0,0,0,0
Netflix_spectator,com.netflix.spectator.nflx,0,0,0,0,0,0,0,0
Netflix_spectator,com.netflix.spectator.atlas,0,0,0,0,0,0,0,0
Netflix_spectator,com.netflix.spectator.atlas.impl,0,0,0,1,0,0,0,1
Netflix_spectator,com.netflix.spectator.metrics3,0,0,0,0,0,0,0,0
Netflix_spectator,com.netflix.spectator.micrometer,0,0,0,0,0,0,0,0
Netflix_spectator,com.netflix.spectator.servo,0,0,0,0,0,0,0,0
Netflix_spectator,com.netflix.spectator.stateless,0,0,0,0,0,0,0,0
Netflix_spectator,com.netflix.spectator.controllers.filter,0,0,0,0,0,0,0,0
Netflix_spectator,com.netflix.spectator.controllers,0,0,0,0,0,0,0,0
Netflix_spectator,com.netflix.spectator.controllers.model,0,0,0,0,1,0,0,1
Netflix_Surus,org.surus.math,0,0,0,0,0,0,0,0
Netflix_Surus,org.surus.pig,0,0,0,0,1,0,0,1
netplex_json-smart-v2,net.minidev.asm,1,1,0,0,1,1,0,4
netplex_json-smart-v2,net.minidev.asm.ex,0,0,0,0,0,0,0,0
netplex_json-smart-v2,net.minidev.asm.bean,1,0,0,0,0,0,0,1
netplex_json-smart-v2,net.minidev.json,3,1,0,0,0,1,0,5
netplex_json-smart-v2,net.minidev.json.parser,1,1,0,0,0,0,0,2
netplex_json-smart-v2,net.minidev.json.reader,1,0,0,0,0,1,0,2
netplex_json-smart-v2,net.minidev.json.writer,1,0,0,0,0,0,0,1
netplex_json-smart-v2,net.minidev.json.actions,0,1,0,0,0,0,0,1
netplex_json-smart-v2,net.minidev.json.actions.navigate,0,0,0,0,0,0,0,0
netplex_json-smart-v2,net.minidev.json.actions.path,0,0,0,0,0,0,0,0
netplex_json-smart-v2,net.minidev.json.actions.traverse,0,0,0,0,1,0,0,1
NFSdb_nfsdb,org.questdb,0,0,0,0,1,3,1,5
NFSdb_nfsdb,org.questdb.generated,0,0,0,1,0,0,1,2
NFSdb_nfsdb,io.questdb.cairo,43,1,0,1,1,43,1,90
NFSdb_nfsdb,io.questdb.cairo.map,2,0,0,0,0,18,1,21
NFSdb_nfsdb,io.questdb.cairo.pool,3,0,0,0,0,8,1,12
NFSdb_nfsdb,io.questdb.cairo.pool.ex,0,0,0,0,0,0,1,1
NFSdb_nfsdb,io.questdb.cairo.security,0,0,0,0,0,0,1,1
NFSdb_nfsdb,io.questdb.cairo.sql,3,1,0,0,1,61,1,67
NFSdb_nfsdb,io.questdb.cutlass.http,1,1,0,1,1,10,1,15
NFSdb_nfsdb,io.questdb.cutlass.http.processors,0,0,0,0,1,10,1,12
NFSdb_nfsdb,io.questdb.cutlass.json,2,0,0,0,0,3,1,6
NFSdb_nfsdb,io.questdb.cutlass.line,0,0,0,1,0,2,1,4
NFSdb_nfsdb,io.questdb.cutlass.line.udp,1,1,0,0,1,2,1,6
NFSdb_nfsdb,io.questdb.cutlass.pgwire,1,0,0,0,1,7,1,10
NFSdb_nfsdb,io.questdb.cutlass.text,8,1,0,0,0,11,1,21
NFSdb_nfsdb,io.questdb.cutlass.text.types,3,0,0,0,0,5,1,9
NFSdb_nfsdb,io.questdb.griffin,51,1,0,1,0,18,1,72
NFSdb_nfsdb,io.questdb.griffin.engine,9,1,0,0,1,0,1,12
NFSdb_nfsdb,io.questdb.griffin.engine.functions,3,1,0,1,1,8,1,15
NFSdb_nfsdb,io.questdb.griffin.engine.functions.bind,7,0,0,0,1,5,1,14
NFSdb_nfsdb,io.questdb.griffin.engine.functions.bool,4,0,0,0,1,2,1,8
NFSdb_nfsdb,io.questdb.griffin.engine.functions.cast,3,0,0,1,1,2,1,8
NFSdb_nfsdb,io.questdb.griffin.engine.functions.catalogue,0,0,0,0,1,2,1,4
NFSdb_nfsdb,io.questdb.griffin.engine.functions.columns,1,1,0,0,1,0,1,4
NFSdb_nfsdb,io.questdb.griffin.engine.functions.conditional,0,0,0,0,1,1,1,3
NFSdb_nfsdb,io.questdb.griffin.engine.functions.constants,4,0,0,0,0,0,1,5
NFSdb_nfsdb,io.questdb.griffin.engine.functions.date,3,0,0,0,1,3,1,8
NFSdb_nfsdb,io.questdb.griffin.engine.functions.eq,3,0,0,1,1,4,1,10
NFSdb_nfsdb,io.questdb.griffin.engine.functions.groupby,0,0,0,1,1,3,1,6
NFSdb_nfsdb,io.questdb.griffin.engine.functions.gt,0,0,0,0,0,0,1,1
NFSdb_nfsdb,io.questdb.griffin.engine.functions.lt,0,0,0,0,1,1,1,3
NFSdb_nfsdb,io.questdb.griffin.engine.functions.math,2,0,0,1,1,1,1,6
NFSdb_nfsdb,io.questdb.griffin.engine.functions.regex.impl,0,0,0,1,0,2,1,4
NFSdb_nfsdb,io.questdb.griffin.engine.functions.regex,0,0,0,0,1,3,1,5
NFSdb_nfsdb,io.questdb.griffin.engine.functions.rnd,3,1,0,1,0,2,1,8
NFSdb_nfsdb,io.questdb.griffin.engine.functions.str,3,0,0,0,1,3,1,8
NFSdb_nfsdb,io.questdb.griffin.engine.groupby,0,0,0,1,1,6,1,9
NFSdb_nfsdb,io.questdb.griffin.engine.join,0,0,0,0,0,5,1,6
NFSdb_nfsdb,io.questdb.griffin.engine.orderby,0,0,0,0,1,1,1,3
NFSdb_nfsdb,io.questdb.griffin.engine.table,3,0,0,1,1,5,1,11
NFSdb_nfsdb,io.questdb.griffin.engine.union,0,0,0,0,1,2,1,4
NFSdb_nfsdb,io.questdb.griffin.model,3,1,0,0,1,6,1,12
NFSdb_nfsdb,io.questdb.log,0,0,0,0,0,30,1,31
NFSdb_nfsdb,io.questdb.mp,2,0,0,1,0,5,1,9
NFSdb_nfsdb,io.questdb.network,0,1,0,1,1,5,1,9
NFSdb_nfsdb,io.questdb,3,1,0,0,1,2,1,8
NFSdb_nfsdb,io.questdb.std,42,1,0,1,0,95,1,140
NFSdb_nfsdb,io.questdb.std.ex,0,0,0,0,0,0,1,1
NFSdb_nfsdb,io.questdb.std.microtime,3,0,0,0,0,8,1,12
NFSdb_nfsdb,io.questdb.std.str,7,1,0,0,1,38,1,48
NFSdb_nfsdb,io.questdb.std.time,2,0,0,0,0,5,1,8
NFSdb_nfsdb,io.questdb.cutlass,0,0,0,0,0,0,1,1
NFSdb_nfsdb,io.questdb.griffin.engine.groupby.func,0,0,0,0,0,1,1,2
nguyenq_tess4j,com.recognition.software.jdeskew,0,0,0,0,0,0,0,0
nguyenq_tess4j,net.sourceforge.tess4j,1,0,0,1,1,0,0,3
nguyenq_tess4j,net.sourceforge.tess4j.util,1,1,0,0,1,0,0,3
nhl_link-rest,io.agrest,46,1,0,1,1,7,1,57
nhl_link-rest,io.agrest.constraints,2,0,0,0,0,0,1,3
nhl_link-rest,io.agrest.encoder,5,1,0,1,1,1,1,10
nhl_link-rest,io.agrest.encoder.converter,2,0,0,0,0,0,1,3
nhl_link-rest,io.agrest.meta,10,1,0,0,1,1,1,14
nhl_link-rest,io.agrest.meta.cayenne,2,0,0,0,0,0,1,3
nhl_link-rest,io.agrest.meta.compiler,5,0,0,0,1,0,1,7
nhl_link-rest,io.agrest.meta.parser,1,0,0,0,0,0,1,2
nhl_link-rest,io.agrest.multisource,0,0,0,0,1,0,1,2
nhl_link-rest,io.agrest.processor,2,1,0,0,0,0,1,4
nhl_link-rest,io.agrest.property,18,0,0,0,0,1,1,20
nhl_link-rest,io.agrest.provider,4,1,0,0,1,0,1,7
nhl_link-rest,io.agrest.resolver,0,0,0,0,1,2,1,4
nhl_link-rest,io.agrest.runtime,43,1,0,0,1,0,1,46
nhl_link-rest,io.agrest.runtime.cayenne.access.types,0,0,0,0,0,0,1,1
nhl_link-rest,io.agrest.runtime.cayenne,5,1,0,0,1,0,1,8
nhl_link-rest,io.agrest.runtime.cayenne.processor.delete,0,0,0,0,0,0,1,1
nhl_link-rest,io.agrest.runtime.cayenne.processor.select,0,0,0,0,1,0,1,2
nhl_link-rest,io.agrest.runtime.cayenne.processor.unrelate,0,0,0,0,0,0,1,1
nhl_link-rest,io.agrest.runtime.cayenne.processor.update,3,0,0,0,1,0,1,5
nhl_link-rest,io.agrest.runtime.cayenne.processor,0,0,0,0,0,0,1,1
nhl_link-rest,io.agrest.runtime.constraints,7,0,0,0,1,0,1,9
nhl_link-rest,io.agrest.runtime.encoder,4,0,0,0,1,2,1,8
nhl_link-rest,io.agrest.runtime.entity,2,0,0,0,1,0,1,4
nhl_link-rest,io.agrest.runtime.executor,0,0,0,0,0,0,1,1
nhl_link-rest,io.agrest.runtime.jackson,0,0,0,0,0,0,1,1
nhl_link-rest,io.agrest.runtime.meta,1,0,0,0,1,0,1,3
nhl_link-rest,io.agrest.runtime.path,2,0,0,0,0,0,1,3
nhl_link-rest,io.agrest.runtime.processor.delete,0,0,0,0,0,0,1,1
nhl_link-rest,io.agrest.runtime.processor.meta,0,0,0,0,0,0,1,1
nhl_link-rest,io.agrest.runtime.processor.select,4,0,0,0,1,3,1,9
nhl_link-rest,io.agrest.runtime.processor.unrelate,0,0,0,0,0,0,1,1
nhl_link-rest,io.agrest.runtime.processor.update,2,0,0,0,1,2,1,6
nhl_link-rest,io.agrest.runtime.protocol,3,1,0,0,1,2,1,8
nhl_link-rest,io.agrest.runtime.request,0,0,0,0,0,1,1,2
nhl_link-rest,io.agrest.runtime.semantics,0,0,0,0,0,0,1,1
nhl_link-rest,io.agrest.runtime.shutdown,0,0,0,0,0,0,1,1
nhl_link-rest,io.agrest.it,0,0,0,1,1,0,1,3
nhl_link-rest,io.agrest.it.fixture.cayenne.auto,0,0,0,0,1,0,1,2
nhl_link-rest,io.agrest.it.fixture.cayenne,0,0,0,0,1,0,1,2
nhl_link-rest,io.agrest.it.fixture.cayenne.iso.auto,0,0,0,0,1,0,1,2
nhl_link-rest,io.agrest.it.fixture.cayenne.iso,0,0,0,0,1,0,1,2
nhl_link-rest,io.agrest.it.fixture,11,1,0,0,1,0,1,14
nhl_link-rest,io.agrest.it.fixture.pojo.model,0,0,0,0,1,0,1,2
nhl_link-rest,io.agrest.it.fixture.pojo,0,0,0,0,0,0,1,1
nhl_link-rest,io.agrest.it.fixture.pojox,1,1,0,0,0,0,1,3
nhl_link-rest,io.agrest.unit,2,0,0,0,0,0,1,3
nhl_link-rest,io.agrest.parser.converter,4,1,0,1,1,0,1,8
nhl_link-rest,io.agrest.protocol,0,0,0,0,0,0,1,1
nhl_link-rest,io.agrest.runtime.parser.converter,4,0,0,0,0,0,1,5
nhl_link-rest,io.agrest.client,1,1,0,0,0,0,1,3
nhl_link-rest,io.agrest.client.protocol,0,0,0,0,0,0,1,1
nhl_link-rest,io.agrest.client.runtime.response,0,0,0,0,0,0,1,1
nhl_link-rest,io.agrest.client.runtime.run,1,0,0,0,0,0,1,2
nhl_link-rest,io.agrest.client.it.noadapter,0,0,0,0,1,0,1,2
nhl_link-rest,io.swagger.codegen,0,0,0,0,0,0,1,1
nhl_link-rest,io.swagger.codegen.languages,0,0,0,0,0,0,1,1
nhl_link-rest,io.swagger.codegen.languages.features,0,0,0,0,0,0,1,1
nhl_link-rest,io.agrest.swagger.api.v1.service,0,0,0,0,1,0,1,2
nhl_link-rest,io.agrest.sencha.encoder,0,0,0,0,0,0,1,1
nhl_link-rest,io.agrest.sencha.ops,0,0,0,0,0,0,1,1
nhl_link-rest,io.agrest.sencha.protocol,0,0,0,0,0,0,1,1
nhl_link-rest,io.agrest.sencha.provider,0,1,0,0,0,0,1,2
nhl_link-rest,io.agrest.sencha.runtime.encoder,0,1,0,0,0,0,1,2
nhl_link-rest,io.agrest.sencha.runtime.entity,0,0,0,0,0,0,1,1
nhl_link-rest,io.agrest.sencha.runtime.processor.select,1,0,0,0,0,0,1,2
nhl_link-rest,io.agrest.sencha.runtime.protocol,0,1,0,0,1,0,1,3
nhl_link-rest,io.agrest.sencha.runtime.semantics,0,0,0,0,0,0,1,1
nhl_link-rest,io.agrest.sencha,1,1,0,0,1,0,1,4
nhl_link-rest,io.agrest.sencha.it.fixture,0,0,0,0,0,0,1,1
nhl_link-rest,io.agrest.sencha.it,0,0,0,0,1,0,1,2
nhnopensource_volley-extensions,com.navercorp.volleyextensions.cache.disk,0,0,0,0,0,0,0,0
nhnopensource_volley-extensions,com.navercorp.volleyextensions.cache.universalimageloader.disc,0,0,0,0,0,0,0,0
nhnopensource_volley-extensions,com.navercorp.volleyextensions.cache.universalimageloader.disc.impl,0,0,0,0,1,0,0,1
nhnopensource_volley-extensions,com.navercorp.volleyextensions.cache.universalimageloader.disc.naming,0,0,0,0,0,0,0,0
nhnopensource_volley-extensions,com.navercorp.volleyextensions.cache.universalimageloader.memory.impl,0,0,0,0,1,0,0,1
nhnopensource_volley-extensions,com.navercorp.volleyextensions.cache.universalimageloader.memory,0,0,0,0,0,0,0,0
nhnopensource_volley-extensions,com.navercorp.volleyextensions.util,0,0,0,0,0,0,0,0
nhnopensource_volley-extensions,com.navercorp.volleyextensions.request,0,0,0,0,1,0,0,1
nhnopensource_volley-extensions,com.navercorp.volleyextensions.mock,0,0,0,0,0,0,0,0
nhnopensource_volley-extensions,com.navercorp.volleyextensions.robolectric,0,0,0,0,0,0,0,0
nhnopensource_volley-extensions,com.navercorp.volleyextensions.view,0,0,0,0,0,0,0,0
nhnopensource_volley-extensions,com.navercorp.volleyextensions.volleyer.builder,0,0,0,0,0,0,0,0
nhnopensource_volley-extensions,com.navercorp.volleyextensions.volleyer,1,1,0,0,1,0,0,3
nhnopensource_volley-extensions,com.navercorp.volleyextensions.volleyer.exception,0,0,0,0,0,0,0,0
nhnopensource_volley-extensions,com.navercorp.volleyextensions.volleyer.factory,1,1,0,0,1,0,0,3
nhnopensource_volley-extensions,com.navercorp.volleyextensions.volleyer.http,1,1,0,0,1,0,0,3
nhnopensource_volley-extensions,com.navercorp.volleyextensions.volleyer.multipart,1,0,0,0,0,0,0,1
nhnopensource_volley-extensions,com.navercorp.volleyextensions.volleyer.multipart.stack,0,0,0,0,0,0,0,0
nhnopensource_volley-extensions,com.navercorp.volleyextensions.volleyer.request.creator,0,0,0,0,0,0,0,0
nhnopensource_volley-extensions,com.navercorp.volleyextensions.volleyer.request.executor,0,0,0,0,0,0,0,0
nhnopensource_volley-extensions,com.navercorp.volleyextensions.volleyer.request,0,0,0,0,0,0,0,0
nhnopensource_volley-extensions,com.navercorp.volleyextensions.volleyer.response.parser,0,0,0,0,1,0,0,1
nhnopensource_volley-extensions,com.navercorp.volleyextensions.volleyer.util,0,0,0,0,1,0,0,1
nhnopensource_volley-extensions,com.navercorp.volleyextensions.volleyer.mock,0,0,0,0,0,0,0,0
niclashoyer_neo4j-sparql-extension,de.unikiel.inf.comsys.neo4j.http,3,1,0,0,0,0,0,4
niclashoyer_neo4j-sparql-extension,de.unikiel.inf.comsys.neo4j.http.streams,0,0,0,0,1,0,0,1
niclashoyer_neo4j-sparql-extension,de.unikiel.inf.comsys.neo4j.inference.debug,0,0,0,0,0,0,0,0
niclashoyer_neo4j-sparql-extension,de.unikiel.inf.comsys.neo4j.inference,2,0,0,0,1,0,0,3
niclashoyer_neo4j-sparql-extension,de.unikiel.inf.comsys.neo4j.inference.rules,0,0,0,0,1,0,0,1
niclashoyer_neo4j-sparql-extension,de.unikiel.inf.comsys.neo4j.inference.rules.extractor,0,0,0,0,1,0,0,1
niclashoyer_neo4j-sparql-extension,de.unikiel.inf.comsys.neo4j.inference.sail,0,0,0,0,0,0,0,0
niclashoyer_neo4j-sparql-extension,de.unikiel.inf.comsys.neo4j,2,1,0,0,0,0,0,3
niclashoyer_neo4j-sparql-extension,de.unikiel.inf.comsys.neo4j.http,3,1,0,0,0,0,0,4
niclashoyer_neo4j-sparql-extension,de.unikiel.inf.comsys.neo4j.http.streams,0,0,0,0,1,0,0,1
niclashoyer_neo4j-sparql-extension,de.unikiel.inf.comsys.neo4j.inference.debug,0,0,0,0,0,0,0,0
niclashoyer_neo4j-sparql-extension,de.unikiel.inf.comsys.neo4j.inference,2,0,0,0,1,0,0,3
niclashoyer_neo4j-sparql-extension,de.unikiel.inf.comsys.neo4j.inference.rules,0,0,0,0,1,0,0,1
niclashoyer_neo4j-sparql-extension,de.unikiel.inf.comsys.neo4j.inference.rules.extractor,0,0,0,0,1,0,0,1
niclashoyer_neo4j-sparql-extension,de.unikiel.inf.comsys.neo4j.inference.sail,0,0,0,0,0,0,0,0
niclashoyer_neo4j-sparql-extension,de.unikiel.inf.comsys.neo4j,2,1,0,0,0,0,0,3
nirmal070125_KubernetesAPIJavaClient,com.github.kubernetes.java.client.exceptions,0,0,0,0,0,0,0,0
nirmal070125_KubernetesAPIJavaClient,com.github.kubernetes.java.client.interfaces,0,0,0,0,0,1,0,1
nirmal070125_KubernetesAPIJavaClient,com.github.kubernetes.java.client.model,0,0,0,0,1,1,0,2
nirmal070125_KubernetesAPIJavaClient,com.github.kubernetes.java.client.v2,0,0,0,0,0,0,0,0
nirmal070125_KubernetesAPIJavaClient,com.github.kubernetes.java.client.live,0,0,0,0,0,1,0,1
nirmal070125_KubernetesAPIJavaClient,com.github.kubernetes.java.client,0,0,0,0,0,0,0,0
nirmal070125_KubernetesAPIJavaClient,com.github.kubernetes.java.client.unit,0,0,0,0,0,0,0,0
NirmataOSS_workflow,com.nirmata.workflow.admin,0,0,0,0,1,0,0,1
NirmataOSS_workflow,com.nirmata.workflow.details,2,1,0,0,1,0,0,4
NirmataOSS_workflow,com.nirmata.workflow.details.internalmodels,0,0,0,0,0,0,0,0
NirmataOSS_workflow,com.nirmata.workflow.events,0,0,0,0,0,0,0,0
NirmataOSS_workflow,com.nirmata.workflow.executor,0,0,0,0,0,0,0,0
NirmataOSS_workflow,com.nirmata.workflow.models,0,0,0,0,1,0,0,1
NirmataOSS_workflow,com.nirmata.workflow.queue,0,0,0,0,0,0,0,0
NirmataOSS_workflow,com.nirmata.workflow.queue.zookeeper,1,0,0,0,1,0,0,2
NirmataOSS_workflow,com.nirmata.workflow.serialization,0,0,0,0,1,0,0,1
NirmataOSS_workflow,com.nirmata.workflow,1,1,0,0,1,0,0,3
NLPchina_ansj_seg,org.ansj.lucene.util,0,0,0,0,1,1,0,2
NLPchina_ansj_seg,org.ansj.lucene3,0,0,0,0,0,0,0,0
NLPchina_ansj_seg,org.ansj.lucene4,0,0,0,0,0,0,0,0
NLPchina_ansj_seg,org.ansj.ansj_lucene4_plug,0,0,0,0,0,0,0,0
NLPchina_ansj_seg,org.ansj.lucene5,0,0,0,0,0,0,0,0
NLPchina_ansj_seg,org.ansj.ansj_lucene5_plug,0,0,0,0,1,0,0,1
NLPchina_ansj_seg,org.ansj.lucene6,0,0,0,0,0,0,0,0
NLPchina_ansj_seg,org.ansj.ansj_lucene_plug,0,0,0,0,1,0,0,1
NLPchina_ansj_seg,org.ansj.lucene7,0,0,0,0,0,0,0,0
NLPchina_ansj_seg,org.ansj.solr,0,0,0,0,0,0,0,0
NLPchina_ansj_seg,org.ansj.app.crf,3,1,0,0,1,0,0,5
NLPchina_ansj_seg,org.ansj.app.crf.model,2,0,0,0,1,0,0,3
NLPchina_ansj_seg,org.ansj.app.crf.pojo,1,0,0,0,0,0,0,1
NLPchina_ansj_seg,org.ansj.app.extracting.domain,0,0,0,0,0,1,0,1
NLPchina_ansj_seg,org.ansj.app.extracting.exception,0,0,0,0,0,0,0,0
NLPchina_ansj_seg,org.ansj.app.extracting,0,0,0,0,0,1,0,1
NLPchina_ansj_seg,org.ansj.app.keyword,0,0,0,0,0,0,0,0
NLPchina_ansj_seg,org.ansj.app.phrase,0,0,0,0,0,0,0,0
NLPchina_ansj_seg,org.ansj.app.summary.pojo,0,0,0,0,0,0,0,0
NLPchina_ansj_seg,org.ansj.app.summary,0,0,0,0,0,0,0,0
NLPchina_ansj_seg,org.ansj.dic,4,1,0,0,0,1,0,6
NLPchina_ansj_seg,org.ansj.dic.impl,1,0,0,0,0,0,0,1
NLPchina_ansj_seg,org.ansj.domain,9,1,0,0,1,3,0,14
NLPchina_ansj_seg,org.ansj.exception,0,0,0,0,0,0,0,0
NLPchina_ansj_seg,org.ansj.library,17,1,0,0,1,1,0,20
NLPchina_ansj_seg,org.ansj.recognition.arrimpl,3,0,0,0,1,0,0,4
NLPchina_ansj_seg,org.ansj.recognition.impl,4,0,0,0,1,0,0,5
NLPchina_ansj_seg,org.ansj.recognition,0,0,0,0,0,0,0,0
NLPchina_ansj_seg,org.ansj.splitWord.analysis,7,1,0,0,1,1,0,10
NLPchina_ansj_seg,org.ansj.splitWord,3,0,0,0,0,2,0,5
NLPchina_ansj_seg,org.ansj.splitWord.impl,0,0,0,0,0,0,0,0
NLPchina_ansj_seg,org.ansj.util,11,1,0,0,1,1,0,14
NLPchina_ansj_seg,org.ansj,0,0,0,0,0,0,0,0
NLPchina_ansj_seg,org.ansj.demo,0,0,0,0,1,1,0,2
NLPchina_elasticsearch-sql,com.alibaba.druid.pool,5,0,0,0,1,0,0,6
NLPchina_elasticsearch-sql,org.elasticsearch.plugin.nlpcn,8,1,0,0,1,0,0,10
NLPchina_elasticsearch-sql,org.elasticsearch.plugin.nlpcn.executors,2,0,0,0,1,0,0,3
NLPchina_elasticsearch-sql,org.nlpcn.es4sql.domain,5,1,0,0,1,1,0,8
NLPchina_elasticsearch-sql,org.nlpcn.es4sql.domain.hints,0,0,0,0,0,1,0,1
NLPchina_elasticsearch-sql,org.nlpcn.es4sql.exception,0,0,0,0,0,0,0,0
NLPchina_elasticsearch-sql,org.nlpcn.es4sql.jdbc,0,0,0,0,0,0,0,0
NLPchina_elasticsearch-sql,org.nlpcn.es4sql.parse,0,0,0,0,1,0,0,1
NLPchina_elasticsearch-sql,org.nlpcn.es4sql.query,9,1,0,0,1,1,0,12
NLPchina_elasticsearch-sql,org.nlpcn.es4sql.query.join,4,0,0,0,1,0,0,5
NLPchina_elasticsearch-sql,org.nlpcn.es4sql.query.maker,7,0,0,0,0,0,0,7
NLPchina_elasticsearch-sql,org.nlpcn.es4sql.query.multi,0,0,0,0,0,0,0,0
NLPchina_elasticsearch-sql,org.nlpcn.es4sql,15,1,0,0,1,0,0,17
NLPchina_elasticsearch-sql,org.nlpcn.es4sql.spatial,0,0,0,0,1,0,0,1
NLPchina_elasticsearch-sql,com.zhongshu,0,0,0,0,0,0,0,0
NLPchina_nlp-lang,org.nlpcn.commons.lang.bloomFilter.bitMap,0,0,0,0,0,0,0,0
NLPchina_nlp-lang,org.nlpcn.commons.lang.bloomFilter,0,0,0,0,0,0,0,0
NLPchina_nlp-lang,org.nlpcn.commons.lang.bloomFilter.filter,0,0,0,0,1,0,0,1
NLPchina_nlp-lang,org.nlpcn.commons.lang.bloomFilter.iface,0,0,0,0,0,0,0,0
NLPchina_nlp-lang,org.nlpcn.commons.lang.dat,0,0,0,0,0,0,0,0
NLPchina_nlp-lang,org.nlpcn.commons.lang.dic,0,0,0,0,0,0,0,0
NLPchina_nlp-lang,org.nlpcn.commons.lang.finger,0,0,0,0,0,0,0,0
NLPchina_nlp-lang,org.nlpcn.commons.lang.finger.pojo,0,0,0,0,0,0,0,0
NLPchina_nlp-lang,org.nlpcn.commons.lang.index,0,0,0,0,0,0,0,0
NLPchina_nlp-lang,org.nlpcn.commons.lang.jianfan,0,0,0,0,0,0,0,0
NLPchina_nlp-lang,org.nlpcn.commons.lang.occurrence,0,0,0,0,0,0,0,0
NLPchina_nlp-lang,org.nlpcn.commons.lang.pinyin,0,0,0,0,0,0,0,0
NLPchina_nlp-lang,org.nlpcn.commons.lang.standardization,0,0,0,0,0,0,0,0
NLPchina_nlp-lang,org.nlpcn.commons.lang.tire.domain,0,0,0,0,0,1,0,1
NLPchina_nlp-lang,org.nlpcn.commons.lang.tire,0,0,0,0,0,1,0,1
NLPchina_nlp-lang,org.nlpcn.commons.lang.tire.library,0,0,0,0,0,0,0,0
NLPchina_nlp-lang,org.nlpcn.commons.lang.util,0,0,0,0,1,0,0,1
NLPchina_nlp-lang,org.nlpcn.commons.lang.util.logging,0,0,0,0,1,0,0,1
NLPchina_nlp-lang,org.nlpcn.commons.lang.util.tuples,0,0,0,0,0,0,0,0
NLPchina_nlp-lang,org.nlpcn.commons.lang.util.tuples.valueintf,0,0,0,0,1,0,0,1
NLPchina_nlp-lang,org.nlpcn.commons.lang.viterbi.function,0,0,0,0,0,0,0,0
NLPchina_nlp-lang,org.nlpcn.commons.lang.viterbi,0,0,0,0,0,0,0,0
NLPchina_nlp-lang,org.nlpcn.commons.lang,0,0,0,0,0,0,0,0
NLPchina_nlp-lang,org.nlpcn.commons.lang.tire.splitWord,0,0,0,0,1,1,0,2
Nodeclipse_EditBox,pm.eclipse.editbox.actions,0,0,0,0,0,0,0,0
Nodeclipse_EditBox,pm.eclipse.editbox,1,1,0,0,1,0,0,3
Nodeclipse_EditBox,pm.eclipse.editbox.impl,1,0,0,0,1,0,0,2
Nodeclipse_EditBox,pm.eclipse.editbox.pref,0,0,0,0,1,0,0,1
nordicway_moji,example,0,0,0,0,0,0,0,0
nordicway_moji,it.zielke.moji,0,0,0,0,1,0,0,1
nosceon_titanite,org.nosceon.titanite,4,1,0,1,0,0,0,6
nosceon_titanite,org.nosceon.titanite.body,1,0,0,0,1,0,0,2
nosceon_titanite,org.nosceon.titanite.exception,0,0,0,0,1,0,0,1
nosceon_titanite,org.nosceon.titanite.service,1,1,0,0,0,0,0,2
nosceon_titanite,org.nosceon.titanite.sse,1,1,0,0,0,0,0,2
nosceon_titanite,org.nosceon.titanite.view,0,0,0,0,0,0,0,0
nosceon_titanite,org.nosceon.titanite.auth,0,0,0,0,0,0,0,0
nosceon_titanite,org.nosceon.titanite.auth.basic,0,0,0,0,0,0,0,0
nosceon_titanite,org.nosceon.titanite.examples,0,0,0,0,1,0,0,1
nosceon_titanite,org.nosceon.titanite.json,0,0,0,0,1,0,0,1
nosceon_titanite,org.nosceon.titanite.scope.exception,0,0,0,0,0,0,0,0
nosceon_titanite,org.nosceon.titanite.scope,1,1,0,0,0,0,0,2
nosceon_titanite,org.nosceon.titanite.xml,0,0,0,0,0,0,0,0
novoda_sqlite-analyzer,com.novoda.sqlite.grammar,0,0,0,1,0,0,0,1
novoda_sqlite-analyzer,com.novoda.sqlite,0,0,0,0,0,0,0,0
novoda_sqlite-analyzer,com.novoda.sqlite.impl,0,0,0,0,0,0,0,0
novoda_sqlite-analyzer,com.novoda.sqlite.model,0,0,0,0,0,0,0,0
novoda_sqlite-analyzer,com.novoda.sqlite.generator,0,0,0,0,0,0,0,0
novoda_sqlite-analyzer,com.example,0,0,0,0,0,0,0,0
novoda_sqlite-analyzer,com.novoda.sqliteprovider.demo.simple.provider,0,0,0,0,0,0,0,0
novoda_sqlite-analyzer,com.novoda.sqliteprovider.demo.simple.ui,0,0,0,0,0,0,0,0
numenta_htm.java,org.numenta.nupic.benchmarks,0,0,0,0,0,0,1,1
numenta_htm.java,org.numenta.nupic.algorithms,3,1,0,1,1,3,1,10
numenta_htm.java,org.numenta.nupic.datagen,3,0,0,0,1,1,1,6
numenta_htm.java,org.numenta.nupic.encoders,4,1,0,1,0,0,1,7
numenta_htm.java,org.numenta.nupic,3,0,0,0,1,2,1,7
numenta_htm.java,org.numenta.nupic.model,13,1,0,0,0,3,1,18
numenta_htm.java,org.numenta.nupic.monitor,0,0,0,0,0,0,1,1
numenta_htm.java,org.numenta.nupic.monitor.mixin,0,0,0,0,0,0,1,1
numenta_htm.java,org.numenta.nupic.network,18,0,0,1,1,0,1,21
numenta_htm.java,org.numenta.nupic.network.sensor,6,1,0,1,1,1,1,11
numenta_htm.java,org.numenta.nupic.research.sensorimotor,0,0,0,0,0,0,1,1
numenta_htm.java,org.numenta.nupic.serialize,4,1,0,0,1,0,1,7
numenta_htm.java,org.numenta.nupic.util,18,1,0,1,0,2,1,23
numenta_htm.java,org.numenta.nupic.integration,0,0,0,0,0,0,1,1
nurkiewicz_java8-workshop,com.nurkiewicz.java8.agent,0,0,0,0,0,0,0,0
nurkiewicz_java8-workshop,com.nurkiewicz.java8.atomic,0,0,0,0,0,0,0,0
nurkiewicz_java8-workshop,com.nurkiewicz.java8.defmethods,0,0,0,0,0,0,0,0
nurkiewicz_java8-workshop,com.nurkiewicz.java8,0,0,0,1,1,0,0,2
nurkiewicz_java8-workshop,com.nurkiewicz.java8.holidays,0,0,0,0,1,0,0,1
nurkiewicz_java8-workshop,com.nurkiewicz.java8.interfaces,0,0,0,0,0,0,0,0
nurkiewicz_java8-workshop,com.nurkiewicz.java8.people,0,0,0,0,0,0,0,0
nurkiewicz_java8-workshop,com.nurkiewicz.java8.stackoverflow,0,0,0,0,1,0,0,1
nurkiewicz_java8-workshop,com.nurkiewicz.java8.util,0,0,0,0,0,0,0,0
nurkiewicz_java8-workshop,com.nurkiewicz.rxjava,0,0,0,0,1,0,0,1
nurkiewicz_java8-workshop,com.nurkiewicz.rxjava.util,0,0,0,0,0,0,0,0
nurkiewicz_java8-workshop,com.nurkiewicz.rxjava.weather,0,0,0,0,0,0,0,0
nutzam_nutzwx,org.nutz.plugins.weixin,0,0,0,0,0,0,0,0
nutzam_nutzwx,org.nutz.weixin.at.impl,0,0,0,0,1,0,0,1
nutzam_nutzwx,org.nutz.weixin.at,0,0,0,0,0,0,0,0
nutzam_nutzwx,org.nutz.weixin.bean,0,0,0,0,1,0,0,1
nutzam_nutzwx,org.nutz.weixin.impl,2,0,0,0,1,0,0,3
nutzam_nutzwx,org.nutz.weixin.mvc,1,0,0,0,0,0,0,1
nutzam_nutzwx,org.nutz.weixin.repo.com.qq.weixin.mp.aes,2,1,0,0,0,0,0,3
nutzam_nutzwx,org.nutz.weixin.session,0,0,0,0,0,0,0,0
nutzam_nutzwx,org.nutz.weixin.session.memory,0,0,0,0,0,0,0,0
nutzam_nutzwx,org.nutz.weixin.spi,0,0,0,0,1,0,0,1
nutzam_nutzwx,org.nutz.weixin.util,4,1,0,0,1,0,0,6
nutzam_nutzwx,org.nutz.weixin,0,0,0,0,0,0,0,0
nutzam_ssdb4j,org.nutz.ssdb4j.impl,4,0,0,0,1,1,0,6
nutzam_ssdb4j,org.nutz.ssdb4j.pool,3,0,0,0,0,0,0,3
nutzam_ssdb4j,org.nutz.ssdb4j.replication,0,0,0,0,0,0,0,0
nutzam_ssdb4j,org.nutz.ssdb4j.spi,4,1,0,0,1,1,0,7
nutzam_ssdb4j,org.nutz.ssdb4j,6,1,0,0,0,1,0,8
oasp_oasp4j,io.oasp.module.basic.common.api.config,0,0,0,0,1,1,0,2
oasp_oasp4j,io.oasp.module.basic.common.api.query,0,0,0,0,0,0,0,0
oasp_oasp4j,io.oasp.module.basic.common.api.reference,0,0,0,0,1,0,0,1
oasp_oasp4j,io.oasp.module.basic.common.api.reflect,0,0,0,0,0,0,0,0
oasp_oasp4j,io.oasp.module.basic.common.api.to,0,0,0,0,0,0,0,0
oasp_oasp4j,io.oasp.module.basic.configuration,0,0,0,0,0,0,0,0
oasp_oasp4j,io.oasp.module.batch.common.base,0,0,0,0,0,0,0,0
oasp_oasp4j,io.oasp.module.batch.common.impl,0,0,0,0,0,0,0,0
oasp_oasp4j,io.oasp.module.beanmapping.common.api,0,0,0,0,0,0,0,0
oasp_oasp4j,io.oasp.module.beanmapping.common.base,0,0,0,0,0,0,0,0
oasp_oasp4j,io.oasp.module.beanmapping.common.impl.dozer,0,0,0,0,0,0,0,0
oasp_oasp4j,io.oasp.module.beanmapping.common.impl,0,0,0,0,1,0,0,1
oasp_oasp4j,io.oasp.module.beanmapping.common.impl.orika,0,0,0,0,0,0,0,0
oasp_oasp4j,io.oasp.module.cxf.common.impl.client,0,0,0,0,0,0,0,0
oasp_oasp4j,io.oasp.module.cxf.common.impl.client.interceptor,0,0,0,0,0,0,0,0
oasp_oasp4j,io.oasp.module.cxf.common.impl.client.rest,0,0,0,0,0,0,0,0
oasp_oasp4j,io.oasp.module.cxf.common.impl.client.ws,0,0,0,0,0,0,0,0
oasp_oasp4j,io.oasp.module.cxf.common.impl.server,0,0,0,0,0,0,0,0
oasp_oasp4j,io.oasp.module.cxf.common.impl.server.rest,0,0,0,0,0,0,0,0
oasp_oasp4j,io.oasp.module.cxf.common.impl.server.soap,0,0,0,0,0,0,0,0
oasp_oasp4j,io.oasp.module.jpa.common.api.to,0,0,0,0,0,0,0,0
oasp_oasp4j,io.oasp.module.jpa.common.base,0,0,0,0,0,0,0,0
oasp_oasp4j,io.oasp.module.jpa.dataaccess.api,1,1,0,0,1,0,0,3
oasp_oasp4j,io.oasp.module.jpa.dataaccess.api.feature,0,0,0,0,0,0,0,0
oasp_oasp4j,io.oasp.module.jpa.dataaccess.base,0,0,0,0,1,0,0,1
oasp_oasp4j,io.oasp.module.jpa.dataaccess.impl,0,0,0,0,0,0,0,0
oasp_oasp4j,io.oasp.example.component.common.api,0,0,0,0,0,0,0,0
oasp_oasp4j,io.oasp.example.component.common.api.to,0,0,0,0,0,0,0,0
oasp_oasp4j,io.oasp.example.component.dataaccess.api,1,0,0,0,0,0,0,1
oasp_oasp4j,io.oasp.example.component.dataaccess.api.dao,0,0,0,0,0,0,0,0
oasp_oasp4j,io.oasp.example.component.dataaccess.impl,0,0,0,0,0,0,0,0
oasp_oasp4j,io.oasp.example.component.dataaccess.impl.dao,0,0,0,0,0,0,0,0
oasp_oasp4j,io.oasp.example.general.common.api.config,0,0,0,0,0,0,0,0
oasp_oasp4j,io.oasp.example.general.common.api,0,0,0,0,0,0,0,0
oasp_oasp4j,io.oasp.example.general.dataaccess.api,0,0,0,0,0,0,0,0
oasp_oasp4j,io.oasp.example,0,0,0,0,0,0,0,0
oasp_oasp4j,io.oasp.module.jpa.dataaccess.api.data,0,0,0,0,0,0,0,0
oasp_oasp4j,io.oasp.module.jpa.dataaccess.impl.data,0,0,0,0,1,0,0,1
oasp_oasp4j,io.oasp.module.json.common.base,0,0,0,0,1,0,0,1
oasp_oasp4j,io.oasp.module.json.common.base.type,0,0,0,0,0,0,0,0
oasp_oasp4j,io.oasp.module.logging.common.api,0,0,0,0,0,0,0,0
oasp_oasp4j,io.oasp.module.logging.common.impl,0,0,0,0,1,0,0,1
oasp_oasp4j,io.oasp.module.rest.common.api,0,0,0,0,0,0,0,0
oasp_oasp4j,io.oasp.module.rest.service.api,0,0,0,0,0,0,0,0
oasp_oasp4j,io.oasp.module.rest.service.impl.json,0,0,0,0,0,0,0,0
oasp_oasp4j,io.oasp.module.rest.service.impl,0,0,0,0,0,0,0,0
oasp_oasp4j,io.oasp.module.security.common.api.accesscontrol,0,0,0,0,1,0,0,1
oasp_oasp4j,io.oasp.module.security.common.api.exception,0,0,0,0,0,0,0,0
oasp_oasp4j,io.oasp.module.security.common.base.accesscontrol,0,0,0,0,1,0,0,1
oasp_oasp4j,io.oasp.module.security.common.impl.accesscontrol,0,0,0,0,1,0,0,1
oasp_oasp4j,io.oasp.module.security.common.impl.rest,0,0,0,0,0,0,0,0
oasp_oasp4j,io.oasp.module.security.common.impl.web,0,0,0,0,0,0,0,0
oasp_oasp4j,io.oasp.module.service.common.api.client.config,0,0,0,0,0,0,0,0
oasp_oasp4j,io.oasp.module.service.common.api.client.context,0,0,0,0,0,1,0,1
oasp_oasp4j,io.oasp.module.service.common.api.client.discovery,0,0,0,0,0,0,0,0
oasp_oasp4j,io.oasp.module.service.common.api.client,0,0,0,0,0,0,0,0
oasp_oasp4j,io.oasp.module.service.common.api.config,0,0,0,0,0,0,0,0
oasp_oasp4j,io.oasp.module.service.common.api.constants,0,0,0,0,0,0,0,0
oasp_oasp4j,io.oasp.module.service.common.api.header,0,0,0,0,0,1,0,1
oasp_oasp4j,io.oasp.module.service.common.api,0,0,0,0,0,0,0,0
oasp_oasp4j,io.oasp.module.service.common.api.sync,0,0,0,0,0,0,0,0
oasp_oasp4j,io.oasp.module.service.common.base.config,0,0,0,0,0,0,0,0
oasp_oasp4j,io.oasp.module.service.common.base.context,0,0,0,0,0,0,0,0
oasp_oasp4j,io.oasp.module.service.common.impl.discovery,0,0,0,0,0,0,0,0
oasp_oasp4j,io.oasp.module.service.common.impl.header,0,0,0,0,0,1,0,1
oasp_oasp4j,io.oasp.module.service.common.impl,0,0,0,0,0,0,0,0
oasp_oasp4j,io.oasp.module.web.common.base.debug,0,0,0,0,0,0,0,0
oasp_oasp4j,io.oasp.module.web.common.base,0,0,0,0,0,0,0,0
oasp_oasp4j,$,0,0,0,1,1,0,0,2
oasp_oasp4j,it.pkg.general.common.api,0,0,0,0,1,0,0,1
oasp_oasp4j,it.pkg.general.common.api.exception,0,0,0,0,1,0,0,1
oasp_oasp4j,it.pkg.general.common.api.to,0,0,0,0,0,0,0,0
oasp_oasp4j,it.pkg.general.logic.api.to,0,0,0,0,0,0,0,0
oasp_oasp4j,it.pkg.general.service.api.rest,0,0,0,0,0,0,0,0
oasp_oasp4j,it.pkg.general.common.api.constants,0,0,0,0,0,0,0,0
oasp_oasp4j,it.pkg.general.common.base,0,0,0,0,1,0,0,1
oasp_oasp4j,it.pkg.general.common.impl.config,0,0,0,0,1,0,0,1
oasp_oasp4j,it.pkg.general.common.impl.security,0,0,0,0,1,0,0,1
oasp_oasp4j,it.pkg.general.dataaccess.api,0,0,0,0,1,0,0,1
oasp_oasp4j,it.pkg.general.dataaccess.api.dao,0,0,0,0,0,0,0,0
oasp_oasp4j,it.pkg.general.logic.api,0,0,0,0,0,0,0,0
oasp_oasp4j,it.pkg.general.logic.base,0,0,0,0,0,0,0,0
oasp_oasp4j,it.pkg.general.logic.impl.config,0,0,0,0,0,0,0,0
oasp_oasp4j,it.pkg.general.logic.impl,0,0,0,0,0,0,0,0
oasp_oasp4j,it.pkg.general.service.impl.config,0,0,0,0,1,0,0,1
oasp_oasp4j,it.pkg.general.service.impl,0,0,0,0,0,0,0,0
oasp_oasp4j,it.pkg.general.service.impl.rest,0,0,0,0,1,0,0,1
oasp_oasp4j,it.pkg,0,0,0,0,1,0,0,1
oasp_oasp4j,it.pkg.general.batch.impl.config,0,0,0,0,0,0,0,0
OAuth-Apis_apis,org.surfnet.oaaas.auth,0,0,0,0,1,1,0,2
OAuth-Apis_apis,org.surfnet.oaaas.cas,0,0,0,0,0,0,0,0
OAuth-Apis_apis,org.surfnet.oaaas.model,0,0,0,0,1,2,0,3
OAuth-Apis_apis,org.surfnet.oaaas.model.validation,0,0,0,0,0,0,0,0
OAuth-Apis_apis,org.surfnet.oaaas.noop,0,0,0,0,0,0,0,0
OAuth-Apis_apis,org.surfnet.oaaas.repository,0,0,0,0,1,1,0,2
OAuth-Apis_apis,org.surfnet.oaaas.resource.resourceserver,0,0,0,0,1,0,0,1
OAuth-Apis_apis,org.surfnet.oaaas.resource,0,0,0,0,0,0,0,0
OAuth-Apis_apis,org.surfnet.oaaas.support,0,0,0,0,0,0,0,0
OAuth-Apis_apis,org.surfnet.oaaas.authentication,0,0,0,0,0,0,0,0
OAuth-Apis_apis,org.surfnet.oaaas.config,0,0,0,0,0,0,0,0
OAuth-Apis_apis,org.surfnet.oaaas.consent,0,0,0,0,0,0,0,0
OAuth-Apis_apis,org.surfnet.oaaas.logging,0,0,0,0,0,0,0,0
OAuth-Apis_apis,org.surfnet.oaaas.it,0,0,0,0,1,1,0,2
OAuth-Apis_apis,org.surfnet.oaaas.selenium,0,0,0,0,0,0,0,0
OAuth-Apis_apis,org.surfnet.oaaas.web,0,0,0,0,0,0,0,0
OAuth-Apis_apis,org.surfnet.oaaas.example.api,0,0,0,0,0,0,0,0
OAuth-Apis_apis,org.surfnet.oaaas.example.api.domain,0,0,0,0,0,0,0,0
OAuth-Apis_apis,org.surfnet.oaaas.example.api.resource,0,0,0,0,0,0,0,0
OAuth-Apis_apis,org.surfnet.oaaas.conext.mock,0,0,0,0,0,0,0,0
OAuth-Apis_apis,org.surfnet.oaaas.auth.principal,0,0,0,0,0,1,0,1
OAuth-Apis_apis,org.surfnet.oaaas.conext,0,0,0,0,0,0,0,0
OAuth-Apis_apis,org.surfnet.oaaas.jetty,0,0,0,0,0,0,0,0
ObeoNetwork_UML-Designer,org.eclipse.umlgen.gen.java.main,0,0,0,0,0,0,0,0
ObeoNetwork_UML-Designer,org.eclipse.umlgen.gen.java.services,0,0,0,0,1,0,0,1
ObeoNetwork_UML-Designer,org.eclipse.umlgen.gen.java,0,0,0,0,0,0,0,0
ObeoNetwork_UML-Designer,org.eclipse.umlgen.gen.java.utils,0,0,0,0,0,0,0,0
ObeoNetwork_UML-Designer,org.eclipse.umlgen.gen.java.ui.common,0,1,0,0,0,0,0,1
ObeoNetwork_UML-Designer,org.eclipse.umlgen.gen.java.ui.handler,0,0,0,0,0,0,0,0
ObeoNetwork_UML-Designer,org.eclipse.umlgen.gen.java.ui.launch,0,0,0,0,1,0,0,1
ObeoNetwork_UML-Designer,org.eclipse.umlgen.gen.java.ui.launch.tabs,0,0,0,0,0,0,0,0
ObeoNetwork_UML-Designer,org.eclipse.umlgen.gen.java.ui.properties,0,0,0,0,0,0,0,0
ObeoNetwork_UML-Designer,org.eclipse.umlgen.gen.java.ui,0,0,0,0,0,0,0,0
ObeoNetwork_UML-Designer,org.eclipse.umlgen.gen.java.ui.utils,0,0,0,0,0,0,0,0
ObeoNetwork_UML-Designer,org.eclipse.umlgen.reverse.java,0,0,0,0,0,0,0,0
ObeoNetwork_UML-Designer,org.eclipse.umlgen.reverse.java.internal.handler,0,0,0,0,0,0,0,0
ObeoNetwork_UML-Designer,org.eclipse.umlgen.reverse.java.internal,0,0,0,0,0,0,0,0
ObeoNetwork_UML-Designer,org.eclipse.umlgen.reverse.java.internal.wizards,0,0,0,0,0,0,0,0
ObeoNetwork_UML-Designer,org.eclipse.umlgen.reverse.java.logging,0,0,0,0,0,0,0,0
ObeoNetwork_UML-Designer,org.eclipse.umlgen.reverse.java.preferencesStore,0,0,0,0,0,0,0,0
ObeoNetwork_UML-Designer,org.eclipse.umlgen.reverse.java.properties,0,0,0,0,0,0,0,0
ObeoNetwork_UML-Designer,org.eclipse.umlgen.ui.properties,0,0,0,0,0,0,0,0
ObeoNetwork_UML-Designer,org.obeonetwork.dsl.uml2.core,0,0,0,0,0,0,0,0
ObeoNetwork_UML-Designer,org.obeonetwork.dsl.uml2.core.api.services,0,0,0,0,0,0,0,0
ObeoNetwork_UML-Designer,org.obeonetwork.dsl.uml2.core.api.utils,0,0,0,0,0,0,0,0
ObeoNetwork_UML-Designer,org.obeonetwork.dsl.uml2.core.api.wizards,0,0,0,0,1,0,0,1
ObeoNetwork_UML-Designer,org.obeonetwork.dsl.uml2.core.internal.commands,0,0,0,0,0,0,0,0
ObeoNetwork_UML-Designer,org.obeonetwork.dsl.uml2.core.internal.dialogs,0,0,0,0,1,0,0,1
ObeoNetwork_UML-Designer,org.obeonetwork.dsl.uml2.core.internal.listeners,0,0,0,0,1,0,0,1
ObeoNetwork_UML-Designer,org.obeonetwork.dsl.uml2.core.internal.properties,0,0,0,0,0,0,0,0
ObeoNetwork_UML-Designer,org.obeonetwork.dsl.uml2.core.internal.services,0,0,0,1,1,0,0,2
ObeoNetwork_UML-Designer,org.obeonetwork.dsl.uml2.core.internal.triggers,0,0,0,0,0,0,0,0
ObeoNetwork_UML-Designer,org.obeonetwork.dsl.uml2.core.internal.wizards,0,0,0,0,0,0,0,0
ObeoNetwork_UML-Designer,org.obeonetwork.dsl.uml2.core.internal.wizards.newproject,0,0,0,0,0,0,0,0
ObeoNetwork_UML-Designer,org.obeonetwork.dsl.uml2.core.preferences,0,0,0,0,0,0,0,0
ObeoNetwork_UML-Designer,org.obeonetwork.dsl.uml2.core.wizard,0,0,0,0,0,0,0,0
ObeoNetwork_UML-Designer,org.obeonetwork.dsl.uml2.dashboard.activities.capture,0,0,0,0,0,0,0,0
ObeoNetwork_UML-Designer,org.obeonetwork.dsl.uml2.dashboard.activities.design,0,0,0,0,1,0,0,1
ObeoNetwork_UML-Designer,org.obeonetwork.dsl.uml2.dashboard.activities.extend,0,0,0,0,0,0,0,0
ObeoNetwork_UML-Designer,org.obeonetwork.dsl.uml2.dashboard.activities.help,0,0,0,0,0,0,0,0
ObeoNetwork_UML-Designer,org.obeonetwork.dsl.uml2.dashboard.activities.review,0,0,0,0,0,0,0,0
ObeoNetwork_UML-Designer,org.obeonetwork.dsl.uml2.dashboard.commands,0,0,0,0,0,0,0,0
ObeoNetwork_UML-Designer,org.obeonetwork.dsl.uml2.dashboard,0,0,0,0,0,0,0,0
ObeoNetwork_UML-Designer,org.obeonetwork.dsl.uml2.dashboard.listeners,0,0,0,0,0,0,0,0
ObeoNetwork_UML-Designer,org.obeonetwork.dsl.uml2.dashboard.predicates,0,0,0,0,0,0,0,0
ObeoNetwork_UML-Designer,org.obeonetwork.dsl.uml2.dashboard.services,0,0,0,0,0,0,0,0
ObeoNetwork_UML-Designer,org.obeonetwork.dsl.uml2.design.api.services,0,0,0,0,1,0,0,1
ObeoNetwork_UML-Designer,org.obeonetwork.dsl.uml2.design.api.utils,0,0,0,0,0,0,0,0
ObeoNetwork_UML-Designer,org.obeonetwork.dsl.uml2.design.api.wizards,0,0,0,0,0,0,0,0
ObeoNetwork_UML-Designer,org.obeonetwork.dsl.uml2.design.internal.actions,0,0,0,0,0,0,0,0
ObeoNetwork_UML-Designer,org.obeonetwork.dsl.uml2.design.internal.commands,0,0,0,0,1,0,0,1
ObeoNetwork_UML-Designer,org.obeonetwork.dsl.uml2.design.internal.constraints,0,0,0,0,0,0,0,0
ObeoNetwork_UML-Designer,org.obeonetwork.dsl.uml2.design.internal.dialogs,0,0,0,0,1,0,0,1
ObeoNetwork_UML-Designer,org.obeonetwork.dsl.uml2.design.internal.editpart,0,0,0,0,0,0,0,0
ObeoNetwork_UML-Designer,org.obeonetwork.dsl.uml2.design.internal.listeners,0,0,0,0,0,0,0,0
ObeoNetwork_UML-Designer,org.obeonetwork.dsl.uml2.design.internal.services,0,0,0,0,1,0,0,1
ObeoNetwork_UML-Designer,org.obeonetwork.dsl.uml2.design.internal.triggers,0,0,0,0,0,0,0,0
ObeoNetwork_UML-Designer,org.obeonetwork.dsl.uml2.design.internal.wizards.example,0,0,0,0,0,0,0,0
ObeoNetwork_UML-Designer,org.obeonetwork.dsl.uml2.design.internal.wizards,0,0,0,0,0,0,0,0
ObeoNetwork_UML-Designer,org.obeonetwork.dsl.uml2.design.internal.wizards.newmodel,0,0,0,0,0,0,0,0
ObeoNetwork_UML-Designer,org.obeonetwork.dsl.uml2.design.internal.wizards.newproject,0,0,0,0,0,0,0,0
ObeoNetwork_UML-Designer,org.obeonetwork.dsl.uml2.design,0,0,0,0,0,0,0,0
ObeoNetwork_UML-Designer,org.obeonetwork.dsl.uml2.discovery.handlers,0,0,0,0,0,0,0,0
ObeoNetwork_UML-Designer,org.obeonetwork.dsl.uml2.discovery,0,0,0,0,0,0,0,0
ObeoNetwork_UML-Designer,org.obeonetwork.dsl.uml2.editor.internal,0,0,0,0,1,0,0,1
ObeoNetwork_UML-Designer,org.obeonetwork.dsl.uml2.navigator,0,0,0,0,0,0,0,0
ObeoNetwork_UML-Designer,org.obeonetwork.dsl.uml2.usage.analytics,0,0,0,0,0,0,0,0
ObeoNetwork_UML-Designer,org.obeonetwork.dsl.uml2.usage.dialog,0,0,0,0,0,0,0,0
ObeoNetwork_UML-Designer,org.obeonetwork.dsl.uml2.usage.preferences,0,0,0,0,0,0,0,0
ObeoNetwork_UML-Designer,org.obeonetwork.dsl.uml2.usage,0,0,0,0,0,0,0,0
ObeoNetwork_UML-Designer,org.obeonetwork.gmf.runtime.diagram.ui.extension,0,0,0,0,0,0,0,0
ObeoNetwork_UML-Designer,org.obeonetwork.gmf.runtime.diagram.ui.extension.rotatable.editPart,0,0,0,0,0,0,0,0
ObeoNetwork_UML-Designer,org.obeonetwork.gmf.runtime.diagram.ui.extension.rotatable.editPart.listener,0,0,0,0,0,0,0,0
ObeoNetwork_UML-Designer,org.obeonetwork.gmf.runtime.diagram.ui.extension.rotatable.figure,0,0,0,0,0,0,0,0
ObeoNetwork_UML-Designer,org.obeonetwork.gmf.runtime.diagram.ui.extension.rotatable.figure.listener,0,0,0,0,0,0,0,0
ObeoNetwork_UML-Designer,org.obeonetwork.gmf.runtime.diagram.ui.extension.rotatable,0,0,0,0,0,0,0,0
ObeoNetwork_UML-Designer,org.obeonetwork.gmf.runtime.diagram.ui.extension.rotatable.provider,0,0,0,0,0,0,0,0
OfficeDev_ews-java-api,microsoft.exchange.webservices.data.autodiscover,5,1,0,0,1,4,0,11
OfficeDev_ews-java-api,microsoft.exchange.webservices.data.autodiscover.configuration,0,0,0,0,0,0,0,0
OfficeDev_ews-java-api,microsoft.exchange.webservices.data.autodiscover.configuration.outlook,2,0,0,0,0,2,0,4
OfficeDev_ews-java-api,microsoft.exchange.webservices.data.autodiscover.exception,0,0,0,0,0,0,0,0
OfficeDev_ews-java-api,microsoft.exchange.webservices.data.autodiscover.exception.error,0,0,0,0,0,1,0,1
OfficeDev_ews-java-api,microsoft.exchange.webservices.data.autodiscover.request,2,0,0,0,0,1,0,3
OfficeDev_ews-java-api,microsoft.exchange.webservices.data.autodiscover.response,3,0,0,0,0,2,0,5
OfficeDev_ews-java-api,microsoft.exchange.webservices.data.core,24,1,0,1,1,27,0,54
OfficeDev_ews-java-api,microsoft.exchange.webservices.data.core.exception.dns,0,0,0,0,0,0,0,0
OfficeDev_ews-java-api,microsoft.exchange.webservices.data.core.exception.http,0,0,0,0,0,0,0,0
OfficeDev_ews-java-api,microsoft.exchange.webservices.data.core.exception.misc,0,0,0,0,0,0,0,0
OfficeDev_ews-java-api,microsoft.exchange.webservices.data.core.exception.service.local,0,0,0,0,0,0,0,0
OfficeDev_ews-java-api,microsoft.exchange.webservices.data.core.exception.service.remote,2,0,0,0,0,0,0,2
OfficeDev_ews-java-api,microsoft.exchange.webservices.data.core.exception.xml,0,0,0,0,0,0,0,0
OfficeDev_ews-java-api,microsoft.exchange.webservices.data.core.request,3,0,0,1,1,1,0,6
OfficeDev_ews-java-api,microsoft.exchange.webservices.data.core.response,0,0,0,1,0,4,0,5
OfficeDev_ews-java-api,microsoft.exchange.webservices.data.core.service.folder,2,0,0,0,0,0,0,2
OfficeDev_ews-java-api,microsoft.exchange.webservices.data.core.service,0,0,0,0,0,12,0,12
OfficeDev_ews-java-api,microsoft.exchange.webservices.data.core.service.item,9,1,0,0,1,7,0,18
OfficeDev_ews-java-api,microsoft.exchange.webservices.data.core.service.response,2,0,0,0,1,3,0,6
OfficeDev_ews-java-api,microsoft.exchange.webservices.data.core.service.schema,3,0,0,0,1,0,0,4
OfficeDev_ews-java-api,microsoft.exchange.webservices.data.credential,0,0,0,0,1,0,0,1
OfficeDev_ews-java-api,microsoft.exchange.webservices.data.dns,0,0,0,0,0,1,0,1
OfficeDev_ews-java-api,microsoft.exchange.webservices.data,0,0,0,0,0,0,0,0
OfficeDev_ews-java-api,microsoft.exchange.webservices.data.messaging,0,1,0,0,0,1,0,2
OfficeDev_ews-java-api,microsoft.exchange.webservices.data.misc,13,1,0,1,1,4,0,20
OfficeDev_ews-java-api,microsoft.exchange.webservices.data.misc.availability,0,0,0,0,1,2,0,3
OfficeDev_ews-java-api,microsoft.exchange.webservices.data.misc.id,0,0,0,0,0,0,0,0
OfficeDev_ews-java-api,microsoft.exchange.webservices.data.notification,0,0,0,0,1,1,0,2
OfficeDev_ews-java-api,microsoft.exchange.webservices.data.property.complex,17,1,0,1,0,15,0,34
OfficeDev_ews-java-api,microsoft.exchange.webservices.data.property.complex.availability,0,1,0,0,1,2,0,4
OfficeDev_ews-java-api,microsoft.exchange.webservices.data.property.complex.recurrence,0,0,0,0,0,1,0,1
OfficeDev_ews-java-api,microsoft.exchange.webservices.data.property.complex.recurrence.pattern,3,0,0,0,0,1,0,4
OfficeDev_ews-java-api,microsoft.exchange.webservices.data.property.complex.recurrence.range,4,0,0,0,0,0,0,4
OfficeDev_ews-java-api,microsoft.exchange.webservices.data.property.complex.time,2,0,0,0,0,0,0,2
OfficeDev_ews-java-api,microsoft.exchange.webservices.data.property.definition,10,1,0,0,0,7,0,18
OfficeDev_ews-java-api,microsoft.exchange.webservices.data.search,0,0,0,0,1,0,0,1
OfficeDev_ews-java-api,microsoft.exchange.webservices.data.search.filter,4,1,0,0,1,1,0,7
OfficeDev_ews-java-api,microsoft.exchange.webservices.data.security,0,0,0,0,0,5,0,5
OfficeDev_ews-java-api,microsoft.exchange.webservices.data.sync,0,0,0,0,0,0,0,0
OfficeDev_ews-java-api,microsoft.exchange.webservices.data.util,0,0,0,0,0,0,0,0
OfficeDev_ews-java-api,microsoft.exchange.webservices.base,0,0,0,0,0,0,0,0
OfficeDev_ews-java-api,microsoft.exchange.webservices.base.util,0,0,0,0,0,0,0,0
OfficeDev_ews-java-api,microsoft.exchange.webservices.data.core.service.items,0,0,0,0,0,0,0,0
OfficeDev_ews-java-api,microsoft.exchange.webservices.data.exception,0,0,0,0,0,0,0,0
OfficeDev_ews-java-api,microsoft.exchange.webservices.data.autodiscover,5,1,0,0,1,4,0,11
OfficeDev_ews-java-api,microsoft.exchange.webservices.data.autodiscover.configuration,0,0,0,0,0,0,0,0
OfficeDev_ews-java-api,microsoft.exchange.webservices.data.autodiscover.configuration.outlook,2,0,0,0,0,2,0,4
OfficeDev_ews-java-api,microsoft.exchange.webservices.data.autodiscover.exception,0,0,0,0,0,0,0,0
OfficeDev_ews-java-api,microsoft.exchange.webservices.data.autodiscover.exception.error,0,0,0,0,0,1,0,1
OfficeDev_ews-java-api,microsoft.exchange.webservices.data.autodiscover.request,2,0,0,0,0,1,0,3
OfficeDev_ews-java-api,microsoft.exchange.webservices.data.autodiscover.response,3,0,0,0,0,2,0,5
OfficeDev_ews-java-api,microsoft.exchange.webservices.data.core,24,1,0,1,1,27,0,54
OfficeDev_ews-java-api,microsoft.exchange.webservices.data.core.exception.dns,0,0,0,0,0,0,0,0
OfficeDev_ews-java-api,microsoft.exchange.webservices.data.core.exception.http,0,0,0,0,0,0,0,0
OfficeDev_ews-java-api,microsoft.exchange.webservices.data.core.exception.misc,0,0,0,0,0,0,0,0
OfficeDev_ews-java-api,microsoft.exchange.webservices.data.core.exception.service.local,0,0,0,0,0,0,0,0
OfficeDev_ews-java-api,microsoft.exchange.webservices.data.core.exception.service.remote,2,0,0,0,0,0,0,2
OfficeDev_ews-java-api,microsoft.exchange.webservices.data.core.exception.xml,0,0,0,0,0,0,0,0
OfficeDev_ews-java-api,microsoft.exchange.webservices.data.core.request,3,0,0,1,1,1,0,6
OfficeDev_ews-java-api,microsoft.exchange.webservices.data.core.response,0,0,0,1,0,4,0,5
OfficeDev_ews-java-api,microsoft.exchange.webservices.data.core.service.folder,2,0,0,0,0,0,0,2
OfficeDev_ews-java-api,microsoft.exchange.webservices.data.core.service,0,0,0,0,0,12,0,12
OfficeDev_ews-java-api,microsoft.exchange.webservices.data.core.service.item,9,1,0,0,1,7,0,18
OfficeDev_ews-java-api,microsoft.exchange.webservices.data.core.service.response,2,0,0,0,1,3,0,6
OfficeDev_ews-java-api,microsoft.exchange.webservices.data.core.service.schema,3,0,0,0,1,0,0,4
OfficeDev_ews-java-api,microsoft.exchange.webservices.data.credential,0,0,0,0,1,0,0,1
OfficeDev_ews-java-api,microsoft.exchange.webservices.data.dns,0,0,0,0,0,1,0,1
OfficeDev_ews-java-api,microsoft.exchange.webservices.data,0,0,0,0,0,0,0,0
OfficeDev_ews-java-api,microsoft.exchange.webservices.data.messaging,0,1,0,0,0,1,0,2
OfficeDev_ews-java-api,microsoft.exchange.webservices.data.misc,13,1,0,1,1,4,0,20
OfficeDev_ews-java-api,microsoft.exchange.webservices.data.misc.availability,0,0,0,0,1,2,0,3
OfficeDev_ews-java-api,microsoft.exchange.webservices.data.misc.id,0,0,0,0,0,0,0,0
OfficeDev_ews-java-api,microsoft.exchange.webservices.data.notification,0,0,0,0,1,1,0,2
OfficeDev_ews-java-api,microsoft.exchange.webservices.data.property.complex,17,1,0,1,0,15,0,34
OfficeDev_ews-java-api,microsoft.exchange.webservices.data.property.complex.availability,0,1,0,0,1,2,0,4
OfficeDev_ews-java-api,microsoft.exchange.webservices.data.property.complex.recurrence,0,0,0,0,0,1,0,1
OfficeDev_ews-java-api,microsoft.exchange.webservices.data.property.complex.recurrence.pattern,3,0,0,0,0,1,0,4
OfficeDev_ews-java-api,microsoft.exchange.webservices.data.property.complex.recurrence.range,4,0,0,0,0,0,0,4
OfficeDev_ews-java-api,microsoft.exchange.webservices.data.property.complex.time,2,0,0,0,0,0,0,2
OfficeDev_ews-java-api,microsoft.exchange.webservices.data.property.definition,10,1,0,0,0,7,0,18
OfficeDev_ews-java-api,microsoft.exchange.webservices.data.search,0,0,0,0,1,0,0,1
OfficeDev_ews-java-api,microsoft.exchange.webservices.data.search.filter,4,1,0,0,1,1,0,7
OfficeDev_ews-java-api,microsoft.exchange.webservices.data.security,0,0,0,0,0,5,0,5
OfficeDev_ews-java-api,microsoft.exchange.webservices.data.sync,0,0,0,0,0,0,0,0
OfficeDev_ews-java-api,microsoft.exchange.webservices.data.util,0,0,0,0,0,0,0,0
OfficeDev_ews-java-api,microsoft.exchange.webservices.base,0,0,0,0,0,0,0,0
OfficeDev_ews-java-api,microsoft.exchange.webservices.base.util,0,0,0,0,0,0,0,0
OfficeDev_ews-java-api,microsoft.exchange.webservices.data.core.service.items,0,0,0,0,0,0,0,0
OfficeDev_ews-java-api,microsoft.exchange.webservices.data.exception,0,0,0,0,0,0,0,0
OHDSI_WebAPI,org.ohdsi.webapi.activity,0,0,0,0,0,0,0,0
OHDSI_WebAPI,org.ohdsi.webapi.analysis,0,0,0,0,0,0,0,0
OHDSI_WebAPI,org.ohdsi.webapi.analysis.converter,0,0,0,0,0,0,0,0
OHDSI_WebAPI,org.ohdsi.webapi,31,1,0,1,1,0,0,34
OHDSI_WebAPI,org.ohdsi.webapi.cache,1,1,0,0,0,0,0,2
OHDSI_WebAPI,org.ohdsi.webapi.cdmresults.cache,1,1,0,0,0,0,0,2
OHDSI_WebAPI,org.ohdsi.webapi.cdmresults,1,0,0,0,0,0,0,1
OHDSI_WebAPI,org.ohdsi.webapi.cdmresults.mapper,0,0,0,0,0,0,0,0
OHDSI_WebAPI,org.ohdsi.webapi.cohort,0,0,0,0,0,0,0,0
OHDSI_WebAPI,org.ohdsi.webapi.cohortanalysis,2,0,0,0,1,0,0,3
OHDSI_WebAPI,org.ohdsi.webapi.cohortcharacterization,10,1,0,0,1,0,0,12
OHDSI_WebAPI,org.ohdsi.webapi.cohortcharacterization.converter,3,0,0,0,1,0,0,4
OHDSI_WebAPI,org.ohdsi.webapi.cohortcharacterization.domain,0,0,0,0,0,0,0,0
OHDSI_WebAPI,org.ohdsi.webapi.cohortcharacterization.dto,1,1,0,0,1,0,0,3
OHDSI_WebAPI,org.ohdsi.webapi.cohortcharacterization.repository,0,0,0,0,1,0,0,1
OHDSI_WebAPI,org.ohdsi.webapi.cohortcharacterization.specification,0,0,0,0,0,0,0,0
OHDSI_WebAPI,org.ohdsi.webapi.cohortdefinition,6,1,0,0,1,0,0,8
OHDSI_WebAPI,org.ohdsi.webapi.cohortdefinition.converter,0,0,0,0,1,0,0,1
OHDSI_WebAPI,org.ohdsi.webapi.cohortdefinition.dto,0,0,0,0,0,0,0,0
OHDSI_WebAPI,org.ohdsi.webapi.cohortfeatures,0,0,0,0,0,0,0,0
OHDSI_WebAPI,org.ohdsi.webapi.cohortresults,0,0,0,1,1,0,0,2
OHDSI_WebAPI,org.ohdsi.webapi.cohortresults.mapper,0,0,0,0,1,0,0,1
OHDSI_WebAPI,org.ohdsi.webapi.common.analyses,0,0,0,0,0,0,0,0
OHDSI_WebAPI,org.ohdsi.webapi.common,4,0,0,0,0,0,0,4
OHDSI_WebAPI,org.ohdsi.webapi.common.generation,2,0,0,0,1,0,0,3
OHDSI_WebAPI,org.ohdsi.webapi.common.sensitiveinfo,0,0,0,0,1,0,0,1
OHDSI_WebAPI,org.ohdsi.webapi.conceptset,0,0,0,0,1,1,0,2
OHDSI_WebAPI,org.ohdsi.webapi.conceptset.converter,0,0,0,0,0,0,0,0
OHDSI_WebAPI,org.ohdsi.webapi.configuration,0,0,0,0,0,0,0,0
OHDSI_WebAPI,org.ohdsi.webapi.converter,0,0,0,0,0,0,0,0
OHDSI_WebAPI,org.ohdsi.webapi.cyclops.specification,0,0,0,0,0,0,0,0
OHDSI_WebAPI,org.ohdsi.webapi.db.migartion,0,0,0,0,1,0,0,1
OHDSI_WebAPI,org.ohdsi.webapi.estimation.comparativecohortanalysis.specification,0,0,0,0,1,0,0,1
OHDSI_WebAPI,org.ohdsi.webapi.estimation.converter,0,0,0,0,0,0,0,0
OHDSI_WebAPI,org.ohdsi.webapi.estimation.domain,0,0,0,0,0,0,0,0
OHDSI_WebAPI,org.ohdsi.webapi.estimation.dto,0,0,0,0,0,0,0,0
OHDSI_WebAPI,org.ohdsi.webapi.estimation,0,0,0,0,0,0,0,0
OHDSI_WebAPI,org.ohdsi.webapi.estimation.repository,0,0,0,0,0,0,0,0
OHDSI_WebAPI,org.ohdsi.webapi.estimation.specification,0,0,0,0,1,0,0,1
OHDSI_WebAPI,org.ohdsi.webapi.evidence,0,0,0,0,1,0,0,1
OHDSI_WebAPI,org.ohdsi.webapi.evidence.negativecontrols,0,0,0,0,0,0,0,0
OHDSI_WebAPI,org.ohdsi.webapi.exampleapplication,0,0,0,0,0,0,0,0
OHDSI_WebAPI,org.ohdsi.webapi.exampleapplication.model,0,0,0,0,0,0,0,0
OHDSI_WebAPI,org.ohdsi.webapi.exampleapplication.repository,0,0,0,0,0,0,0,0
OHDSI_WebAPI,org.ohdsi.webapi.exception,0,0,0,0,0,0,0,0
OHDSI_WebAPI,org.ohdsi.webapi.executionengine.controller,0,0,0,0,0,0,0,0
OHDSI_WebAPI,org.ohdsi.webapi.executionengine.dto,0,0,0,0,0,0,0,0
OHDSI_WebAPI,org.ohdsi.webapi.executionengine.entity,0,0,0,0,1,0,0,1
OHDSI_WebAPI,org.ohdsi.webapi.executionengine.exception,0,0,0,0,0,0,0,0
OHDSI_WebAPI,org.ohdsi.webapi.executionengine.job,2,0,0,0,0,0,0,2
OHDSI_WebAPI,org.ohdsi.webapi.executionengine.repository,0,0,0,0,0,0,0,0
OHDSI_WebAPI,org.ohdsi.webapi.executionengine.service,0,0,0,0,1,0,0,1
OHDSI_WebAPI,org.ohdsi.webapi.executionengine.util,0,0,0,0,0,0,0,0
OHDSI_WebAPI,org.ohdsi.webapi.feanalysis.converter,0,0,0,0,1,0,0,1
OHDSI_WebAPI,org.ohdsi.webapi.feanalysis.domain,0,0,0,0,1,0,0,1
OHDSI_WebAPI,org.ohdsi.webapi.feanalysis.dto,0,0,0,0,1,0,0,1
OHDSI_WebAPI,org.ohdsi.webapi.feanalysis,0,0,0,0,0,0,0,0
OHDSI_WebAPI,org.ohdsi.webapi.feanalysis.repository,0,0,0,0,0,0,0,0
OHDSI_WebAPI,org.ohdsi.webapi.feasibility,2,0,0,0,1,0,0,3
OHDSI_WebAPI,org.ohdsi.webapi.featureextraction.specification,0,0,0,0,0,0,0,0
OHDSI_WebAPI,org.ohdsi.webapi.generationcache,3,0,0,0,1,0,0,4
OHDSI_WebAPI,org.ohdsi.webapi.helper,0,0,0,0,0,0,0,0
OHDSI_WebAPI,org.ohdsi.webapi.info,0,0,0,0,0,0,0,0
OHDSI_WebAPI,org.ohdsi.webapi.ircalc,3,0,0,0,1,0,0,4
OHDSI_WebAPI,org.ohdsi.webapi.job,3,1,0,0,1,0,0,5
OHDSI_WebAPI,org.ohdsi.webapi.model,0,0,0,0,0,0,0,0
OHDSI_WebAPI,org.ohdsi.webapi.model.results,0,0,0,0,0,0,0,0
OHDSI_WebAPI,org.ohdsi.webapi.pathway.converter,0,0,0,0,1,0,0,1
OHDSI_WebAPI,org.ohdsi.webapi.pathway.domain,0,0,0,0,0,0,0,0
OHDSI_WebAPI,org.ohdsi.webapi.pathway.dto,0,0,0,0,1,0,0,1
OHDSI_WebAPI,org.ohdsi.webapi.pathway.dto.internal,0,0,0,0,0,0,0,0
OHDSI_WebAPI,org.ohdsi.webapi.pathway,0,0,0,0,0,0,0,0
OHDSI_WebAPI,org.ohdsi.webapi.pathway.repository,0,0,0,0,0,0,0,0
OHDSI_WebAPI,org.ohdsi.webapi.person,0,0,0,0,1,0,0,1
OHDSI_WebAPI,org.ohdsi.webapi.prediction.converter,0,0,0,0,0,0,0,0
OHDSI_WebAPI,org.ohdsi.webapi.prediction.domain,0,0,0,0,0,0,0,0
OHDSI_WebAPI,org.ohdsi.webapi.prediction.dto,0,0,0,0,0,0,0,0
OHDSI_WebAPI,org.ohdsi.webapi.prediction,0,0,0,0,0,0,0,0
OHDSI_WebAPI,org.ohdsi.webapi.prediction.repository,0,0,0,0,0,0,0,0
OHDSI_WebAPI,org.ohdsi.webapi.prediction.specification,0,0,0,0,1,0,0,1
OHDSI_WebAPI,org.ohdsi.webapi.report,0,0,0,1,1,0,0,2
OHDSI_WebAPI,org.ohdsi.webapi.report.mapper,0,0,0,0,1,0,0,1
OHDSI_WebAPI,org.ohdsi.webapi.security,8,1,0,0,0,0,0,9
OHDSI_WebAPI,org.ohdsi.webapi.security.config,0,0,0,0,0,0,0,0
OHDSI_WebAPI,org.ohdsi.webapi.security.converter,0,0,0,0,0,0,0,0
OHDSI_WebAPI,org.ohdsi.webapi.security.dto,0,0,0,0,0,0,0,0
OHDSI_WebAPI,org.ohdsi.webapi.security.listener,0,0,0,0,0,0,0,0
OHDSI_WebAPI,org.ohdsi.webapi.security.model,0,0,0,0,0,0,0,0
OHDSI_WebAPI,org.ohdsi.webapi.service,21,0,0,1,1,0,0,23
OHDSI_WebAPI,org.ohdsi.webapi.service.converters,0,0,0,0,1,1,0,2
OHDSI_WebAPI,org.ohdsi.webapi.service.dto,3,1,0,0,1,1,0,6
OHDSI_WebAPI,org.ohdsi.webapi.service.vocabulary,0,0,0,0,0,0,0,0
OHDSI_WebAPI,org.ohdsi.webapi.shiro.Entities,0,0,0,0,1,0,0,1
OHDSI_WebAPI,org.ohdsi.webapi.shiro.exception,0,0,0,0,0,0,0,0
OHDSI_WebAPI,org.ohdsi.webapi.shiro.filters,0,0,0,0,1,0,0,1
OHDSI_WebAPI,org.ohdsi.webapi.shiro.lockout,0,0,0,0,1,0,0,1
OHDSI_WebAPI,org.ohdsi.webapi.shiro.management,2,1,0,0,1,0,0,4
OHDSI_WebAPI,org.ohdsi.webapi.shiro.management.datasource,0,0,0,0,1,0,0,1
OHDSI_WebAPI,org.ohdsi.webapi.shiro.mapper,0,0,0,0,0,0,0,0
OHDSI_WebAPI,org.ohdsi.webapi.shiro,0,0,0,0,0,0,0,0
OHDSI_WebAPI,org.ohdsi.webapi.shiro.realms,0,0,0,0,1,0,0,1
OHDSI_WebAPI,org.ohdsi.webapi.shiro.runas,0,0,0,0,0,0,0,0
OHDSI_WebAPI,org.ohdsi.webapi.shiro.subject,0,0,0,0,0,0,0,0
OHDSI_WebAPI,org.ohdsi.webapi.shiro.tokens,0,0,0,0,0,0,0,0
OHDSI_WebAPI,org.ohdsi.webapi.source,0,0,0,0,1,0,0,1
OHDSI_WebAPI,org.ohdsi.webapi.sqlrender,2,0,0,0,0,0,0,2
OHDSI_WebAPI,org.ohdsi.webapi.therapy,0,0,0,0,0,0,0,0
OHDSI_WebAPI,org.ohdsi.webapi.user.converter,0,0,0,0,0,0,0,0
OHDSI_WebAPI,org.ohdsi.webapi.user.dto,0,0,0,0,0,0,0,0
OHDSI_WebAPI,org.ohdsi.webapi.user.importer.converter,0,0,0,0,1,1,0,2
OHDSI_WebAPI,org.ohdsi.webapi.user.importer.dto,0,0,0,0,0,1,0,1
OHDSI_WebAPI,org.ohdsi.webapi.user.importer.exception,0,0,0,0,0,0,0,0
OHDSI_WebAPI,org.ohdsi.webapi.user.importer.model,0,0,0,0,1,1,0,2
OHDSI_WebAPI,org.ohdsi.webapi.user.importer.providers,0,0,0,0,1,0,0,1
OHDSI_WebAPI,org.ohdsi.webapi.user.importer.repository,0,0,0,0,0,0,0,0
OHDSI_WebAPI,org.ohdsi.webapi.user.importer.service,0,0,0,0,1,0,0,1
OHDSI_WebAPI,org.ohdsi.webapi.user.importer,0,0,0,0,0,0,0,0
OHDSI_WebAPI,org.ohdsi.webapi.user.importer.utils,0,0,0,0,0,0,0,0
OHDSI_WebAPI,org.ohdsi.webapi.user,0,0,0,0,0,0,0,0
OHDSI_WebAPI,org.ohdsi.webapi.util,16,1,0,1,1,0,0,19
OHDSI_WebAPI,org.ohdsi.webapi.vocabulary,0,0,0,0,1,0,0,1
OHDSI_WebAPI,org.pac4j.oidc.profile.converter,0,0,0,0,0,0,0,0
open-eid_digidoc4j,org.digidoc4j.ddoc,5,1,0,1,1,1,1,10
open-eid_digidoc4j,org.digidoc4j.ddoc.c14n.common,0,0,0,0,0,0,1,1
open-eid_digidoc4j,org.digidoc4j.ddoc.c14n,0,0,0,0,0,0,1,1
open-eid_digidoc4j,org.digidoc4j.ddoc.factory,4,0,0,0,1,1,1,7
open-eid_digidoc4j,org.digidoc4j.ddoc.tsl,0,0,0,0,1,0,1,2
open-eid_digidoc4j,org.digidoc4j.ddoc.utils,3,1,0,0,0,1,1,6
open-eid_digidoc4j,org.digidoc4j,26,1,0,1,1,4,1,34
open-eid_digidoc4j,org.digidoc4j.exceptions,0,0,0,1,0,2,1,4
open-eid_digidoc4j,org.digidoc4j.impl,12,1,0,1,1,2,1,18
open-eid_digidoc4j,org.digidoc4j.impl.asic,5,0,0,0,1,1,1,8
open-eid_digidoc4j,org.digidoc4j.impl.asic.asice,0,0,0,0,1,0,1,2
open-eid_digidoc4j,org.digidoc4j.impl.asic.asice.bdoc,2,0,0,0,1,0,1,4
open-eid_digidoc4j,org.digidoc4j.impl.asic.asics,0,0,0,0,0,0,1,1
open-eid_digidoc4j,org.digidoc4j.impl.asic.manifest,2,1,0,0,0,0,1,4
open-eid_digidoc4j,org.digidoc4j.impl.asic.ocsp,0,0,0,0,0,0,1,1
open-eid_digidoc4j,org.digidoc4j.impl.asic.report,0,0,0,0,0,0,1,1
open-eid_digidoc4j,org.digidoc4j.impl.asic.tsl,3,1,0,0,1,0,1,6
open-eid_digidoc4j,org.digidoc4j.impl.asic.xades,0,0,0,0,1,0,1,2
open-eid_digidoc4j,org.digidoc4j.impl.asic.xades.validation,3,0,0,0,1,0,1,5
open-eid_digidoc4j,org.digidoc4j.impl.ddoc,4,0,0,0,1,3,1,9
open-eid_digidoc4j,org.digidoc4j.impl.pades,0,0,0,0,0,0,1,1
open-eid_digidoc4j,org.digidoc4j.main,4,0,0,0,1,1,1,7
open-eid_digidoc4j,org.digidoc4j.main.xades,0,0,0,0,0,0,1,1
open-eid_digidoc4j,org.digidoc4j.signers,4,0,0,0,1,0,1,6
open-eid_digidoc4j,org.digidoc4j.utils,12,1,0,0,1,0,1,15
open-eid_digidoc4j,org.digidoc4j.impl.bdoc.asic,0,0,0,0,0,1,1,2
open-eid_digidoc4j,org.digidoc4j.impl.bdoc,0,0,0,0,1,1,1,3
open-eid_digidoc4j,org.digidoc4j.impl.bdoc.manifest,0,0,0,0,0,0,1,1
open-eid_digidoc4j,org.digidoc4j.impl.bdoc.ocsp,0,0,0,0,0,0,1,1
open-eid_digidoc4j,org.digidoc4j.impl.bdoc.report,0,0,0,0,0,0,1,1
open-eid_digidoc4j,org.digidoc4j.impl.bdoc.tsl,0,0,0,0,0,0,1,1
open-eid_digidoc4j,org.digidoc4j.impl.bdoc.xades.validation,0,0,0,0,0,0,1,1
open-eid_digidoc4j,org.digidoc4j.impl.bdoc.xades,0,0,0,0,0,0,1,1
open-eid_digidoc4j,org.digidoc4j.impl.edoc,0,0,0,0,0,0,1,1
open-eid_digidoc4j,org.digidoc4j.jvm,0,0,0,0,0,0,1,1
OpenClinica_OpenClinica,org.akaza.openclinica.gwt.client,0,0,0,0,0,0,1,1
OpenClinica_OpenClinica,core.org.akaza.openclinica.bean.admin,0,0,0,0,1,1,1,3
OpenClinica_OpenClinica,core.org.akaza.openclinica.bean.core,3,1,0,0,1,21,1,27
OpenClinica_OpenClinica,core.org.akaza.openclinica.bean.extract,0,1,0,0,1,3,1,6
OpenClinica_OpenClinica,core.org.akaza.openclinica.bean.extract.odm,0,0,0,0,0,0,1,1
OpenClinica_OpenClinica,core.org.akaza.openclinica.bean.login,0,0,0,0,1,1,1,3
OpenClinica_OpenClinica,core.org.akaza.openclinica.bean.managestudy,0,1,0,0,1,14,1,17
OpenClinica_OpenClinica,core.org.akaza.openclinica.bean.masking,0,0,0,0,0,0,1,1
OpenClinica_OpenClinica,core.org.akaza.openclinica.bean.odmbeans,0,0,0,1,1,0,1,3
OpenClinica_OpenClinica,core.org.akaza.openclinica.bean.oid,0,0,0,0,0,1,1,2
OpenClinica_OpenClinica,core.org.akaza.openclinica.bean.rule.action,0,0,0,0,1,0,1,2
OpenClinica_OpenClinica,core.org.akaza.openclinica.bean.rule,0,0,0,0,1,0,1,2
OpenClinica_OpenClinica,core.org.akaza.openclinica.bean.rule.expression,0,0,0,0,0,0,1,1
OpenClinica_OpenClinica,core.org.akaza.openclinica.bean.service,0,0,0,0,1,0,1,2
OpenClinica_OpenClinica,core.org.akaza.openclinica.bean.submit,2,1,0,0,1,14,1,19
OpenClinica_OpenClinica,core.org.akaza.openclinica.bean.submit.crfdata,0,0,0,0,1,0,1,2
OpenClinica_OpenClinica,core.org.akaza.openclinica.core,1,0,0,0,1,1,1,4
OpenClinica_OpenClinica,core.org.akaza.openclinica.core.form,0,0,0,0,0,0,1,1
OpenClinica_OpenClinica,core.org.akaza.openclinica.core.form.xform,0,0,0,0,0,0,1,1
OpenClinica_OpenClinica,core.org.akaza.openclinica.core.util,0,0,0,0,0,0,1,1
OpenClinica_OpenClinica,core.org.akaza.openclinica.dao.admin,0,0,0,0,0,0,1,1
OpenClinica_OpenClinica,core.org.akaza.openclinica.dao.cache,0,0,0,0,0,0,1,1
OpenClinica_OpenClinica,core.org.akaza.openclinica.dao.core,2,0,0,0,1,0,1,4
OpenClinica_OpenClinica,core.org.akaza.openclinica.dao,0,0,0,0,1,2,1,4
OpenClinica_OpenClinica,core.org.akaza.openclinica.dao.extract,2,0,0,0,0,0,1,3
OpenClinica_OpenClinica,core.org.akaza.openclinica.dao.hibernate,2,0,0,1,1,6,1,11
OpenClinica_OpenClinica,core.org.akaza.openclinica.dao.hibernate.multitenant,0,0,0,0,0,0,1,1
OpenClinica_OpenClinica,core.org.akaza.openclinica.dao.jpa,0,0,0,0,0,0,1,1
OpenClinica_OpenClinica,core.org.akaza.openclinica.dao.logic,0,0,0,0,0,0,1,1
OpenClinica_OpenClinica,core.org.akaza.openclinica.dao.login,1,0,0,0,0,2,1,4
OpenClinica_OpenClinica,core.org.akaza.openclinica.dao.managestudy,0,0,0,1,1,4,1,7
OpenClinica_OpenClinica,core.org.akaza.openclinica.dao.rule.action,0,0,0,0,0,0,1,1
OpenClinica_OpenClinica,core.org.akaza.openclinica.dao.rule,0,0,0,0,1,1,1,3
OpenClinica_OpenClinica,core.org.akaza.openclinica.dao.service,0,0,0,0,0,0,1,1
OpenClinica_OpenClinica,core.org.akaza.openclinica.dao.submit,1,1,0,0,1,1,1,5
OpenClinica_OpenClinica,core.org.akaza.openclinica.dao.ws,0,0,0,0,0,0,1,1
OpenClinica_OpenClinica,core.org.akaza.openclinica.domain,0,0,0,0,1,2,1,4
OpenClinica_OpenClinica,core.org.akaza.openclinica.domain.admin,0,0,0,0,0,0,1,1
OpenClinica_OpenClinica,core.org.akaza.openclinica.domain.crfdata,0,0,0,0,0,3,1,4
OpenClinica_OpenClinica,core.org.akaza.openclinica.domain.datamap,0,1,0,1,1,9,1,13
OpenClinica_OpenClinica,core.org.akaza.openclinica.domain.enumsupport,0,0,0,0,0,0,1,1
OpenClinica_OpenClinica,core.org.akaza.openclinica.domain.managestudy,0,0,0,0,0,0,1,1
OpenClinica_OpenClinica,core.org.akaza.openclinica.domain.rule.action,0,1,0,0,1,1,1,4
OpenClinica_OpenClinica,core.org.akaza.openclinica.domain.rule,0,1,0,0,1,0,1,3
OpenClinica_OpenClinica,core.org.akaza.openclinica.domain.rule.expression,0,0,0,0,1,0,1,2
OpenClinica_OpenClinica,core.org.akaza.openclinica.domain.technicaladmin,0,0,0,0,0,3,1,4
OpenClinica_OpenClinica,core.org.akaza.openclinica.domain.usageStats,0,0,0,0,0,0,1,1
OpenClinica_OpenClinica,core.org.akaza.openclinica.domain.user,0,0,0,0,0,0,1,1
OpenClinica_OpenClinica,core.org.akaza.openclinica.domain.xform.dto,0,0,0,0,1,0,1,2
OpenClinica_OpenClinica,core.org.akaza.openclinica.domain.xform,0,0,0,0,1,0,1,2
OpenClinica_OpenClinica,core.org.akaza.openclinica.exception,0,0,0,0,1,0,1,2
OpenClinica_OpenClinica,core.org.akaza.openclinica.i18n.core,0,0,0,0,0,0,1,1
OpenClinica_OpenClinica,core.org.akaza.openclinica.i18n.util,0,0,0,0,0,1,1,2
OpenClinica_OpenClinica,core.org.akaza.openclinica.job,5,1,0,0,1,0,1,8
OpenClinica_OpenClinica,core.org.akaza.openclinica.log,0,0,0,0,1,0,1,2
OpenClinica_OpenClinica,core.org.akaza.openclinica.logic.core,0,0,0,0,0,0,1,1
OpenClinica_OpenClinica,core.org.akaza.openclinica.logic.expressionTree,0,0,0,0,0,0,1,1
OpenClinica_OpenClinica,core.org.akaza.openclinica.logic.importdata,0,0,0,0,0,0,1,1
OpenClinica_OpenClinica,core.org.akaza.openclinica.logic.masking.rules,0,0,0,0,0,0,1,1
OpenClinica_OpenClinica,core.org.akaza.openclinica.logic.masking,0,0,0,0,0,0,1,1
OpenClinica_OpenClinica,core.org.akaza.openclinica.logic.odmExport,3,1,0,0,1,1,1,7
OpenClinica_OpenClinica,core.org.akaza.openclinica.logic.rulerunner,0,0,0,0,1,0,1,2
OpenClinica_OpenClinica,core.org.akaza.openclinica.logic.score.function,0,0,0,0,1,0,1,2
OpenClinica_OpenClinica,core.org.akaza.openclinica.logic.score,0,0,0,0,0,0,1,1
OpenClinica_OpenClinica,core.org.akaza.openclinica.ocobserver,0,0,0,0,1,0,1,2
OpenClinica_OpenClinica,core.org.akaza.openclinica.service.archival,0,0,0,0,0,0,1,1
OpenClinica_OpenClinica,core.org.akaza.openclinica.service,3,1,0,1,1,7,1,14
OpenClinica_OpenClinica,core.org.akaza.openclinica.service.auth,0,0,0,0,0,0,1,1
OpenClinica_OpenClinica,core.org.akaza.openclinica.service.crfdata,2,0,0,0,1,5,1,9
OpenClinica_OpenClinica,core.org.akaza.openclinica.service.crfdata.front,0,0,0,0,0,1,1,2
OpenClinica_OpenClinica,core.org.akaza.openclinica.service.crfdata.xform,0,0,0,0,1,0,1,2
OpenClinica_OpenClinica,core.org.akaza.openclinica.service.dto,0,0,0,0,1,0,1,2
OpenClinica_OpenClinica,core.org.akaza.openclinica.service.extract,2,1,0,0,1,0,1,5
OpenClinica_OpenClinica,core.org.akaza.openclinica.service.managestudy,0,0,0,0,1,1,1,3
OpenClinica_OpenClinica,core.org.akaza.openclinica.service.pmanage,0,0,0,0,1,0,1,2
OpenClinica_OpenClinica,core.org.akaza.openclinica.service.randomize,0,0,0,0,0,0,1,1
OpenClinica_OpenClinica,core.org.akaza.openclinica.service.rest.errors,0,0,0,0,0,0,1,1
OpenClinica_OpenClinica,core.org.akaza.openclinica.service.rule.expression,0,0,0,0,0,0,1,1
OpenClinica_OpenClinica,core.org.akaza.openclinica.service.rule,0,0,0,0,1,0,1,2
OpenClinica_OpenClinica,core.org.akaza.openclinica.service.subject,0,0,0,0,0,0,1,1
OpenClinica_OpenClinica,core.org.akaza.openclinica.service.usageStats,0,0,0,0,0,0,1,1
OpenClinica_OpenClinica,core.org.akaza.openclinica.service.user,0,0,0,0,0,0,1,1
OpenClinica_OpenClinica,core.org.akaza.openclinica.validator.rule.action,0,0,0,0,0,0,1,1
OpenClinica_OpenClinica,core.org.akaza.openclinica.validator,0,0,0,0,0,0,1,1
OpenClinica_OpenClinica,core.org.akaza.openclinica.validator.xform,0,0,0,0,0,0,1,1
OpenClinica_OpenClinica,core.org.akaza.openclinica.web.bean,4,1,0,0,0,6,1,12
OpenClinica_OpenClinica,core.org.akaza.openclinica.web.crfdata,0,0,0,0,0,0,1,1
OpenClinica_OpenClinica,core.org.akaza.openclinica.web.domain,0,0,0,0,0,0,1,1
OpenClinica_OpenClinica,core.org.akaza.openclinica.web.filter,0,0,0,0,1,1,1,3
OpenClinica_OpenClinica,core.org.akaza.openclinica.web.filter.rest,0,0,0,0,0,0,1,1
OpenClinica_OpenClinica,core.org.akaza.openclinica.web,11,1,0,0,0,0,1,13
OpenClinica_OpenClinica,core.org.akaza.openclinica.web.job,2,0,0,0,1,0,1,4
OpenClinica_OpenClinica,core.org.akaza.openclinica.web.pform.dto,0,0,0,0,1,1,1,3
OpenClinica_OpenClinica,core.org.akaza.openclinica.web.pform,0,1,0,0,1,0,1,3
OpenClinica_OpenClinica,core.org.akaza.openclinica.web.pform.formlist,0,0,0,0,1,0,1,2
OpenClinica_OpenClinica,core.org.akaza.openclinica.web.pform.manifest,0,0,0,0,0,0,1,1
OpenClinica_OpenClinica,core.org.akaza.openclinica.web.pform.widget,0,0,0,0,0,2,1,3
OpenClinica_OpenClinica,core.org.akaza.openclinica.web.rest.client.auth.impl,0,0,0,0,0,0,1,1
OpenClinica_OpenClinica,core.org.akaza.openclinica.web.rest.client.dto,0,0,0,0,0,0,1,1
OpenClinica_OpenClinica,core.org.akaza.openclinica.web.rest.client.impl,0,0,0,0,0,0,1,1
OpenClinica_OpenClinica,core.org.akaza.openclinica.web.rest.client.us.impl,0,0,0,0,0,0,1,1
OpenClinica_OpenClinica,core.org.akaza.openclinica.web.restful,0,0,0,0,0,0,1,1
OpenClinica_OpenClinica,core.org.akaza.openclinica.web.restful.data.bean,0,0,0,0,0,0,1,1
OpenClinica_OpenClinica,core.org.akaza.openclinica.web.restful.data.validator,0,0,0,0,0,0,1,1
OpenClinica_OpenClinica,core.org.akaza.openclinica.web.table.scheduledjobs,0,0,0,0,0,0,1,1
OpenClinica_OpenClinica,core.org.akaza.openclinica.web.table.sdv,0,0,0,0,1,0,1,2
OpenClinica_OpenClinica,core.org.akaza.openclinica.web.util,0,0,0,0,0,0,1,1
OpenClinica_OpenClinica,org.akaza.openclinica.config,0,0,0,0,1,0,1,2
OpenClinica_OpenClinica,org.akaza.openclinica.control,0,1,0,0,1,0,1,3
OpenClinica_OpenClinica,org.akaza.openclinica.control.admin,13,0,0,1,1,0,1,16
OpenClinica_OpenClinica,org.akaza.openclinica.control.core,5,1,0,0,0,0,1,7
OpenClinica_OpenClinica,org.akaza.openclinica.control.extract,3,0,0,0,1,0,1,5
OpenClinica_OpenClinica,org.akaza.openclinica.control.form,0,0,0,0,1,0,1,2
OpenClinica_OpenClinica,org.akaza.openclinica.control.form.spreadsheet,0,0,0,0,1,0,1,2
OpenClinica_OpenClinica,org.akaza.openclinica.control.login,0,0,0,0,1,0,1,2
OpenClinica_OpenClinica,org.akaza.openclinica.control.managestudy,9,1,0,1,1,5,1,18
OpenClinica_OpenClinica,org.akaza.openclinica.control.rule,0,0,0,0,0,0,1,1
OpenClinica_OpenClinica,org.akaza.openclinica.control.submit,9,1,0,1,1,0,1,13
OpenClinica_OpenClinica,org.akaza.openclinica.control.techadmin,0,0,0,0,0,0,1,1
OpenClinica_OpenClinica,org.akaza.openclinica.control.urlRewrite,0,0,0,0,0,0,1,1
OpenClinica_OpenClinica,org.akaza.openclinica.controller,0,0,0,1,1,1,1,4
OpenClinica_OpenClinica,org.akaza.openclinica.controller.dto,0,0,0,0,1,0,1,2
OpenClinica_OpenClinica,org.akaza.openclinica.controller.helper,0,0,0,0,1,0,1,2
OpenClinica_OpenClinica,org.akaza.openclinica.controller.helper.table,0,0,0,0,1,0,1,2
OpenClinica_OpenClinica,org.akaza.openclinica.controller.openrosa,0,0,0,0,1,0,1,2
OpenClinica_OpenClinica,org.akaza.openclinica.controller.openrosa.processor,0,0,0,0,1,0,1,2
OpenClinica_OpenClinica,org.akaza.openclinica.controller.user,0,0,0,0,0,0,1,1
OpenClinica_OpenClinica,org.akaza.openclinica.dto.randomize,0,0,0,0,0,0,1,1
OpenClinica_OpenClinica,org.akaza.openclinica.service,0,0,0,0,1,0,1,2
OpenClinica_OpenClinica,org.akaza.openclinica.view,4,1,0,0,1,0,1,7
OpenClinica_OpenClinica,org.akaza.openclinica.view.display,0,0,0,0,0,0,1,1
OpenClinica_OpenClinica,org.akaza.openclinica.view.form,3,1,0,0,1,1,1,7
OpenClinica_OpenClinica,org.akaza.openclinica.view.tags,0,0,0,0,0,0,1,1
OpenClinica_OpenClinica,org.akaza.openclinica.web.filter,0,0,0,0,0,0,1,1
OpenClinica_OpenClinica,org.akaza.openclinica.web.restful.errors,0,0,0,0,0,0,1,1
OpenClinica_OpenClinica,core.org.akaza.openclinica.templates,0,0,0,0,0,0,1,1
openhab_jmdns,javax.jmdns.impl.constants,0,0,0,0,0,0,0,0
openhab_jmdns,javax.jmdns.impl,4,1,0,1,0,2,0,8
openhab_jmdns,javax.jmdns.impl.tasks,1,0,0,0,0,2,0,3
openhab_jmdns,javax.jmdns.impl.tasks.resolver,1,0,0,0,0,1,0,2
openhab_jmdns,javax.jmdns.impl.tasks.state,1,0,0,0,0,1,0,2
openhab_jmdns,javax.jmdns.impl.util,0,0,0,0,0,0,0,0
openhab_jmdns,javax.jmdns,1,1,0,0,1,0,0,3
openhab_jmdns,com.strangeberry.jmdns.tools,0,0,0,0,0,0,0,0
openhab_jmdns,util,0,0,0,0,0,0,0,0
openhab_openhab2,org.openhab.binding.airquality.internal,0,0,0,0,0,0,0,0
openhab_openhab2,org.openhab.binding.airquality.internal.discovery,0,0,0,0,0,0,0,0
openhab_openhab2,org.openhab.binding.airquality.internal.handler,0,0,0,0,0,0,0,0
openhab_openhab2,org.openhab.binding.airquality.internal.json,0,0,0,0,1,0,0,1
openhab_openhab2,org.openhab.binding.airvisualnode.internal,0,0,0,0,0,0,0,0
openhab_openhab2,org.openhab.binding.airvisualnode.internal.config,0,0,0,0,0,0,0,0
openhab_openhab2,org.openhab.binding.airvisualnode.internal.discovery,0,0,0,0,0,0,0,0
openhab_openhab2,org.openhab.binding.airvisualnode.internal.handler,0,0,0,0,0,0,0,0
openhab_openhab2,org.openhab.binding.airvisualnode.internal.json,0,0,0,0,1,0,0,1
openhab_openhab2,org.openhab.binding.allplay.internal,0,0,0,0,0,0,0,0
openhab_openhab2,org.openhab.binding.allplay.internal.discovery,0,0,0,0,0,0,0,0
openhab_openhab2,org.openhab.binding.allplay.internal.handler,0,0,0,0,0,0,0,0
openhab_openhab2,org.openhab.binding.amazondashbutton.internal,0,0,0,0,0,0,0,0
openhab_openhab2,org.openhab.binding.amazondashbutton.internal.capturing,0,0,0,0,0,0,0,0
openhab_openhab2,org.openhab.binding.amazondashbutton.internal.config,0,0,0,0,0,0,0,0
openhab_openhab2,org.openhab.binding.amazondashbutton.internal.discovery,0,0,0,0,0,0,0,0
openhab_openhab2,org.openhab.binding.amazondashbutton.internal.handler,0,0,0,0,0,0,0,0
openhab_openhab2,org.openhab.binding.amazondashbutton.internal.pcap,0,0,0,0,0,0,0,0
openhab_openhab2,org.openhab.binding.amazonechocontrol.internal,0,0,0,0,1,0,0,1
openhab_openhab2,org.openhab.binding.amazonechocontrol.internal.channelhandler,0,0,0,0,0,0,0,0
openhab_openhab2,org.openhab.binding.amazonechocontrol.internal.discovery,0,0,0,0,0,0,0,0
openhab_openhab2,org.openhab.binding.amazonechocontrol.internal.handler,0,0,0,0,0,0,0,0
openhab_openhab2,org.openhab.binding.amazonechocontrol.internal.jsons,0,0,0,1,1,0,0,2
openhab_openhab2,org.openhab.binding.amazonechocontrol.internal.statedescription,0,0,0,0,0,0,0,0
openhab_openhab2,org.openhab.binding.ambientweather.internal,0,0,0,0,0,0,0,0
openhab_openhab2,org.openhab.binding.ambientweather.internal.config,0,0,0,0,0,0,0,0
openhab_openhab2,org.openhab.binding.ambientweather.internal.handler,0,0,0,0,0,0,0,0
openhab_openhab2,org.openhab.binding.ambientweather.internal.model,0,0,0,0,0,0,0,0
openhab_openhab2,org.openhab.binding.ambientweather.internal.processor,0,0,0,0,1,0,0,1
openhab_openhab2,org.openhab.binding.ambientweather.internal.util,0,0,0,0,0,0,0,0
openhab_openhab2,org.openhab.binding.astro.internal,0,1,0,0,0,0,0,1
openhab_openhab2,org.openhab.binding.astro.internal.calc,0,0,0,0,0,0,0,0
openhab_openhab2,org.openhab.binding.astro.internal.config,0,0,0,0,0,0,0,0
openhab_openhab2,org.openhab.binding.astro.internal.discovery,0,0,0,0,0,0,0,0
openhab_openhab2,org.openhab.binding.astro.internal.handler,0,0,0,0,0,0,0,0
openhab_openhab2,org.openhab.binding.astro.internal.job,0,0,0,0,1,0,0,1
openhab_openhab2,org.openhab.binding.astro.internal.model,1,0,0,0,1,0,0,2
openhab_openhab2,org.openhab.binding.astro.internal.util,1,1,0,0,0,0,0,2
openhab_openhab2,org.openhab.binding.atlona.internal,0,0,0,0,0,0,0,0
openhab_openhab2,org.openhab.binding.atlona.internal.discovery,0,0,0,0,0,0,0,0
openhab_openhab2,org.openhab.binding.atlona.internal.handler,0,0,0,0,0,0,0,0
openhab_openhab2,org.openhab.binding.atlona.internal.net,0,0,0,0,0,0,0,0
openhab_openhab2,org.openhab.binding.atlona.internal.pro3,0,0,0,0,1,0,0,1
openhab_openhab2,org.openhab.binding.autelis.internal,0,0,0,0,0,0,0,0
openhab_openhab2,org.openhab.binding.autelis.internal.config,0,0,0,0,0,0,0,0
openhab_openhab2,org.openhab.binding.autelis.internal.discovery,0,0,0,0,0,0,0,0
openhab_openhab2,org.openhab.binding.autelis.internal.handler,0,0,0,0,0,0,0,0
openhab_openhab2,org.openhab.binding.avmfritz.internal.ahamodel,0,0,0,0,1,0,0,1
openhab_openhab2,org.openhab.binding.avmfritz.internal.ahamodel.templates,0,0,0,0,0,0,0,0
openhab_openhab2,org.openhab.binding.avmfritz.internal,0,0,0,0,0,0,0,0
openhab_openhab2,org.openhab.binding.avmfritz.internal.config,0,0,0,0,0,0,0,0
openhab_openhab2,org.openhab.binding.avmfritz.internal.discovery,0,0,0,0,0,0,0,0
openhab_openhab2,org.openhab.binding.avmfritz.internal.handler,0,0,0,0,1,0,0,1
openhab_openhab2,org.openhab.binding.avmfritz.internal.hardware.callbacks,0,0,0,0,1,0,0,1
openhab_openhab2,org.openhab.binding.avmfritz.internal.hardware,0,0,0,0,0,0,0,0
openhab_openhab2,org.openhab.binding.avmfritz.internal.util,0,0,0,0,0,0,0,0
openhab_openhab2,org.openhab.binding.bigassfan.internal,0,0,0,0,0,0,0,0
openhab_openhab2,org.openhab.binding.bigassfan.internal.discovery,0,0,0,0,0,0,0,0
openhab_openhab2,org.openhab.binding.bigassfan.internal.handler,0,0,0,0,0,0,0,0
openhab_openhab2,org.openhab.binding.bigassfan.internal.utils,0,0,0,0,0,0,0,0
openhab_openhab2,org.openhab.binding.bluetooth,0,0,0,0,1,0,0,1
openhab_openhab2,org.openhab.binding.bluetooth.discovery,0,0,0,0,0,0,0,0
openhab_openhab2,org.openhab.binding.bluetooth.discovery.internal,0,0,0,0,0,0,0,0
openhab_openhab2,org.openhab.binding.bluetooth.internal,0,0,0,0,0,0,0,0
openhab_openhab2,org.openhab.binding.bluetooth.notification,0,0,0,0,0,0,0,0
openhab_openhab2,org.openhab.binding.bluetooth.bluegiga,0,0,0,0,0,0,0,0
openhab_openhab2,org.openhab.binding.bluetooth.bluegiga.handler,0,0,0,0,0,0,0,0
openhab_openhab2,org.openhab.binding.bluetooth.bluegiga.internal,0,0,0,0,1,0,0,1
openhab_openhab2,org.openhab.binding.bluetooth.bluegiga.internal.command.attributeclient,0,0,0,0,1,0,0,1
openhab_openhab2,org.openhab.binding.bluetooth.bluegiga.internal.command.attributedb,0,0,0,0,1,0,0,1
openhab_openhab2,org.openhab.binding.bluetooth.bluegiga.internal.command.connection,0,0,0,0,1,0,0,1
openhab_openhab2,org.openhab.binding.bluetooth.bluegiga.internal.command.gap,0,0,0,0,1,0,0,1
openhab_openhab2,org.openhab.binding.bluetooth.bluegiga.internal.command.security,0,0,0,0,1,0,0,1
openhab_openhab2,org.openhab.binding.bluetooth.bluegiga.internal.command.system,0,0,0,0,1,0,0,1
openhab_openhab2,org.openhab.binding.bluetooth.bluegiga.internal.eir,0,0,0,0,0,0,0,0
openhab_openhab2,org.openhab.binding.bluetooth.bluegiga.internal.factory,0,0,0,0,0,0,0,0
openhab_openhab2,org.openhab.binding.bluetooth.bluez,0,0,0,0,0,0,0,0
openhab_openhab2,org.openhab.binding.bluetooth.bluez.handler,0,0,0,0,0,0,0,0
openhab_openhab2,org.openhab.binding.bluetooth.bluez.internal,0,0,0,0,0,0,0,0
openhab_openhab2,org.openhab.binding.bluetooth.bluez.internal.discovery,0,0,0,0,0,0,0,0
openhab_openhab2,org.openhab.binding.bluetooth.blukii,0,0,0,0,0,0,0,0
openhab_openhab2,org.openhab.binding.bluetooth.blukii.handler,0,0,0,0,0,0,0,0
openhab_openhab2,org.openhab.binding.bluetooth.blukii.internal,0,0,0,0,0,0,0,0
openhab_openhab2,org.openhab.binding.bluetooth.blukii.internal.data,0,0,0,0,0,0,0,0
openhab_openhab2,org.openhab.binding.bluetooth.ruuvitag.internal,0,0,0,0,0,0,0,0
openhab_openhab2,org.openhab.binding.boschindego.internal,0,0,0,0,0,0,0,0
openhab_openhab2,org.openhab.binding.boschindego.internal.handler,0,0,0,0,0,0,0,0
openhab_openhab2,org.openhab.binding.bosesoundtouch.internal,0,0,0,0,1,0,0,1
openhab_openhab2,org.openhab.binding.bosesoundtouch.internal.discovery,0,0,0,0,0,0,0,0
openhab_openhab2,org.openhab.binding.bosesoundtouch.internal.handler,0,0,0,0,0,0,0,0
openhab_openhab2,org.openhab.binding.buienradar.internal.buienradarapi,0,0,0,0,0,0,0,0
openhab_openhab2,org.openhab.binding.buienradar.internal,0,0,0,0,0,0,0,0
openhab_openhab2,org.openhab.binding.buienradar,0,0,0,0,0,0,0,0
openhab_openhab2,org.openhab.binding.chromecast.internal,0,0,0,0,1,0,0,1
openhab_openhab2,org.openhab.binding.chromecast.internal.discovery,0,0,0,0,0,0,0,0
openhab_openhab2,org.openhab.binding.chromecast.internal.factory,0,0,0,0,0,0,0,0
openhab_openhab2,org.openhab.binding.chromecast.internal.handler,0,0,0,0,0,0,0,0
openhab_openhab2,org.openhab.binding.cm11a.internal,0,0,0,0,0,0,0,0
openhab_openhab2,org.openhab.binding.cm11a.internal.config,0,0,0,0,0,0,0,0
openhab_openhab2,org.openhab.binding.cm11a.internal.handler,0,0,0,0,0,0,0,0
openhab_openhab2,org.openhab.binding.coolmasternet.internal.config,0,0,0,0,0,0,0,0
openhab_openhab2,org.openhab.binding.coolmasternet.internal,0,0,0,0,0,0,0,0
openhab_openhab2,org.openhab.binding.coolmasternet.internal.handler,0,0,0,0,0,0,0,0
openhab_openhab2,org.openhab.binding.daikin.internal.api.airbase,0,0,0,0,0,0,0,0
openhab_openhab2,org.openhab.binding.daikin.internal.api,0,0,0,0,0,0,0,0
openhab_openhab2,org.openhab.binding.daikin.internal.config,0,0,0,0,0,0,0,0
openhab_openhab2,org.openhab.binding.daikin.internal,0,0,0,0,0,0,0,0
openhab_openhab2,org.openhab.binding.daikin.internal.discovery,0,0,0,0,0,0,0,0
openhab_openhab2,org.openhab.binding.daikin.internal.handler,0,0,0,0,0,0,0,0
openhab_openhab2,org.openhab.binding.darksky.internal.config,0,0,0,0,0,0,0,0
openhab_openhab2,org.openhab.binding.darksky.internal.connection,0,0,0,0,0,0,0,0
openhab_openhab2,org.openhab.binding.darksky.internal,0,0,0,0,0,0,0,0
openhab_openhab2,org.openhab.binding.darksky.internal.discovery,0,0,0,0,0,0,0,0
openhab_openhab2,org.openhab.binding.darksky.internal.factory,0,0,0,0,0,0,0,0
openhab_openhab2,org.openhab.binding.darksky.internal.handler,0,0,0,0,0,0,0,0
openhab_openhab2,org.openhab.binding.darksky.internal.model,0,0,0,0,1,0,0,1
openhab_openhab2,org.openhab.binding.darksky.internal.utils,0,0,0,0,0,0,0,0
openhab_openhab2,org.openhab.binding.deconz.internal,0,0,0,0,0,0,0,0
openhab_openhab2,org.openhab.binding.deconz.internal.discovery,0,0,0,0,0,0,0,0
openhab_openhab2,org.openhab.binding.deconz.internal.dto,0,0,0,0,1,0,0,1
openhab_openhab2,org.openhab.binding.deconz.internal.handler,0,0,0,0,0,0,0,0
openhab_openhab2,org.openhab.binding.deconz.internal.netutils,0,0,0,0,0,0,0,0
openhab_openhab2,org.openhab.binding.denonmarantz.internal.config,0,0,0,0,0,0,0,0
openhab_openhab2,org.openhab.binding.denonmarantz.internal.connector,0,0,0,0,0,0,0,0
openhab_openhab2,org.openhab.binding.denonmarantz.internal.connector.http,0,0,0,0,0,1,0,1
openhab_openhab2,org.openhab.binding.denonmarantz.internal.connector.telnet,0,0,0,0,0,0,0,0
openhab_openhab2,org.openhab.binding.denonmarantz.internal,0,0,0,0,0,1,0,1
openhab_openhab2,org.openhab.binding.denonmarantz.internal.discovery,0,0,0,0,0,0,0,0
openhab_openhab2,org.openhab.binding.denonmarantz.internal.handler,0,0,0,0,0,0,0,0
openhab_openhab2,org.openhab.binding.denonmarantz.internal.xml.adapters,0,0,0,0,0,0,0,0
openhab_openhab2,org.openhab.binding.denonmarantz.internal.xml.entities.commands,0,0,0,0,1,0,0,1
openhab_openhab2,org.openhab.binding.denonmarantz.internal.xml.entities,0,0,0,0,0,1,0,1
openhab_openhab2,org.openhab.binding.denonmarantz.internal.xml.entities.types,0,0,0,0,0,1,0,1
openhab_openhab2,org.openhab.binding.digiplex.internal.communication,0,0,0,0,0,0,0,0
openhab_openhab2,org.openhab.binding.digiplex.internal.communication.events,0,0,0,0,0,0,0,0
openhab_openhab2,org.openhab.binding.digiplex.internal,0,0,0,0,0,0,0,0
openhab_openhab2,org.openhab.binding.digiplex.internal.discovery,0,0,0,0,0,0,0,0
openhab_openhab2,org.openhab.binding.digiplex.internal.handler,0,0,0,0,1,0,0,1
openhab_openhab2,org.openhab.binding.digitalstrom.internal,2,1,0,0,0,0,0,3
openhab_openhab2,org.openhab.binding.digitalstrom.internal.discovery,0,0,0,0,1,0,0,1
openhab_openhab2,org.openhab.binding.digitalstrom.internal.handler,3,1,0,0,1,0,0,5
openhab_openhab2,org.openhab.binding.digitalstrom.internal.lib.climate.datatypes,0,0,0,0,0,0,0,0
openhab_openhab2,org.openhab.binding.digitalstrom.internal.lib.climate.jsonresponsecontainer,0,0,0,0,0,0,0,0
openhab_openhab2,org.openhab.binding.digitalstrom.internal.lib.climate.jsonresponsecontainer.impl,0,0,0,0,1,0,0,1
openhab_openhab2,org.openhab.binding.digitalstrom.internal.lib.climate,0,0,0,0,0,0,0,0
openhab_openhab2,org.openhab.binding.digitalstrom.internal.lib.config,0,0,0,0,0,0,0,0
openhab_openhab2,org.openhab.binding.digitalstrom.internal.lib.event.constants,0,0,0,0,0,0,0,0
openhab_openhab2,org.openhab.binding.digitalstrom.internal.lib.event,0,0,0,0,0,0,0,0
openhab_openhab2,org.openhab.binding.digitalstrom.internal.lib.event.types,0,0,0,0,0,0,0,0
openhab_openhab2,org.openhab.binding.digitalstrom.internal.lib,0,0,0,0,0,0,0,0
openhab_openhab2,org.openhab.binding.digitalstrom.internal.lib.listener,0,0,0,0,1,0,0,1
openhab_openhab2,org.openhab.binding.digitalstrom.internal.lib.manager,0,0,0,0,0,1,0,1
openhab_openhab2,org.openhab.binding.digitalstrom.internal.lib.manager.impl,0,0,0,0,1,0,0,1
openhab_openhab2,org.openhab.binding.digitalstrom.internal.lib.sensorjobexecutor,0,0,0,0,1,2,0,3
openhab_openhab2,org.openhab.binding.digitalstrom.internal.lib.sensorjobexecutor.sensorjob.impl,0,0,0,0,0,2,0,2
openhab_openhab2,org.openhab.binding.digitalstrom.internal.lib.sensorjobexecutor.sensorjob,0,0,0,0,0,2,0,2
openhab_openhab2,org.openhab.binding.digitalstrom.internal.lib.serverconnection,0,0,0,0,0,1,0,1
openhab_openhab2,org.openhab.binding.digitalstrom.internal.lib.serverconnection.impl,0,0,0,0,0,0,0,0
openhab_openhab2,org.openhab.binding.digitalstrom.internal.lib.serverconnection.simpledsrequestbuilder.constants,0,0,0,0,0,0,0,0
openhab_openhab2,org.openhab.binding.digitalstrom.internal.lib.serverconnection.simpledsrequestbuilder,0,0,0,0,0,0,0,0
openhab_openhab2,org.openhab.binding.digitalstrom.internal.lib.structure,0,0,0,0,0,0,0,0
openhab_openhab2,org.openhab.binding.digitalstrom.internal.lib.structure.devices,0,0,0,0,0,2,0,2
openhab_openhab2,org.openhab.binding.digitalstrom.internal.lib.structure.devices.deviceparameters,0,0,0,0,0,0,0,0
openhab_openhab2,org.openhab.binding.digitalstrom.internal.lib.structure.devices.deviceparameters.impl,0,0,0,0,1,2,0,3
openhab_openhab2,org.openhab.binding.digitalstrom.internal.lib.structure.devices.impl,0,0,0,0,0,0,0,0
openhab_openhab2,org.openhab.binding.digitalstrom.internal.lib.structure.impl,0,0,0,0,0,0,0,0
openhab_openhab2,org.openhab.binding.digitalstrom.internal.lib.structure.scene.constants,0,0,0,0,0,0,0,0
openhab_openhab2,org.openhab.binding.digitalstrom.internal.lib.structure.scene,0,0,0,0,0,0,0,0
openhab_openhab2,org.openhab.binding.digitalstrom.internal.providers,2,1,0,0,0,0,0,3
openhab_openhab2,org.openhab.binding.dlinksmarthome.internal,0,0,0,0,0,0,0,0
openhab_openhab2,org.openhab.binding.dlinksmarthome.internal.handler,0,0,0,0,0,0,0,0
openhab_openhab2,org.openhab.binding.dlinksmarthome.internal.motionsensor,0,0,0,0,0,0,0,0
openhab_openhab2,org.openhab.binding.dmx.action,0,0,0,0,0,0,0,0
openhab_openhab2,org.openhab.binding.dmx.internal.action,1,0,0,0,0,1,0,2
openhab_openhab2,org.openhab.binding.dmx.internal.config,1,1,0,0,1,0,0,3
openhab_openhab2,org.openhab.binding.dmx.internal,5,1,0,0,1,1,0,8
openhab_openhab2,org.openhab.binding.dmx.internal.dmxoverethernet,2,0,0,0,1,0,0,3
openhab_openhab2,org.openhab.binding.dmx.internal.handler,4,0,0,0,1,0,0,5
openhab_openhab2,org.openhab.binding.dmx.internal.multiverse,5,1,0,0,0,1,0,7
openhab_openhab2,org.openhab.binding.dscalarm.internal.config,0,0,0,0,1,0,0,1
openhab_openhab2,org.openhab.binding.dscalarm.internal.discovery,0,0,0,0,0,0,0,0
openhab_openhab2,org.openhab.binding.dscalarm.internal,0,0,0,0,0,0,0,0
openhab_openhab2,org.openhab.binding.dscalarm.internal.factory,0,0,0,0,0,0,0,0
openhab_openhab2,org.openhab.binding.dscalarm.internal.handler,0,0,0,0,1,0,0,1
openhab_openhab2,org.openhab.binding.dsmr.internal.device.connector,0,0,0,0,0,0,0,0
openhab_openhab2,org.openhab.binding.dsmr.internal.device.cosem,0,0,0,0,1,0,0,1
openhab_openhab2,org.openhab.binding.dsmr.internal.device,0,0,0,0,1,0,0,1
openhab_openhab2,org.openhab.binding.dsmr.internal.device.p1telegram,1,0,0,0,1,0,0,2
openhab_openhab2,org.openhab.binding.dsmr.internal.discovery,0,0,0,0,1,0,0,1
openhab_openhab2,org.openhab.binding.dsmr.internal,1,1,0,0,0,0,0,2
openhab_openhab2,org.openhab.binding.dsmr.internal.handler,0,1,0,0,0,0,0,1
openhab_openhab2,org.openhab.binding.dsmr.internal.meter,0,0,0,0,0,0,0,0
openhab_openhab2,org.openhab.binding.dwdunwetter.internal.config,0,0,0,0,0,0,0,0
openhab_openhab2,org.openhab.binding.dwdunwetter.internal.data,0,0,0,0,1,0,0,1
openhab_openhab2,org.openhab.binding.dwdunwetter.internal,0,0,0,0,0,0,0,0
openhab_openhab2,org.openhab.binding.dwdunwetter.internal.factory,0,0,0,0,0,0,0,0
openhab_openhab2,org.openhab.binding.dwdunwetter.internal.handler,0,0,0,0,0,0,0,0
openhab_openhab2,org.openhab.binding.dwdunwetter,0,0,0,0,0,0,0,0
openhab_openhab2,org.openhab.binding.elerotransmitterstick.internal.config,0,0,0,0,0,0,0,0
openhab_openhab2,org.openhab.binding.elerotransmitterstick.internal.discovery,0,0,0,0,0,0,0,0
openhab_openhab2,org.openhab.binding.elerotransmitterstick.internal,0,0,0,0,0,0,0,0
openhab_openhab2,org.openhab.binding.elerotransmitterstick.internal.handler,0,0,0,0,0,0,0,0
openhab_openhab2,org.openhab.binding.elerotransmitterstick.internal.stick,0,0,0,0,0,0,0,0
openhab_openhab2,org.openhab.binding.enocean.internal.config,0,0,0,0,1,0,0,1
openhab_openhab2,org.openhab.binding.enocean.internal.discovery,0,0,0,0,0,0,0,0
openhab_openhab2,org.openhab.binding.enocean.internal.eep.A5_02,0,0,0,0,1,0,0,1
openhab_openhab2,org.openhab.binding.enocean.internal.eep.A5_04,0,0,0,0,0,0,0,0
openhab_openhab2,org.openhab.binding.enocean.internal.eep.A5_06,0,0,0,0,0,0,0,0
openhab_openhab2,org.openhab.binding.enocean.internal.eep.A5_07,0,0,0,0,0,0,0,0
openhab_openhab2,org.openhab.binding.enocean.internal.eep.A5_08,0,0,0,0,0,0,0,0
openhab_openhab2,org.openhab.binding.enocean.internal.eep.A5_10,0,0,0,1,1,0,0,2
openhab_openhab2,org.openhab.binding.enocean.internal.eep.A5_11,0,0,0,0,0,0,0,0
openhab_openhab2,org.openhab.binding.enocean.internal.eep.A5_12,0,0,0,0,0,0,0,0
openhab_openhab2,org.openhab.binding.enocean.internal.eep.A5_14,0,0,0,0,0,0,0,0
openhab_openhab2,org.openhab.binding.enocean.internal.eep.A5_20,0,0,0,0,0,0,0,0
openhab_openhab2,org.openhab.binding.enocean.internal.eep.A5_38,0,0,0,0,0,0,0,0
openhab_openhab2,org.openhab.binding.enocean.internal.eep.A5_3F,0,0,0,0,0,0,0,0
openhab_openhab2,org.openhab.binding.enocean.internal.eep.Base,0,0,0,0,1,0,0,1
openhab_openhab2,org.openhab.binding.enocean.internal.eep.D2_01,0,0,0,0,1,0,0,1
openhab_openhab2,org.openhab.binding.enocean.internal.eep.D2_05,0,0,0,0,0,0,0,0
openhab_openhab2,org.openhab.binding.enocean.internal.eep.D5_00,0,0,0,0,0,0,0,0
openhab_openhab2,org.openhab.binding.enocean.internal.eep,2,1,0,0,0,0,0,3
openhab_openhab2,org.openhab.binding.enocean.internal.eep.F6_01,0,0,0,0,0,0,0,0
openhab_openhab2,org.openhab.binding.enocean.internal.eep.F6_02,0,0,0,0,0,0,0,0
openhab_openhab2,org.openhab.binding.enocean.internal.eep.F6_10,0,0,0,0,0,0,0,0
openhab_openhab2,org.openhab.binding.enocean.internal.eep.Generic,0,0,0,0,0,0,0,0
openhab_openhab2,org.openhab.binding.enocean.internal,4,1,0,0,0,0,0,5
openhab_openhab2,org.openhab.binding.enocean.internal.handler,4,0,0,0,0,0,0,4
openhab_openhab2,org.openhab.binding.enocean.internal.messages,4,0,0,0,1,0,0,5
openhab_openhab2,org.openhab.binding.enocean.internal.transceiver,4,1,0,0,1,0,0,6
openhab_openhab2,org.openhab.binding.enturno.internal.connection,0,0,0,0,0,0,0,0
openhab_openhab2,org.openhab.binding.enturno.internal,0,0,0,0,0,0,0,0
openhab_openhab2,org.openhab.binding.enturno.internal.model,0,0,0,0,0,0,0,0
openhab_openhab2,org.openhab.binding.enturno.internal.model.estimated,0,0,0,0,1,0,0,1
openhab_openhab2,org.openhab.binding.enturno.internal.model.simplified,0,0,0,0,0,0,0,0
openhab_openhab2,org.openhab.binding.enturno.internal.model.stopplace,0,0,0,0,0,0,0,0
openhab_openhab2,org.openhab.binding.evohome.internal.api,0,0,0,0,0,0,0,0
openhab_openhab2,org.openhab.binding.evohome.internal.api.models.v2.request,0,0,0,0,0,0,0,0
openhab_openhab2,org.openhab.binding.evohome.internal.api.models.v2.response,0,0,0,0,1,0,0,1
openhab_openhab2,org.openhab.binding.evohome.internal.configuration,0,0,0,0,0,0,0,0
openhab_openhab2,org.openhab.binding.evohome.internal.discovery,0,0,0,0,0,0,0,0
openhab_openhab2,org.openhab.binding.evohome.internal,0,0,0,0,0,0,0,0
openhab_openhab2,org.openhab.binding.evohome.internal.handler,0,0,0,0,0,0,0,0
openhab_openhab2,org.openhab.binding.exec.internal,0,0,0,0,0,0,0,0
openhab_openhab2,org.openhab.binding.exec.internal.handler,0,0,0,0,0,0,0,0
openhab_openhab2,org.openhab.binding.feed.internal,0,0,0,0,0,0,0,0
openhab_openhab2,org.openhab.binding.feed.internal.handler,0,0,0,0,0,0,0,0
openhab_openhab2,org.openhab.binding.feican.internal,0,0,0,0,1,0,0,1
openhab_openhab2,org.openhab.binding.feican.internal.handler,0,0,0,0,0,0,0,0
openhab_openhab2,org.openhab.binding.folding.internal.discovery,0,0,0,0,0,0,0,0
openhab_openhab2,org.openhab.binding.folding.internal,0,0,0,0,0,0,0,0
openhab_openhab2,org.openhab.binding.folding.internal.handler,0,0,0,0,0,0,0,0
openhab_openhab2,org.openhab.binding.freebox.internal.api,1,1,0,0,0,0,0,2
openhab_openhab2,org.openhab.binding.freebox.internal.api.model,1,0,0,1,1,0,0,3
openhab_openhab2,org.openhab.binding.freebox.internal.config,0,0,0,0,0,0,0,0
openhab_openhab2,org.openhab.binding.freebox.internal.discovery,0,0,0,0,0,0,0,0
openhab_openhab2,org.openhab.binding.freebox.internal,0,0,0,0,0,0,0,0
openhab_openhab2,org.openhab.binding.freebox.internal.handler,0,0,0,0,0,0,0,0
openhab_openhab2,org.openhab.binding.fronius.internal.api,0,0,0,0,1,0,0,1
openhab_openhab2,org.openhab.binding.fronius.internal,0,0,0,0,0,0,0,0
openhab_openhab2,org.openhab.binding.fronius.internal.handler,0,0,0,0,0,0,0,0
openhab_openhab2,org.openhab.binding.fronius.internal.math,0,0,0,0,0,0,0,0
openhab_openhab2,org.openhab.binding.fsinternetradio.internal,0,0,0,0,0,0,0,0
openhab_openhab2,org.openhab.binding.fsinternetradio.internal.handler,0,0,0,0,0,0,0,0
openhab_openhab2,org.openhab.binding.fsinternetradio.internal.radio,0,0,0,0,0,0,0,0
openhab_openhab2,org.openhab.binding.ftpupload.internal.config,0,0,0,0,0,0,0,0
openhab_openhab2,org.openhab.binding.ftpupload.internal.ftp,0,0,0,0,1,0,0,1
openhab_openhab2,org.openhab.binding.ftpupload.internal,0,0,0,0,0,0,0,0
openhab_openhab2,org.openhab.binding.ftpupload.internal.handler,0,0,0,0,0,0,0,0
openhab_openhab2,org.openhab.binding.gardena.internal.config,0,0,0,0,0,0,0,0
openhab_openhab2,org.openhab.binding.gardena.internal.discovery,0,0,0,0,0,0,0,0
openhab_openhab2,org.openhab.binding.gardena.internal.exception,0,0,0,0,0,0,0,0
openhab_openhab2,org.openhab.binding.gardena.internal,0,0,0,0,0,0,0,0
openhab_openhab2,org.openhab.binding.gardena.internal.handler,1,1,0,0,0,0,0,2
openhab_openhab2,org.openhab.binding.gardena.internal.model,0,0,0,0,1,0,0,1
openhab_openhab2,org.openhab.binding.gardena.internal.model.command,0,0,0,0,1,0,0,1
openhab_openhab2,org.openhab.binding.gardena.internal.model.deser,0,0,0,0,0,0,0,0
openhab_openhab2,org.openhab.binding.gardena.internal.model.property,0,0,0,0,0,0,0,0
openhab_openhab2,org.openhab.binding.gardena.internal.util,1,1,0,0,0,0,0,2
openhab_openhab2,org.openhab.binding.globalcache.internal.command,0,0,0,0,1,0,0,1
openhab_openhab2,org.openhab.binding.globalcache.internal.discovery,0,0,0,0,0,0,0,0
openhab_openhab2,org.openhab.binding.globalcache.internal,0,0,0,0,0,0,0,0
openhab_openhab2,org.openhab.binding.globalcache.internal.handler,0,0,0,0,1,0,0,1
openhab_openhab2,org.openhab.binding.gpstracker.internal.config,0,0,0,0,0,0,0,0
openhab_openhab2,org.openhab.binding.gpstracker.internal.discovery,0,0,0,0,0,0,0,0
openhab_openhab2,org.openhab.binding.gpstracker.internal,0,0,0,0,0,0,0,0
openhab_openhab2,org.openhab.binding.gpstracker.internal.handler,0,0,0,0,0,0,0,0
openhab_openhab2,org.openhab.binding.gpstracker.internal.message,0,0,0,0,0,0,0,0
openhab_openhab2,org.openhab.binding.gpstracker.internal.profile,0,0,0,0,0,0,0,0
openhab_openhab2,org.openhab.binding.gpstracker.internal.provider,0,0,0,0,0,0,0,0
openhab_openhab2,org.openhab.binding.gpstracker.internal.provider.gpslogger,0,0,0,0,0,0,0,0
openhab_openhab2,org.openhab.binding.gpstracker.internal.provider.owntracks,0,0,0,0,0,0,0,0
openhab_openhab2,org.openhab.binding.groheondus.internal,0,0,0,0,0,0,0,0
openhab_openhab2,org.openhab.binding.groheondus.internal.discovery,0,0,0,0,0,0,0,0
openhab_openhab2,org.openhab.binding.groheondus.internal.handler,0,0,0,0,0,0,0,0
openhab_openhab2,org.openhab.binding.harmonyhub.internal.config,0,0,0,0,0,0,0,0
openhab_openhab2,org.openhab.binding.harmonyhub.internal.discovery,0,0,0,0,0,0,0,0
openhab_openhab2,org.openhab.binding.harmonyhub.internal.handler,0,0,0,0,0,0,0,0
openhab_openhab2,org.openhab.binding.harmonyhub.internal,0,0,0,0,0,0,0,0
openhab_openhab2,org.openhab.binding.hdanywhere.internal.handler,0,0,0,0,0,0,0,0
openhab_openhab2,org.openhab.binding.hdanywhere.internal,0,0,0,0,0,0,0,0
openhab_openhab2,org.openhab.binding.hdpowerview.internal.api.requests,0,0,0,0,0,0,0,0
openhab_openhab2,org.openhab.binding.hdpowerview.internal.api.responses,0,0,0,0,0,0,0,0
openhab_openhab2,org.openhab.binding.hdpowerview.internal.api,0,0,0,0,0,0,0,0
openhab_openhab2,org.openhab.binding.hdpowerview.internal.config,0,0,0,0,0,0,0,0
openhab_openhab2,org.openhab.binding.hdpowerview.internal.discovery,0,0,0,0,0,0,0,0
openhab_openhab2,org.openhab.binding.hdpowerview.internal.handler,0,0,0,0,0,0,0,0
openhab_openhab2,org.openhab.binding.hdpowerview.internal,0,0,0,0,0,0,0,0
openhab_openhab2,org.openhab.binding.helios.internal.handler,1,0,0,0,0,0,0,1
openhab_openhab2,org.openhab.binding.helios.internal,0,0,0,0,0,0,0,0
openhab_openhab2,org.openhab.binding.helios.internal.ws.rest,0,0,0,0,1,0,0,1
openhab_openhab2,org.openhab.binding.helios.internal.ws.soap,1,1,0,0,1,0,0,3
openhab_openhab2,org.openhab.binding.heos.handler,0,0,0,0,0,0,0,0
openhab_openhab2,org.openhab.binding.heos,0,0,0,0,0,0,0,0
openhab_openhab2,org.openhab.binding.heos.internal.api,0,0,0,0,0,0,0,0
openhab_openhab2,org.openhab.binding.heos.internal.discovery,0,0,0,0,0,0,0,0
openhab_openhab2,org.openhab.binding.heos.internal.handler,0,0,0,0,1,0,0,1
openhab_openhab2,org.openhab.binding.heos.internal,0,0,0,0,0,0,0,0
openhab_openhab2,org.openhab.binding.heos.internal.resources,0,0,0,0,1,0,0,1
openhab_openhab2,org.openhab.binding.homematic.internal.common,0,0,0,0,0,0,0,0
openhab_openhab2,org.openhab.binding.homematic.internal.communicator,0,0,0,0,1,1,0,2
openhab_openhab2,org.openhab.binding.homematic.internal.communicator.client,0,0,0,0,1,0,0,1
openhab_openhab2,org.openhab.binding.homematic.internal.communicator.message,0,0,0,0,0,0,0,0
openhab_openhab2,org.openhab.binding.homematic.internal.communicator.parser,0,0,0,0,1,0,0,1
openhab_openhab2,org.openhab.binding.homematic.internal.communicator.server,0,0,0,0,1,0,0,1
openhab_openhab2,org.openhab.binding.homematic.internal.communicator.virtual,0,0,0,0,1,1,0,2
openhab_openhab2,org.openhab.binding.homematic.internal.converter,0,0,0,0,1,0,0,1
openhab_openhab2,org.openhab.binding.homematic.internal.converter.type,0,0,0,0,1,0,0,1
openhab_openhab2,org.openhab.binding.homematic.internal.discovery,0,0,0,0,0,0,0,0
openhab_openhab2,org.openhab.binding.homematic.internal.discovery.eq3udp,0,0,0,0,0,0,0,0
openhab_openhab2,org.openhab.binding.homematic.internal.handler,0,0,0,0,1,0,0,1
openhab_openhab2,org.openhab.binding.homematic.internal,0,0,0,0,0,0,0,0
openhab_openhab2,org.openhab.binding.homematic.internal.misc,0,0,0,0,0,0,0,0
openhab_openhab2,org.openhab.binding.homematic.internal.model,0,0,0,0,1,1,0,2
openhab_openhab2,org.openhab.binding.homematic.internal.type.generator,0,0,0,0,0,0,0,0
openhab_openhab2,org.openhab.binding.homematic.internal.type,0,0,0,0,1,0,0,1
openhab_openhab2,org.openhab.binding.homematic.type,0,0,0,0,0,0,0,0
openhab_openhab2,org.openhab.binding.hpprinter.internal.api,0,0,0,0,0,0,0,0
openhab_openhab2,org.openhab.binding.hpprinter.internal.binder,0,0,0,0,0,0,0,0
openhab_openhab2,org.openhab.binding.hpprinter.internal.handler,0,0,0,0,0,0,0,0
openhab_openhab2,org.openhab.binding.hpprinter.internal,0,0,0,0,0,0,0,0
openhab_openhab2,org.openhab.binding.hue.internal.action,0,0,0,0,0,0,0,0
openhab_openhab2,org.openhab.binding.hue.internal,4,1,0,1,1,0,0,7
openhab_openhab2,org.openhab.binding.hue.internal.config,0,0,0,0,0,0,0,0
openhab_openhab2,org.openhab.binding.hue.internal.discovery,2,0,0,0,1,0,0,3
openhab_openhab2,org.openhab.binding.hue.internal.exceptions,0,0,0,0,0,0,0,0
openhab_openhab2,org.openhab.binding.hue.internal.handler,2,0,0,0,1,0,0,3
openhab_openhab2,org.openhab.binding.hue.internal.handler.sensors,2,1,0,0,0,0,0,3
openhab_openhab2,org.openhab.binding.hyperion.internal.connection,0,0,0,0,0,0,0,0
openhab_openhab2,org.openhab.binding.hyperion.internal.handler,0,0,0,0,0,0,0,0
openhab_openhab2,org.openhab.binding.hyperion.internal,0,0,0,0,0,0,0,0
openhab_openhab2,org.openhab.binding.hyperion.internal.protocol,0,0,0,0,0,0,0,0
openhab_openhab2,org.openhab.binding.hyperion.internal.protocol.ng,0,0,0,0,1,0,0,1
openhab_openhab2,org.openhab.binding.hyperion.internal.protocol.v1,0,0,0,0,1,0,0,1
openhab_openhab2,org.openhab.binding.iaqualink.internal.api,0,0,0,0,0,0,0,0
openhab_openhab2,org.openhab.binding.iaqualink.internal.api.model,0,0,0,0,1,0,0,1
openhab_openhab2,org.openhab.binding.iaqualink.internal.config,0,0,0,0,0,0,0,0
openhab_openhab2,org.openhab.binding.iaqualink.internal.handler,0,0,0,0,0,0,0,0
openhab_openhab2,org.openhab.binding.iaqualink.internal,0,0,0,0,0,0,0,0
openhab_openhab2,org.openhab.binding.icloud.internal.configuration,0,0,0,0,0,0,0,0
openhab_openhab2,org.openhab.binding.icloud.internal.discovery,0,0,0,0,0,0,0,0
openhab_openhab2,org.openhab.binding.icloud.internal.handler,0,0,0,0,0,0,0,0
openhab_openhab2,org.openhab.binding.icloud.internal,0,0,0,0,1,0,0,1
openhab_openhab2,org.openhab.binding.icloud.internal.json.request,0,0,0,0,0,0,0,0
openhab_openhab2,org.openhab.binding.icloud.internal.json.response,0,0,0,0,1,0,0,1
openhab_openhab2,org.openhab.binding.icloud.internal.utilities,0,0,0,0,0,0,0,0
openhab_openhab2,org.openhab.binding.ihc.internal,0,0,0,0,1,0,0,1
openhab_openhab2,org.openhab.binding.ihc.internal.config,0,0,0,0,0,0,0,0
openhab_openhab2,org.openhab.binding.ihc.internal.converters,0,0,0,1,1,0,0,2
openhab_openhab2,org.openhab.binding.ihc.internal.handler,0,0,0,0,0,0,0,0
openhab_openhab2,org.openhab.binding.ihc.internal.profiles,0,0,0,0,0,0,0,0
openhab_openhab2,org.openhab.binding.ihc.internal.ws.datatypes,0,0,0,0,1,0,0,1
openhab_openhab2,org.openhab.binding.ihc.internal.ws.exeptions,0,0,0,0,0,0,0,0
openhab_openhab2,org.openhab.binding.ihc.internal.ws.http,0,0,0,0,0,0,0,0
openhab_openhab2,org.openhab.binding.ihc.internal.ws,0,0,0,0,1,0,0,1
openhab_openhab2,org.openhab.binding.ihc.internal.ws.projectfile,0,0,0,0,0,0,0,0
openhab_openhab2,org.openhab.binding.ihc.internal.ws.resourcevalues,0,0,0,0,0,0,0,0
openhab_openhab2,org.openhab.binding.ihc.internal.ws.services,0,0,0,0,0,0,0,0
openhab_openhab2,org.openhab.binding.innogysmarthome.internal.client,5,0,0,0,0,1,0,6
openhab_openhab2,org.openhab.binding.innogysmarthome.internal.client.entity.action,1,0,0,0,0,0,0,1
openhab_openhab2,org.openhab.binding.innogysmarthome.internal.client.entity.capability,0,0,0,0,0,1,0,1
openhab_openhab2,org.openhab.binding.innogysmarthome.internal.client.entity,4,1,0,0,1,1,0,7
openhab_openhab2,org.openhab.binding.innogysmarthome.internal.client.entity.device,1,0,0,0,0,1,0,2
openhab_openhab2,org.openhab.binding.innogysmarthome.internal.client.entity.error,0,0,0,0,0,0,0,0
openhab_openhab2,org.openhab.binding.innogysmarthome.internal.client.entity.event,0,0,0,0,0,0,0,0
openhab_openhab2,org.openhab.binding.innogysmarthome.internal.client.entity.link,0,0,0,0,0,1,0,1
openhab_openhab2,org.openhab.binding.innogysmarthome.internal.client.entity.state,2,1,0,0,0,1,0,4
openhab_openhab2,org.openhab.binding.innogysmarthome.internal.client.exception,0,0,0,0,1,0,0,1
openhab_openhab2,org.openhab.binding.innogysmarthome.internal.discovery,0,0,0,0,0,0,0,0
openhab_openhab2,org.openhab.binding.innogysmarthome.internal.handler,0,0,0,0,0,0,0,0
openhab_openhab2,org.openhab.binding.innogysmarthome.internal,0,1,0,0,0,0,0,1
openhab_openhab2,org.openhab.binding.innogysmarthome.internal.listener,0,0,0,0,0,0,0,0
openhab_openhab2,org.openhab.binding.innogysmarthome.internal.manager,0,0,0,0,0,0,0,0
openhab_openhab2,org.openhab.binding.ipp.internal.discovery,0,0,0,0,0,0,0,0
openhab_openhab2,org.openhab.binding.ipp.internal.handler,0,0,0,0,0,0,0,0
openhab_openhab2,org.openhab.binding.ipp.internal,0,0,0,0,0,0,0,0
openhab_openhab2,org.openhab.binding.irtrans.internal.handler,1,1,0,0,0,0,0,2
openhab_openhab2,org.openhab.binding.irtrans.internal,1,0,0,0,0,0,0,1
openhab_openhab2,org.openhab.binding.jeelink.internal.config,0,0,0,0,0,0,0,0
openhab_openhab2,org.openhab.binding.jeelink.internal.connection,0,0,0,0,1,0,0,1
openhab_openhab2,org.openhab.binding.jeelink.internal.discovery,0,0,0,0,0,0,0,0
openhab_openhab2,org.openhab.binding.jeelink.internal.ec3k,0,0,0,0,0,0,0,0
openhab_openhab2,org.openhab.binding.jeelink.internal,0,0,0,0,1,0,0,1
openhab_openhab2,org.openhab.binding.jeelink.internal.lacrosse,0,0,0,0,1,0,0,1
openhab_openhab2,org.openhab.binding.jeelink.internal.pca301,0,0,0,0,0,0,0,0
openhab_openhab2,org.openhab.binding.keba.internal.handler,0,0,0,0,0,0,0,0
openhab_openhab2,org.openhab.binding.keba.internal,0,0,0,0,0,0,0,0
openhab_openhab2,org.openhab.binding.km200.internal.discovery,0,0,0,0,0,0,0,0
openhab_openhab2,org.openhab.binding.km200.internal.handler,1,1,0,0,1,0,0,3
openhab_openhab2,org.openhab.binding.km200.internal,1,0,0,0,1,0,0,2
openhab_openhab2,org.openhab.binding.knx.internal.channel,0,0,0,0,1,0,0,1
openhab_openhab2,org.openhab.binding.knx.internal.client,0,0,0,0,1,0,0,1
openhab_openhab2,org.openhab.binding.knx.internal.config,0,0,0,0,0,0,0,0
openhab_openhab2,org.openhab.binding.knx.internal.dpt,0,0,0,0,0,0,0,0
openhab_openhab2,org.openhab.binding.knx.internal.factory,0,0,0,0,0,0,0,0
openhab_openhab2,org.openhab.binding.knx.internal.handler,0,0,0,0,1,0,0,1
openhab_openhab2,org.openhab.binding.knx.internal,0,0,0,0,0,0,0,0
openhab_openhab2,org.openhab.binding.knx.internal.profiles,0,0,0,0,0,0,0,0
openhab_openhab2,org.openhab.binding.kodi.internal.config,0,0,0,0,0,0,0,0
openhab_openhab2,org.openhab.binding.kodi.internal.discovery,0,0,0,0,0,0,0,0
openhab_openhab2,org.openhab.binding.kodi.internal.handler,0,0,0,0,0,0,0,0
openhab_openhab2,org.openhab.binding.kodi.internal,0,0,0,0,1,0,0,1
openhab_openhab2,org.openhab.binding.kodi.internal.model,0,0,0,0,1,0,0,1
openhab_openhab2,org.openhab.binding.kodi.internal.protocol,0,0,0,0,0,0,0,0
openhab_openhab2,org.openhab.binding.kodi.internal.utils,0,0,0,0,0,0,0,0
openhab_openhab2,org.openhab.binding.konnected.internal.discovery,0,0,0,0,0,0,0,0
openhab_openhab2,org.openhab.binding.konnected.internal.gson,0,0,0,0,0,0,0,0
openhab_openhab2,org.openhab.binding.konnected.internal.handler,0,0,0,0,0,0,0,0
openhab_openhab2,org.openhab.binding.konnected.internal,0,0,0,0,0,0,0,0
openhab_openhab2,org.openhab.binding.konnected.internal.servlet,0,0,0,0,0,0,0,0
openhab_openhab2,org.openhab.binding.internal.kostal.inverter.firstgeneration,0,0,0,0,0,0,0,0
openhab_openhab2,org.openhab.binding.internal.kostal.inverter,0,0,0,0,0,0,0,0
openhab_openhab2,org.openhab.binding.internal.kostal.inverter.thirdgeneration,0,0,0,0,1,0,0,1
openhab_openhab2,org.openhab.binding.lametrictime.internal.config,0,0,0,0,0,0,0,0
openhab_openhab2,org.openhab.binding.lametrictime.internal.discovery,0,0,0,0,0,0,0,0
openhab_openhab2,org.openhab.binding.lametrictime.internal.handler,0,0,0,0,1,0,0,1
openhab_openhab2,org.openhab.binding.lametrictime.internal,0,0,0,0,1,0,0,1
openhab_openhab2,org.openhab.binding.leapmotion.internal.discovery,0,0,0,0,0,0,0,0
openhab_openhab2,org.openhab.binding.leapmotion.internal.handler,0,0,0,0,0,0,0,0
openhab_openhab2,org.openhab.binding.leapmotion.internal,0,0,0,0,1,0,0,1
openhab_openhab2,org.openhab.binding.lgtvserial.internal.handler,0,0,0,0,0,0,0,0
openhab_openhab2,org.openhab.binding.lgtvserial.internal,0,0,0,0,0,0,0,0
openhab_openhab2,org.openhab.binding.lgtvserial.internal.protocol.serial.commands,0,0,0,1,0,0,0,1
openhab_openhab2,org.openhab.binding.lgtvserial.internal.protocol.serial,0,0,0,0,1,0,0,1
openhab_openhab2,org.openhab.binding.lgtvserial.internal.protocol.serial.responses,0,0,0,0,0,0,0,0
openhab_openhab2,org.openhab.binding.lgwebos.action,0,0,0,0,0,0,0,0
openhab_openhab2,org.openhab.binding.lgwebos.internal,0,0,0,0,1,0,0,1
openhab_openhab2,org.openhab.binding.lgwebos.internal.discovery,0,0,0,0,0,0,0,0
openhab_openhab2,org.openhab.binding.lgwebos.internal.handler.command,0,0,0,0,0,0,0,0
openhab_openhab2,org.openhab.binding.lgwebos.internal.handler.core,0,0,0,0,1,0,0,1
openhab_openhab2,org.openhab.binding.lgwebos.internal.handler,0,0,0,0,1,0,0,1
openhab_openhab2,org.openhab.binding.lifx.internal.fields,0,0,0,0,1,0,0,1
openhab_openhab2,org.openhab.binding.lifx.internal.handler,0,0,0,0,0,0,0,0
openhab_openhab2,org.openhab.binding.lifx.internal,0,0,0,0,1,0,0,1
openhab_openhab2,org.openhab.binding.lifx.internal.listener,0,0,0,0,0,0,0,0
openhab_openhab2,org.openhab.binding.lifx.internal.protocol,0,0,0,1,0,0,0,1
openhab_openhab2,org.openhab.binding.lifx.internal.util,0,0,0,0,0,0,0,0
openhab_openhab2,org.openhab.binding.linuxinput.internal,0,0,0,0,1,0,0,1
openhab_openhab2,org.openhab.binding.linuxinput.internal.evdev4j,0,0,0,0,1,0,0,1
openhab_openhab2,org.openhab.binding.linuxinput.internal.evdev4j.jnr,0,0,0,0,1,0,0,1
openhab_openhab2,org.openhab.binding.lirc.internal.config,0,0,0,0,0,0,0,0
openhab_openhab2,org.openhab.binding.lirc.internal.connector,0,0,0,0,0,0,0,0
openhab_openhab2,org.openhab.binding.lirc.internal.discovery,0,0,0,0,0,0,0,0
openhab_openhab2,org.openhab.binding.lirc.internal.handler,0,0,0,0,0,0,0,0
openhab_openhab2,org.openhab.binding.lirc.internal,0,0,0,0,0,0,0,0
openhab_openhab2,org.openhab.binding.lirc.internal.messages,0,0,0,0,0,0,0,0
openhab_openhab2,org.apache.commons.io.input,0,0,0,0,0,0,0,0
openhab_openhab2,org.openhab.binding.logreader.internal.config,0,0,0,0,0,0,0,0
openhab_openhab2,org.openhab.binding.logreader.internal.filereader,0,0,0,0,0,0,0,0
openhab_openhab2,org.openhab.binding.logreader.internal.filereader.api,0,0,0,0,0,0,0,0
openhab_openhab2,org.openhab.binding.logreader.internal.handler,0,0,0,0,0,0,0,0
openhab_openhab2,org.openhab.binding.logreader.internal,0,0,0,0,0,0,0,0
openhab_openhab2,org.openhab.binding.logreader.internal.searchengine,0,0,0,0,0,0,0,0
openhab_openhab2,org.openhab.binding.loxone.internal.controls,1,0,0,1,1,0,0,3
openhab_openhab2,org.openhab.binding.loxone.internal,0,0,0,0,1,0,0,1
openhab_openhab2,org.openhab.binding.loxone.internal.security,0,0,0,0,0,0,0,0
openhab_openhab2,org.openhab.binding.loxone.internal.types,1,1,0,0,1,0,0,3
openhab_openhab2,org.openhab.binding.lutron.internal.config,0,0,0,0,0,0,0,0
openhab_openhab2,org.openhab.binding.lutron.internal.discovery,0,0,0,0,0,0,0,0
openhab_openhab2,org.openhab.binding.lutron.internal.discovery.project,0,0,0,0,1,0,0,1
openhab_openhab2,org.openhab.binding.lutron.internal.grxprg,1,0,0,0,1,0,0,2
openhab_openhab2,org.openhab.binding.lutron.internal.handler,0,0,0,0,1,0,0,1
openhab_openhab2,org.openhab.binding.lutron.internal.hw,1,0,0,0,1,0,0,2
openhab_openhab2,org.openhab.binding.lutron.internal,3,1,0,0,0,0,0,4
openhab_openhab2,org.openhab.binding.lutron.internal.net,0,0,0,0,0,0,0,0
openhab_openhab2,org.openhab.binding.lutron.internal.protocol,0,0,0,0,0,0,0,0
openhab_openhab2,org.openhab.binding.lutron.internal.radiora.config,0,0,0,0,0,0,0,0
openhab_openhab2,org.openhab.binding.lutron.internal.radiora.handler,0,0,0,0,0,0,0,0
openhab_openhab2,org.openhab.binding.lutron.internal.radiora.protocol,0,0,0,0,1,0,0,1
openhab_openhab2,org.openhab.binding.lutron.internal.radiora,1,0,0,0,1,0,0,2
openhab_openhab2,org.openhab.binding.lutron.internal.xml,0,0,0,0,0,0,0,0
openhab_openhab2,org.openhab.binding.mail.action,0,0,0,0,0,0,0,0
openhab_openhab2,org.openhab.binding.mail.internal.config,0,0,0,0,0,0,0,0
openhab_openhab2,org.openhab.binding.mail.internal,0,0,0,0,0,0,0,0
openhab_openhab2,org.openhab.binding.mail,0,0,0,0,0,0,0,0
openhab_openhab2,org.openhab.binding.max.internal.command,0,1,0,0,0,0,0,1
openhab_openhab2,org.openhab.binding.max.internal.config,0,0,0,0,0,0,0,0
openhab_openhab2,org.openhab.binding.max.internal.device,0,0,0,0,1,0,0,1
openhab_openhab2,org.openhab.binding.max.internal.discovery,0,0,0,0,0,0,0,0
openhab_openhab2,org.openhab.binding.max.internal.exceptions,0,0,0,0,1,0,0,1
openhab_openhab2,org.openhab.binding.max.internal.factory,0,0,0,0,0,0,0,0
openhab_openhab2,org.openhab.binding.max.internal.handler,0,0,0,0,0,0,0,0
openhab_openhab2,org.openhab.binding.max.internal,0,0,0,0,0,0,0,0
openhab_openhab2,org.openhab.binding.max.internal.message,0,0,0,0,0,0,0,0
openhab_openhab2,org.openhab.binding.mcp23017.internal,0,0,0,0,0,0,0,0
openhab_openhab2,org.openhab.binding.mcp23017.internal.handler,0,0,0,0,0,0,0,0
openhab_openhab2,org.openhab.binding.meteoblue.internal,0,0,0,0,0,0,0,0
openhab_openhab2,org.openhab.binding.meteoblue.internal.handler,0,0,0,0,0,0,0,0
openhab_openhab2,org.openhab.binding.meteoblue.internal.json,0,0,0,0,0,0,0,0
openhab_openhab2,org.openhab.binding.meteostick.internal.handler,0,0,0,0,1,0,0,1
openhab_openhab2,org.openhab.binding.meteostick.internal,0,0,0,0,0,0,0,0
openhab_openhab2,org.openhab.binding.miele.internal.discovery,0,0,0,0,0,0,0,0
openhab_openhab2,org.openhab.binding.miele.internal.handler,0,0,0,0,1,0,0,1
openhab_openhab2,org.openhab.binding.miele.internal,0,0,0,0,0,0,0,0
openhab_openhab2,org.openhab.binding.mihome.internal,1,1,0,0,1,0,0,3
openhab_openhab2,org.openhab.binding.mihome.internal.discovery,0,0,0,0,0,0,0,0
openhab_openhab2,org.openhab.binding.mihome.internal.handler,1,0,0,0,1,0,0,2
openhab_openhab2,org.openhab.binding.mihome.internal.socket,0,0,0,0,0,0,0,0
openhab_openhab2,org.openhab.binding.miio.internal.basic,0,0,0,0,0,0,0,0
openhab_openhab2,org.openhab.binding.miio.internal.discovery,0,0,0,0,0,0,0,0
openhab_openhab2,org.openhab.binding.miio.internal.handler,0,0,0,0,0,0,0,0
openhab_openhab2,org.openhab.binding.miio.internal,0,0,0,0,1,0,0,1
openhab_openhab2,org.openhab.binding.miio.internal.transport,0,0,0,0,0,0,0,0
openhab_openhab2,org.openhab.binding.milight.internal.discovery,0,0,0,0,0,0,0,0
openhab_openhab2,org.openhab.binding.milight.internal.handler,0,0,0,0,1,0,0,1
openhab_openhab2,org.openhab.binding.milight.internal,0,0,0,0,0,0,0,0
openhab_openhab2,org.openhab.binding.milight.internal.protocol,0,0,0,0,0,0,0,0
openhab_openhab2,org.openhab.binding.minecraft.internal.config,0,0,0,0,0,0,0,0
openhab_openhab2,org.openhab.binding.minecraft.internal.discovery,0,0,0,0,0,0,0,0
openhab_openhab2,org.openhab.binding.minecraft.internal.handler,0,0,0,0,0,0,0,0
openhab_openhab2,org.openhab.binding.minecraft.internal.message.data.commands,0,0,0,0,0,0,0,0
openhab_openhab2,org.openhab.binding.minecraft.internal.message.data,0,0,0,0,0,0,0,0
openhab_openhab2,org.openhab.binding.minecraft.internal.message,0,0,0,0,0,0,0,0
openhab_openhab2,org.openhab.binding.minecraft.internal,0,0,0,0,0,0,0,0
openhab_openhab2,org.openhab.binding.minecraft.internal.server,0,0,0,0,0,0,0,0
openhab_openhab2,org.openhab.binding.minecraft.internal.util,0,0,0,0,0,0,0,0
openhab_openhab2,org.openhab.binding.modbus.discovery.internal,0,0,0,0,0,0,0,0
openhab_openhab2,org.openhab.binding.modbus.discovery,0,0,0,0,0,0,0,0
openhab_openhab2,org.openhab.binding.modbus.handler,0,0,0,0,0,0,0,0
openhab_openhab2,org.openhab.binding.modbus.internal,1,1,0,0,1,0,0,3
openhab_openhab2,org.openhab.binding.modbus.internal.config,0,0,0,0,0,0,0,0
openhab_openhab2,org.openhab.binding.modbus.internal.handler,1,0,0,0,1,0,0,2
openhab_openhab2,org.openhab.binding.modbus,0,0,0,0,0,0,0,0
openhab_openhab2,org.openhab.binding.mqtt.action,0,0,0,0,0,0,0,0
openhab_openhab2,org.openhab.binding.mqtt.discovery,0,0,0,0,0,0,0,0
openhab_openhab2,org.openhab.binding.mqtt.handler,1,0,0,0,1,0,0,2
openhab_openhab2,org.openhab.binding.mqtt.internal.discovery,0,0,0,0,0,0,0,0
openhab_openhab2,org.openhab.binding.mqtt.internal,1,1,0,0,0,0,0,2
openhab_openhab2,org.openhab.binding.mqtt.internal.ssl,0,0,0,0,1,0,0,1
openhab_openhab2,org.openhab.binding.mqtt,0,1,0,0,1,0,0,2
openhab_openhab2,org.openhab.binding.mqtt.generic,0,0,0,0,1,0,0,1
openhab_openhab2,org.openhab.binding.mqtt.generic.internal.handler,0,0,0,0,0,0,0,0
openhab_openhab2,org.openhab.binding.mqtt.generic.internal,0,0,0,0,0,0,0,0
openhab_openhab2,org.openhab.binding.mqtt.generic.mapping,0,0,0,0,1,0,0,1
openhab_openhab2,org.openhab.binding.mqtt.generic.tools,0,0,0,0,0,0,0,0
openhab_openhab2,org.openhab.binding.mqtt.generic.values,0,0,0,0,1,0,0,1
openhab_openhab2,org.openhab.binding.mqtt.homeassistant.generic.internal,0,0,0,0,0,0,0,0
openhab_openhab2,org.openhab.binding.mqtt.homeassistant.internal,1,1,0,1,1,0,0,4
openhab_openhab2,org.openhab.binding.mqtt.homeassistant.internal.discovery,0,0,0,0,0,0,0,0
openhab_openhab2,org.openhab.binding.mqtt.homeassistant.internal.handler,1,0,0,0,0,0,0,1
openhab_openhab2,org.openhab.binding.mqtt.homeassistant.internal.util,0,0,0,0,0,0,0,0
openhab_openhab2,org.openhab.binding.mqtt.homie.generic.internal,0,0,0,0,0,0,0,0
openhab_openhab2,org.openhab.binding.mqtt.homie.internal.discovery,0,0,0,0,0,0,0,0
openhab_openhab2,org.openhab.binding.mqtt.homie.internal.handler,0,0,0,0,0,0,0,0
openhab_openhab2,org.openhab.binding.mqtt.homie.internal.homie300,0,0,0,0,1,0,0,1
openhab_openhab2,org.openhab.binding.mqtt.homie,0,0,0,0,0,0,0,0
openhab_openhab2,org.openhab.binding.mqtt.homie.generic.internal.mapping,0,0,0,0,0,0,0,0
openhab_openhab2,org.openhab.binding.nanoleaf.internal.config,0,0,0,0,0,0,0,0
openhab_openhab2,org.openhab.binding.nanoleaf.internal.discovery,0,0,0,0,0,0,0,0
openhab_openhab2,org.openhab.binding.nanoleaf.internal.handler,0,0,0,0,0,0,0,0
openhab_openhab2,org.openhab.binding.nanoleaf.internal.model,0,0,0,0,1,0,0,1
openhab_openhab2,org.openhab.binding.nanoleaf.internal,0,0,0,0,1,0,0,1
openhab_openhab2,org.openhab.binding.neato.internal.classes,0,0,0,0,1,0,0,1
openhab_openhab2,org.openhab.binding.neato.internal.config,0,0,0,0,0,0,0,0
openhab_openhab2,org.openhab.binding.neato.internal,0,0,0,0,1,0,0,1
openhab_openhab2,org.openhab.binding.neato.internal.discovery,0,0,0,0,0,0,0,0
openhab_openhab2,org.openhab.binding.neato.internal.handler,0,0,0,0,0,0,0,0
openhab_openhab2,org.openhab.binding.neeo.internal.discovery,0,0,0,0,0,0,0,0
openhab_openhab2,org.openhab.binding.neeo.internal.handler,0,0,0,0,1,0,0,1
openhab_openhab2,org.openhab.binding.neeo.internal.models,0,0,0,0,1,0,0,1
openhab_openhab2,org.openhab.binding.neeo.internal,0,0,0,0,1,0,0,1
openhab_openhab2,org.openhab.binding.neeo.internal.net,0,0,0,0,0,0,0,0
openhab_openhab2,org.openhab.binding.neohub.internal,0,0,0,0,1,0,0,1
openhab_openhab2,org.openhab.binding.nest.internal.config,0,0,0,0,0,0,0,0
openhab_openhab2,org.openhab.binding.nest.internal.data,0,0,0,0,1,0,0,1
openhab_openhab2,org.openhab.binding.nest.internal.discovery,0,0,0,0,0,0,0,0
openhab_openhab2,org.openhab.binding.nest.internal.exceptions,0,0,0,0,0,0,0,0
openhab_openhab2,org.openhab.binding.nest.internal.handler,0,0,0,0,1,0,0,1
openhab_openhab2,org.openhab.binding.nest.internal.listener,0,0,0,0,0,0,0,0
openhab_openhab2,org.openhab.binding.nest.internal,0,0,0,0,0,0,0,0
openhab_openhab2,org.openhab.binding.nest.internal.rest,0,0,0,0,0,0,0,0
openhab_openhab2,org.openhab.binding.nest.internal.update,0,0,0,0,0,0,0,0
openhab_openhab2,org.openhab.binding.netatmo.internal.channelhelper,0,0,0,0,0,0,0,0
openhab_openhab2,org.openhab.binding.netatmo.internal,0,0,0,0,1,0,0,1
openhab_openhab2,org.openhab.binding.netatmo.internal.config,0,0,0,0,0,0,0,0
openhab_openhab2,org.openhab.binding.netatmo.internal.discovery,0,0,0,0,0,0,0,0
openhab_openhab2,org.openhab.binding.netatmo.internal.handler,0,0,0,0,1,0,0,1
openhab_openhab2,org.openhab.binding.netatmo.internal.homecoach,0,0,0,0,0,0,0,0
openhab_openhab2,org.openhab.binding.netatmo.internal.station,0,0,0,0,0,0,0,0
openhab_openhab2,org.openhab.binding.netatmo.internal.thermostat,0,0,0,0,0,0,0,0
openhab_openhab2,org.openhab.binding.netatmo.internal.webhook,0,0,0,0,0,0,0,0
openhab_openhab2,org.openhab.binding.netatmo.internal.welcome,0,0,0,0,0,0,0,0
openhab_openhab2,org.openhab.binding.network.internal.dhcp,0,0,0,0,0,0,0,0
openhab_openhab2,org.openhab.binding.network.internal.discovery,0,0,0,0,0,0,0,0
openhab_openhab2,org.openhab.binding.network.internal.handler,0,0,0,0,0,0,0,0
openhab_openhab2,org.openhab.binding.network.internal,0,0,0,0,1,0,0,1
openhab_openhab2,org.openhab.binding.network.internal.toberemoved.cache,0,0,0,0,0,0,0,0
openhab_openhab2,org.openhab.binding.network.internal.utils,0,0,0,0,0,0,0,0
openhab_openhab2,org.openhab.binding.nibeheatpump.internal.config,0,0,0,0,0,0,0,0
openhab_openhab2,org.openhab.binding.nibeheatpump.internal.connection,0,0,0,0,1,0,0,1
openhab_openhab2,org.openhab.binding.nibeheatpump.internal.handler,0,0,0,0,0,0,0,0
openhab_openhab2,org.openhab.binding.nibeheatpump.internal.message,0,0,0,0,0,0,0,0
openhab_openhab2,org.openhab.binding.nibeheatpump.internal.models,0,0,0,0,1,0,0,1
openhab_openhab2,org.openhab.binding.nibeheatpump.internal,0,0,0,0,0,0,0,0
openhab_openhab2,org.openhab.binding.nibeheatpump.internal.protocol,0,0,0,0,0,0,0,0
openhab_openhab2,org.openhab.binding.nibeuplink.internal,0,0,0,0,0,0,0,0
openhab_openhab2,org.openhab.binding.nibeuplink.internal.callback,0,0,0,0,0,0,0,0
openhab_openhab2,org.openhab.binding.nibeuplink.internal.command,0,0,0,0,0,0,0,0
openhab_openhab2,org.openhab.binding.nibeuplink.internal.config,0,0,0,0,0,0,0,0
openhab_openhab2,org.openhab.binding.nibeuplink.internal.connector,0,0,0,0,0,0,0,0
openhab_openhab2,org.openhab.binding.nibeuplink.internal.handler,0,0,0,0,0,0,0,0
openhab_openhab2,org.openhab.binding.nibeuplink.internal.model,0,0,0,0,1,0,0,1
openhab_openhab2,org.openhab.binding.nikohomecontrol.internal.discovery,0,0,0,0,0,0,0,0
openhab_openhab2,org.openhab.binding.nikohomecontrol.internal.handler,0,0,0,0,1,0,0,1
openhab_openhab2,org.openhab.binding.nikohomecontrol.internal,0,0,0,0,0,0,0,0
openhab_openhab2,org.openhab.binding.nikohomecontrol.internal.protocol.nhc1,0,0,0,0,1,0,0,1
openhab_openhab2,org.openhab.binding.nikohomecontrol.internal.protocol.nhc2,0,0,0,0,1,0,0,1
openhab_openhab2,org.openhab.binding.nikohomecontrol.internal.protocol,0,0,0,0,1,0,0,1
openhab_openhab2,org.openhab.binding.ntp.internal.discovery,0,0,0,0,0,0,0,0
openhab_openhab2,org.openhab.binding.ntp.internal.handler,0,0,0,0,0,0,0,0
openhab_openhab2,org.openhab.binding.ntp.internal,0,0,0,0,0,0,0,0
openhab_openhab2,org.openhab.binding.nuki.internal.converter,0,0,0,0,0,0,0,0
openhab_openhab2,org.openhab.binding.nuki.internal.dataexchange,0,0,0,0,1,0,0,1
openhab_openhab2,org.openhab.binding.nuki.internal.dto,0,0,0,0,1,0,0,1
openhab_openhab2,org.openhab.binding.nuki.internal.handler,0,0,0,0,0,0,0,0
openhab_openhab2,org.openhab.binding.nuki.internal,0,0,0,0,0,0,0,0
openhab_openhab2,org.openhab.binding.oceanic.internal.handler,0,0,0,0,0,0,0,0
openhab_openhab2,org.openhab.binding.oceanic.internal,0,0,0,0,0,0,0,0
openhab_openhab2,org.openhab.binding.omnikinverter.internal.handler,0,0,0,0,0,0,0,0
openhab_openhab2,org.openhab.binding.omnikinverter.internal,0,0,0,0,0,0,0,0
openhab_openhab2,org.openhab.binding.onebusaway.internal.config,0,0,0,0,0,0,0,0
openhab_openhab2,org.openhab.binding.onebusaway.internal.handler,0,0,0,0,1,0,0,1
openhab_openhab2,org.openhab.binding.onebusaway.internal,0,0,0,0,0,0,0,0
openhab_openhab2,org.openhab.binding.onewire.internal.config,2,1,0,0,1,0,0,4
openhab_openhab2,org.openhab.binding.onewire.internal.device,2,0,0,0,1,0,0,3
openhab_openhab2,org.openhab.binding.onewire.internal,5,1,0,0,1,0,0,7
openhab_openhab2,org.openhab.binding.onewire.internal.discovery,0,0,0,0,0,0,0,0
openhab_openhab2,org.openhab.binding.onewire.internal.handler,5,1,0,0,1,0,0,7
openhab_openhab2,org.openhab.binding.onewire.internal.owserver,1,0,0,0,0,0,0,1
openhab_openhab2,org.openhab.binding.onewire,0,0,0,0,0,0,0,0
openhab_openhab2,org.openhab.binding.onewire.device,0,0,0,0,1,0,0,1
openhab_openhab2,org.openhab.binding.onewire.owserver,0,0,0,0,0,0,0,0
openhab_openhab2,org.openhab.binding.onewiregpio.internal.handler,0,0,0,0,0,0,0,0
openhab_openhab2,org.openhab.binding.onewiregpio.internal,0,0,0,0,0,0,0,0
openhab_openhab2,org.openhab.binding.onkyo.internal.automation.modules,0,0,0,0,0,0,0,0
openhab_openhab2,org.openhab.binding.onkyo.internal.config,0,0,0,0,0,0,0,0
openhab_openhab2,org.openhab.binding.onkyo.internal.discovery,0,0,0,0,0,0,0,0
openhab_openhab2,org.openhab.binding.onkyo.internal.eiscp,0,0,0,0,0,0,0,0
openhab_openhab2,org.openhab.binding.onkyo.internal.handler,0,0,0,0,0,0,0,0
openhab_openhab2,org.openhab.binding.onkyo.internal,0,0,0,0,1,0,0,1
openhab_openhab2,org.openhab.binding.opengarage.internal.api,0,0,0,0,0,0,0,0
openhab_openhab2,org.openhab.binding.opengarage.internal,0,0,0,0,1,0,0,1
openhab_openhab2,org.openhab.binding.opensprinkler.internal.api.exception,0,0,0,0,1,0,0,1
openhab_openhab2,org.openhab.binding.opensprinkler.internal.api,0,0,0,0,1,0,0,1
openhab_openhab2,org.openhab.binding.opensprinkler.internal.config,0,0,0,0,0,0,0,0
openhab_openhab2,org.openhab.binding.opensprinkler.internal.discovery,0,0,0,0,0,0,0,0
openhab_openhab2,org.openhab.binding.opensprinkler.internal.handler,0,0,0,0,1,0,0,1
openhab_openhab2,org.openhab.binding.opensprinkler.internal.model,0,0,0,0,0,0,0,0
openhab_openhab2,org.openhab.binding.opensprinkler.internal,0,0,0,0,0,0,0,0
openhab_openhab2,org.openhab.binding.opensprinkler.internal.util,0,0,0,0,0,0,0,0
openhab_openhab2,org.openhab.binding.openuv.internal.discovery,0,0,0,0,0,0,0,0
openhab_openhab2,org.openhab.binding.openuv.internal.handler,0,0,0,0,0,0,0,0
openhab_openhab2,org.openhab.binding.openuv.internal.json,0,0,0,0,0,0,0,0
openhab_openhab2,org.openhab.binding.openuv.internal,0,0,0,0,0,0,0,0
openhab_openhab2,org.openhab.binding.openweathermap.internal.config,0,0,0,0,0,0,0,0
openhab_openhab2,org.openhab.binding.openweathermap.internal.connection,0,0,0,0,0,0,0,0
openhab_openhab2,org.openhab.binding.openweathermap.internal.discovery,0,0,0,0,0,0,0,0
openhab_openhab2,org.openhab.binding.openweathermap.internal.factory,0,0,0,0,0,0,0,0
openhab_openhab2,org.openhab.binding.openweathermap.internal.handler,0,1,0,0,0,0,0,1
openhab_openhab2,org.openhab.binding.openweathermap.internal.model.base,0,0,0,0,1,0,0,1
openhab_openhab2,org.openhab.binding.openweathermap.internal.model.forecast.daily,0,0,0,0,0,0,0,0
openhab_openhab2,org.openhab.binding.openweathermap.internal.model.forecast.hourly,0,0,0,0,0,0,0,0
openhab_openhab2,org.openhab.binding.openweathermap.internal.model,0,0,0,0,0,0,0,0
openhab_openhab2,org.openhab.binding.openweathermap.internal.model.weather,0,0,0,0,0,0,0,0
openhab_openhab2,org.openhab.binding.openweathermap.internal,0,0,0,0,0,0,0,0
openhab_openhab2,org.openhab.binding.openweathermap.internal.utils,0,0,0,0,0,0,0,0
openhab_openhab2,org.openhab.binding.orvibo.internal.discovery,0,0,0,0,0,0,0,0
openhab_openhab2,org.openhab.binding.orvibo.internal.handler,0,0,0,0,0,0,0,0
openhab_openhab2,org.openhab.binding.orvibo.internal,0,0,0,0,0,0,0,0
openhab_openhab2,org.openhab.binding.paradoxalarm.internal.communication,0,0,0,0,1,0,0,1
openhab_openhab2,org.openhab.binding.paradoxalarm.internal.communication.messages,0,0,0,0,1,0,0,1
openhab_openhab2,org.openhab.binding.paradoxalarm.internal.discovery,0,0,0,0,0,0,0,0
openhab_openhab2,org.openhab.binding.paradoxalarm.internal.exceptions,0,0,0,0,0,0,0,0
openhab_openhab2,org.openhab.binding.paradoxalarm.internal.handlers,0,0,0,0,1,0,0,1
openhab_openhab2,org.openhab.binding.paradoxalarm.internal.model,1,1,0,0,1,0,0,3
openhab_openhab2,org.openhab.binding.paradoxalarm.internal.parsers,1,0,0,0,0,0,0,1
openhab_openhab2,org.openhab.binding.paradoxalarm.internal.util,0,0,0,0,0,0,0,0
openhab_openhab2,main,0,0,0,0,0,0,0,0
openhab_openhab2,org.openhab.binding.pentair.internal.config,0,0,0,0,0,0,0,0
openhab_openhab2,org.openhab.binding.pentair.internal.handler,0,0,0,0,1,0,0,1
openhab_openhab2,org.openhab.binding.pentair.internal,0,0,0,0,1,0,0,1
openhab_openhab2,org.openhab.binding.phc.internal.handler,0,0,0,0,0,0,0,0
openhab_openhab2,org.openhab.binding.phc.internal,0,0,0,0,0,0,0,0
openhab_openhab2,org.openhab.binding.pioneeravr.internal.discovery,0,0,0,0,0,0,0,0
openhab_openhab2,org.openhab.binding.pioneeravr.internal.handler,0,0,0,0,0,0,0,0
openhab_openhab2,org.openhab.binding.pioneeravr.internal,0,0,0,0,0,0,0,0
openhab_openhab2,org.openhab.binding.pioneeravr.internal.protocol.avr,0,0,0,0,1,0,0,1
openhab_openhab2,org.openhab.binding.pioneeravr.internal.protocol,0,0,0,0,1,0,0,1
openhab_openhab2,org.openhab.binding.pioneeravr.internal.protocol.event,0,0,0,0,0,0,0,0
openhab_openhab2,org.openhab.binding.pioneeravr.internal.protocol.ip,0,0,0,0,0,0,0,0
openhab_openhab2,org.openhab.binding.pioneeravr.internal.protocol.serial,0,0,0,0,0,0,0,0
openhab_openhab2,org.openhab.binding.pioneeravr.internal.protocol.states,0,0,0,0,0,0,0,0
openhab_openhab2,org.openhab.binding.pioneeravr.internal.protocol.utils,0,0,0,0,0,0,0,0
openhab_openhab2,org.openhab.binding.pjlinkdevice.internal,0,0,0,0,1,0,0,1
openhab_openhab2,org.openhab.binding.pjlinkdevice.internal.device.command,0,0,0,0,1,0,0,1
openhab_openhab2,org.openhab.binding.pjlinkdevice.internal.device.command.authentication,0,0,0,0,0,0,0,0
openhab_openhab2,org.openhab.binding.pjlinkdevice.internal.device.command.errorstatus,0,0,0,0,0,0,0,0
openhab_openhab2,org.openhab.binding.pjlinkdevice.internal.device.command.identification,0,0,0,0,0,0,0,0
openhab_openhab2,org.openhab.binding.pjlinkdevice.internal.device.command.input,0,0,0,0,1,0,0,1
openhab_openhab2,org.openhab.binding.pjlinkdevice.internal.device.command.mute,0,0,0,0,1,0,0,1
openhab_openhab2,org.openhab.binding.pjlinkdevice.internal.device.command.power,0,0,0,0,1,0,0,1
openhab_openhab2,org.openhab.binding.pjlinkdevice.internal.device,0,0,0,0,0,0,0,0
openhab_openhab2,org.openhab.binding.pjlinkdevice.internal.discovery,0,0,0,0,0,0,0,0
openhab_openhab2,org.openhab.binding.plclogo.internal.config,0,0,0,0,1,0,0,1
openhab_openhab2,org.openhab.binding.plclogo.internal.discovery,0,0,0,0,0,0,0,0
openhab_openhab2,org.openhab.binding.plclogo.internal.handler,0,0,0,0,1,0,0,1
openhab_openhab2,org.openhab.binding.plclogo.internal,0,0,0,0,0,0,0,0
openhab_openhab2,org.openhab.binding.plugwise.internal.config,0,0,0,0,0,0,0,0
openhab_openhab2,org.openhab.binding.plugwise.internal.handler,0,0,0,0,1,0,0,1
openhab_openhab2,org.openhab.binding.plugwise.internal.listener,0,0,0,0,0,0,0,0
openhab_openhab2,org.openhab.binding.plugwise.internal,0,1,0,0,1,0,0,2
openhab_openhab2,org.openhab.binding.plugwise.internal.protocol,0,0,0,1,0,0,0,1
openhab_openhab2,org.openhab.binding.plugwise.internal.protocol.field,0,0,0,0,0,0,0,0
openhab_openhab2,org.openhab.binding.powermax.internal.config,0,0,0,0,0,0,0,0
openhab_openhab2,org.openhab.binding.powermax.internal.connector,0,0,0,0,0,0,0,0
openhab_openhab2,org.openhab.binding.powermax.internal.console,0,0,0,0,0,0,0,0
openhab_openhab2,org.openhab.binding.powermax.internal.discovery,0,0,0,0,0,0,0,0
openhab_openhab2,org.openhab.binding.powermax.internal.handler,0,0,0,0,0,0,0,0
openhab_openhab2,org.openhab.binding.powermax.internal.message,0,0,0,0,1,0,0,1
openhab_openhab2,org.openhab.binding.powermax.internal,0,0,0,0,0,0,0,0
openhab_openhab2,org.openhab.binding.powermax.internal.state,0,0,0,0,1,0,0,1
openhab_openhab2,org.openhab.binding.pulseaudio.internal.cli,0,0,0,0,0,0,0,0
openhab_openhab2,org.openhab.binding.pulseaudio.internal.discovery,0,0,0,0,0,0,0,0
openhab_openhab2,org.openhab.binding.pulseaudio.internal.handler,1,1,0,0,0,0,0,2
openhab_openhab2,org.openhab.binding.pulseaudio.internal.items,0,0,0,0,0,0,0,0
openhab_openhab2,org.openhab.binding.pulseaudio.internal,1,0,0,0,0,0,0,1
openhab_openhab2,org.openhab.binding.pushbullet.internal.action,0,0,0,0,0,0,0,0
openhab_openhab2,org.openhab.binding.pushbullet.internal.handler,0,0,0,0,0,0,0,0
openhab_openhab2,org.openhab.binding.pushbullet.internal.model,0,0,0,0,0,0,0,0
openhab_openhab2,org.openhab.binding.pushbullet.internal,0,0,0,0,0,0,0,0
openhab_openhab2,org.openhab.binding.regoheatpump.internal.handler,0,0,0,0,1,0,0,1
openhab_openhab2,org.openhab.binding.regoheatpump.internal.protocol,0,0,0,0,0,0,0,0
openhab_openhab2,org.openhab.binding.regoheatpump.internal.rego6xx,0,0,0,0,0,0,0,0
openhab_openhab2,org.openhab.binding.regoheatpump.internal,0,0,0,0,0,0,0,0
openhab_openhab2,org.openhab.binding.rfxcom.internal.config,0,0,0,0,0,0,0,0
openhab_openhab2,org.openhab.binding.rfxcom.internal.connector,0,0,0,0,1,0,0,1
openhab_openhab2,org.openhab.binding.rfxcom.internal,0,0,0,0,0,0,0,0
openhab_openhab2,org.openhab.binding.rfxcom.internal.discovery,0,0,0,0,0,0,0,0
openhab_openhab2,org.openhab.binding.rfxcom.internal.exceptions,0,0,0,0,0,0,0,0
openhab_openhab2,org.openhab.binding.rfxcom.internal.handler,0,0,0,0,0,0,0,0
openhab_openhab2,org.openhab.binding.rfxcom.internal.messages,0,0,0,1,0,0,0,1
openhab_openhab2,org.openhab.binding.rme.internal.handler,0,0,0,0,0,0,0,0
openhab_openhab2,org.openhab.binding.rme.internal,0,0,0,0,0,0,0,0
openhab_openhab2,org.openhab.binding.robonect.internal.config,0,0,0,0,0,0,0,0
openhab_openhab2,org.openhab.binding.robonect.internal.handler,0,0,0,0,0,0,0,0
openhab_openhab2,org.openhab.binding.robonect.internal.model.cmd,0,0,0,0,1,0,0,1
openhab_openhab2,org.openhab.binding.robonect.internal.model,0,0,0,0,1,0,0,1
openhab_openhab2,org.openhab.binding.robonect.internal,0,0,0,0,1,0,0,1
openhab_openhab2,org.openhab.binding.rotel.internal.communication,0,0,0,0,1,0,0,1
openhab_openhab2,org.openhab.binding.rotel.internal.configuration,0,0,0,0,0,0,0,0
openhab_openhab2,org.openhab.binding.rotel.internal.handler,0,0,0,0,0,0,0,0
openhab_openhab2,org.openhab.binding.rotel.internal,0,0,0,0,0,0,0,0
openhab_openhab2,org.openhab.binding.rotelra1x.internal,0,0,0,0,0,0,0,0
openhab_openhab2,org.openhab.binding.rotelra1x.internal.handler,0,0,0,0,0,0,0,0
openhab_openhab2,org.openhab.binding.russound.internal.discovery,0,0,0,0,0,0,0,0
openhab_openhab2,org.openhab.binding.russound.internal.net,0,0,0,0,1,0,0,1
openhab_openhab2,org.openhab.binding.russound.internal.rio,0,0,0,0,1,0,0,1
openhab_openhab2,org.openhab.binding.russound.internal.rio.controller,0,1,0,0,0,0,0,1
openhab_openhab2,org.openhab.binding.russound.internal.rio.models,0,0,0,0,0,0,0,0
openhab_openhab2,org.openhab.binding.russound.internal.rio.source,0,0,0,0,0,0,0,0
openhab_openhab2,org.openhab.binding.russound.internal.rio.system,0,0,0,0,0,0,0,0
openhab_openhab2,org.openhab.binding.russound.internal.rio.zone,0,0,0,0,0,0,0,0
openhab_openhab2,org.openhab.binding.russound.internal,0,0,0,0,0,0,0,0
openhab_openhab2,org.openhab.binding.samsungtv.internal.config,0,0,0,0,0,0,0,0
openhab_openhab2,org.openhab.binding.samsungtv.internal.discovery,0,0,0,0,0,0,0,0
openhab_openhab2,org.openhab.binding.samsungtv.internal.handler,0,0,0,0,0,0,0,0
openhab_openhab2,org.openhab.binding.samsungtv.internal.protocol,0,0,0,1,1,0,0,2
openhab_openhab2,org.openhab.binding.samsungtv.internal,0,0,0,0,0,0,0,0
openhab_openhab2,org.openhab.binding.samsungtv.internal.service.api,0,0,0,0,0,0,0,0
openhab_openhab2,org.openhab.binding.samsungtv.internal.service,0,0,0,0,1,0,0,1
openhab_openhab2,org.openhab.binding.satel.internal.command,0,0,0,0,1,0,0,1
openhab_openhab2,org.openhab.binding.satel.internal.config,0,0,0,0,0,0,0,0
openhab_openhab2,org.openhab.binding.satel.internal.discovery,0,0,0,0,0,0,0,0
openhab_openhab2,org.openhab.binding.satel.internal.event,0,0,0,0,1,0,0,1
openhab_openhab2,org.openhab.binding.satel.internal.handler,0,0,0,0,1,0,0,1
openhab_openhab2,org.openhab.binding.satel.internal.protocol,0,0,0,0,1,0,0,1
openhab_openhab2,org.openhab.binding.satel.internal,0,0,0,0,0,0,0,0
openhab_openhab2,org.openhab.binding.satel.internal.types,0,0,0,0,0,0,0,0
openhab_openhab2,org.openhab.binding.seneye.internal,0,0,0,0,1,0,0,1
openhab_openhab2,org.openhab.binding.seneye.internal.handler,0,0,0,0,0,0,0,0
openhab_openhab2,org.openhab.binding.sensebox.internal.config,0,0,0,0,0,0,0,0
openhab_openhab2,org.openhab.binding.sensebox.internal.handler,0,0,0,0,0,0,0,0
openhab_openhab2,org.openhab.binding.sensebox.internal.model,0,0,0,0,1,0,0,1
openhab_openhab2,org.openhab.binding.sensebox.internal,0,0,0,0,0,0,0,0
openhab_openhab2,org.openhab.binding.serialbutton.internal.handler,0,0,0,0,0,0,0,0
openhab_openhab2,org.openhab.binding.serialbutton.internal,0,0,0,0,0,0,0,0
openhab_openhab2,org.openhab.binding.siemensrds.internal,0,0,0,0,1,0,0,1
openhab_openhab2,org.openhab.binding.silvercrestwifisocket.internal.discovery,0,0,0,0,0,0,0,0
openhab_openhab2,org.openhab.binding.silvercrestwifisocket.internal.entities,0,0,0,0,0,0,0,0
openhab_openhab2,org.openhab.binding.silvercrestwifisocket.internal.exceptions,0,0,0,0,0,0,0,0
openhab_openhab2,org.openhab.binding.silvercrestwifisocket.internal.handler,0,0,0,0,0,0,0,0
openhab_openhab2,org.openhab.binding.silvercrestwifisocket.internal.runnable,0,0,0,0,0,0,0,0
openhab_openhab2,org.openhab.binding.silvercrestwifisocket.internal,0,0,0,0,0,0,0,0
openhab_openhab2,org.openhab.binding.silvercrestwifisocket.internal.utils,0,0,0,0,0,0,0,0
openhab_openhab2,org.openhab.binding.sinope.handler,0,0,0,0,0,0,0,0
openhab_openhab2,org.openhab.binding.sinope.internal.config,0,0,0,0,0,0,0,0
openhab_openhab2,org.openhab.binding.sinope.internal.core.appdata,0,0,0,0,0,0,0,0
openhab_openhab2,org.openhab.binding.sinope.internal.core.base,0,0,0,0,1,0,0,1
openhab_openhab2,org.openhab.binding.sinope.internal.core,0,0,0,0,1,0,0,1
openhab_openhab2,org.openhab.binding.sinope.internal.discovery,0,0,0,0,0,0,0,0
openhab_openhab2,org.openhab.binding.sinope.internal,0,0,0,0,0,0,0,0
openhab_openhab2,org.openhab.binding.sinope.internal.util,0,0,0,0,0,0,0,0
openhab_openhab2,org.openhab.binding.sinope,0,0,0,0,0,0,0,0
openhab_openhab2,org.openhab.binding.sleepiq.internal.config,0,0,0,0,0,0,0,0
openhab_openhab2,org.openhab.binding.sleepiq.internal.discovery,0,0,0,0,0,0,0,0
openhab_openhab2,org.openhab.binding.sleepiq.internal.handler,1,0,0,0,0,0,0,1
openhab_openhab2,org.openhab.binding.sleepiq.internal,1,1,0,0,0,0,0,2
openhab_openhab2,org.openhab.binding.smaenergymeter.internal.configuration,0,0,0,0,0,0,0,0
openhab_openhab2,org.openhab.binding.smaenergymeter.internal.discovery,0,0,0,0,0,0,0,0
openhab_openhab2,org.openhab.binding.smaenergymeter.internal.handler,0,0,0,0,0,0,0,0
openhab_openhab2,org.openhab.binding.smaenergymeter.internal,0,0,0,0,0,0,0,0
openhab_openhab2,org.openmuc.jrxtx,0,0,0,0,0,0,0,0
openhab_openhab2,org.openhab.binding.smartmeter.connectors,0,0,0,0,0,0,0,0
openhab_openhab2,org.openhab.binding.smartmeter.internal.conformity.negate,1,0,0,0,0,0,0,1
openhab_openhab2,org.openhab.binding.smartmeter.internal.iec62056,0,0,0,0,0,0,0,0
openhab_openhab2,org.openhab.binding.smartmeter.internal,2,0,0,0,1,0,0,3
openhab_openhab2,org.openhab.binding.smartmeter.internal.sml,1,0,0,0,0,0,0,1
openhab_openhab2,org.openhab.binding.smartmeter,3,1,0,0,0,0,0,4
openhab_openhab2,org.openhab.binding.snmp.internal.config,0,0,0,0,0,0,0,0
openhab_openhab2,org.openhab.binding.snmp.internal,0,0,0,0,1,0,0,1
openhab_openhab2,org.openhab.binding.solaredge.internal,0,0,0,0,0,0,0,0
openhab_openhab2,org.openhab.binding.solaredge.internal.callback,0,0,0,0,0,0,0,0
openhab_openhab2,org.openhab.binding.solaredge.internal.command,0,0,0,0,1,0,0,1
openhab_openhab2,org.openhab.binding.solaredge.internal.config,0,0,0,0,0,1,0,1
openhab_openhab2,org.openhab.binding.solaredge.internal.connector,0,0,0,0,0,1,0,1
openhab_openhab2,org.openhab.binding.solaredge.internal.handler,0,0,0,0,0,1,0,1
openhab_openhab2,org.openhab.binding.solaredge.internal.model,0,0,0,0,1,0,0,1
openhab_openhab2,org.openhab.binding.solarlog.internal.handler,0,0,0,0,0,0,0,0
openhab_openhab2,org.openhab.binding.solarlog.internal,0,0,0,0,0,0,0,0
openhab_openhab2,org.openhab.binding.somfytahoma.internal.config,0,0,0,0,0,0,0,0
openhab_openhab2,org.openhab.binding.somfytahoma.internal.discovery,0,0,0,0,0,0,0,0
openhab_openhab2,org.openhab.binding.somfytahoma.internal.handler,0,0,0,0,1,0,0,1
openhab_openhab2,org.openhab.binding.somfytahoma.internal.model,0,0,0,0,1,0,0,1
openhab_openhab2,org.openhab.binding.somfytahoma.internal,0,0,0,0,0,0,0,0
openhab_openhab2,org.openhab.binding.sonos.internal.config,0,0,0,0,0,0,0,0
openhab_openhab2,org.openhab.binding.sonos.internal.discovery,0,0,0,0,0,0,0,0
openhab_openhab2,org.openhab.binding.sonos.internal.handler,0,0,0,0,0,0,0,0
openhab_openhab2,org.openhab.binding.sonos.internal,0,0,0,0,1,0,0,1
openhab_openhab2,org.openhab.binding.sonyaudio.internal.discovery,0,0,0,0,0,0,0,0
openhab_openhab2,org.openhab.binding.sonyaudio.internal.handler,0,0,0,0,1,0,0,1
openhab_openhab2,org.openhab.binding.sonyaudio.internal.protocol,0,0,0,1,1,0,0,2
openhab_openhab2,org.openhab.binding.sonyaudio.internal,0,0,0,0,0,0,0,0
openhab_openhab2,org.openhab.binding.sonyprojector.internal.communication.sdcp,0,0,0,0,0,0,0,0
openhab_openhab2,org.openhab.binding.sonyprojector.internal.communication.serial,0,0,0,0,0,0,0,0
openhab_openhab2,org.openhab.binding.sonyprojector.internal.communication,0,0,0,0,0,0,0,0
openhab_openhab2,org.openhab.binding.sonyprojector.internal.configuration,0,0,0,0,0,0,0,0
openhab_openhab2,org.openhab.binding.sonyprojector.internal.handler,0,0,0,0,0,0,0,0
openhab_openhab2,org.openhab.binding.sonyprojector.internal,0,0,0,0,0,0,0,0
openhab_openhab2,org.openhab.binding.spotify.internal.api.exception,0,0,0,0,0,0,0,0
openhab_openhab2,org.openhab.binding.spotify.internal.api.model,0,0,0,0,1,0,0,1
openhab_openhab2,org.openhab.binding.spotify.internal.api,0,0,0,0,0,0,0,0
openhab_openhab2,org.openhab.binding.spotify.internal.discovery,0,0,0,0,0,0,0,0
openhab_openhab2,org.openhab.binding.spotify.internal.handler,0,0,0,0,1,0,0,1
openhab_openhab2,org.openhab.binding.spotify.internal,0,0,0,0,1,0,0,1
openhab_openhab2,org.openhab.binding.squeezebox.internal.config,0,0,0,0,0,0,0,0
openhab_openhab2,org.openhab.binding.squeezebox.internal.discovery,0,0,0,0,0,0,0,0
openhab_openhab2,org.openhab.binding.squeezebox.internal.handler,0,0,0,0,1,0,0,1
openhab_openhab2,org.openhab.binding.squeezebox.internal.model,0,0,0,0,0,0,0,0
openhab_openhab2,org.openhab.binding.squeezebox.internal,0,0,0,0,0,0,0,0
openhab_openhab2,org.openhab.binding.squeezebox.internal.utils,0,0,0,0,0,0,0,0
openhab_openhab2,org.openhab.binding.synopanalyser.internal.synop,0,0,0,0,0,0,0,0
openhab_openhab2,org.openhab.binding.synopanalyzer.internal.config,0,0,0,0,0,0,0,0
openhab_openhab2,org.openhab.binding.synopanalyzer.internal.handler,0,0,0,0,0,0,0,0
openhab_openhab2,org.openhab.binding.synopanalyzer.internal,0,0,0,0,0,0,0,0
openhab_openhab2,org.openhab.binding.systeminfo.internal.discovery,0,0,0,0,0,0,0,0
openhab_openhab2,org.openhab.binding.systeminfo.internal.handler,0,0,0,0,0,0,0,0
openhab_openhab2,org.openhab.binding.systeminfo.internal.model,0,0,0,0,0,0,0,0
openhab_openhab2,org.openhab.binding.systeminfo.internal,0,0,0,0,0,0,0,0
openhab_openhab2,org.openhab.binding.tado.internal.adapter,0,0,0,0,0,0,0,0
openhab_openhab2,org.openhab.binding.tado.internal.api,0,0,0,0,0,0,0,0
openhab_openhab2,org.openhab.binding.tado.internal.builder,0,0,0,0,1,0,0,1
openhab_openhab2,org.openhab.binding.tado.internal.config,0,0,0,0,0,0,0,0
openhab_openhab2,org.openhab.binding.tado.internal.discovery,0,0,0,0,0,0,0,0
openhab_openhab2,org.openhab.binding.tado.internal.handler,0,0,0,0,0,0,0,0
openhab_openhab2,org.openhab.binding.tado.internal,0,0,0,0,0,0,0,0
openhab_openhab2,org.openhab.binding.tankerkoenig.internal.config,0,0,0,0,1,0,0,1
openhab_openhab2,org.openhab.binding.tankerkoenig.internal.data,0,0,0,0,0,0,0,0
openhab_openhab2,org.openhab.binding.tankerkoenig.internal.handler,0,0,0,0,0,0,0,0
openhab_openhab2,org.openhab.binding.tankerkoenig.internal.serializer,0,0,0,0,0,0,0,0
openhab_openhab2,org.openhab.binding.tankerkoenig.internal,0,0,0,0,0,0,0,0
openhab_openhab2,org.openhab.binding.tellstick.internal.conf,0,0,0,0,0,0,0,0
openhab_openhab2,org.openhab.binding.tellstick.internal.core,0,0,0,0,0,0,0,0
openhab_openhab2,org.openhab.binding.tellstick.internal.discovery,0,0,0,0,0,0,0,0
openhab_openhab2,org.openhab.binding.tellstick.internal.handler,0,0,0,0,0,0,0,0
openhab_openhab2,org.openhab.binding.tellstick.internal.live,0,0,0,0,0,0,0,0
openhab_openhab2,org.openhab.binding.tellstick.internal.live.xml,0,0,0,0,1,0,0,1
openhab_openhab2,org.openhab.binding.tellstick.internal,0,0,0,0,0,0,0,0
openhab_openhab2,org.openhab.binding.tesla.internal.command,0,0,0,0,0,0,0,0
openhab_openhab2,org.openhab.binding.tesla.internal.handler,0,0,0,0,0,0,0,0
openhab_openhab2,org.openhab.binding.tesla.internal.protocol,0,0,0,0,1,0,0,1
openhab_openhab2,org.openhab.binding.tesla.internal,0,0,0,0,0,0,0,0
openhab_openhab2,org.openhab.binding.tesla.internal.throttler,0,0,0,0,1,0,0,1
openhab_openhab2,org.openhab.binding.toon.internal.api,0,0,0,0,1,0,0,1
openhab_openhab2,org.openhab.binding.toon.internal.config,0,0,0,0,0,0,0,0
openhab_openhab2,org.openhab.binding.toon.internal.discovery,0,0,0,0,0,0,0,0
openhab_openhab2,org.openhab.binding.toon.internal.handler,0,0,0,0,0,0,0,0
openhab_openhab2,org.openhab.binding.toon.internal,0,0,0,0,0,0,0,0
openhab_openhab2,org.openhab.binding.tplinksmarthome.internal,1,1,0,0,1,0,0,3
openhab_openhab2,org.openhab.binding.tplinksmarthome.internal.device,0,0,0,0,1,0,0,1
openhab_openhab2,org.openhab.binding.tplinksmarthome.internal.handler,1,0,0,0,0,0,0,1
openhab_openhab2,org.openhab.binding.tplinksmarthome.internal.model,0,0,0,1,1,0,0,2
openhab_openhab2,org.openhab.binding.tradfri.internal,0,0,0,0,1,0,0,1
openhab_openhab2,org.openhab.binding.tradfri.internal.config,0,0,0,0,0,0,0,0
openhab_openhab2,org.openhab.binding.tradfri.internal.discovery,0,0,0,0,0,0,0,0
openhab_openhab2,org.openhab.binding.tradfri.internal.handler,0,0,0,0,1,0,0,1
openhab_openhab2,org.openhab.binding.tradfri.internal.model,0,0,0,0,1,0,0,1
openhab_openhab2,org.openhab.binding.unifi.internal.api.cache,0,0,0,0,0,0,0,0
openhab_openhab2,org.openhab.binding.unifi.internal.api.model,0,0,0,0,1,0,0,1
openhab_openhab2,org.openhab.binding.unifi.internal.api,0,0,0,0,0,0,0,0
openhab_openhab2,org.openhab.binding.unifi.internal.api.util,0,0,0,0,1,0,0,1
openhab_openhab2,org.openhab.binding.unifi.internal.handler,1,0,0,0,0,0,0,1
openhab_openhab2,org.openhab.binding.unifi.internal.ssl,0,0,0,0,0,0,0,0
openhab_openhab2,org.openhab.binding.unifi.internal,1,1,0,0,0,0,0,2
openhab_openhab2,org.openhab.binding.urtsi.internal.config,0,0,0,0,0,0,0,0
openhab_openhab2,org.openhab.binding.urtsi.internal.handler,0,0,0,0,0,0,0,0
openhab_openhab2,org.openhab.binding.urtsi.internal.mapping,0,0,0,0,0,0,0,0
openhab_openhab2,org.openhab.binding.urtsi.internal,0,0,0,0,0,0,0,0
openhab_openhab2,org.openhab.binding.valloxmv.internal,0,0,0,0,1,0,0,1
openhab_openhab2,org.openhab.binding.vektiva.internal.config,0,0,0,0,0,0,0,0
openhab_openhab2,org.openhab.binding.vektiva.internal.handler,0,0,0,0,0,0,0,0
openhab_openhab2,org.openhab.binding.vektiva.internal.net,0,0,0,0,0,0,0,0
openhab_openhab2,org.openhab.binding.vektiva.internal,0,0,0,0,0,0,0,0
openhab_openhab2,org.openhab.binding.velbus.internal.discovery,0,0,0,0,0,0,0,0
openhab_openhab2,org.openhab.binding.velbus.internal.handler,1,0,0,0,1,0,0,2
openhab_openhab2,org.openhab.binding.velbus.internal.packets,2,1,0,0,0,0,0,3
openhab_openhab2,org.openhab.binding.velbus.internal,2,0,0,0,1,0,0,3
openhab_openhab2,org.openhab.binding.vitotronic.internal.discovery,0,0,0,0,0,0,0,0
openhab_openhab2,org.openhab.binding.vitotronic.internal.handler,0,0,0,0,0,0,0,0
openhab_openhab2,org.openhab.binding.vitotronic.internal,0,0,0,0,0,0,0,0
openhab_openhab2,org.openhab.binding.volvooncall.internal.action,0,0,0,0,0,0,0,0
openhab_openhab2,org.openhab.binding.volvooncall.internal.config,0,0,0,0,0,0,0,0
openhab_openhab2,org.openhab.binding.volvooncall.internal.discovery,0,0,0,0,0,0,0,0
openhab_openhab2,org.openhab.binding.volvooncall.internal.dto,0,0,0,0,1,0,0,1
openhab_openhab2,org.openhab.binding.volvooncall.internal.handler,0,0,0,0,0,0,0,0
openhab_openhab2,org.openhab.binding.volvooncall.internal,0,0,0,0,0,0,0,0
openhab_openhab2,org.openhab.binding.volvooncall.internal.wrapper,0,0,0,0,0,0,0,0
openhab_openhab2,org.openhab.binding.weatherunderground.internal.config,0,0,0,0,0,0,0,0
openhab_openhab2,org.openhab.binding.weatherunderground.internal.discovery,0,0,0,0,0,0,0,0
openhab_openhab2,org.openhab.binding.weatherunderground.internal.handler,0,0,0,0,0,0,0,0
openhab_openhab2,org.openhab.binding.weatherunderground.internal.json,0,0,0,0,1,0,0,1
openhab_openhab2,org.openhab.binding.weatherunderground.internal,0,0,0,0,0,0,0,0
openhab_openhab2,org.openhab.binding.wemo.internal.discovery,0,0,0,0,0,0,0,0
openhab_openhab2,org.openhab.binding.wemo.internal.handler,0,0,0,0,1,0,0,1
openhab_openhab2,org.openhab.binding.wemo.internal.http,0,0,0,0,0,0,0,0
openhab_openhab2,org.openhab.binding.wemo.internal,0,0,0,0,0,0,0,0
openhab_openhab2,org.openhab.binding.wifiled.internal.configuration,0,0,0,0,0,0,0,0
openhab_openhab2,org.openhab.binding.wifiled.internal.discovery,0,0,0,0,0,0,0,0
openhab_openhab2,org.openhab.binding.wifiled.internal.handler,0,0,0,0,1,0,0,1
openhab_openhab2,org.openhab.binding.wifiled.internal,0,0,0,0,0,0,0,0
openhab_openhab2,org.openhab.binding.wifiled.discovery,0,0,0,0,0,0,0,0
openhab_openhab2,org.openhab.binding.wifiled.handler,0,0,0,0,0,0,0,0
openhab_openhab2,org.openhab.binding.windcentrale.internal.config,0,0,0,0,0,0,0,0
openhab_openhab2,org.openhab.binding.windcentrale.internal.handler,0,0,0,0,0,0,0,0
openhab_openhab2,org.openhab.binding.windcentrale.internal,0,0,0,0,0,0,0,0
openhab_openhab2,org.openhab.binding.xmltv.internal.configuration,0,0,0,0,0,0,0,0
openhab_openhab2,org.openhab.binding.xmltv.internal.discovery,0,0,0,0,0,0,0,0
openhab_openhab2,org.openhab.binding.xmltv.internal.handler,0,0,0,0,0,0,0,0
openhab_openhab2,org.openhab.binding.xmltv.internal.jaxb,0,0,0,0,0,0,0,0
openhab_openhab2,org.openhab.binding.xmltv.internal,0,0,0,0,0,0,0,0
openhab_openhab2,org.openhab.binding.xmppclient.action,0,0,0,0,0,0,0,0
openhab_openhab2,org.openhab.binding.xmppclient.handler,0,0,0,0,0,0,0,0
openhab_openhab2,org.openhab.binding.xmppclient.internal,0,0,0,0,0,0,0,0
openhab_openhab2,org.openhab.binding.xmppclient,0,0,0,0,0,0,0,0
openhab_openhab2,org.openhab.binding.yamahareceiver.internal,4,0,0,0,1,0,0,5
openhab_openhab2,org.openhab.binding.yamahareceiver.internal.config,2,1,0,0,0,0,0,3
openhab_openhab2,org.openhab.binding.yamahareceiver.internal.discovery,0,0,0,0,0,0,0,0
openhab_openhab2,org.openhab.binding.yamahareceiver.internal.handler,0,0,0,0,0,0,0,0
openhab_openhab2,org.openhab.binding.yamahareceiver.internal.protocol,1,1,0,0,1,0,0,3
openhab_openhab2,org.openhab.binding.yamahareceiver.internal.protocol.xml,4,0,0,1,1,0,0,6
openhab_openhab2,org.openhab.binding.yamahareceiver.internal.state,4,1,0,0,1,0,0,6
openhab_openhab2,org.openhab.binding.yeelight.internal.discovery,0,0,0,0,0,0,0,0
openhab_openhab2,org.openhab.binding.yeelight.internal.handler,0,0,0,0,0,0,0,0
openhab_openhab2,org.openhab.binding.yeelight.internal.lib,0,0,0,0,0,0,0,0
openhab_openhab2,org.openhab.binding.yeelight.internal.lib.device,0,0,0,0,0,0,0,0
openhab_openhab2,org.openhab.binding.yeelight.internal.lib.device.connection,0,0,0,0,0,0,0,0
openhab_openhab2,org.openhab.binding.yeelight.internal.lib.listeners,0,0,0,0,0,0,0,0
openhab_openhab2,org.openhab.binding.yeelight.internal.lib.services,0,0,0,0,0,0,0,0
openhab_openhab2,org.openhab.binding.yeelight.internal,0,0,0,0,0,0,0,0
openhab_openhab2,org.openhab.binding.zoneminder.internal.config,1,0,0,0,0,0,0,1
openhab_openhab2,org.openhab.binding.zoneminder.internal,2,1,0,0,0,0,0,3
openhab_openhab2,org.openhab.binding.zoneminder.internal.discovery,0,0,0,0,0,0,0,0
openhab_openhab2,org.openhab.binding.zoneminder.internal.handler,2,0,0,0,0,0,0,2
openhab_openhab2,org.openhab.binding.zway.internal.config,0,0,0,0,0,0,0,0
openhab_openhab2,org.openhab.binding.zway.internal.converter,0,0,0,0,0,0,0,0
openhab_openhab2,org.openhab.binding.zway.internal.discovery,0,0,0,0,0,0,0,0
openhab_openhab2,org.openhab.binding.zway.internal.handler,1,0,0,0,1,0,0,2
openhab_openhab2,org.openhab.binding.zway.internal,1,1,0,0,0,0,0,2
openhab_openhab2,org.openhab.extensionservice.marketplace.internal,0,0,0,0,0,0,0,0
openhab_openhab2,org.openhab.extensionservice.marketplace.internal.model,0,0,0,0,0,0,0,0
openhab_openhab2,org.openhab.extensionservice.marketplace,0,0,0,0,0,0,0,0
openhab_openhab2,org.openhab.extensionservice.marketplace.automation.internal,0,0,0,0,0,0,0,0
openhab_openhab2,org.openhab.io.internal.azureiothub,0,0,0,0,0,0,0,0
openhab_openhab2,org.openhab.io.homekit,0,0,0,0,0,0,0,0
openhab_openhab2,org.openhab.io.homekit.internal.accessories,0,0,0,0,1,0,0,1
openhab_openhab2,org.openhab.io.homekit.internal.battery,0,0,0,0,0,0,0,0
openhab_openhab2,org.openhab.io.homekit.internal,0,0,0,0,1,0,0,1
openhab_openhab2,org.glassfish.jersey.servlet.init,0,0,0,0,0,0,0,0
openhab_openhab2,org.openhab.io.hueemulation.internal.automation,0,0,0,0,1,0,0,1
openhab_openhab2,org.openhab.io.hueemulation.internal.automation.dto,0,0,0,0,0,0,0,0
openhab_openhab2,org.openhab.io.hueemulation.internal,1,0,0,0,1,0,0,2
openhab_openhab2,org.openhab.io.hueemulation.internal.dto,1,1,0,1,1,0,0,4
openhab_openhab2,org.openhab.io.hueemulation.internal.dto.changerequest,0,0,0,0,1,0,0,1
openhab_openhab2,org.openhab.io.hueemulation.internal.dto.response,0,0,0,0,1,0,0,1
openhab_openhab2,org.openhab.io.hueemulation.internal.rest,0,0,0,0,1,0,0,1
openhab_openhab2,org.openhab.io.hueemulation.internal.upnp,0,0,0,0,0,0,0,0
openhab_openhab2,org.openhab.io.hueemulation.internal.rest.mocks,0,0,0,0,0,0,0,0
openhab_openhab2,org.openhab.io.imperihome.internal.action,0,0,0,0,1,0,0,1
openhab_openhab2,org.openhab.io.imperihome.internal.handler,0,0,0,0,0,0,0,0
openhab_openhab2,org.openhab.io.imperihome.internal,0,0,0,0,0,0,0,0
openhab_openhab2,org.openhab.io.imperihome.internal.io,0,0,0,0,0,0,0,0
openhab_openhab2,org.openhab.io.imperihome.internal.model.device,0,0,0,0,1,0,0,1
openhab_openhab2,org.openhab.io.imperihome.internal.model,0,0,0,0,0,0,0,0
openhab_openhab2,org.openhab.io.imperihome.internal.model.param,0,0,0,0,0,0,0,0
openhab_openhab2,org.openhab.io.imperihome.internal.processor,0,0,0,0,0,0,0,0
openhab_openhab2,org.openhab.io.imperihome.internal.util,0,0,0,0,0,0,0,0
openhab_openhab2,org.openhab.io.javasound.internal,0,0,0,0,0,0,0,0
openhab_openhab2,org.openhab.io.mqttembeddedbroker,0,0,0,0,0,0,0,0
openhab_openhab2,org.openhab.io.mqttembeddedbroker.internal,0,0,0,0,1,0,0,1
openhab_openhab2,org.openhab.io.neeo.internal,1,0,0,0,1,0,0,2
openhab_openhab2,org.openhab.io.neeo.internal.discovery,0,0,0,0,0,0,0,0
openhab_openhab2,org.openhab.io.neeo.internal.models,1,1,0,0,1,0,0,3
openhab_openhab2,org.openhab.io.neeo.internal.net,0,0,0,0,0,0,0,0
openhab_openhab2,org.openhab.io.neeo.internal.serialization,0,0,0,0,1,0,0,1
openhab_openhab2,org.openhab.io.neeo.internal.servletservices,0,0,0,0,1,0,0,1
openhab_openhab2,org.openhab.io.neeo.internal.servletservices.models,0,0,0,0,0,0,0,0
openhab_openhab2,org.openhab.io.neeo,0,0,0,0,0,0,0,0
openhab_openhab2,org.openhab.io.openhabcloud.internal,0,0,0,0,0,0,0,0
openhab_openhab2,org.openhab.io.openhabcloud,0,0,0,0,0,0,0,0
openhab_openhab2,org.openhab.io.transport.modbus,0,0,0,1,1,0,0,2
openhab_openhab2,org.openhab.io.transport.modbus.endpoint,0,0,0,0,1,0,0,1
openhab_openhab2,org.openhab.io.transport.modbus.internal,0,0,0,0,1,0,0,1
openhab_openhab2,org.openhab.io.transport.modbus.internal.pooling,0,0,0,0,0,0,0,0
openhab_openhab2,org.openhab.io.transport.modbus.json,0,0,0,0,0,0,0,0
openhab_openhab2,org.openhab.io.webaudio.internal,0,0,0,0,0,0,0,0
openhab_openhab2,org.openhab.persistence.mapdb.internal,0,0,0,0,0,0,0,0
openhab_openhab2,org.openhab.persistence.mapdb,0,0,0,0,0,0,0,0
openhab_openhab2,org.openhab.transform.bin2json.internal,0,0,0,0,0,0,0,0
openhab_openhab2,org.openhab.transform.exec.internal,0,0,0,0,0,0,0,0
openhab_openhab2,org.openhab.transform.exec.internal.profiles,0,0,0,0,0,0,0,0
openhab_openhab2,org.openhab.transform.javascript.internal,0,0,0,0,0,0,0,0
openhab_openhab2,org.openhab.transform.javascript.internal.profiles,0,0,0,0,0,0,0,0
openhab_openhab2,org.openhab.transform.jinja.internal,0,0,0,0,0,0,0,0
openhab_openhab2,org.openhab.transform.jinja.internal.profiles,0,0,0,0,0,0,0,0
openhab_openhab2,org.openhab.transform.jsonpath.internal,0,0,0,0,0,0,0,0
openhab_openhab2,org.openhab.transform.jsonpath.internal.profiles,0,0,0,0,0,0,0,0
openhab_openhab2,org.openhab.transform.map.internal,0,0,0,0,0,0,0,0
openhab_openhab2,org.openhab.transform.map.internal.profiles,0,0,0,0,0,0,0,0
openhab_openhab2,org.openhab.transform.regex.internal.profiles,0,0,0,0,0,0,0,0
openhab_openhab2,org.openhab.transform.regex.internal,0,0,0,0,0,0,0,0
openhab_openhab2,org.openhab.transform.scale.internal.profiles,0,0,0,0,0,0,0,0
openhab_openhab2,org.openhab.transform.scale.internal,0,0,0,0,0,0,0,0
openhab_openhab2,org.openhab.transform.xpath.internal.profiles,0,0,0,0,0,0,0,0
openhab_openhab2,org.openhab.transform.xpath.internal,0,0,0,0,0,0,0,0
openhab_openhab2,org.openhab.transform.xslt.internal.profiles,0,0,0,0,0,0,0,0
openhab_openhab2,org.openhab.transform.xslt.internal,0,0,0,0,0,0,0,0
openhab_openhab2,org.openhab.voice.googletts.internal,0,0,0,0,0,0,0,0
openhab_openhab2,org.openhab.voice.googletts.internal.protocol,0,0,0,0,1,0,0,1
openhab_openhab2,org.openhab.voice.mactts.internal,0,0,0,0,0,0,0,0
openhab_openhab2,org.openhab.voice.marytts.internal,0,0,0,0,0,0,0,0
openhab_openhab2,org.openhab.voice.picotts.internal,0,0,0,0,0,0,0,0
openhab_openhab2,org.openhab.voice.pollytts.internal.cloudapi,0,0,0,0,0,0,0,0
openhab_openhab2,org.openhab.voice.pollytts.internal,0,0,0,0,0,0,0,0
openhab_openhab2,org.openhab.voice.voicerss.internal.cloudapi,0,0,0,0,0,0,0,0
openhab_openhab2,org.openhab.voice.voicerss.internal,0,0,0,0,0,0,0,0
openhab_openhab2,org.openhab.voice.voicerss.tool,0,0,0,0,0,0,0,0
openhab_openhab2,org.openhab.binding.nest.handler,0,0,0,0,1,0,0,1
openhab_openhab2,org.openhab.binding.ntp.server,0,0,0,0,0,0,0,0
OpenHFT_Chronicle-Bytes,net.openhft.chronicle.bytes.microbenchmarks,0,0,0,0,0,0,0,0
OpenHFT_Chronicle-Bytes,net.openhft.chronicle.bytes,3,1,0,1,1,0,0,6
OpenHFT_Chronicle-Bytes,net.openhft.chronicle.bytes.algo,2,0,0,0,0,0,0,2
OpenHFT_Chronicle-Bytes,net.openhft.chronicle.bytes.pool,0,0,0,0,0,0,0,0
OpenHFT_Chronicle-Bytes,net.openhft.chronicle.bytes.ref,0,0,0,0,1,0,0,1
OpenHFT_Chronicle-Bytes,net.openhft.chronicle.bytes.util,2,0,0,0,1,0,0,3
OpenHFT_Chronicle-Bytes,net.openhft.chronicle.bytes.jitter,0,0,0,0,0,0,0,0
OpenHFT_Chronicle-Bytes,net.openhft.chronicle.bytes.readme,0,0,0,0,1,0,0,1
OpenHFT_Chronicle-Core,net.openhft.chronicle.core.benchmark,0,0,0,0,0,0,0,0
OpenHFT_Chronicle-Core,java.lang,0,0,0,0,0,0,0,0
OpenHFT_Chronicle-Core,java.nio,0,0,0,0,0,0,0,0
OpenHFT_Chronicle-Core,net.openhft.chronicle.bytes,0,0,0,0,0,0,0,0
OpenHFT_Chronicle-Core,net.openhft.chronicle.core,0,0,0,0,1,0,0,1
OpenHFT_Chronicle-Core,net.openhft.chronicle.core.cleaner,0,0,0,0,0,0,0,0
OpenHFT_Chronicle-Core,net.openhft.chronicle.core.cleaner.impl.jdk8,0,0,0,0,0,0,0,0
OpenHFT_Chronicle-Core,net.openhft.chronicle.core.cleaner.impl.reflect,0,0,0,0,0,0,0,0
OpenHFT_Chronicle-Core,net.openhft.chronicle.core.cleaner.spi,0,0,0,0,0,0,0,0
OpenHFT_Chronicle-Core,net.openhft.chronicle.core.cooler,1,0,0,0,0,0,0,1
OpenHFT_Chronicle-Core,net.openhft.chronicle.core.io,1,1,0,0,1,0,0,3
OpenHFT_Chronicle-Core,net.openhft.chronicle.core.jlbh,0,0,0,0,1,0,0,1
OpenHFT_Chronicle-Core,net.openhft.chronicle.core.onoes,0,0,0,0,1,0,0,1
OpenHFT_Chronicle-Core,net.openhft.chronicle.core.pool,0,0,0,0,1,0,0,1
OpenHFT_Chronicle-Core,net.openhft.chronicle.core.tcp,0,0,0,0,0,0,0,0
OpenHFT_Chronicle-Core,net.openhft.chronicle.core.threads,0,0,0,0,1,0,0,1
OpenHFT_Chronicle-Core,net.openhft.chronicle.core.time,0,0,0,0,1,0,0,1
OpenHFT_Chronicle-Core,net.openhft.chronicle.core.util,1,0,0,1,1,0,0,3
OpenHFT_Chronicle-Core,net.openhft.chronicle.core.values,0,0,0,0,1,0,0,1
OpenHFT_Chronicle-Core,net.openhft.chronicle.core.watcher,0,0,0,0,0,0,0,0
OpenHFT_Chronicle-Core,net.openhft.chronicle.core.jitter,0,0,0,0,0,0,0,0
OpenHFT_Chronicle-Map,net.openhft.chronicle.hash,0,0,0,0,1,1,0,2
OpenHFT_Chronicle-Map,net.openhft.chronicle.hash.impl,2,0,0,0,1,0,0,3
OpenHFT_Chronicle-Map,net.openhft.chronicle.hash.impl.stage.data.bytes,0,0,0,0,0,0,0,0
OpenHFT_Chronicle-Map,net.openhft.chronicle.hash.impl.stage.entry,0,0,0,0,1,0,0,1
OpenHFT_Chronicle-Map,net.openhft.chronicle.hash.impl.stage.hash,0,0,0,0,1,0,0,1
OpenHFT_Chronicle-Map,net.openhft.chronicle.hash.impl.stage.iter,0,0,0,0,1,0,0,1
OpenHFT_Chronicle-Map,net.openhft.chronicle.hash.impl.stage.query,0,0,0,0,1,0,0,1
OpenHFT_Chronicle-Map,net.openhft.chronicle.hash.impl.stage.replication,0,0,0,0,0,0,0,0
OpenHFT_Chronicle-Map,net.openhft.chronicle.hash.impl.util,0,0,0,0,1,0,0,1
OpenHFT_Chronicle-Map,net.openhft.chronicle.hash.impl.util.jna,0,0,0,0,0,0,0,0
OpenHFT_Chronicle-Map,net.openhft.chronicle.hash.impl.util.math,0,0,0,0,0,0,0,0
OpenHFT_Chronicle-Map,net.openhft.chronicle.hash.locks,0,0,0,0,0,1,0,1
OpenHFT_Chronicle-Map,net.openhft.chronicle.hash.replication,0,0,0,0,0,2,0,2
OpenHFT_Chronicle-Map,net.openhft.chronicle.hash.serialization,5,1,0,0,1,0,0,7
OpenHFT_Chronicle-Map,net.openhft.chronicle.hash.serialization.impl,6,1,0,1,1,0,0,9
OpenHFT_Chronicle-Map,net.openhft.chronicle.map,7,1,0,1,1,2,0,12
OpenHFT_Chronicle-Map,net.openhft.chronicle.map.impl,4,0,0,1,1,0,0,6
OpenHFT_Chronicle-Map,net.openhft.chronicle.map.impl.ret,0,0,0,0,0,0,0,0
OpenHFT_Chronicle-Map,net.openhft.chronicle.map.impl.stage.data.bytes,0,0,0,0,0,0,0,0
OpenHFT_Chronicle-Map,net.openhft.chronicle.map.impl.stage.data,0,0,0,0,0,0,0,0
OpenHFT_Chronicle-Map,net.openhft.chronicle.map.impl.stage.data.instance,0,0,0,0,0,0,0,0
OpenHFT_Chronicle-Map,net.openhft.chronicle.map.impl.stage.entry,0,0,0,0,0,0,0,0
OpenHFT_Chronicle-Map,net.openhft.chronicle.map.impl.stage.input,0,0,0,0,0,0,0,0
OpenHFT_Chronicle-Map,net.openhft.chronicle.map.impl.stage.iter,0,0,0,0,1,0,0,1
OpenHFT_Chronicle-Map,net.openhft.chronicle.map.impl.stage.map,0,0,0,0,1,0,0,1
OpenHFT_Chronicle-Map,net.openhft.chronicle.map.impl.stage.query,0,0,0,0,1,0,0,1
OpenHFT_Chronicle-Map,net.openhft.chronicle.map.impl.stage.replication,0,0,0,0,0,0,0,0
OpenHFT_Chronicle-Map,net.openhft.chronicle.map.impl.stage.ret,0,0,0,0,0,0,0,0
OpenHFT_Chronicle-Map,net.openhft.chronicle.map.replication,0,0,0,0,0,1,0,1
OpenHFT_Chronicle-Map,net.openhft.chronicle.set,0,1,0,0,1,1,0,3
OpenHFT_Chronicle-Map,net.openhft.chronicle.set.replication,0,0,0,0,0,1,0,1
OpenHFT_Chronicle-Map,net.openhft.xstream.converters,0,0,0,0,1,0,0,1
OpenHFT_Chronicle-Map,eg,0,0,0,0,1,0,0,1
OpenHFT_Chronicle-Map,examples.portfolio,0,0,0,0,0,0,0,0
OpenHFT_Chronicle-Map,net.openhft.chronicle.map.example,0,0,0,0,1,0,0,1
OpenHFT_Chronicle-Map,net.openhft.chronicle.map.externalizable,0,0,0,0,0,0,0,0
OpenHFT_Chronicle-Map,net.openhft.chronicle.map.fromdocs,1,1,0,0,1,0,0,3
OpenHFT_Chronicle-Map,net.openhft.chronicle.map.fromdocs.pingpong_latency,0,0,0,0,0,0,0,0
OpenHFT_Chronicle-Map,net.openhft.chronicle.map.ipc,0,0,0,0,0,0,0,0
OpenHFT_Chronicle-Map,net.openhft.chronicle.map.jsr166,0,0,0,1,1,0,0,2
OpenHFT_Chronicle-Map,net.openhft.chronicle.map.jsr166.map,0,0,0,0,1,0,0,1
OpenHFT_Chronicle-Map,net.openhft.chronicle.map.perf,0,0,0,0,0,0,0,0
OpenHFT_Chronicle-Map,net.openhft.chronicle.map.utility,0,0,0,0,0,0,0,0
OpenHFT_Chronicle-Map,net.openhft.chronicle.map.watcher,0,0,0,0,0,0,0,0
OpenHFT_Chronicle-Map,net.openhft.lang.values,0,0,0,0,0,0,0,0
OpenHFT_Chronicle-Queue,net.openhft.chronicle.queue.benchmark,0,0,0,0,0,0,0,0
OpenHFT_Chronicle-Queue,net.openhft.chronicle.engine.client.internal,0,0,0,0,1,0,0,1
OpenHFT_Chronicle-Queue,net.openhft.chronicle.queue,9,1,0,1,1,0,0,12
OpenHFT_Chronicle-Queue,net.openhft.chronicle.queue.impl,7,0,0,0,1,0,0,8
OpenHFT_Chronicle-Queue,net.openhft.chronicle.queue.impl.ringbuffer,4,1,0,0,0,0,0,5
OpenHFT_Chronicle-Queue,net.openhft.chronicle.queue.stateless.bytes,0,0,0,0,0,0,0,0
OpenHFT_Chronicle-Queue,net.openhft.chronicle.queue.stateless,0,0,0,0,0,0,0,0
OpenHFT_Chronicle-Queue,net.openhft.chronicle.sandbox.replay,0,0,0,0,1,0,0,1
OpenHFT_Chronicle-Queue,simple,0,0,0,0,0,0,0,0
OpenHFT_Chronicle-Queue,net.openhft.chronicle.sandbox.attic,0,0,0,0,0,0,0,0
OpenHFT_Chronicle-Queue,net.openhft.chronicle.osgi,0,0,0,0,0,0,0,0
OpenHFT_Chronicle-Queue,net.openhft.load.config,0,0,0,0,0,0,0,0
OpenHFT_Chronicle-Queue,net.openhft.load,0,0,0,0,1,0,0,1
OpenHFT_Chronicle-Queue,net.openhft.load.messages,0,0,0,0,0,0,0,0
OpenHFT_Chronicle-Queue,net.openhft.chronicle.queue.backed.map,0,0,0,0,0,0,0,0
OpenHFT_Chronicle-Queue,net.openhft.chronicle.queue.batch,0,0,0,0,0,0,0,0
OpenHFT_Chronicle-Queue,net.openhft.chronicle.queue.impl.single,10,1,0,1,1,0,0,13
OpenHFT_Chronicle-Queue,net.openhft.chronicle.queue.impl.table,0,0,0,0,0,0,0,0
OpenHFT_Chronicle-Queue,net.openhft.chronicle.queue.jitter,0,0,0,0,0,0,0,0
OpenHFT_Chronicle-Queue,net.openhft.chronicle.queue.reader,0,0,0,0,1,0,0,1
OpenHFT_Chronicle-Queue,net.openhft.chronicle.queue.service,4,0,0,0,1,0,0,5
OpenHFT_Chronicle-Queue,net.openhft.chronicle.queue.util,0,0,0,0,0,0,0,0
OpenHFT_Chronicle-Queue,net.openhft.chronicle.queue.bench,0,0,0,0,1,0,0,1
OpenHFT_Chronicle-Queue,net.openhft.chronicle.queue.cleanup,0,0,0,0,0,0,0,0
OpenHFT_Chronicle-Queue,net.openhft.chronicle.queue.harness,0,0,0,0,0,0,0,0
OpenHFT_Chronicle-Queue,net.openhft.chronicle.queue.impl.single.jira,0,0,0,0,0,0,0,0
OpenHFT_Chronicle-Queue,net.openhft.chronicle.queue.impl.single.pretoucher,0,0,0,0,1,0,0,1
OpenHFT_Chronicle-Queue,net.openhft.chronicle.queue.micros,3,0,0,0,0,0,0,3
OpenHFT_Chronicle-Queue,net.openhft.chronicle.queue.watcher,0,0,0,0,0,0,0,0
OpenHFT_Chronicle-Wire,baseline,0,0,0,0,1,0,0,1
OpenHFT_Chronicle-Wire,net.openhft.chronicle.wire.benchmarks.bytes,0,0,0,0,0,0,0,0
OpenHFT_Chronicle-Wire,net.openhft.chronicle.wire.benchmarks,1,1,0,0,0,0,0,2
OpenHFT_Chronicle-Wire,net.openhft.chronicle.wire.benchmarks.sbe,1,0,0,0,0,0,0,1
OpenHFT_Chronicle-Wire,net.openhft.chronicle.wire,1,1,0,2,1,0,0,5
OpenHFT_Chronicle-Wire,net.openhft.chronicle,0,0,0,0,0,0,0,0
OpenHFT_Chronicle-Wire,net.openhft.chronicle.wire.bytesmarshallable,0,0,0,0,0,0,0,0
OpenHFT_Chronicle-Wire,net.openhft.chronicle.wire.compact,0,0,0,0,0,0,0,0
OpenHFT_Chronicle-Wire,net.openhft.chronicle.wire.map,0,0,0,0,0,0,0,0
OpenHFT_Chronicle-Wire,net.openhft.chronicle.wire.marshallable,0,0,0,0,1,0,0,1
OpenHFT_Chronicle-Wire,net.openhft.chronicle.wire.monitoring,1,0,0,0,0,0,0,1
OpenHFT_Chronicle-Wire,net.openhft.chronicle.wire.reordered,0,0,0,0,0,0,0,0
OpenHFT_Chronicle-Wire,net.openhft.chronicle.wire.reuse,0,0,0,0,1,0,0,1
OpenHFT_Chronicle-Wire,net.openhft.chronicle.wire.serializable,0,0,0,0,0,0,0,0
OpenHFT_Chronicle-Wire,net.openhft.chronicle.wire.type.conversions.binary,0,0,0,0,0,0,0,0
OPENNETWORKINGLAB_OpenVirteX,net.onrc.openvirtex.api,0,0,0,0,0,0,1,1
OPENNETWORKINGLAB_OpenVirteX,net.onrc.openvirtex.api.server,0,0,0,0,0,0,1,1
OPENNETWORKINGLAB_OpenVirteX,net.onrc.openvirtex.api.service,0,0,0,0,0,0,1,1
OPENNETWORKINGLAB_OpenVirteX,net.onrc.openvirtex.api.service.handlers,12,1,0,0,0,0,1,14
OPENNETWORKINGLAB_OpenVirteX,net.onrc.openvirtex.api.service.handlers.monitoring,0,0,0,0,1,0,1,2
OPENNETWORKINGLAB_OpenVirteX,net.onrc.openvirtex.api.service.handlers.tenant,0,0,0,0,1,0,1,2
OPENNETWORKINGLAB_OpenVirteX,net.onrc.openvirtex.core.cmd,1,1,0,0,0,0,1,3
OPENNETWORKINGLAB_OpenVirteX,net.onrc.openvirtex.core.io,0,0,0,0,1,0,1,2
OPENNETWORKINGLAB_OpenVirteX,net.onrc.openvirtex.core,11,1,0,0,0,0,1,13
OPENNETWORKINGLAB_OpenVirteX,net.onrc.openvirtex.db,21,1,0,0,0,0,1,23
OPENNETWORKINGLAB_OpenVirteX,net.onrc.openvirtex.elements.address,5,0,0,0,0,0,1,6
OPENNETWORKINGLAB_OpenVirteX,net.onrc.openvirtex.elements.datapath,6,0,0,0,1,1,1,9
OPENNETWORKINGLAB_OpenVirteX,net.onrc.openvirtex.elements.datapath.role,0,0,0,0,0,0,1,1
OPENNETWORKINGLAB_OpenVirteX,net.onrc.openvirtex.elements.datapath.statistics,0,0,0,0,0,0,1,1
OPENNETWORKINGLAB_OpenVirteX,net.onrc.openvirtex.elements.host,3,0,0,0,0,0,1,4
OPENNETWORKINGLAB_OpenVirteX,net.onrc.openvirtex.elements.link,5,0,0,0,0,1,1,7
OPENNETWORKINGLAB_OpenVirteX,net.onrc.openvirtex.elements,0,0,0,0,0,0,1,1
OPENNETWORKINGLAB_OpenVirteX,net.onrc.openvirtex.elements.network,15,1,0,0,0,0,1,17
OPENNETWORKINGLAB_OpenVirteX,net.onrc.openvirtex.elements.port,3,1,0,0,1,1,1,7
OPENNETWORKINGLAB_OpenVirteX,net.onrc.openvirtex.exceptions,0,0,0,1,1,0,1,3
OPENNETWORKINGLAB_OpenVirteX,net.onrc.openvirtex.linkdiscovery,0,0,0,0,0,0,1,1
OPENNETWORKINGLAB_OpenVirteX,net.onrc.openvirtex.messages.actions,2,0,0,0,1,0,1,4
OPENNETWORKINGLAB_OpenVirteX,net.onrc.openvirtex.messages,5,1,0,0,1,0,1,8
OPENNETWORKINGLAB_OpenVirteX,net.onrc.openvirtex.messages.statistics,0,0,0,0,1,0,1,2
OPENNETWORKINGLAB_OpenVirteX,net.onrc.openvirtex.packet,2,1,0,0,0,0,1,4
OPENNETWORKINGLAB_OpenVirteX,net.onrc.openvirtex.protocol,0,0,0,0,0,0,1,1
OPENNETWORKINGLAB_OpenVirteX,net.onrc.openvirtex.routing,4,0,0,0,1,0,1,6
OPENNETWORKINGLAB_OpenVirteX,net.onrc.openvirtex.util,1,0,0,0,0,0,1,2
OpenNMS_newts,org.opennms.newts.aggregate,0,0,0,0,0,1,0,1
OpenNMS_newts,org.opennms.newts.api,0,0,0,0,1,2,0,3
OpenNMS_newts,org.opennms.newts.api.query,0,0,0,0,1,1,0,2
OpenNMS_newts,org.opennms.newts.api.search,0,0,0,0,1,1,0,2
OpenNMS_newts,org.opennms.newts.cassandra,0,0,0,0,1,0,0,1
OpenNMS_newts,org.opennms.newts.cassandra.search,0,0,0,0,1,1,0,2
OpenNMS_newts,org.opennms.newts.cassandra.search.support,0,0,0,0,0,0,0,0
OpenNMS_newts,org.opennms.newts.persistence.cassandra,0,0,0,0,1,0,0,1
OpenNMS_newts,org.cassandraunit,0,0,0,0,0,0,0,0
OpenNMS_newts,org.opennms.newts.gsod,0,0,0,0,1,0,0,1
OpenNMS_newts,org.opennms.newts.stress,0,0,0,0,1,0,0,1
OpenNMS_newts,org.opennms.newts.graphite,0,0,0,0,0,0,0,0
OpenNMS_newts,org.opennms.newts.reporter.metrics,0,0,0,0,0,0,0,0
OpenNMS_newts,org.opennms.newts.api.search.query,0,0,0,0,0,0,0,0
OpenNMS_newts,org.opennms.newts.rest,0,0,0,1,1,0,0,2
openpreserve_pagelyzer,JDescriptors,0,0,0,0,0,0,0,0
openpreserve_pagelyzer,JDescriptors.fr.lip6.bin,0,0,0,0,1,1,0,2
openpreserve_pagelyzer,JDescriptors.fr.lip6.bof,0,0,0,0,0,1,0,1
openpreserve_pagelyzer,JDescriptors.fr.lip6.clustering,0,0,0,0,0,0,0,0
openpreserve_pagelyzer,JDescriptors.fr.lip6.color,0,0,0,0,0,1,0,1
openpreserve_pagelyzer,JDescriptors.fr.lip6.color.model,0,0,0,0,0,0,0,0
openpreserve_pagelyzer,JDescriptors.fr.lip6.copy,0,0,0,0,0,0,0,0
openpreserve_pagelyzer,JDescriptors.fr.lip6,0,0,0,0,0,1,0,1
openpreserve_pagelyzer,JDescriptors.fr.lip6.detector,0,0,0,0,0,0,0,0
openpreserve_pagelyzer,JDescriptors.fr.lip6.io,0,0,0,0,0,1,0,1
openpreserve_pagelyzer,JDescriptors.fr.lip6.quantizer,0,0,0,0,0,1,0,1
openpreserve_pagelyzer,JDescriptors.fr.lip6.sift,0,0,0,0,0,0,0,0
openpreserve_pagelyzer,JDescriptors.fr.lip6.texture,0,0,0,0,0,0,0,0
openpreserve_pagelyzer,JKernelMachines.fr.lip6.classifier,0,0,0,0,0,2,0,2
openpreserve_pagelyzer,JKernelMachines.fr.lip6.classifier.transductive,0,0,0,0,0,0,0,0
openpreserve_pagelyzer,JKernelMachines.fr.lip6.density,0,0,0,0,0,0,0,0
openpreserve_pagelyzer,JKernelMachines.fr.lip6.evaluation,0,0,0,0,0,0,0,0
openpreserve_pagelyzer,JKernelMachines.fr.lip6.kernel.adaptative,0,0,0,0,0,2,0,2
openpreserve_pagelyzer,JKernelMachines.fr.lip6.kernel,0,0,0,0,1,3,0,4
openpreserve_pagelyzer,JKernelMachines.fr.lip6.kernel.extra.bag,0,0,0,0,1,0,0,1
openpreserve_pagelyzer,JKernelMachines.fr.lip6.kernel.extra,0,0,0,0,0,0,0,0
openpreserve_pagelyzer,JKernelMachines.fr.lip6.kernel.typed,0,0,0,0,1,0,0,1
openpreserve_pagelyzer,JKernelMachines.fr.lip6.kernel.typed.index,0,0,0,0,0,0,0,0
openpreserve_pagelyzer,JKernelMachines.fr.lip6.threading,0,0,0,0,0,2,0,2
openpreserve_pagelyzer,JKernelMachines.fr.lip6.type,0,0,0,0,0,0,0,0
openpreserve_pagelyzer,Scape,0,0,0,0,1,0,0,1
openpreserve_pagelyzer,pagelyzer,0,0,0,0,1,0,0,1
openpreserve_pagelyzer,(default package),0,0,0,0,0,0,0,0
openscore_score-actions,io.cloudslang.content.alibaba.actions.instances,0,0,0,0,1,0,0,1
openscore_score-actions,io.cloudslang.content.alibaba.services,0,0,0,0,0,0,0,0
openscore_score-actions,io.cloudslang.content.alibaba.utils,0,0,0,0,0,0,0,0
openscore_score-actions,io.cloudslang.content.alibaba.utils.constants,0,0,0,0,1,0,0,1
openscore_score-actions,io.cloudslang.content.amazon.actions.cloudformation,0,0,0,0,0,0,0,0
openscore_score-actions,io.cloudslang.content.amazon.actions.images,0,0,0,0,1,1,0,2
openscore_score-actions,io.cloudslang.content.amazon.actions.instances,0,0,0,0,1,1,0,2
openscore_score-actions,io.cloudslang.content.amazon.actions.lambda,0,0,0,0,0,0,0,0
openscore_score-actions,io.cloudslang.content.amazon.actions.loadbalancing,0,0,0,0,0,1,0,1
openscore_score-actions,io.cloudslang.content.amazon.actions.network,0,0,0,0,1,1,0,2
openscore_score-actions,io.cloudslang.content.amazon.actions.regions,0,0,0,0,0,1,0,1
openscore_score-actions,io.cloudslang.content.amazon.actions.servicecatalog,0,0,0,0,0,0,0,0
openscore_score-actions,io.cloudslang.content.amazon.actions.signature,0,0,0,0,0,0,0,0
openscore_score-actions,io.cloudslang.content.amazon.actions.snapshots,0,0,0,0,0,1,0,1
openscore_score-actions,io.cloudslang.content.amazon.actions.storage,0,0,0,0,0,0,0,0
openscore_score-actions,io.cloudslang.content.amazon.actions.tags,0,0,0,0,0,1,0,1
openscore_score-actions,io.cloudslang.content.amazon.actions.volumes,0,0,0,0,0,1,0,1
openscore_score-actions,io.cloudslang.content.amazon.entities.aws,0,0,0,0,1,0,0,1
openscore_score-actions,io.cloudslang.content.amazon.entities.constants,0,0,0,1,1,0,0,2
openscore_score-actions,io.cloudslang.content.amazon.entities.inputs,1,1,0,0,0,8,0,10
openscore_score-actions,io.cloudslang.content.amazon.entities.validators,0,0,0,0,1,0,0,1
openscore_score-actions,io.cloudslang.content.amazon.execute,0,1,0,0,0,0,0,1
openscore_score-actions,io.cloudslang.content.amazon.factory,0,0,0,0,1,0,0,1
openscore_score-actions,io.cloudslang.content.amazon.factory.helpers,0,0,0,0,1,0,0,1
openscore_score-actions,io.cloudslang.content.amazon.services,2,0,0,0,0,0,0,2
openscore_score-actions,io.cloudslang.content.amazon.services.helpers,0,0,0,0,0,0,0,0
openscore_score-actions,io.cloudslang.content.amazon.utils,2,1,0,0,1,8,0,12
openscore_score-actions,io.cloudslang.content.amazon.inputs,0,0,0,0,0,0,0,0
openscore_score-actions,io.cloudslang.content.azure.actions.storage,0,0,0,0,0,0,0,0
openscore_score-actions,io.cloudslang.content.azure.actions.utils,0,0,0,0,0,0,0,0
openscore_score-actions,io.cloudslang.content.azure.entities,0,0,0,0,0,0,0,0
openscore_score-actions,io.cloudslang.content.azure.services,0,1,0,0,0,0,0,1
openscore_score-actions,io.cloudslang.content.azure.utils,0,0,0,0,1,0,0,1
openscore_score-actions,io.cloudslang.content.constants,0,0,0,0,1,0,0,1
openscore_score-actions,io.cloudslang.content.utils,0,0,0,1,1,1,0,3
openscore_score-actions,io.cloudslang.content.couchbase.actions.buckets,0,0,0,0,0,0,0,0
openscore_score-actions,io.cloudslang.content.couchbase.actions.cluster,0,0,0,0,0,0,0,0
openscore_score-actions,io.cloudslang.content.couchbase.actions.nodes,0,0,0,0,0,0,0,0
openscore_score-actions,io.cloudslang.content.couchbase.actions.views,0,0,0,0,0,0,0,0
openscore_score-actions,io.cloudslang.content.couchbase.actions.xdcr,0,0,0,0,0,0,0,0
openscore_score-actions,io.cloudslang.content.couchbase.entities.constants,0,0,0,0,1,0,0,1
openscore_score-actions,io.cloudslang.content.couchbase.entities.inputs,1,1,0,0,0,1,0,3
openscore_score-actions,io.cloudslang.content.couchbase.execute,0,1,0,0,0,1,0,2
openscore_score-actions,io.cloudslang.content.couchbase.factory.buckets,1,0,0,0,0,0,0,1
openscore_score-actions,io.cloudslang.content.couchbase.factory.cluster,1,0,0,0,0,0,0,1
openscore_score-actions,io.cloudslang.content.couchbase.factory,5,0,0,0,0,0,0,5
openscore_score-actions,io.cloudslang.content.couchbase.factory.nodes,1,0,0,0,0,0,0,1
openscore_score-actions,io.cloudslang.content.couchbase.factory.views,0,0,0,0,0,0,0,0
openscore_score-actions,io.cloudslang.content.couchbase.utils,5,1,0,0,0,0,0,6
openscore_score-actions,io.cloudslang.content.database.actions,0,0,0,0,1,1,0,2
openscore_score-actions,io.cloudslang.content.database.constants,0,0,0,0,1,0,0,1
openscore_score-actions,io.cloudslang.content.database.services,0,1,0,0,0,1,0,2
openscore_score-actions,io.cloudslang.content.database.services.databases,0,0,0,0,1,0,0,1
openscore_score-actions,io.cloudslang.content.database.services.dbconnection,0,0,0,0,0,0,0,0
openscore_score-actions,io.cloudslang.content.database.utils,0,0,0,0,1,1,0,2
openscore_score-actions,io.cloudslang.content.datetime.actions,0,0,0,0,1,0,0,1
openscore_score-actions,io.cloudslang.content.datetime.services,0,0,0,0,0,0,0,0
openscore_score-actions,io.cloudslang.content.datetime.utils,0,0,0,0,1,0,0,1
openscore_score-actions,io.cloudslang.content.dropbox.actions.folders,0,0,0,0,0,0,0,0
openscore_score-actions,io.cloudslang.content.dropbox.entities.constants,0,0,0,0,1,0,0,1
openscore_score-actions,io.cloudslang.content.dropbox.entities.inputs,1,1,0,0,0,2,0,4
openscore_score-actions,io.cloudslang.content.dropbox.execute,0,1,0,0,0,0,0,1
openscore_score-actions,io.cloudslang.content.dropbox.factory.folders,0,0,0,0,0,1,0,1
openscore_score-actions,io.cloudslang.content.dropbox.factory,2,0,0,0,0,0,0,2
openscore_score-actions,io.cloudslang.content.dropbox.utils,2,1,0,0,0,0,0,3
openscore_score-actions,io.cloudslang.content.execute,0,0,0,0,0,1,0,1
openscore_score-actions,io.cloudslang.content.httpclient.actions,0,0,0,0,0,0,0,0
openscore_score-actions,io.cloudslang.content.httpclient.build.auth,1,0,0,0,1,0,0,2
openscore_score-actions,io.cloudslang.content.httpclient.build.conn,0,0,0,0,0,0,0,0
openscore_score-actions,io.cloudslang.content.httpclient.build,1,1,0,0,1,0,0,3
openscore_score-actions,io.cloudslang.content.httpclient.components,0,0,0,0,0,0,0,0
openscore_score-actions,io.cloudslang.content.httpclient.consume,0,0,0,0,1,0,0,1
openscore_score-actions,io.cloudslang.content.httpclient.entities,0,0,0,0,0,4,0,4
openscore_score-actions,io.cloudslang.content.httpclient.execute,0,0,0,0,0,0,0,0
openscore_score-actions,io.cloudslang.content.httpclient.services,0,1,0,0,0,0,0,1
openscore_score-actions,io.cloudslang.content.httpclient.utils,0,0,0,0,0,0,0,0
openscore_score-actions,io.cloudslang.content.httpclient,0,0,0,0,0,0,0,0
openscore_score-actions,io.cloudslang.content.urldecoder,0,0,0,0,0,0,0,0
openscore_score-actions,io.cloudslang.content.urlencoder,0,0,0,0,0,0,0,0
openscore_score-actions,io.cloudslang.content.json.actions,0,0,0,0,1,0,0,1
openscore_score-actions,io.cloudslang.content.json.exceptions,0,0,0,0,0,0,0,0
openscore_score-actions,io.cloudslang.content.json.services,0,0,0,0,0,0,0,0
openscore_score-actions,io.cloudslang.content.json.utils,0,0,0,0,1,0,0,1
openscore_score-actions,io.cloudslang.content.actions,0,0,0,0,1,0,0,1
openscore_score-actions,io.cloudslang.content.exceptions,0,0,0,0,0,0,0,0
openscore_score-actions,io.cloudslang.content.services,0,0,0,0,0,1,0,1
openscore_score-actions,io.cloudslang.content.mail.actions,0,0,0,0,0,1,0,1
openscore_score-actions,io.cloudslang.content.mail.entities,0,0,0,0,0,1,0,1
openscore_score-actions,io.cloudslang.content.mail.services,0,0,0,0,0,1,0,1
openscore_score-actions,io.cloudslang.content.mail.sslconfig,0,0,0,0,0,0,0,0
openscore_score-actions,io.cloudslang.content.mail.utils,0,0,0,0,0,0,0,0
openscore_score-actions,io.cloudslang.content.dca.actions.authentication,0,0,0,0,0,0,0,0
openscore_score-actions,io.cloudslang.content.dca.actions.credentials,0,0,0,0,0,0,0,0
openscore_score-actions,io.cloudslang.content.dca.actions.resources,0,0,0,0,0,0,0,0
openscore_score-actions,io.cloudslang.content.dca.actions.templates,0,0,0,0,0,0,0,0
openscore_score-actions,io.cloudslang.content.dca.actions.utils,0,0,0,0,0,0,0,0
openscore_score-actions,io.cloudslang.content.dca.controllers,0,0,0,0,0,0,0,0
openscore_score-actions,io.cloudslang.content.dca.models,0,0,0,0,0,0,0,0
openscore_score-actions,io.cloudslang.content.dca.utils,0,0,0,0,1,0,0,1
openscore_score-actions,io.cloudslang.content.hcm.actions.utils,0,0,0,0,0,0,0,0
openscore_score-actions,io.cloudslang.content.hcm.services,0,0,0,0,0,0,0,0
openscore_score-actions,io.cloudslang.content.hcm.utils,0,0,0,0,1,0,0,1
openscore_score-actions,io.cloudslang.content.office365.actions.email,0,0,0,0,1,0,0,1
openscore_score-actions,io.cloudslang.content.office365.actions.userManagement,0,0,0,0,0,0,0,0
openscore_score-actions,io.cloudslang.content.office365.actions.utils,0,0,0,0,0,0,0,0
openscore_score-actions,io.cloudslang.content.office365.entities,0,0,0,0,1,1,0,2
openscore_score-actions,io.cloudslang.content.office365.entities.createMessageModels,0,0,0,0,1,1,0,2
openscore_score-actions,io.cloudslang.content.office365.entities.createUserModels,0,0,0,0,0,0,0,0
openscore_score-actions,io.cloudslang.content.office365.services,0,0,0,0,0,0,0,0
openscore_score-actions,io.cloudslang.content.office365.utils,0,0,0,1,1,1,0,3
openscore_score-actions,io.cloudslang.content.postgres.actions,0,0,0,0,0,0,0,0
openscore_score-actions,io.cloudslang.content.postgres.services,0,0,0,0,0,0,0,0
openscore_score-actions,io.cloudslang.content.postgres.utils,0,0,0,0,0,0,0,0
openscore_score-actions,io.cloudslang.content.entities,0,0,0,0,0,1,0,1
openscore_score-actions,io.cloudslang.content.rft.actions.ftp,0,0,0,0,0,0,0,0
openscore_score-actions,io.cloudslang.content.rft.actions,0,0,0,0,0,0,0,0
openscore_score-actions,io.cloudslang.content.rft.entities,0,0,0,0,1,0,0,1
openscore_score-actions,io.cloudslang.content.rft.services,0,0,0,0,0,0,0,0
openscore_score-actions,io.cloudslang.content.rft.utils,0,1,0,0,1,0,0,2
openscore_score-actions,io.cloudslang.content.rft.utils.ftp,0,0,1,0,0,0,0,1
openscore_score-actions,io.cloudslang.content.ssh.actions,0,0,0,0,0,0,0,0
openscore_score-actions,io.cloudslang.content.ssh.entities,0,0,0,0,1,0,0,1
openscore_score-actions,io.cloudslang.content.ssh.exceptions,0,0,0,0,0,0,0,0
openscore_score-actions,io.cloudslang.content.ssh.services.actions,0,0,0,0,0,0,0,0
openscore_score-actions,io.cloudslang.content.ssh.services.impl,0,0,0,0,0,0,0,0
openscore_score-actions,io.cloudslang.content.ssh.services,0,0,0,0,0,0,0,0
openscore_score-actions,io.cloudslang.content.ssh.utils,0,0,0,0,1,0,0,1
openscore_score-actions,io.cloudslang.content.tesseract.actions,0,0,0,0,0,0,0,0
openscore_score-actions,io.cloudslang.content.tesseract.actions.utils,0,0,0,0,0,0,0,0
openscore_score-actions,io.cloudslang.content.tesseract.services,0,0,0,0,0,0,0,0
openscore_score-actions,io.cloudslang.content.tesseract.utils,0,0,0,0,1,0,0,1
openscore_score-actions,io.cloudslang.content.utilities.actions,0,0,0,0,1,0,0,1
openscore_score-actions,io.cloudslang.content.utilities.entities,0,0,0,0,1,1,0,2
openscore_score-actions,io.cloudslang.content.utilities.entities.constants,0,0,0,0,1,0,0,1
openscore_score-actions,io.cloudslang.content.utilities.services.base64coder,0,0,0,0,0,0,0,0
openscore_score-actions,io.cloudslang.content.utilities.services,0,0,0,0,0,0,0,0
openscore_score-actions,io.cloudslang.content.utilities.services.localping,0,0,0,0,1,1,0,2
openscore_score-actions,io.cloudslang.content.utilities.services.osdetector,0,0,0,0,1,0,0,1
openscore_score-actions,io.cloudslang.content.utilities.util,0,0,0,0,1,1,0,2
openscore_score-actions,io.cloudslang.content.utilities,0,0,0,0,0,0,0,0
openscore_score-actions,io.cloudslang.content.vmware.actions.cluster,0,0,0,0,1,0,0,1
openscore_score-actions,io.cloudslang.content.vmware.actions.deployment,0,0,0,0,0,0,0,0
openscore_score-actions,io.cloudslang.content.vmware.actions.guest,0,0,0,0,1,0,0,1
openscore_score-actions,io.cloudslang.content.vmware.actions.vm,0,0,0,0,1,0,0,1
openscore_score-actions,io.cloudslang.content.vmware.actions.vm.utils,0,0,0,0,0,0,0,0
openscore_score-actions,io.cloudslang.content.vmware.connection,8,1,0,0,0,0,0,9
openscore_score-actions,io.cloudslang.content.vmware.connection.exceptions,0,0,0,0,0,0,0,0
openscore_score-actions,io.cloudslang.content.vmware.connection.helpers.build,0,0,0,0,0,0,0,0
openscore_score-actions,io.cloudslang.content.vmware.connection.helpers,1,0,0,0,0,0,0,1
openscore_score-actions,io.cloudslang.content.vmware.connection.impl,0,0,0,0,0,0,0,0
openscore_score-actions,io.cloudslang.content.vmware.constants,0,0,0,0,0,0,0,0
openscore_score-actions,io.cloudslang.content.vmware.entities,3,1,0,0,1,0,0,5
openscore_score-actions,io.cloudslang.content.vmware.entities.http,4,1,0,0,0,0,0,5
openscore_score-actions,io.cloudslang.content.vmware.services,0,1,0,0,1,0,0,2
openscore_score-actions,io.cloudslang.content.vmware.services.helpers,3,1,0,0,0,0,0,4
openscore_score-actions,io.cloudslang.content.vmware.services.utils,0,0,0,0,0,0,0,0
openscore_score-actions,io.cloudslang.content.vmware.utils,8,1,0,0,1,0,0,10
openscore_score-actions,io.cloudslang.content.xml.actions,0,0,0,0,1,0,0,1
openscore_score-actions,io.cloudslang.content.xml.entities,0,0,0,0,0,0,0,0
openscore_score-actions,io.cloudslang.content.xml.entities.inputs,1,1,0,0,1,0,0,3
openscore_score-actions,io.cloudslang.content.xml.factory,0,0,0,0,0,0,0,0
openscore_score-actions,io.cloudslang.content.xml.services,0,0,0,0,1,0,0,1
openscore_score-actions,io.cloudslang.content.xml.services.impl,0,0,0,0,1,0,0,1
openscore_score-actions,io.cloudslang.content.xml.utils,1,1,0,0,1,0,0,3
OpenSOC_opensoc-streaming,com.opensoc.alerts,0,0,0,0,0,0,0,0
OpenSOC_opensoc-streaming,com.opensoc.alerts.adapters,0,0,0,0,1,0,0,1
OpenSOC_opensoc-streaming,com.opensoc.tagging,0,0,0,0,0,0,0,0
OpenSOC_opensoc-streaming,com.opensoc.tagging.adapters,0,0,0,0,0,0,0,0
OpenSOC_opensoc-streaming,com.opensoc.alerts.interfaces,0,0,0,0,0,0,0,0
OpenSOC_opensoc-streaming,com.opensoc.configuration,0,0,0,0,0,0,0,0
OpenSOC_opensoc-streaming,com.opensoc.dataloads.interfaces,0,0,0,0,0,0,0,0
OpenSOC_opensoc-streaming,com.opensoc.enrichment.interfaces,0,0,0,0,0,0,0,0
OpenSOC_opensoc-streaming,com.opensoc.hbase,0,0,0,0,0,0,0,0
OpenSOC_opensoc-streaming,com.opensoc.helpers.services,0,0,0,0,0,0,0,0
OpenSOC_opensoc-streaming,com.opensoc.helpers.topology,0,0,0,0,0,0,0,0
OpenSOC_opensoc-streaming,com.opensoc.index.interfaces,0,0,0,0,0,0,0,0
OpenSOC_opensoc-streaming,com.opensoc.ise.parser,0,0,0,0,0,0,0,0
OpenSOC_opensoc-streaming,com.opensoc.json.serialization,0,0,0,0,0,0,0,0
OpenSOC_opensoc-streaming,com.opensoc.metrics,0,0,0,0,0,0,0,0
OpenSOC_opensoc-streaming,com.opensoc.parser.interfaces,0,0,0,0,0,0,0,0
OpenSOC_opensoc-streaming,com.opensoc.pcap,0,0,0,0,1,0,0,1
OpenSOC_opensoc-streaming,com.opensoc.tldextractor,0,0,0,0,0,0,0,0
OpenSOC_opensoc-streaming,com.opensoc.dataloads.cif,0,0,0,0,0,0,0,0
OpenSOC_opensoc-streaming,com.opensoc.dataloads,0,0,0,0,0,0,0,0
OpenSOC_opensoc-streaming,com.opensoc.alerts.server,0,0,0,0,0,0,0,0
OpenSOC_opensoc-streaming,com.opensoc.dataservices.auth,0,0,0,0,0,0,0,0
OpenSOC_opensoc-streaming,com.opensoc.dataservices.common,0,0,0,0,0,0,0,0
OpenSOC_opensoc-streaming,com.opensoc.dataservices.kafkaclient,0,0,0,0,0,0,0,0
OpenSOC_opensoc-streaming,com.opensoc.dataservices.kafkaclient.poll,0,0,0,0,0,0,0,0
OpenSOC_opensoc-streaming,com.opensoc.dataservices,0,0,0,0,0,0,0,0
OpenSOC_opensoc-streaming,com.opensoc.dataservices.modules.guice,0,0,0,0,0,0,0,0
OpenSOC_opensoc-streaming,com.opensoc.dataservices.rest,0,0,0,0,0,0,0,0
OpenSOC_opensoc-streaming,com.opensoc.dataservices.servlet,0,0,0,0,0,0,0,0
OpenSOC_opensoc-streaming,com.opensoc.dataservices.websocket,0,0,0,0,0,0,0,0
OpenSOC_opensoc-streaming,com.opensoc.pcapservice,0,0,0,1,1,0,0,2
OpenSOC_opensoc-streaming,com.opensoc.pcapservice.rest,0,0,0,0,0,0,0,0
OpenSOC_opensoc-streaming,com.opensoc.services.alerts,0,0,0,0,0,0,0,0
OpenSOC_opensoc-streaming,com.opensoc.enrichment.adapters.cif,0,0,0,0,0,0,0,0
OpenSOC_opensoc-streaming,com.opensoc.enrichment.adapters.geo,0,0,0,0,0,0,0,0
OpenSOC_opensoc-streaming,com.opensoc.enrichment.adapters.host,0,0,0,0,0,0,0,0
OpenSOC_opensoc-streaming,com.opensoc.enrichment.adapters.threat,0,0,0,0,0,0,0,0
OpenSOC_opensoc-streaming,com.opensoc.enrichment.adapters.whois,0,0,0,0,0,0,0,0
OpenSOC_opensoc-streaming,com.opensoc.enrichment.common,0,0,0,0,0,0,0,0
OpenSOC_opensoc-streaming,com.opensoc.indexing,0,0,0,0,0,0,0,0
OpenSOC_opensoc-streaming,com.opensoc.indexing.adapters,0,0,0,0,0,0,0,0
OpenSOC_opensoc-streaming,com.opensoc.filters,0,0,0,0,0,0,0,0
OpenSOC_opensoc-streaming,com.opensoc.parsing,0,0,0,0,0,0,0,0
OpenSOC_opensoc-streaming,com.opensoc.parsing.parsers,0,0,0,0,1,0,0,1
OpenSOC_opensoc-streaming,org.apache.hadoop.hbase.regionserver.compactions,0,0,0,0,0,0,0,0
OpenSOC_opensoc-streaming,com.opensoc.topology,0,0,0,0,1,0,0,1
OpenSOC_opensoc-streaming,com.opensoc.topology.runner,0,0,0,0,1,0,0,1
OpenTOSCA_container,org.opentosca.broker.mqtt,0,0,0,0,0,0,0,0
OpenTOSCA_container,org.opentosca.bus.application.api.jsonhttp,0,0,0,0,0,0,0,0
OpenTOSCA_container,org.opentosca.bus.application.api.jsonhttp.processor,1,1,0,0,1,0,0,3
OpenTOSCA_container,org.opentosca.bus.application.api.jsonhttp.route,1,0,0,0,0,0,0,1
OpenTOSCA_container,org.opentosca.bus.application.api.jsonhttp.servicehandler,0,0,0,0,0,0,0,0
OpenTOSCA_container,org.opentosca.bus.application.api.resthttp,0,0,0,0,0,0,0,0
OpenTOSCA_container,org.opentosca.bus.application.api.resthttp.processor,1,0,0,0,1,0,0,2
OpenTOSCA_container,org.opentosca.bus.application.api.resthttp.route,1,1,0,0,0,0,0,2
OpenTOSCA_container,org.opentosca.bus.application.api.resthttp.servicehandler,0,0,0,0,0,0,0,0
OpenTOSCA_container,org.opentosca.bus.application.api.soaphttp,0,0,0,0,0,0,0,0
OpenTOSCA_container,org.opentosca.bus.application.api.soaphttp.model,0,0,0,0,0,0,0,0
OpenTOSCA_container,org.opentosca.bus.application.api.soaphttp.processor,0,0,0,0,0,0,0,0
OpenTOSCA_container,org.opentosca.bus.application.api.soaphttp.route,0,1,0,0,0,0,0,1
OpenTOSCA_container,org.opentosca.bus.application.api.soaphttp.servicehandler,0,0,0,0,0,0,0,0
OpenTOSCA_container,org.opentosca.bus.application.model.exception,0,0,0,0,0,0,0,0
OpenTOSCA_container,org.opentosca.bus.application.plugin.jsonhttp.service.impl,1,1,0,0,0,0,0,2
OpenTOSCA_container,org.opentosca.bus.application.plugin.jsonhttp.service.impl.processor,0,0,0,0,0,0,0,0
OpenTOSCA_container,org.opentosca.bus.application.plugin.jsonhttp.service.impl.route,1,0,0,0,0,0,0,1
OpenTOSCA_container,org.opentosca.bus.application.plugin.service,0,0,0,0,0,0,0,0
OpenTOSCA_container,org.opentosca.bus.application.plugin.soaphttp.service.impl,0,0,0,0,0,0,0,0
OpenTOSCA_container,org.opentosca.bus.application.plugin.soaphttp.service.impl.processor,1,1,0,0,0,0,0,2
OpenTOSCA_container,org.opentosca.bus.application.plugin.soaphttp.service.impl.route,1,0,0,0,0,0,0,1
OpenTOSCA_container,org.opentosca.bus.application.service,0,0,0,0,0,0,0,0
OpenTOSCA_container,org.opentosca.bus.application.service.impl,2,1,0,0,0,0,0,3
OpenTOSCA_container,org.opentosca.bus.application.service.impl.model,0,0,0,0,0,0,0,0
OpenTOSCA_container,org.opentosca.bus.application.service.impl.processor,2,1,0,0,0,0,0,3
OpenTOSCA_container,org.opentosca.bus.application.service.impl.route,3,0,0,0,0,0,0,3
OpenTOSCA_container,org.opentosca.bus.application.service.impl.servicehandler,0,0,0,0,0,0,0,0
OpenTOSCA_container,org.opentosca.bus.management.servicehandler,0,0,0,0,0,0,0,0
OpenTOSCA_container,org.opentosca.bus.management.utils,0,0,0,0,0,0,0,0
OpenTOSCA_container,org.opentosca.bus.management.api.osgievent,1,0,0,0,0,0,0,1
OpenTOSCA_container,org.opentosca.bus.management.api.osgievent.route,1,1,0,0,0,0,0,2
OpenTOSCA_container,org.opentosca.bus.management.api.resthttp,2,0,0,0,0,0,0,2
OpenTOSCA_container,org.opentosca.bus.management.api.resthttp.model,0,0,0,0,0,0,0,0
OpenTOSCA_container,org.opentosca.bus.management.api.resthttp.processor,2,1,0,0,1,0,0,4
OpenTOSCA_container,org.opentosca.bus.management.api.resthttp.route,3,1,0,0,0,0,0,4
OpenTOSCA_container,org.opentosca.bus.management.api.soaphttp,2,0,0,0,0,0,0,2
OpenTOSCA_container,org.opentosca.bus.management.api.soaphttp.model,0,0,0,0,0,0,0,0
OpenTOSCA_container,org.opentosca.bus.management.api.soaphttp.processor,1,0,0,0,0,0,0,1
OpenTOSCA_container,org.opentosca.bus.management.api.soaphttp.route,2,1,0,0,0,0,0,3
OpenTOSCA_container,org.opentosca.bus.management.deployment.plugin,0,0,0,0,0,0,0,0
OpenTOSCA_container,org.opentosca.bus.management.deployment.plugin.remote,0,0,0,0,0,0,0,0
OpenTOSCA_container,org.opentosca.bus.management.deployment.plugin.script,0,0,0,0,0,0,0,0
OpenTOSCA_container,org.opentosca.bus.management.deployment.plugin.script.util,0,0,0,0,0,0,0,0
OpenTOSCA_container,org.opentosca.bus.management.deployment.plugin.tomcat,0,0,0,0,0,0,0,0
OpenTOSCA_container,org.opentosca.bus.management.deployment.plugin.tomcat.util,0,0,0,0,0,0,0,0
OpenTOSCA_container,org.opentosca.bus.management.invocation.plugin,0,0,0,0,0,0,0,0
OpenTOSCA_container,org.opentosca.bus.management.invocation.plugin.remote,0,0,0,0,0,0,0,0
OpenTOSCA_container,org.opentosca.bus.management.invocation.plugin.rest,0,0,0,0,0,0,0,0
OpenTOSCA_container,org.opentosca.bus.management.invocation.plugin.rest.model,0,0,0,0,0,0,0,0
OpenTOSCA_container,org.opentosca.bus.management.invocation.plugin.rest.util,0,0,0,0,0,0,0,0
OpenTOSCA_container,org.opentosca.bus.management.invocation.plugin.script,0,0,0,0,0,0,0,0
OpenTOSCA_container,org.opentosca.bus.management.invocation.plugin.script.model.artifacttypes,0,0,0,0,0,0,0,0
OpenTOSCA_container,org.opentosca.bus.management.invocation.plugin.script.servicehandler,0,0,0,0,0,0,0,0
OpenTOSCA_container,org.opentosca.bus.management.invocation.plugin.script.typeshandler,0,0,0,0,0,0,0,0
OpenTOSCA_container,org.opentosca.bus.management.invocation.plugin.soaphttp,1,0,0,0,0,0,0,1
OpenTOSCA_container,org.opentosca.bus.management.invocation.plugin.soaphttp.processor,1,1,0,0,0,0,0,2
OpenTOSCA_container,org.opentosca.bus.management.invocation.plugin.soaphttp.route,1,0,0,0,0,0,0,1
OpenTOSCA_container,org.opentosca.bus.management.invocation.plugin.soaphttp.util,0,0,0,0,0,0,0,0
OpenTOSCA_container,org.opentosca.bus.management.service,0,0,0,0,0,0,0,0
OpenTOSCA_container,org.opentosca.bus.management.service.impl,3,1,0,0,0,0,0,4
OpenTOSCA_container,org.opentosca.bus.management.service.impl.collaboration,1,0,0,0,0,0,0,1
OpenTOSCA_container,org.opentosca.bus.management.service.impl.collaboration.model,0,0,0,0,0,0,0,0
OpenTOSCA_container,org.opentosca.bus.management.service.impl.collaboration.processor,0,0,0,0,0,0,0,0
OpenTOSCA_container,org.opentosca.bus.management.service.impl.collaboration.route,0,0,0,0,0,0,0,0
OpenTOSCA_container,org.opentosca.bus.management.service.impl.instance.plan,1,0,0,0,0,0,0,1
OpenTOSCA_container,org.opentosca.bus.management.service.impl.servicehandler,0,0,0,0,0,0,0,0
OpenTOSCA_container,org.opentosca.bus.management.service.impl.util,1,0,0,0,0,0,0,1
OpenTOSCA_container,org.opentosca.container.api,0,0,0,0,0,0,0,0
OpenTOSCA_container,org.opentosca.container.api.config,0,0,0,0,1,0,0,1
OpenTOSCA_container,org.opentosca.container.api.controller,0,0,0,0,1,0,0,1
OpenTOSCA_container,org.opentosca.container.api.controller.content,0,0,0,0,0,0,0,0
OpenTOSCA_container,org.opentosca.container.api.dto.boundarydefinitions,0,0,0,0,0,0,0,0
OpenTOSCA_container,org.opentosca.container.api.dto,0,0,0,0,1,0,0,1
OpenTOSCA_container,org.opentosca.container.api.dto.plan,0,0,0,0,1,0,0,1
OpenTOSCA_container,org.opentosca.container.api.dto.request,0,0,0,0,1,0,0,1
OpenTOSCA_container,org.opentosca.container.api.dto.situations,0,0,0,0,1,0,0,1
OpenTOSCA_container,org.opentosca.container.api.service,0,0,0,0,1,0,0,1
OpenTOSCA_container,org.opentosca.container.api.util,0,0,0,0,0,0,0,0
OpenTOSCA_container,org.opentosca.container.application,0,0,0,0,0,0,0,0
OpenTOSCA_container,authclient.java.io.xsd,0,0,0,0,0,0,0,0
OpenTOSCA_container,authclient.java.net.xsd,0,0,0,0,0,0,0,0
OpenTOSCA_container,authclient.java.util.xsd,0,0,0,0,1,0,0,1
OpenTOSCA_container,org.apache.axiom.attachments.lifecycle.xsd,0,0,0,0,0,0,0,0
OpenTOSCA_container,org.apache.axiom.attachments.xsd,2,0,0,0,1,0,0,3
OpenTOSCA_container,org.apache.axiom.om.xsd,0,0,0,0,0,0,0,0
OpenTOSCA_container,org.apache.axiom.soap.xsd,2,0,0,0,0,0,0,2
OpenTOSCA_container,org.apache.axis2.addressing.xsd,4,1,0,0,0,0,0,5
OpenTOSCA_container,org.apache.axis2.client.xsd,3,0,0,0,0,0,0,3
OpenTOSCA_container,org.apache.axis2.clustering.management.xsd,5,1,0,0,0,0,0,6
OpenTOSCA_container,org.apache.axis2.clustering.state.xsd,4,1,0,0,0,0,0,5
OpenTOSCA_container,org.apache.axis2.clustering.xsd,11,1,0,0,0,0,0,12
OpenTOSCA_container,org.apache.axis2.context.xsd,22,1,0,0,0,0,0,23
OpenTOSCA_container,org.apache.axis2.deployment.util.xsd,5,1,0,0,0,0,0,6
OpenTOSCA_container,org.apache.axis2.description.java2wsdl.xsd,2,1,0,0,0,0,0,3
OpenTOSCA_container,org.apache.axis2.description.xsd,10,1,0,0,1,0,0,12
OpenTOSCA_container,org.apache.axis2.engine.xsd,15,1,0,0,1,0,0,17
OpenTOSCA_container,org.apache.axis2.transaction.xsd,39,1,0,0,0,0,0,40
OpenTOSCA_container,org.apache.axis2.transport.xsd,0,0,0,0,0,0,0,0
OpenTOSCA_container,org.apache.axis2.util.threadpool.xsd,0,0,0,0,0,0,0,0
OpenTOSCA_container,org.apache.axis2.util.xsd,0,0,0,0,0,0,0,0
OpenTOSCA_container,org.apache.neethi.xsd,7,1,0,0,0,0,0,8
OpenTOSCA_container,org.apache.ws.commons.schema.constants.xsd,0,0,0,0,0,0,0,0
OpenTOSCA_container,org.apache.ws.commons.schema.xsd,3,0,0,0,1,0,0,4
OpenTOSCA_container,org.opentosca.container.connector.bps,0,0,0,0,0,0,0,0
OpenTOSCA_container,org.w3c.dom.xsd,3,1,0,0,0,0,0,4
OpenTOSCA_container,org.wso2.bps.management.schema,1,1,0,2,1,0,0,5
OpenTOSCA_container,org.wso2.bps.management.wsdl.bpelpackagemanagement,0,0,0,0,0,0,0,0
OpenTOSCA_container,org.wso2.bps.management.wsdl.instancemanagement,1,0,0,0,0,0,0,1
OpenTOSCA_container,org.wso2.bps.management.wsdl.processmanagement,0,0,0,0,0,0,0,0
OpenTOSCA_container,org.wso2.carbon.bpel.deployer.services,0,0,0,0,0,0,0,0
OpenTOSCA_container,org.wso2.carbon.bpel.deployer.services.types.xsd,0,0,0,0,0,0,0,0
OpenTOSCA_container,org.wso2.carbon.core.common.xsd,0,0,0,0,0,0,0,0
OpenTOSCA_container,org.wso2.carbon.core.services.authentication,0,0,0,1,1,0,0,2
OpenTOSCA_container,org.wso2.carbon.core.services.authentication.xsd,0,0,0,0,0,0,0,0
OpenTOSCA_container,org.wso2.securevault.xsd,0,0,0,0,0,0,0,0
OpenTOSCA_container,org.apache.www.ode.deployapi,0,0,0,0,1,0,0,1
OpenTOSCA_container,org.apache.www.ode.pmapi,0,0,0,0,1,0,0,1
OpenTOSCA_container,org.apache.www.ode.pmapi.types._2006._08._02,0,0,0,1,1,0,0,2
OpenTOSCA_container,org.opentosca.container.connector.ode,0,0,0,0,0,0,0,0
OpenTOSCA_container,org.w3.www._2005._05.xmlmime,0,0,0,0,0,0,0,0
OpenTOSCA_container,org.opentosca.container.connector.winery,0,0,0,0,0,0,0,0
OpenTOSCA_container,org.opentosca.container.control,0,0,0,0,0,0,0,0
OpenTOSCA_container,org.opentosca.container.control.impl,0,0,0,0,0,2,0,2
OpenTOSCA_container,org.opentosca.container.core,0,0,0,0,0,0,0,0
OpenTOSCA_container,org.opentosca.container.core.common,0,0,0,0,1,0,0,1
OpenTOSCA_container,org.opentosca.container.core.common.jpa,0,0,0,0,0,0,0,0
OpenTOSCA_container,org.opentosca.container.core.engine.impl,0,0,0,0,0,0,0,0
OpenTOSCA_container,org.opentosca.container.core.engine.impl.consolidation,0,0,0,0,0,0,0,0
OpenTOSCA_container,org.opentosca.container.core.engine.impl.resolver,0,0,0,0,1,0,0,1
OpenTOSCA_container,org.opentosca.container.core.engine.impl.resolver.data,0,0,0,0,0,0,0,0
OpenTOSCA_container,org.opentosca.container.core.engine,0,0,0,0,1,2,0,3
OpenTOSCA_container,org.opentosca.container.core.engine.xml.impl,0,0,0,0,0,0,0,0
OpenTOSCA_container,org.opentosca.container.core.engine.xml,0,0,0,0,0,0,0,0
OpenTOSCA_container,org.opentosca.container.core.mapping,0,0,0,0,1,0,0,1
OpenTOSCA_container,org.opentosca.container.core.model,0,0,0,0,1,1,0,2
OpenTOSCA_container,org.opentosca.container.core.model.credentials,0,0,0,0,0,0,0,0
OpenTOSCA_container,org.opentosca.container.core.model.csar,0,0,0,0,0,1,0,1
OpenTOSCA_container,org.opentosca.container.core.model.csar.id,0,0,0,0,0,0,0,0
OpenTOSCA_container,org.opentosca.container.core.model.csar.toscametafile,0,0,0,0,0,0,0,0
OpenTOSCA_container,org.opentosca.container.core.model.deployment,0,0,0,0,0,0,0,0
OpenTOSCA_container,org.opentosca.container.core.model.deployment.ia,0,0,0,0,0,0,0,0
OpenTOSCA_container,org.opentosca.container.core.model.deployment.plan,0,0,0,0,0,0,0,0
OpenTOSCA_container,org.opentosca.container.core.model.deployment.process,0,0,0,0,0,0,0,0
OpenTOSCA_container,org.opentosca.container.core.model.endpoint,0,0,0,0,0,1,0,1
OpenTOSCA_container,org.opentosca.container.core.model.endpoint.rest,0,0,0,0,0,0,0,0
OpenTOSCA_container,org.opentosca.container.core.model.endpoint.wsdl,0,0,0,0,0,1,0,1
OpenTOSCA_container,org.opentosca.container.core.model.instance,0,0,0,0,1,1,0,2
OpenTOSCA_container,org.opentosca.container.core.next.jpa,0,0,0,0,0,0,0,0
OpenTOSCA_container,org.opentosca.container.core.next.model,0,0,0,0,1,1,0,2
OpenTOSCA_container,org.opentosca.container.core.next.repository,0,0,0,0,1,1,0,2
OpenTOSCA_container,org.opentosca.container.core.next.trigger,0,0,0,0,0,0,0,0
OpenTOSCA_container,org.opentosca.container.core.next.utils,0,0,0,0,1,0,0,1
OpenTOSCA_container,org.opentosca.container.core.next.xml,0,0,0,0,0,0,0,0
OpenTOSCA_container,org.opentosca.container.core.service,0,0,0,0,1,3,0,4
OpenTOSCA_container,org.opentosca.container.core.service.internal,0,0,0,0,1,0,0,1
OpenTOSCA_container,org.opentosca.container.core.impl,0,0,0,0,0,0,0,0
OpenTOSCA_container,org.opentosca.container.core.impl.persistence,0,0,0,0,1,1,0,2
OpenTOSCA_container,org.opentosca.container.core.impl.plan,0,0,0,0,0,0,0,0
OpenTOSCA_container,org.opentosca.container.core.impl.service,0,0,0,0,1,0,0,1
OpenTOSCA_container,org.opentosca.container.core.impl.service.internal,0,0,0,0,1,1,0,2
OpenTOSCA_container,org.opentosca.container.core.impl.service.internal.credentials,0,0,0,0,0,0,0,0
OpenTOSCA_container,org.opentosca.container.core.impl.service.internal.file.csar,0,0,0,0,0,0,0,0
OpenTOSCA_container,org.opentosca.container.core.impl.service.internal.file,0,0,0,0,0,0,0,0
OpenTOSCA_container,org.opentosca.container.core.impl.service.internal.file.visitors,0,0,0,0,0,0,0,0
OpenTOSCA_container,org.opentosca.container.core.tosca,0,0,0,0,0,0,0,0
OpenTOSCA_container,org.opentosca.container.core.tosca.convention,0,0,0,0,0,0,0,0
OpenTOSCA_container,org.opentosca.container.core.tosca.extension,0,0,0,0,1,0,0,1
OpenTOSCA_container,org.opentosca.container.core.tosca.model,0,0,0,1,0,2,0,3
OpenTOSCA_container,org.opentosca.container.engine.plan,0,0,0,0,0,1,0,1
OpenTOSCA_container,org.opentosca.container.engine.plan.impl,0,0,0,0,0,2,0,2
OpenTOSCA_container,org.opentosca.container.engine.plan.plugin,0,0,0,0,0,2,0,2
OpenTOSCA_container,org.apache.ode.activityrecovery,0,0,0,0,1,0,0,1
OpenTOSCA_container,org.apache.ode.schemas.dd._2007._03,0,0,0,1,1,0,0,2
OpenTOSCA_container,org.opentosca.container.engine.plan.plugin.bpel,1,1,0,0,0,0,0,2
OpenTOSCA_container,org.opentosca.container.engine.plan.plugin.bpel.util,1,0,0,0,0,0,0,1
OpenTOSCA_container,org.opentosca.container.engine.plan.plugin.camunda,0,0,0,0,0,0,0,0
OpenTOSCA_container,org.opentosca.container.portability,0,0,0,0,0,0,0,0
OpenTOSCA_container,org.opentosca.container.portability.impl,0,0,0,0,0,0,0,0
OpenTOSCA_container,org.opentosca.container.portability.model,0,0,0,0,0,0,0,0
OpenTOSCA_container,org.opentosca.container.portability.model.util,0,0,0,0,0,0,0,0
OpenTOSCA_container,org.eclipse.gemini.jpa,13,1,0,1,0,0,0,15
OpenTOSCA_container,org.eclipse.gemini.jpa.classloader,4,1,0,1,1,0,0,7
OpenTOSCA_container,org.eclipse.gemini.jpa.configadmin,2,0,0,0,1,0,0,3
OpenTOSCA_container,org.eclipse.gemini.jpa.datasource,1,0,0,0,1,0,0,2
OpenTOSCA_container,org.eclipse.gemini.jpa.eclipselink,5,0,0,0,1,0,0,6
OpenTOSCA_container,org.eclipse.gemini.jpa.jndi,1,0,0,0,0,0,0,1
OpenTOSCA_container,org.eclipse.gemini.jpa.proxy,3,1,0,0,1,0,0,5
OpenTOSCA_container,org.eclipse.gemini.jpa.weaving,2,1,0,0,0,0,0,3
OpenTOSCA_container,org.eclipse.gemini.jpa.xml,5,0,0,0,1,0,0,6
OpenTOSCA_container,org.opentosca.planbuilder,0,0,0,0,1,0,0,1
OpenTOSCA_container,org.opentosca.planbuilder.plugins.activator,0,0,0,0,0,0,0,0
OpenTOSCA_container,org.opentosca.planbuilder.plugins.artifactbased,0,0,0,0,0,0,0,0
OpenTOSCA_container,org.opentosca.planbuilder.plugins.context,0,0,0,0,0,4,0,4
OpenTOSCA_container,org.opentosca.planbuilder.plugins.registry,0,0,0,0,0,0,0,0
OpenTOSCA_container,org.opentosca.planbuilder.plugins.typebased,0,0,0,0,1,0,0,1
OpenTOSCA_container,org.opentosca.planbuilder.plugins.utils,0,0,0,0,0,0,0,0
OpenTOSCA_container,org.opentosca.planbuilder.core.bpel,0,0,0,0,0,0,0,0
OpenTOSCA_container,org.opentosca.planbuilder.core.bpel.artifactbasednodehandler,0,0,0,0,1,0,0,1
OpenTOSCA_container,org.opentosca.planbuilder.core.bpel.context,0,1,0,0,0,3,0,4
OpenTOSCA_container,org.opentosca.planbuilder.core.bpel.fragments,0,0,0,0,0,7,0,7
OpenTOSCA_container,org.opentosca.planbuilder.core.bpel.handlers,0,0,0,0,0,5,0,5
OpenTOSCA_container,org.opentosca.planbuilder.core.bpel.tosca.handlers,0,0,0,0,1,9,0,10
OpenTOSCA_container,org.opentosca.planbuilder.core.bpel.typebasednodehandler,0,0,0,0,0,0,0,0
OpenTOSCA_container,org.opentosca.planbuilder.core.bpel.typebasedplanbuilder,0,0,0,0,1,0,0,1
OpenTOSCA_container,org.opentosca.planbuilder.csarhandler,0,0,0,0,0,1,0,1
OpenTOSCA_container,org.eclipse.winery.model.selfservice,0,0,0,0,1,0,0,1
OpenTOSCA_container,org.oasis_open.docs.tosca.ns._2011._12,0,0,0,1,0,1,0,2
OpenTOSCA_container,org.opentosca.planbuilder.export,0,0,0,0,0,1,0,1
OpenTOSCA_container,org.opentosca.planbuilder.export.exporters,0,0,0,0,0,0,0,0
OpenTOSCA_container,org.opentosca.planbuilder.importer.context.impl,0,0,0,0,0,1,0,1
OpenTOSCA_container,org.opentosca.planbuilder.importer,0,0,0,0,0,0,0,0
OpenTOSCA_container,org.opentosca.planbuilder.integration.layer,0,0,0,0,0,0,0,0
OpenTOSCA_container,org.opentosca.planbuilder.model.plan,0,0,0,0,1,3,0,4
OpenTOSCA_container,org.opentosca.planbuilder.model.plan.bpel,0,0,0,0,0,8,0,8
OpenTOSCA_container,org.opentosca.planbuilder.model.tosca,0,0,0,0,1,9,0,10
OpenTOSCA_container,org.opentosca.planbuilder.model.utils,0,0,0,0,0,0,0,0
OpenTOSCA_container,org.opentosca.planbuilder.postphase.plugin.instancedata,0,0,0,0,0,0,0,0
OpenTOSCA_container,org.opentosca.planbuilder.postphase.plugin.instancedata.bpel,0,0,0,0,0,0,0,0
OpenTOSCA_container,org.opentosca.planbuilder.postphase.plugin.monitoring,0,0,0,0,0,0,0,0
OpenTOSCA_container,org.opentosca.planbuilder.postphase.plugin.monitoring.bpel.impl,0,0,0,0,0,0,0,0
OpenTOSCA_container,org.opentosca.planbuilder.postphase.plugin.vinothek,0,0,0,0,0,0,0,0
OpenTOSCA_container,org.opentosca.planbuilder.postphase.plugin.vinothek.bpel,1,1,0,0,0,0,0,2
OpenTOSCA_container,org.opentosca.planbuilder.postphase.plugin.vinothek.bpel.handler,1,0,0,0,0,1,0,2
OpenTOSCA_container,org.opentosca.planbuilder.postphase.plugin.vinothek.core.handler,0,0,0,0,0,0,0,0
OpenTOSCA_container,org.opentosca.planbuilder.postphase.plugin.vinothek.core,0,0,0,0,0,0,0,0
OpenTOSCA_container,org.opentosca.planbuilder.prephase.plugin.fileupload,0,0,0,0,0,0,0,0
OpenTOSCA_container,org.opentosca.planbuilder.prephase.plugin.fileupload.bpel,0,0,0,0,0,0,0,0
OpenTOSCA_container,org.opentosca.planbuilder.prephase.plugin.fileupload.bpel.handler,0,0,0,0,0,0,0,0
OpenTOSCA_container,org.opentosca.planbuilder.provphase.plugin.ansibleoperation,0,0,0,0,0,0,0,0
OpenTOSCA_container,org.opentosca.planbuilder.provphase.plugin.ansibleoperation.bpel,0,0,0,0,0,0,0,0
OpenTOSCA_container,org.opentosca.planbuilder.provphase.plugin.ansibleoperation.bpel.handler,0,0,0,0,0,0,0,0
OpenTOSCA_container,org.opentosca.planbuilder.provphase.plugin.ansibleoperation.core,0,0,0,0,0,0,0,0
OpenTOSCA_container,org.opentosca.planbuilder.provphase.plugin.ansibleoperation.core.handler,0,0,0,0,0,0,0,0
OpenTOSCA_container,org.opentosca.planbuilder.provphase.plugin.invoker,0,0,0,0,0,0,0,0
OpenTOSCA_container,org.opentosca.planbuilder.provphase.plugin.invoker.bpel,0,0,0,0,0,0,0,0
OpenTOSCA_container,org.opentosca.planbuilder.provphase.plugin.invoker.bpel.handlers,0,0,0,0,0,0,0,0
OpenTOSCA_container,org.opentosca.planbuilder.selection.plugin.firstavailable,0,0,0,0,0,0,0,0
OpenTOSCA_container,org.opentosca.planbuilder.selection.plugin.firstavailable.bpel,0,0,0,0,0,0,0,0
OpenTOSCA_container,org.opentosca.planbuilder.selection.plugin.firstavailable.core,0,0,0,0,0,0,0,0
OpenTOSCA_container,org.opentosca.planbuilder.selection.plugin.input,0,0,0,0,0,0,0,0
OpenTOSCA_container,org.opentosca.planbuilder.selection.plugin.input.bpel,0,1,0,0,0,0,0,1
OpenTOSCA_container,org.opentosca.planbuilder.selection.plugin.input.core,0,0,0,0,0,0,0,0
OpenTOSCA_container,org.opentosca.planbuilder.selection.plugin.mosquitto.workload,0,0,0,0,0,0,0,0
OpenTOSCA_container,org.opentosca.planbuilder.selection.plugin.mosquitto.workload.bpel,0,0,0,0,0,0,0,0
OpenTOSCA_container,org.opentosca.planbuilder.selection.plugin.mosquitto.workload.core,0,0,0,0,0,0,0,0
OpenTOSCA_container,org.opentosca.planbuilder.service,0,0,0,0,1,1,0,2
OpenTOSCA_container,org.opentosca.planbuilder.service.model,0,0,0,0,0,0,0,0
OpenTOSCA_container,org.opentosca.planbuilder.service.resources,0,0,0,0,0,0,0,0
OpenTOSCA_container,org.opentosca.planbuilder.type.plugin.connectsto,0,0,0,0,0,0,0,0
OpenTOSCA_container,org.opentosca.planbuilder.type.plugin.connectsto.bpel,0,1,0,0,0,0,0,1
OpenTOSCA_container,org.opentosca.planbuilder.type.plugin.connectsto.bpel.handler,0,0,0,0,0,1,0,1
OpenTOSCA_container,org.opentosca.planbuilder.type.plugin.connectsto.core,0,0,0,0,0,0,0,0
OpenTOSCA_container,org.opentosca.planbuilder.type.plugin.connectsto.core.handler,0,0,0,0,0,0,0,0
OpenTOSCA_container,org.opentosca.planbuilder.type.plugin.dockercontainer,0,0,0,0,0,0,0,0
OpenTOSCA_container,org.opentosca.planbuilder.type.plugin.dockercontainer.bpel,0,1,0,0,0,1,0,2
OpenTOSCA_container,org.opentosca.planbuilder.type.plugin.dockercontainer.bpel.handler,0,0,0,0,0,1,0,1
OpenTOSCA_container,org.opentosca.planbuilder.type.plugin.dockercontainer.core,0,0,0,0,0,1,0,1
OpenTOSCA_container,org.opentosca.planbuilder.type.plugin.dockercontainer.core.handler,0,0,0,0,0,0,0,0
OpenTOSCA_container,org.opentosca.planbuilder.type.plugin.hardware,0,0,0,0,0,0,0,0
OpenTOSCA_container,org.opentosca.planbuilder.type.plugin.mosquittoconnectsto,0,0,0,0,0,0,0,0
OpenTOSCA_container,org.opentosca.planbuilder.type.plugin.mosquittoconnectsto.bpel,0,1,0,0,0,0,0,1
OpenTOSCA_container,org.opentosca.planbuilder.type.plugin.mosquittoconnectsto.bpel.handler,0,0,0,0,0,0,0,0
OpenTOSCA_container,org.opentosca.planbuilder.type.plugin.mosquittoconnectsto.core,0,0,0,0,0,0,0,0
OpenTOSCA_container,org.opentosca.planbuilder.type.plugin.mosquittoconnectsto.core.handler,0,0,0,0,0,0,0,0
OpenTOSCA_container,org.opentosca.planbuilder.type.plugin.patternbased,0,0,0,0,0,0,0,0
OpenTOSCA_container,org.opentosca.planbuilder.type.plugin.patternbased.bpel,0,0,0,0,1,0,0,1
OpenTOSCA_container,org.opentosca.planbuilder.type.plugin.platforms,0,0,0,0,0,0,0,0
OpenTOSCA_container,org.opentosca.planbuilder.type.plugin.ubuntuvm,0,0,0,0,0,0,0,0
OpenTOSCA_container,org.opentosca.planbuilder.type.plugin.ubuntuvm.bpel,0,0,0,0,0,0,0,0
opentripplanner_OpenTripPlanner,com.google.transit.realtime,0,0,0,2,0,0,1,3
opentripplanner_OpenTripPlanner,com.jhlabs.awt,0,0,0,0,0,0,1,1
opentripplanner_OpenTripPlanner,org.opensphere.geometry.algorithm,0,0,0,0,0,0,1,1
opentripplanner_OpenTripPlanner,org.opensphere.geometry.triangulation,0,0,0,0,0,0,1,1
opentripplanner_OpenTripPlanner,org.opensphere.geometry.triangulation.model,0,0,0,0,0,0,1,1
opentripplanner_OpenTripPlanner,org.opentripplanner.analyst.batch,0,0,0,0,1,0,1,2
opentripplanner_OpenTripPlanner,org.opentripplanner.analyst.batch.aggregator,0,0,0,0,0,0,1,1
opentripplanner_OpenTripPlanner,org.opentripplanner.analyst.broker,0,0,0,0,1,0,1,2
opentripplanner_OpenTripPlanner,org.opentripplanner.analyst.cluster,0,0,0,0,0,0,1,1
opentripplanner_OpenTripPlanner,org.opentripplanner.analyst.core,10,1,0,0,1,1,1,14
opentripplanner_OpenTripPlanner,org.opentripplanner.analyst,20,1,0,0,1,0,1,23
opentripplanner_OpenTripPlanner,org.opentripplanner.analyst.pointset,0,0,0,0,0,0,1,1
opentripplanner_OpenTripPlanner,org.opentripplanner.analyst.request,2,0,0,0,1,0,1,4
opentripplanner_OpenTripPlanner,org.opentripplanner.analyst.scenario,2,1,0,0,1,0,1,5
opentripplanner_OpenTripPlanner,org.opentripplanner.api.adapters,0,0,0,0,1,1,1,3
opentripplanner_OpenTripPlanner,org.opentripplanner.api.common,0,0,0,0,0,0,1,1
opentripplanner_OpenTripPlanner,org.opentripplanner.api.model,3,0,0,0,1,0,1,5
opentripplanner_OpenTripPlanner,org.opentripplanner.api.model.alertpatch,0,0,0,0,0,0,1,1
opentripplanner_OpenTripPlanner,org.opentripplanner.api.model.error,0,0,0,0,0,0,1,1
opentripplanner_OpenTripPlanner,org.opentripplanner.api,0,0,0,0,0,0,1,1
opentripplanner_OpenTripPlanner,org.opentripplanner.api.param,0,0,0,0,0,0,1,1
opentripplanner_OpenTripPlanner,org.opentripplanner.api.parameter,1,1,0,0,1,0,1,4
opentripplanner_OpenTripPlanner,org.opentripplanner.api.resource,15,0,0,1,1,0,1,18
opentripplanner_OpenTripPlanner,org.opentripplanner.calendar.impl,0,0,0,0,0,2,1,3
opentripplanner_OpenTripPlanner,org.opentripplanner.common,11,1,0,0,1,0,1,14
opentripplanner_OpenTripPlanner,org.opentripplanner.common.geometry,15,1,0,1,1,0,1,19
opentripplanner_OpenTripPlanner,org.opentripplanner.common.model,0,0,0,0,0,0,1,1
opentripplanner_OpenTripPlanner,org.opentripplanner.common.pqueue,0,0,0,0,0,0,1,1
opentripplanner_OpenTripPlanner,org.opentripplanner.customize,0,0,0,0,0,0,1,1
opentripplanner_OpenTripPlanner,org.opentripplanner.extra_graph,0,0,0,0,0,0,1,1
opentripplanner_OpenTripPlanner,org.opentripplanner.geocoder,0,0,0,0,1,0,1,2
opentripplanner_OpenTripPlanner,org.opentripplanner.geocoder.bano,0,0,0,0,0,0,1,1
opentripplanner_OpenTripPlanner,org.opentripplanner.geocoder.google,0,0,0,0,1,0,1,2
opentripplanner_OpenTripPlanner,org.opentripplanner.geocoder.nominatim,0,0,0,0,0,0,1,1
opentripplanner_OpenTripPlanner,org.opentripplanner.geocoder.reverse,0,0,0,0,0,0,1,1
opentripplanner_OpenTripPlanner,org.opentripplanner.geocoder.yahoo,0,0,0,0,1,0,1,2
opentripplanner_OpenTripPlanner,org.opentripplanner.graph_builder.annotation,0,0,0,1,0,1,1,3
opentripplanner_OpenTripPlanner,org.opentripplanner.graph_builder,1,0,0,0,1,0,1,3
opentripplanner_OpenTripPlanner,org.opentripplanner.graph_builder.linking,2,0,0,0,1,0,1,4
opentripplanner_OpenTripPlanner,org.opentripplanner.graph_builder.model,1,1,0,0,0,1,1,4
opentripplanner_OpenTripPlanner,org.opentripplanner.graph_builder.module.bike,0,0,0,0,0,0,1,1
opentripplanner_OpenTripPlanner,org.opentripplanner.graph_builder.module,23,1,0,0,1,1,1,27
opentripplanner_OpenTripPlanner,org.opentripplanner.graph_builder.module.extra_elevation_data,0,0,0,0,0,0,1,1
opentripplanner_OpenTripPlanner,org.opentripplanner.graph_builder.module.map,0,0,0,0,1,0,1,2
opentripplanner_OpenTripPlanner,org.opentripplanner.graph_builder.module.ned,0,0,0,0,1,0,1,2
opentripplanner_OpenTripPlanner,org.opentripplanner.graph_builder.module.osm,17,0,0,1,1,3,1,23
opentripplanner_OpenTripPlanner,org.opentripplanner.graph_builder.module.shapefile,0,0,0,0,1,0,1,2
opentripplanner_OpenTripPlanner,org.opentripplanner.graph_builder.module.stopsAlerts,0,0,0,0,0,0,1,1
opentripplanner_OpenTripPlanner,org.opentripplanner.graph_builder.services,0,0,0,0,0,0,1,1
opentripplanner_OpenTripPlanner,org.opentripplanner.graph_builder.services.ned,0,0,0,0,0,0,1,1
opentripplanner_OpenTripPlanner,org.opentripplanner.graph_builder.services.osm,0,0,0,0,0,0,1,1
opentripplanner_OpenTripPlanner,org.opentripplanner.graph_builder.services.shapefile,0,0,0,0,0,0,1,1
opentripplanner_OpenTripPlanner,org.opentripplanner.gtfs,19,1,0,0,1,3,1,25
opentripplanner_OpenTripPlanner,org.opentripplanner.gtfs.mapping,0,0,0,1,1,0,1,3
opentripplanner_OpenTripPlanner,org.opentripplanner.index,2,0,0,0,0,0,1,3
opentripplanner_OpenTripPlanner,org.opentripplanner.index.model,1,0,0,0,1,0,1,3
opentripplanner_OpenTripPlanner,org.opentripplanner.inspector,0,0,0,0,1,0,1,2
opentripplanner_OpenTripPlanner,org.opentripplanner.internals,0,0,0,0,0,0,1,1
opentripplanner_OpenTripPlanner,org.opentripplanner.kryo,0,0,0,0,0,0,1,1
opentripplanner_OpenTripPlanner,org.opentripplanner.model,0,0,0,0,1,4,1,6
opentripplanner_OpenTripPlanner,org.opentripplanner.model.calendar,0,0,0,0,0,2,1,3
opentripplanner_OpenTripPlanner,org.opentripplanner.model.impl,0,0,0,0,0,0,1,1
opentripplanner_OpenTripPlanner,org.opentripplanner.model.json_serialization,0,0,0,0,1,0,1,2
opentripplanner_OpenTripPlanner,org.opentripplanner.openstreetmap.impl,3,0,0,0,1,2,1,7
opentripplanner_OpenTripPlanner,org.opentripplanner.openstreetmap.model,4,1,0,0,1,2,1,9
opentripplanner_OpenTripPlanner,org.opentripplanner.openstreetmap.services,0,0,0,0,0,1,1,2
opentripplanner_OpenTripPlanner,org.opentripplanner.profile,10,1,0,1,1,0,1,14
opentripplanner_OpenTripPlanner,org.opentripplanner.profile.fares,0,0,0,0,0,0,1,1
opentripplanner_OpenTripPlanner,org.opentripplanner.reflect,0,0,0,0,0,0,1,1
opentripplanner_OpenTripPlanner,org.opentripplanner.routing.alertpatch,8,1,0,0,0,1,1,11
opentripplanner_OpenTripPlanner,org.opentripplanner.routing.algorithm,3,0,0,0,1,6,1,11
opentripplanner_OpenTripPlanner,org.opentripplanner.routing.algorithm.strategies,0,0,0,0,1,0,1,2
opentripplanner_OpenTripPlanner,org.opentripplanner.routing.bike_park,0,0,0,0,0,0,1,1
opentripplanner_OpenTripPlanner,org.opentripplanner.routing.bike_rental,0,0,0,0,0,0,1,1
opentripplanner_OpenTripPlanner,org.opentripplanner.routing.core,13,1,0,1,1,8,1,25
opentripplanner_OpenTripPlanner,org.opentripplanner.routing.edgetype,13,1,0,1,1,3,1,20
opentripplanner_OpenTripPlanner,org.opentripplanner.routing.edgetype.factory,3,1,0,0,1,1,1,7
opentripplanner_OpenTripPlanner,org.opentripplanner.routing.edgetype.flex,0,0,0,0,1,0,1,2
opentripplanner_OpenTripPlanner,org.opentripplanner.routing.error,0,0,0,0,0,0,1,1
opentripplanner_OpenTripPlanner,org.opentripplanner.routing.fares,4,0,0,0,0,0,1,5
opentripplanner_OpenTripPlanner,org.opentripplanner.routing.flex,0,0,0,0,1,1,1,3
opentripplanner_OpenTripPlanner,org.opentripplanner.routing.graph,16,1,0,0,1,10,1,29
opentripplanner_OpenTripPlanner,org.opentripplanner.routing.impl,7,1,0,1,1,0,1,11
opentripplanner_OpenTripPlanner,org.opentripplanner.routing.location,0,0,0,0,0,0,1,1
opentripplanner_OpenTripPlanner,org.opentripplanner.routing.request,0,0,0,0,0,0,1,1
opentripplanner_OpenTripPlanner,org.opentripplanner.routing.services,0,0,0,0,1,1,1,3
opentripplanner_OpenTripPlanner,org.opentripplanner.routing.services.notes,0,0,0,0,1,0,1,2
opentripplanner_OpenTripPlanner,org.opentripplanner.routing.spt,2,0,0,0,1,7,1,11
opentripplanner_OpenTripPlanner,org.opentripplanner.routing.transit_index,0,0,0,0,0,0,1,1
opentripplanner_OpenTripPlanner,org.opentripplanner.routing.trippattern,4,1,0,0,1,0,1,7
opentripplanner_OpenTripPlanner,org.opentripplanner.routing.util.elevation,0,0,0,0,0,0,1,1
opentripplanner_OpenTripPlanner,org.opentripplanner.routing.util,1,0,0,0,1,0,1,3
opentripplanner_OpenTripPlanner,org.opentripplanner.routing.vertextype,28,1,0,1,1,2,1,34
opentripplanner_OpenTripPlanner,org.opentripplanner.routing.vertextype.flex,0,0,0,0,0,0,1,1
opentripplanner_OpenTripPlanner,org.opentripplanner.scripting.api,0,0,0,0,1,0,1,2
opentripplanner_OpenTripPlanner,org.opentripplanner.scripting.impl,0,0,0,0,0,0,1,1
opentripplanner_OpenTripPlanner,org.opentripplanner.standalone,5,1,0,0,1,0,1,8
opentripplanner_OpenTripPlanner,org.opentripplanner.updater.alerts,0,0,0,0,0,0,1,1
opentripplanner_OpenTripPlanner,org.opentripplanner.updater.bike_park,0,0,0,0,0,0,1,1
opentripplanner_OpenTripPlanner,org.opentripplanner.updater.bike_rental,0,0,0,0,1,0,1,2
opentripplanner_OpenTripPlanner,org.opentripplanner.updater.example,0,0,0,0,0,0,1,1
opentripplanner_OpenTripPlanner,org.opentripplanner.updater,0,0,0,0,1,0,1,2
opentripplanner_OpenTripPlanner,org.opentripplanner.updater.stoptime,3,0,0,0,1,0,1,5
opentripplanner_OpenTripPlanner,org.opentripplanner.updater.street_notes,0,0,0,0,0,0,1,1
opentripplanner_OpenTripPlanner,org.opentripplanner.util,0,0,0,1,1,1,1,4
opentripplanner_OpenTripPlanner,org.opentripplanner.util.model,0,0,0,0,0,0,1,1
opentripplanner_OpenTripPlanner,org.opentripplanner.util.monitoring,0,0,0,0,0,0,1,1
opentripplanner_OpenTripPlanner,org.opentripplanner.util.stats,0,0,0,0,0,0,1,1
opentripplanner_OpenTripPlanner,org.opentripplanner.util.xml,0,0,0,0,0,0,1,1
opentripplanner_OpenTripPlanner,org.opentripplanner.visibility,0,0,0,0,0,0,1,1
opentripplanner_OpenTripPlanner,org.opentripplanner.visualizer,0,0,0,0,1,0,1,2
opentripplanner_OpenTripPlanner,org.opentripplanner,10,1,0,0,0,0,1,12
opentripplanner_OpenTripPlanner,org.opentripplanner.geocoder.ws,0,0,0,0,0,0,1,1
opentripplanner_OpenTripPlanner,org.opentripplanner.graph_builder.module.linking,0,0,0,0,0,0,1,1
opentripplanner_OpenTripPlanner,org.opentripplanner.mmri,0,0,0,0,0,0,1,1
opentripplanner_OpenTripPlanner,org.opentripplanner.routing.edgetype.loader,0,0,0,0,0,1,1,2
opentripplanner_OpenTripPlanner,org.opentripplanner.routing,0,0,0,0,0,0,1,1
operasoftware_operaprestodriver,com.opera.core.systems,5,1,0,1,1,0,0,8
operasoftware_operaprestodriver,com.opera.core.systems.arguments.interfaces,0,0,0,0,0,0,0,0
operasoftware_operaprestodriver,com.opera.core.systems.arguments,1,1,0,0,0,0,0,2
operasoftware_operaprestodriver,com.opera.core.systems.common.collect,0,0,0,0,0,0,0,0
operasoftware_operaprestodriver,com.opera.core.systems.common.hash,0,0,0,0,0,0,0,0
operasoftware_operaprestodriver,com.opera.core.systems.common.io,0,0,0,0,0,0,0,0
operasoftware_operaprestodriver,com.opera.core.systems.common.lang,0,0,0,0,0,0,0,0
operasoftware_operaprestodriver,com.opera.core.systems.internal,0,0,0,0,1,0,0,1
operasoftware_operaprestodriver,com.opera.core.systems.internal.input,0,0,0,0,0,0,0,0
operasoftware_operaprestodriver,com.opera.core.systems.mobile,0,0,0,0,0,0,0,0
operasoftware_operaprestodriver,com.opera.core.systems.model,0,0,0,0,1,0,0,1
operasoftware_operaprestodriver,com.opera.core.systems.preferences,0,0,0,0,1,0,0,1
operasoftware_operaprestodriver,com.opera.core.systems.runner,1,1,0,0,0,0,0,2
operasoftware_operaprestodriver,com.opera.core.systems.runner.inprocess,0,0,0,0,0,0,0,0
operasoftware_operaprestodriver,com.opera.core.systems.runner.launcher,0,0,0,1,1,0,0,2
operasoftware_operaprestodriver,com.opera.core.systems.scope,0,0,0,0,1,0,0,1
operasoftware_operaprestodriver,com.opera.core.systems.scope.exceptions,0,0,0,0,0,0,0,0
operasoftware_operaprestodriver,com.opera.core.systems.scope.handlers,0,0,0,0,0,0,0,0
operasoftware_operaprestodriver,com.opera.core.systems.scope.internal,0,0,0,0,0,0,0,0
operasoftware_operaprestodriver,com.opera.core.systems.scope.protos,0,0,0,2,1,0,0,3
operasoftware_operaprestodriver,com.opera.core.systems.scope.services,0,0,0,0,1,0,0,1
operasoftware_operaprestodriver,com.opera.core.systems.scope.services.desktop,0,0,0,0,0,0,0,0
operasoftware_operaprestodriver,com.opera.core.systems.scope.stp.services.desktop,0,0,0,0,0,0,0,0
operasoftware_operaprestodriver,com.opera.core.systems.scope.stp.services,0,0,0,0,1,0,0,1
operasoftware_operaprestodriver,com.opera.core.systems.scope.stp,0,0,0,0,0,0,0,0
operasoftware_operaprestodriver,com.opera.core.systems.environment,2,0,0,0,0,0,0,2
operasoftware_operaprestodriver,com.opera.core.systems.environment.webserver,3,1,0,0,0,0,0,4
operasoftware_operaprestodriver,com.opera.core.systems.pages,1,1,0,0,0,0,0,2
optimaize_language-detector,com.optimaize.langdetect.cybozu,0,0,0,0,0,1,0,1
optimaize_language-detector,com.optimaize.langdetect.cybozu.util,1,0,0,0,1,0,0,2
optimaize_language-detector,com.optimaize.langdetect,1,0,0,0,1,1,0,3
optimaize_language-detector,com.optimaize.langdetect.frma,0,0,0,0,1,0,0,1
optimaize_language-detector,com.optimaize.langdetect.i18n,0,0,0,0,0,2,0,2
optimaize_language-detector,com.optimaize.langdetect.ngram,1,1,0,0,1,0,0,3
optimaize_language-detector,com.optimaize.langdetect.profiles,2,1,0,0,1,1,0,5
optimaize_language-detector,com.optimaize.langdetect.profiles.util,2,0,0,0,0,1,0,3
optimaize_language-detector,com.optimaize.langdetect.text,0,0,0,0,0,0,0,0
orangesignal_orangesignal-csv,com.orangesignal.csv.annotation,0,0,0,0,0,0,0,0
orangesignal_orangesignal-csv,com.orangesignal.csv.bean,0,0,0,0,1,1,0,2
orangesignal_orangesignal-csv,com.orangesignal.csv,2,1,0,0,0,3,0,6
orangesignal_orangesignal-csv,com.orangesignal.csv.entryfilters,0,0,0,0,0,0,0,0
orangesignal_orangesignal-csv,com.orangesignal.csv.filters,0,0,0,1,0,3,0,4
orangesignal_orangesignal-csv,com.orangesignal.csv.handlers,2,0,0,0,0,2,0,4
orangesignal_orangesignal-csv,com.orangesignal.csv.io,1,0,0,0,1,3,0,5
orangesignal_orangesignal-csv,com.orangesignal.csv.manager,0,0,0,0,0,0,0,0
orangesignal_orangesignal-csv,com.orangesignal.jlha,0,0,0,1,0,0,0,1
orangesignal_orangesignal-csv,com.orangesignal.csv.entity,0,0,0,0,1,0,0,1
orangesignal_orangesignal-csv,com.orangesignal.csv.model,0,0,0,0,0,0,0,0
OrbitzWorldwide_consul-client,com.orbitz.consul,2,1,0,1,1,1,0,6
OrbitzWorldwide_consul-client,com.orbitz.consul.cache,1,0,0,0,1,0,0,2
OrbitzWorldwide_consul-client,com.orbitz.consul.failover,0,0,0,0,0,0,0,0
OrbitzWorldwide_consul-client,com.orbitz.consul.util,1,1,0,0,1,0,0,3
OrbitzWorldwide_consul-client,com.orbitz.consul.async,0,0,0,0,0,0,0,0
OrbitzWorldwide_consul-client,com.orbitz.consul.config,0,0,0,0,1,0,0,1
OrbitzWorldwide_consul-client,com.orbitz.consul.model.acl,0,0,0,1,1,0,0,2
OrbitzWorldwide_consul-client,com.orbitz.consul.model.agent,0,0,0,1,1,0,0,2
OrbitzWorldwide_consul-client,com.orbitz.consul.model.catalog,0,0,0,0,1,0,0,1
OrbitzWorldwide_consul-client,com.orbitz.consul.model,0,0,0,0,0,1,0,1
OrbitzWorldwide_consul-client,com.orbitz.consul.model.coordinate,0,0,0,0,1,0,0,1
OrbitzWorldwide_consul-client,com.orbitz.consul.model.event,0,0,0,0,0,1,0,1
OrbitzWorldwide_consul-client,com.orbitz.consul.model.health,0,0,0,0,1,0,0,1
OrbitzWorldwide_consul-client,com.orbitz.consul.model.kv,0,0,0,0,1,0,0,1
OrbitzWorldwide_consul-client,com.orbitz.consul.model.operator,0,0,0,0,1,0,0,1
OrbitzWorldwide_consul-client,com.orbitz.consul.model.query,0,0,0,1,1,0,0,2
OrbitzWorldwide_consul-client,com.orbitz.consul.model.session,0,0,0,0,1,0,0,1
OrbitzWorldwide_consul-client,com.orbitz.consul.monitoring,0,0,0,0,0,0,0,0
OrbitzWorldwide_consul-client,com.orbitz.consul.option,0,0,0,0,0,0,0,0
OrbitzWorldwide_consul-client,com.orbitz.consul.util.bookend,0,0,0,0,0,0,0,0
OrbitzWorldwide_consul-client,com.orbitz.consul.util.failover,0,0,0,0,0,0,0,0
OrbitzWorldwide_consul-client,com.orbitz.consul.util.failover.strategy,0,0,0,0,0,0,0,0
orctom_was-maven-plugin,com.orctom.mojo.was,1,0,0,0,0,0,0,1
orctom_was-maven-plugin,com.orctom.mojo.was.utils,1,0,0,0,0,0,0,1
orientechnologies_orientdb-etl,com.orientechnologies.orient.etl.block,0,0,0,0,0,0,0,0
orientechnologies_orientdb-etl,com.orientechnologies.orient.etl.extractor,0,0,0,0,1,0,0,1
orientechnologies_orientdb-etl,com.orientechnologies.orient.etl.listener,0,0,0,0,0,0,0,0
orientechnologies_orientdb-etl,com.orientechnologies.orient.etl.loader,0,0,0,0,1,0,0,1
orientechnologies_orientdb-etl,com.orientechnologies.orient.etl,1,1,0,0,1,0,0,3
orientechnologies_orientdb-etl,com.orientechnologies.orient.etl.source,0,0,0,0,1,0,0,1
orientechnologies_orientdb-etl,com.orientechnologies.orient.etl.transformer,1,0,0,0,1,0,0,2
orientechnologies_orientdb-lucene,com.orientechnologies.lucene.collections,0,0,0,0,0,0,0,0
orientechnologies_orientdb-lucene,com.orientechnologies.lucene.exception,0,0,0,0,0,0,0,0
orientechnologies_orientdb-lucene,com.orientechnologies.lucene.functions,0,0,0,0,0,0,0,0
orientechnologies_orientdb-lucene,com.orientechnologies.lucene.handler,0,0,0,0,0,0,0,0
orientechnologies_orientdb-lucene,com.orientechnologies.lucene.hook,0,0,0,0,0,0,0,0
orientechnologies_orientdb-lucene,com.orientechnologies.lucene.index,0,0,0,0,0,0,0,0
orientechnologies_orientdb-lucene,com.orientechnologies.lucene,1,0,0,0,1,0,0,2
orientechnologies_orientdb-lucene,com.orientechnologies.lucene.manager,1,1,0,0,0,0,0,2
orientechnologies_orientdb-lucene,com.orientechnologies.lucene.operator,0,0,0,0,0,0,0,0
orientechnologies_orientdb-lucene,com.orientechnologies.lucene.query,0,0,0,0,0,0,0,0
orientechnologies_orientdb-lucene,com.orientechnologies.lucene.shape,0,0,0,0,0,0,0,0
orientechnologies_orientdb-lucene,com.orientechnologies.lucene.utils,0,0,0,0,0,0,0,0
OryxProject_oryx,com.cloudera.oryx.example.batch,0,0,0,0,0,0,1,1
OryxProject_oryx,com.cloudera.oryx.example.serving,0,0,0,0,0,0,1,1
OryxProject_oryx,com.cloudera.oryx.example.speed,0,0,0,0,0,0,1,1
OryxProject_oryx,com.cloudera.oryx.app.speed.als,0,0,0,0,1,1,1,3
OryxProject_oryx,com.cloudera.oryx.app.speed.kmeans,0,0,0,0,1,0,1,2
OryxProject_oryx,com.cloudera.oryx.app.speed.rdf,0,0,0,0,1,0,1,2
OryxProject_oryx,com.cloudera.oryx.app.als,0,0,0,0,0,3,1,4
OryxProject_oryx,com.cloudera.oryx.app.classreg.example,0,0,0,0,0,1,1,2
OryxProject_oryx,com.cloudera.oryx.app.classreg.predict,0,0,0,0,0,1,1,2
OryxProject_oryx,com.cloudera.oryx.app.common.fn,0,1,0,0,0,0,1,2
OryxProject_oryx,com.cloudera.oryx.app.kmeans,0,0,0,0,1,0,1,2
OryxProject_oryx,com.cloudera.oryx.app.pmml,0,0,0,0,0,0,1,1
OryxProject_oryx,com.cloudera.oryx.app.rdf.decision,0,0,0,0,0,0,1,1
OryxProject_oryx,com.cloudera.oryx.app.rdf,0,0,0,0,0,0,1,1
OryxProject_oryx,com.cloudera.oryx.app.rdf.tree,0,0,0,0,0,2,1,3
OryxProject_oryx,com.cloudera.oryx.app.schema,0,0,0,0,0,0,1,1
OryxProject_oryx,com.cloudera.oryx.app.batch.mllib.als,0,0,0,0,1,0,1,2
OryxProject_oryx,com.cloudera.oryx.app.batch.mllib.kmeans,0,0,0,0,1,0,1,2
OryxProject_oryx,com.cloudera.oryx.app.batch.mllib.rdf,0,0,0,0,1,0,1,2
OryxProject_oryx,com.cloudera.oryx.app.batch.mllib,0,0,0,0,0,0,1,1
OryxProject_oryx,com.cloudera.oryx.app.serving,0,0,0,0,1,1,1,3
OryxProject_oryx,com.cloudera.oryx.app.serving.als,0,0,0,1,1,0,1,3
OryxProject_oryx,com.cloudera.oryx.app.serving.als.model,0,1,0,0,1,1,1,4
OryxProject_oryx,com.cloudera.oryx.app.serving.classreg.model,0,0,0,0,0,0,1,1
OryxProject_oryx,com.cloudera.oryx.app.serving.classreg,0,0,0,0,0,0,1,1
OryxProject_oryx,com.cloudera.oryx.app.serving.clustering,0,0,0,0,0,0,1,1
OryxProject_oryx,com.cloudera.oryx.app.serving.clustering.model,0,0,0,0,0,0,1,1
OryxProject_oryx,com.cloudera.oryx.app.serving.kmeans,0,0,0,0,1,0,1,2
OryxProject_oryx,com.cloudera.oryx.app.serving.kmeans.model,0,0,0,0,0,0,1,1
OryxProject_oryx,com.cloudera.oryx.app.serving.rdf,0,0,0,0,1,1,1,3
OryxProject_oryx,com.cloudera.oryx.app.serving.rdf.model,0,0,0,0,0,1,1,2
OryxProject_oryx,com.cloudera.oryx.app.traffic.als,0,0,0,0,0,0,1,1
OryxProject_oryx,com.cloudera.oryx.app.traffic,0,0,0,0,0,0,1,1
OryxProject_oryx,com.cloudera.oryx.batch,0,0,0,0,0,0,1,1
OryxProject_oryx,com.cloudera.oryx.serving,0,0,0,0,0,0,1,1
OryxProject_oryx,com.cloudera.oryx.speed,0,0,0,0,0,0,1,1
OryxProject_oryx,com.cloudera.oryx.kafka.util,0,0,0,0,0,0,1,1
OryxProject_oryx,com.cloudera.oryx.api.batch,0,0,0,0,0,0,1,1
OryxProject_oryx,com.cloudera.oryx.api,0,0,0,0,0,0,1,1
OryxProject_oryx,com.cloudera.oryx.api.serving,0,0,0,0,1,0,1,2
OryxProject_oryx,com.cloudera.oryx.api.speed,0,0,0,0,0,0,1,1
OryxProject_oryx,com.cloudera.oryx.common.collection,0,0,0,0,0,0,1,1
OryxProject_oryx,com.cloudera.oryx.common.io,0,0,0,0,0,0,1,1
OryxProject_oryx,com.cloudera.oryx.common.lang,0,0,0,0,1,3,1,5
OryxProject_oryx,com.cloudera.oryx.common.math,0,0,0,0,1,1,1,3
OryxProject_oryx,com.cloudera.oryx.common,0,0,0,0,0,0,1,1
OryxProject_oryx,com.cloudera.oryx.common.pmml,0,0,0,0,0,0,1,1
OryxProject_oryx,com.cloudera.oryx.common.random,0,0,0,0,0,0,1,1
OryxProject_oryx,com.cloudera.oryx.common.settings,0,0,0,0,0,0,1,1
OryxProject_oryx,com.cloudera.oryx.common.text,0,0,0,0,0,0,1,1
OryxProject_oryx,com.cloudera.oryx.lambda,0,0,0,0,1,0,1,2
OryxProject_oryx,com.cloudera.oryx.lambda.batch,0,0,0,0,1,0,1,2
OryxProject_oryx,com.cloudera.oryx.lambda.speed,0,0,0,0,1,0,1,2
OryxProject_oryx,com.cloudera.oryx.lambda.serving,0,0,0,0,1,0,1,2
OryxProject_oryx,com.cloudera.oryx.ml,0,0,0,0,0,0,1,1
OryxProject_oryx,com.cloudera.oryx.ml.param,0,0,0,0,1,0,1,2
oswetto_Loboevolution,org.json,0,0,0,0,0,0,1,1
oswetto_Loboevolution,org.loboevolution.component,1,1,0,0,0,7,1,10
oswetto_Loboevolution,org.loboevolution.component.input,0,0,0,0,0,0,1,1
oswetto_Loboevolution,org.loboevolution.tab,1,1,0,0,1,3,1,7
oswetto_Loboevolution,org.w3c.dom.css,0,0,0,0,0,0,1,1
oswetto_Loboevolution,org.w3c.dom.xpath,0,0,0,0,1,0,1,2
oswetto_Loboevolution,org.loboevolution.common,0,0,0,0,1,23,1,25
oswetto_Loboevolution,org.loboevolution.html,0,0,0,0,0,1,1,2
oswetto_Loboevolution,org.loboevolution.info,0,0,0,0,1,14,1,16
oswetto_Loboevolution,org.loboevolution.laf,0,1,0,0,0,4,1,6
oswetto_Loboevolution,org.loboevolution.net,1,1,0,0,0,3,1,6
oswetto_Loboevolution,org.loboevolution.store,1,0,0,0,0,10,1,12
oswetto_Loboevolution,org.loboevolution.util,0,0,0,0,0,0,1,1
oswetto_Loboevolution,org.loboevolution.gui,0,0,0,0,1,3,1,5
oswetto_Loboevolution,org.loboevolution.http,5,1,0,0,1,11,1,19
oswetto_Loboevolution,org.loboevolution.init,2,1,0,0,0,0,1,4
oswetto_Loboevolution,org.loboevolution.install,1,1,0,0,0,1,1,4
oswetto_Loboevolution,org.loboevolution.menu,1,1,0,0,0,0,1,3
oswetto_Loboevolution,org.loboevolution.menu.bookmarks,0,0,0,0,0,0,1,1
oswetto_Loboevolution,org.loboevolution.menu.crono,0,0,0,0,0,1,1,2
oswetto_Loboevolution,org.loboevolution.menu.file,0,0,0,0,0,0,1,1
oswetto_Loboevolution,org.loboevolution.menu.tools.clear,0,0,0,0,0,0,1,1
oswetto_Loboevolution,org.loboevolution.menu.tools.pref,1,0,0,0,0,1,1,3
oswetto_Loboevolution,org.loboevolution.menu.tools.pref.data,0,0,0,0,0,1,1,2
oswetto_Loboevolution,org.loboevolution.menu.tools.pref.search,0,0,0,0,1,2,1,4
oswetto_Loboevolution,org.loboevolution.menu.tools.pref.startup,0,0,0,0,0,0,1,1
oswetto_Loboevolution,org.loboevolution.menu.tools.screen,0,0,0,0,0,0,1,1
oswetto_Loboevolution,org.loboevolution.menu.view,0,0,0,0,1,2,1,4
oswetto_Loboevolution,org.loboevolution.welcome,0,1,0,0,0,1,1,3
oswetto_Loboevolution,org.loboevolution.html.control,2,1,0,1,0,9,1,14
oswetto_Loboevolution,org.loboevolution.html.dom,0,0,0,1,0,1,1,3
oswetto_Loboevolution,org.loboevolution.html.dom.canvas,0,0,0,0,0,1,1,2
oswetto_Loboevolution,org.loboevolution.html.dom.domimpl,8,0,0,1,0,33,1,43
oswetto_Loboevolution,org.loboevolution.html.dom.filter,4,1,0,0,1,1,1,8
oswetto_Loboevolution,org.loboevolution.html.dom.smil,0,0,0,0,1,0,1,2
oswetto_Loboevolution,org.loboevolution.html.dom.svg,0,0,0,1,1,1,1,4
oswetto_Loboevolution,org.loboevolution.html.dom.svgimpl,0,0,0,1,0,5,1,7
oswetto_Loboevolution,org.loboevolution.html.dom.xpath,0,0,0,0,0,0,1,1
oswetto_Loboevolution,org.loboevolution.html.gui,3,1,0,0,1,8,1,14
oswetto_Loboevolution,org.loboevolution.html.io,0,0,0,0,0,0,1,1
oswetto_Loboevolution,org.loboevolution.html.js,4,1,0,0,0,6,1,12
oswetto_Loboevolution,org.loboevolution.html.js.events,0,0,0,0,0,2,1,3
oswetto_Loboevolution,org.loboevolution.html.js.geolocation,1,0,0,0,1,0,1,3
oswetto_Loboevolution,org.loboevolution.html.parser,2,1,0,0,0,0,1,4
oswetto_Loboevolution,org.loboevolution.html.renderer,9,1,0,1,0,15,1,27
oswetto_Loboevolution,org.loboevolution.html.renderstate,6,1,0,0,0,13,1,21
oswetto_Loboevolution,org.loboevolution.html.style,0,1,0,0,1,15,1,18
oswetto_Loboevolution,org.loboevolution.js,0,0,0,0,1,3,1,5
oswetto_Loboevolution,org.loboevolution.img,0,0,0,0,1,1,1,3
oswetto_Loboevolution,com.jtattoo.plaf,0,0,0,1,0,1,1,3
oswetto_Loboevolution,com.jtattoo.plaf.acryl,0,0,0,0,1,0,1,2
oswetto_Loboevolution,com.jtattoo.plaf.aero,0,0,0,0,1,0,1,2
oswetto_Loboevolution,com.jtattoo.plaf.aluminium,0,0,0,0,1,0,1,2
oswetto_Loboevolution,com.jtattoo.plaf.bernstein,0,0,0,0,0,0,1,1
oswetto_Loboevolution,com.jtattoo.plaf.fast,0,0,0,0,1,0,1,2
oswetto_Loboevolution,com.jtattoo.plaf.graphite,0,0,0,0,1,0,1,2
oswetto_Loboevolution,com.jtattoo.plaf.hifi,0,0,0,1,1,0,1,3
oswetto_Loboevolution,com.jtattoo.plaf.luna,0,0,0,0,1,1,1,3
oswetto_Loboevolution,com.jtattoo.plaf.mcwin,0,0,0,1,1,0,1,3
oswetto_Loboevolution,com.jtattoo.plaf.mint,0,0,0,0,1,0,1,2
oswetto_Loboevolution,com.jtattoo.plaf.noire,0,0,0,0,0,0,1,1
oswetto_Loboevolution,com.jtattoo.plaf.smart,0,0,0,0,1,0,1,2
oswetto_Loboevolution,com.jtattoo.plaf.texture,0,0,0,1,0,1,1,3
oswetto_Loboevolution,com.gargoylesoftware.css.dom,2,0,0,0,0,1,1,4
oswetto_Loboevolution,com.gargoylesoftware.css.parser,3,1,0,0,0,2,1,7
oswetto_Loboevolution,com.gargoylesoftware.css.parser.condition,0,0,0,0,0,0,1,1
oswetto_Loboevolution,com.gargoylesoftware.css.parser.javacc,2,0,0,0,1,2,1,6
oswetto_Loboevolution,com.gargoylesoftware.css.parser.media,0,0,0,0,0,1,1,2
oswetto_Loboevolution,com.gargoylesoftware.css.parser.selector,0,0,0,0,0,1,1,2
oswetto_Loboevolution,com.gargoylesoftware.css.util,0,0,0,0,0,0,1,1
oswetto_Loboevolution,org.mozilla.classfile,1,1,0,0,0,3,1,6
oswetto_Loboevolution,org.mozilla.javascript,4,1,0,2,0,6,1,14
oswetto_Loboevolution,org.mozilla.javascript.ast,1,1,0,1,0,3,1,7
oswetto_Loboevolution,org.mozilla.javascript.commonjs.module,0,0,0,0,0,0,1,1
oswetto_Loboevolution,org.mozilla.javascript.commonjs.module.provider,0,0,0,0,1,0,1,2
oswetto_Loboevolution,org.mozilla.javascript.debug,0,0,0,0,0,0,1,1
oswetto_Loboevolution,org.mozilla.javascript.jdk18,0,0,0,0,0,0,1,1
oswetto_Loboevolution,org.mozilla.javascript.json,1,0,0,0,0,0,1,2
oswetto_Loboevolution,org.mozilla.javascript.optimizer,0,0,0,0,0,4,1,5
oswetto_Loboevolution,org.mozilla.javascript.regexp,0,0,0,0,0,0,1,1
oswetto_Loboevolution,org.mozilla.javascript.serialize,0,0,0,0,0,0,1,1
oswetto_Loboevolution,org.mozilla.javascript.typedarrays,0,0,0,0,0,0,1,1
oswetto_Loboevolution,org.mozilla.javascript.v8dtoa,0,0,0,0,1,0,1,2
oswetto_Loboevolution,org.mozilla.javascript.xml,1,0,0,0,0,0,1,2
oswetto_Loboevolution,org.jpedal.jbig2.decoders,20,1,0,0,0,5,1,27
oswetto_Loboevolution,org.jpedal.jbig2.examples.jai,0,0,0,0,0,0,1,1
oswetto_Loboevolution,org.jpedal.jbig2.examples.pdf,0,0,0,0,0,0,1,1
oswetto_Loboevolution,org.jpedal.jbig2.examples.viewer,0,0,0,0,0,0,1,1
oswetto_Loboevolution,org.jpedal.jbig2.image,7,1,0,0,0,2,1,11
oswetto_Loboevolution,org.jpedal.jbig2.io,0,0,0,0,0,3,1,4
oswetto_Loboevolution,org.jpedal.jbig2.jai,0,0,0,0,0,1,1,2
oswetto_Loboevolution,org.jpedal.jbig2,2,1,0,0,0,1,1,5
oswetto_Loboevolution,org.jpedal.jbig2.segment.extensions,0,0,0,0,0,0,1,1
oswetto_Loboevolution,org.jpedal.jbig2.segment,3,1,0,0,0,3,1,8
oswetto_Loboevolution,org.jpedal.jbig2.segment.pageinformation,3,0,0,0,0,0,1,4
oswetto_Loboevolution,org.jpedal.jbig2.segment.pattern,2,0,0,0,0,0,1,3
oswetto_Loboevolution,org.jpedal.jbig2.segment.region.generic,4,0,0,0,0,0,1,5
oswetto_Loboevolution,org.jpedal.jbig2.segment.region.halftone,2,0,0,0,0,0,1,3
oswetto_Loboevolution,org.jpedal.jbig2.segment.region.refinement,2,0,0,0,0,0,1,3
oswetto_Loboevolution,org.jpedal.jbig2.segment.region,1,1,0,0,0,0,1,3
oswetto_Loboevolution,org.jpedal.jbig2.segment.region.text,3,0,0,0,0,0,1,4
oswetto_Loboevolution,org.jpedal.jbig2.segment.stripes,0,0,0,0,0,0,1,1
oswetto_Loboevolution,org.jpedal.jbig2.segment.symboldictionary,3,0,0,0,0,0,1,4
oswetto_Loboevolution,org.jpedal.jbig2.segment.tables,0,0,0,0,0,0,1,1
oswetto_Loboevolution,org.jpedal.jbig2.util,0,0,0,0,0,4,1,5
oswetto_Loboevolution,org.loboevolution.pdf,0,0,0,0,0,0,1,1
oswetto_Loboevolution,org.loboevolution.pdfview.action,2,0,0,0,0,0,1,3
oswetto_Loboevolution,org.loboevolution.pdfview.annotation,2,0,0,0,0,0,1,3
oswetto_Loboevolution,org.loboevolution.pdfview,15,1,0,1,0,4,1,22
oswetto_Loboevolution,org.loboevolution.pdfview.colorspace,4,1,0,0,1,1,1,8
oswetto_Loboevolution,org.loboevolution.pdfview.decode,2,0,0,0,0,1,1,4
oswetto_Loboevolution,org.loboevolution.pdfview.decrypt,2,0,0,0,0,1,1,4
oswetto_Loboevolution,org.loboevolution.pdfview.font,3,0,0,0,0,2,1,6
oswetto_Loboevolution,org.loboevolution.pdfview.font.cid,1,0,0,0,0,1,1,3
oswetto_Loboevolution,org.loboevolution.pdfview.font.ttf,1,0,0,0,0,1,1,3
oswetto_Loboevolution,org.loboevolution.pdfview.function,3,0,0,0,0,2,1,6
oswetto_Loboevolution,org.loboevolution.pdfview.function.postscript.operation,0,0,0,1,0,0,1,2
oswetto_Loboevolution,org.loboevolution.pdfview.function.postscript,0,0,0,0,0,0,1,1
oswetto_Loboevolution,org.loboevolution.pdfview.pattern,3,0,0,0,0,2,1,6
oswetto_Loboevolution,org.monte.media.jpeg,0,0,0,0,0,0,1,1
otros-systems_otroslogviewer,pl.otros.logview.api.gui,60,1,0,0,1,0,1,63
otros-systems_otroslogviewer,pl.otros.logview.api,38,1,0,0,1,0,1,41
otros-systems_otroslogviewer,pl.otros.logview.api.model,14,1,0,0,1,0,1,17
otros-systems_otroslogviewer,pl.otros.logview.api.pluginable,21,1,0,0,0,0,1,23
otros-systems_otroslogviewer,examples,0,0,0,0,0,0,1,1
otros-systems_otroslogviewer,pl.otros.logview.accept,0,0,0,0,0,0,1,1
otros-systems_otroslogviewer,pl.otros.logview.accept.query.org.apache.log4j.rule,1,0,0,1,0,0,1,3
otros-systems_otroslogviewer,pl.otros.logview.accept.query.org.apache.log4j.spi,1,1,0,0,0,0,1,3
otros-systems_otroslogviewer,pl.otros.logview.accept.query,0,1,0,0,0,0,1,2
otros-systems_otroslogviewer,pl.otros.logview.api.batch,0,0,0,0,1,0,1,2
otros-systems_otroslogviewer,pl.otros.logview.api.importer,2,0,0,0,0,0,1,3
otros-systems_otroslogviewer,pl.otros.logview.api.io,0,1,0,0,1,0,1,3
otros-systems_otroslogviewer,pl.otros.logview.api.loading,5,0,0,0,1,0,1,7
otros-systems_otroslogviewer,pl.otros.logview.api.parser,0,0,0,0,0,0,1,1
otros-systems_otroslogviewer,pl.otros.logview.api.persistance,1,0,0,0,0,0,1,2
otros-systems_otroslogviewer,pl.otros.logview.api.plugins,4,0,0,0,1,0,1,6
otros-systems_otroslogviewer,pl.otros.logview.api.reader,1,0,0,0,0,0,1,2
otros-systems_otroslogviewer,pl.otros.logview.api.services,8,1,0,0,1,0,1,11
otros-systems_otroslogviewer,pl.otros.logview.api.store,0,0,0,0,1,0,1,2
otros-systems_otroslogviewer,pl.otros.logview.api.store.file,0,0,0,0,0,0,1,1
otros-systems_otroslogviewer,pl.otros.logview.api.theme,0,0,0,0,0,0,1,1
otros-systems_otroslogviewer,pl.otros.logview.batch,3,1,0,0,0,0,1,5
otros-systems_otroslogviewer,pl.otros.logview,3,0,0,0,1,0,1,5
otros-systems_otroslogviewer,pl.otros.logview.exceptionshandler,0,0,0,0,1,0,1,2
otros-systems_otroslogviewer,pl.otros.logview.exceptionshandler.errrorreport,0,0,0,0,0,0,1,1
otros-systems_otroslogviewer,pl.otros.logview.filter,4,1,0,0,0,0,1,6
otros-systems_otroslogviewer,pl.otros.logview.gui.actions,18,0,0,1,1,0,1,21
otros-systems_otroslogviewer,pl.otros.logview.gui.actions.globalhotkeys,0,0,0,0,0,0,1,1
otros-systems_otroslogviewer,pl.otros.logview.gui.actions.read,2,1,0,0,1,0,1,5
otros-systems_otroslogviewer,pl.otros.logview.gui.actions.search,3,0,0,0,0,0,1,4
otros-systems_otroslogviewer,pl.otros.logview.gui.actions.table,0,0,0,0,0,0,1,1
otros-systems_otroslogviewer,pl.otros.logview.gui,61,1,0,1,0,0,1,64
otros-systems_otroslogviewer,pl.otros.logview.gui.browser,3,0,0,0,0,0,1,4
otros-systems_otroslogviewer,pl.otros.logview.gui.config,9,0,0,0,1,0,1,11
otros-systems_otroslogviewer,pl.otros.logview.gui.editor.json,0,0,0,0,0,0,1,1
otros-systems_otroslogviewer,pl.otros.logview.gui.editor.log4j,0,0,0,0,0,0,1,1
otros-systems_otroslogviewer,pl.otros.logview.gui.editor,3,0,0,0,0,0,1,4
otros-systems_otroslogviewer,pl.otros.logview.gui.firstuse,4,0,0,0,0,0,1,5
otros-systems_otroslogviewer,pl.otros.logview.gui.markers,1,0,0,0,1,0,1,3
otros-systems_otroslogviewer,pl.otros.logview.gui.markers.editor,1,0,0,0,0,0,1,2
otros-systems_otroslogviewer,pl.otros.logview.gui.message.editor,2,0,0,0,0,0,1,3
otros-systems_otroslogviewer,pl.otros.logview.gui.message.html,1,0,0,0,0,0,1,2
otros-systems_otroslogviewer,pl.otros.logview.gui.message.json,0,0,0,0,0,0,1,1
otros-systems_otroslogviewer,pl.otros.logview.gui.message,2,0,0,0,0,0,1,3
otros-systems_otroslogviewer,pl.otros.logview.gui.message.pattern,1,1,0,0,0,0,1,3
otros-systems_otroslogviewer,pl.otros.logview.gui.message.stacktracecode,0,0,0,0,0,0,1,1
otros-systems_otroslogviewer,pl.otros.logview.gui.message.update,4,0,0,0,0,0,1,5
otros-systems_otroslogviewer,pl.otros.logview.gui.open,3,0,0,0,1,0,1,5
otros-systems_otroslogviewer,pl.otros.logview.gui.renderers,2,0,0,0,1,0,1,4
otros-systems_otroslogviewer,pl.otros.logview.gui.services.jumptocode,1,0,0,0,1,0,1,3
otros-systems_otroslogviewer,pl.otros.logview.gui.services.persist,0,0,0,0,0,0,1,1
otros-systems_otroslogviewer,pl.otros.logview.gui.services.tasks,0,0,0,0,0,0,1,1
otros-systems_otroslogviewer,pl.otros.logview.gui.session,0,0,0,0,0,0,1,1
otros-systems_otroslogviewer,pl.otros.logview.gui.suggestion,3,0,0,0,0,0,1,4
otros-systems_otroslogviewer,pl.otros.logview.gui.table,0,0,0,0,0,0,1,1
otros-systems_otroslogviewer,pl.otros.logview.gui.tip,0,0,0,0,0,0,1,1
otros-systems_otroslogviewer,pl.otros.logview.gui.util,5,1,0,0,1,0,1,8
otros-systems_otroslogviewer,pl.otros.logview.ide,2,0,0,0,0,0,1,3
otros-systems_otroslogviewer,pl.otros.logview.importer,0,0,0,0,1,0,1,2
otros-systems_otroslogviewer,pl.otros.logview.importer.log4jxml,0,0,0,0,1,0,1,2
otros-systems_otroslogviewer,pl.otros.logview.importer.logback,0,0,0,0,0,0,1,1
otros-systems_otroslogviewer,pl.otros.logview.loader,4,1,0,0,1,0,1,7
otros-systems_otroslogviewer,pl.otros.logview.logging,0,0,0,0,0,0,1,1
otros-systems_otroslogviewer,pl.otros.logview.logloader.basic,0,0,0,0,0,0,1,1
otros-systems_otroslogviewer,pl.otros.logview.parser,0,0,0,0,0,0,1,1
otros-systems_otroslogviewer,pl.otros.logview.parser.json,0,0,0,0,0,0,1,1
otros-systems_otroslogviewer,pl.otros.logview.parser.json.log4j2,0,0,0,0,0,0,1,1
otros-systems_otroslogviewer,pl.otros.logview.parser.log4j,1,1,0,0,0,0,1,3
otros-systems_otroslogviewer,pl.otros.logview.pluginable,0,0,0,0,1,0,1,2
otros-systems_otroslogviewer,pl.otros.logview.pluginsimpl,3,0,0,0,0,0,1,4
otros-systems_otroslogviewer,pl.otros.logview.reader,1,0,0,0,0,0,1,2
otros-systems_otroslogviewer,pl.otros.logview.singleinstance,2,0,0,0,0,0,1,3
otros-systems_otroslogviewer,pl.otros.logview.stats,2,0,0,0,1,0,1,4
otros-systems_otroslogviewer,pl.otros.logview.store.async,0,0,0,0,0,0,1,1
otros-systems_otroslogviewer,pl.otros.logview.store.file,0,0,0,0,0,0,1,1
otros-systems_otroslogviewer,pl.otros.logview.uml,0,0,0,0,0,0,1,1
otros-systems_otroslogviewer,pl.otros.logview.util,2,0,0,0,1,0,1,4
otros-systems_otroslogviewer,(default package),0,0,0,0,0,0,1,1
otros-systems_otroslogviewer,pl.otros.logview.accept.query.org.apache.log4j.util,0,0,0,0,0,0,1,1
otros-systems_otroslogviewer,utils,0,0,0,0,0,0,1,1
otros-systems_otroslogviewer,pl.otros.starter,0,0,0,0,0,0,1,1
otros-systems_otroslogviewer,pl.otros.swing.config,1,1,0,0,1,0,1,4
otros-systems_otroslogviewer,pl.otros.swing.config.provider,1,0,0,0,0,0,1,2
otros-systems_otroslogviewer,pl.otros.swing.functional,0,0,0,0,0,0,1,1
otros-systems_otroslogviewer,pl.otros.swing.list,0,0,0,0,0,0,1,1
otros-systems_otroslogviewer,pl.otros.swing,0,0,0,0,0,0,1,1
otros-systems_otroslogviewer,pl.otros.swing.renderer,0,0,0,0,0,0,1,1
otros-systems_otroslogviewer,pl.otros.swing.rulerbar,0,0,0,0,0,0,1,1
otros-systems_otroslogviewer,pl.otros.swing.rulerbar.demo,0,0,0,0,0,0,1,1
otros-systems_otroslogviewer,pl.otros.swing.suggest,0,0,0,0,1,0,1,2
otros-systems_otroslogviewer,pl.otros.swing.suggest.demo,0,0,0,0,0,0,1,1
otros-systems_otroslogviewer,pl.otros.swing.table,0,0,0,0,0,0,1,1
otros-systems_otroslogviewer,pl.otros.swing.text,0,0,0,0,0,0,1,1
otros-systems_otroslogviewer,net.sf.vfsjfilechooser.accessories.bookmarks,0,0,0,0,0,0,1,1
otros-systems_otroslogviewer,net.sf.vfsjfilechooser.utils,0,0,0,0,0,0,1,1
otros-systems_otroslogviewer,pl.otros.vfs.browser.actions,0,0,0,0,1,0,1,2
otros-systems_otroslogviewer,pl.otros.vfs.browser.auth,0,0,0,0,0,0,1,1
otros-systems_otroslogviewer,pl.otros.vfs.browser,2,1,0,0,0,0,1,4
otros-systems_otroslogviewer,pl.otros.vfs.browser.demo,0,0,0,0,0,0,1,1
otros-systems_otroslogviewer,pl.otros.vfs.browser.favorit,0,0,0,0,0,0,1,1
otros-systems_otroslogviewer,pl.otros.vfs.browser.i18n,0,0,0,0,0,0,1,1
otros-systems_otroslogviewer,pl.otros.vfs.browser.list,0,0,0,0,0,0,1,1
otros-systems_otroslogviewer,pl.otros.vfs.browser.listener,0,0,0,0,0,0,1,1
otros-systems_otroslogviewer,pl.otros.vfs.browser.preview,1,0,0,0,0,0,1,2
otros-systems_otroslogviewer,pl.otros.vfs.browser.table,0,0,0,0,1,0,1,2
otros-systems_otroslogviewer,pl.otros.vfs.browser.util,1,1,0,0,0,0,1,3
otros-systems_otroslogviewer,playground,0,0,0,0,0,0,1,1
otros-systems_otroslogviewer,scenario.components,0,0,0,0,0,0,1,1
otros-systems_otroslogviewer,scenario,0,0,0,0,0,0,1,1
otros-systems_otroslogviewer,scenario.log,0,0,0,0,0,0,1,1
otto-de_edison-microservice,de.otto.edison.authentication.configuration,1,1,0,0,0,0,0,2
otto-de_edison-microservice,de.otto.edison.authentication.connection,1,0,0,0,0,0,0,1
otto-de_edison-microservice,de.otto.edison.authentication,0,0,0,0,1,0,0,1
otto-de_edison-microservice,de.otto.edison.configuration,0,0,0,0,0,0,0,0
otto-de_edison-microservice,de.otto.edison.env,0,0,0,0,1,0,0,1
otto-de_edison-microservice,de.otto.edison.health.configuration,0,0,0,0,0,0,0,0
otto-de_edison-microservice,de.otto.edison.health.indicator,0,0,0,0,1,0,0,1
otto-de_edison-microservice,de.otto.edison.logging,0,0,0,0,0,0,0,0
otto-de_edison-microservice,de.otto.edison.logging.ui,0,0,0,0,1,0,0,1
otto-de_edison-microservice,de.otto.edison.navigation.configuration,0,0,0,0,0,0,0,0
otto-de_edison-microservice,de.otto.edison.navigation,0,0,0,0,0,0,0,0
otto-de_edison-microservice,de.otto.edison.registry.client,0,0,0,0,0,0,0,0
otto-de_edison-microservice,de.otto.edison.registry.configuration,0,0,0,0,0,0,0,0
otto-de_edison-microservice,de.otto.edison.status.configuration,2,0,0,0,1,0,0,3
otto-de_edison-microservice,de.otto.edison.status.controller,0,0,0,0,1,0,0,1
otto-de_edison-microservice,de.otto.edison.status.domain,2,1,0,0,0,0,0,3
otto-de_edison-microservice,de.otto.edison.status.indicator,2,1,0,0,0,0,0,3
otto-de_edison-microservice,de.otto.edison.status.scheduler,1,0,0,0,0,0,0,1
otto-de_edison-microservice,de.otto.edison.util,0,0,0,0,0,0,0,0
otto-de_edison-microservice,de.otto.edison.acceptance.api,0,0,0,0,0,0,0,0
otto-de_edison-microservice,de.otto.edison.acceptance.health,0,0,0,0,0,0,0,0
otto-de_edison-microservice,de.otto.edison.acceptance.status,0,0,0,0,0,0,0,0
otto-de_edison-microservice,de.otto.edison.jobs.configuration,0,0,0,0,1,0,0,1
otto-de_edison-microservice,de.otto.edison.jobs.controller,4,0,0,0,1,0,0,5
otto-de_edison-microservice,de.otto.edison.jobs.definition,0,0,0,0,0,0,0,0
otto-de_edison-microservice,de.otto.edison.jobs.domain,7,1,0,0,1,0,0,9
otto-de_edison-microservice,de.otto.edison.jobs.eventbus,3,0,0,0,1,0,0,4
otto-de_edison-microservice,de.otto.edison.jobs.eventbus.events,1,1,0,0,0,0,0,2
otto-de_edison-microservice,de.otto.edison.jobs.repository.cleanup,3,0,0,0,0,0,0,3
otto-de_edison-microservice,de.otto.edison.jobs.repository.inmem,1,0,0,0,0,0,0,1
otto-de_edison-microservice,de.otto.edison.jobs.repository,6,1,0,0,1,0,0,8
otto-de_edison-microservice,de.otto.edison.jobs.repository.mongo,0,0,0,0,0,0,0,0
otto-de_edison-microservice,de.otto.edison.jobs.service,7,1,0,0,0,0,0,8
otto-de_edison-microservice,de.otto.edison.jobs.status,0,0,0,0,0,0,0,0
otto-de_edison-microservice,de.otto.edison.jobs,0,0,0,0,0,0,0,0
otto-de_edison-microservice,de.otto.edison.mongo,0,0,0,0,1,0,0,1
otto-de_edison-microservice,de.otto.edison.mongo.configuration,0,0,0,0,0,0,0,0
otto-de_edison-microservice,de.otto.edison.oauth.configuration,0,0,0,0,0,0,0,0
otto-de_edison-microservice,de.otto.edison.oauth,0,0,0,0,0,0,0,0
otto-de_edison-microservice,de.otto.edison.togglz.configuration,1,1,0,0,1,0,0,3
otto-de_edison-microservice,de.otto.edison.togglz.controller,0,0,0,0,0,0,0,0
otto-de_edison-microservice,de.otto.edison.togglz,0,0,0,0,1,0,0,1
otto-de_edison-microservice,de.otto.edison.togglz.mongo,0,0,0,0,0,0,0,0
otto-de_edison-microservice,de.otto.edison.togglz.s3,1,1,0,0,1,0,0,3
otto-de_edison-microservice,de.otto.edison.togglz.util,0,0,0,0,0,0,0,0
otto-de_edison-microservice,de.otto.edison.acceptance.togglz,0,0,0,0,0,0,0,0
otto-de_edison-microservice,de.otto.edison.validation.configuration,0,0,0,0,0,0,0,0
otto-de_edison-microservice,de.otto.edison.validation.validators,0,0,0,0,1,0,0,1
otto-de_edison-microservice,de.otto.edison.validation.web,0,0,0,0,1,0,0,1
otto-de_edison-microservice,de.otto.edison.example.configuration,0,0,0,0,1,0,0,1
otto-de_edison-microservice,de.otto.edison.example,0,0,0,0,1,0,0,1
otto-de_edison-microservice,de.otto.edison.example.jobs,0,0,0,0,0,0,0,0
otto-de_edison-microservice,de.otto.edison.example.web,0,0,0,0,0,0,0,0
otto-de_edison-microservice,de.otto.edison.example.oauth,0,0,0,0,0,0,0,0
otto-de_edison-microservice,de.otto.edison.example.health,0,0,0,0,0,0,0,0
otto-de_edison-microservice,de.otto.edison.example.service,0,0,0,0,0,0,0,0
otto-de_edison-microservice,de.otto.edison.example.status,0,0,0,0,0,0,0,0
otto-de_edison-microservice,de.otto.edison.example.togglz,0,0,0,0,0,0,0,0
outbrain_Aletheia,com.outbrain.aletheia,2,0,0,0,1,1,0,4
outbrain_Aletheia,com.outbrain.aletheia.breadcrumbs,1,1,0,0,1,0,0,3
outbrain_Aletheia,com.outbrain.aletheia.configuration,1,0,0,0,1,1,0,3
outbrain_Aletheia,com.outbrain.aletheia.configuration.endpoint,0,0,0,0,0,0,0,0
outbrain_Aletheia,com.outbrain.aletheia.configuration.routing,0,0,0,0,0,0,0,0
outbrain_Aletheia,com.outbrain.aletheia.datum,0,1,0,0,1,1,0,3
outbrain_Aletheia,com.outbrain.aletheia.datum.consumption,0,0,0,0,1,0,0,1
outbrain_Aletheia,com.outbrain.aletheia.datum.consumption.openers,0,0,0,0,0,0,0,0
outbrain_Aletheia,com.outbrain.aletheia.datum.envelope,0,0,0,0,0,0,0,0
outbrain_Aletheia,com.outbrain.aletheia.datum.production,0,1,0,0,1,0,0,2
outbrain_Aletheia,com.outbrain.aletheia.datum.serialization.avro,0,0,0,0,0,0,0,0
outbrain_Aletheia,com.outbrain.aletheia.datum.serialization.avro.schema,0,0,0,0,0,0,0,0
outbrain_Aletheia,com.outbrain.aletheia.datum.serialization,0,0,0,0,0,0,0,0
outbrain_Aletheia,com.outbrain.aletheia.datum.serialization.Json,0,0,0,0,0,0,0,0
outbrain_Aletheia,com.outbrain.aletheia.metrics,0,0,0,0,0,0,0,0
outbrain_Aletheia,com.outbrain.aletheia.metrics.common,0,0,0,0,1,0,0,1
outbrain_Aletheia,com.outbrain.aletheia.datum.avro,0,0,0,0,0,0,0,0
outbrain_Aletheia,com.outbrain.aletheia.datum.envelope.avro,0,0,0,0,0,0,0,0
outbrain_Aletheia,com.outbrain.aletheia.configuration.kafka,0,1,0,0,0,0,0,1
outbrain_Aletheia,com.outbrain.aletheia.datum.consumption.kafka,0,0,0,0,1,0,0,1
outbrain_Aletheia,com.outbrain.aletheia.datum.metrics.kafka,0,0,0,0,0,0,0,0
outbrain_Aletheia,com.outbrain.aletheia.datum.production.kafka,0,0,0,0,0,0,0,0
outbrain_Aletheia,com.outbrain.aletheia.kafka.serialization,0,1,0,0,1,0,0,2
outbrain_Aletheia,com.outbrain.aletheia.kafka.streams,0,0,0,0,0,0,0,0
outbrain_Aletheia,com.outbrain.aletheia.configuration.hive,0,0,0,0,0,0,0,0
outbrain_Aletheia,com.outbrain.aletheia.configuration.logFile,0,1,0,0,0,0,0,1
outbrain_Aletheia,com.outbrain.aletheia.datum.production.logFile,0,0,0,0,0,0,0,0
outbrain_Aletheia,com.outbrain.aletheia.datum.production.logFile.writer,0,0,0,0,0,0,0,0
outbrain_Aletheia,com.outbrain.aletheia.tutorial,0,0,0,0,1,0,0,1
outbrain_gruffalo,com.outbrain.gruffalo.netty,0,0,0,0,1,0,0,1
outbrain_gruffalo,com.outbrain.gruffalo.publish,0,0,0,0,0,0,0,0
outbrain_gruffalo,com.outbrain.gruffalo,0,0,0,0,1,0,0,1
outbrain_gruffalo,com.outbrain.gruffalo.util,0,0,0,0,0,0,0,0
oxo42_stateless4j,com.github.oxo42.stateless4j.conversion,0,0,0,0,0,0,0,0
oxo42_stateless4j,com.github.oxo42.stateless4j.delegates,0,0,0,0,1,0,0,1
oxo42_stateless4j,com.github.oxo42.stateless4j,0,0,0,0,0,0,0,0
oxo42_stateless4j,com.github.oxo42.stateless4j.transitions,0,0,0,0,0,0,0,0
oxo42_stateless4j,com.github.oxo42.stateless4j.triggers,0,0,0,0,1,0,0,1
oxo42_stateless4j,com.github.oxo42.stateless4j.graphviz,0,0,0,0,0,0,0,0
oxo42_stateless4j,com.github.oxo42.stateless4j.helpers,0,0,0,0,0,0,0,0
pac4j_pac4j,org.pac4j.cas.authorization,0,0,0,0,0,1,1,2
pac4j_pac4j,org.pac4j.cas.client,0,0,0,0,0,5,1,6
pac4j_pac4j,org.pac4j.cas.client.direct,0,0,0,0,0,0,1,1
pac4j_pac4j,org.pac4j.cas.client.rest,0,0,0,0,0,0,1,1
pac4j_pac4j,org.pac4j.cas.config,0,1,0,0,0,7,1,9
pac4j_pac4j,org.pac4j.cas.credentials.authenticator,0,0,0,0,0,0,1,1
pac4j_pac4j,org.pac4j.cas.credentials.extractor,0,0,0,0,0,1,1,2
pac4j_pac4j,org.pac4j.cas.profile,0,0,0,0,0,0,1,1
pac4j_pac4j,org.pac4j.cas.redirect,0,0,0,0,0,1,1,2
pac4j_pac4j,org.pac4j.cas.store,0,0,0,0,0,0,1,1
pac4j_pac4j,org.pac4j.config.builder,0,1,0,0,1,1,1,4
pac4j_pac4j,org.pac4j.config.client,0,0,0,0,0,0,1,1
pac4j_pac4j,org.pac4j.config.ldaptive,0,0,0,0,0,0,1,1
pac4j_pac4j,org.pac4j.core.authorization.authorizer,0,0,0,1,0,0,1,2
pac4j_pac4j,org.pac4j.core.authorization.authorizer.csrf,0,0,0,0,1,0,1,2
pac4j_pac4j,org.pac4j.core.authorization.checker,0,0,0,0,0,0,1,1
pac4j_pac4j,org.pac4j.core.authorization.generator,0,0,0,0,0,1,1,2
pac4j_pac4j,org.pac4j.core.client,0,1,0,0,1,14,1,17
pac4j_pac4j,org.pac4j.core.client.direct,0,0,0,0,0,0,1,1
pac4j_pac4j,org.pac4j.core.client.finder,0,0,0,0,0,0,1,1
pac4j_pac4j,org.pac4j.core.config,0,1,0,0,1,3,1,6
pac4j_pac4j,org.pac4j.core.context,5,1,0,0,1,1,1,9
pac4j_pac4j,org.pac4j.core.context.session,3,0,0,0,0,0,1,4
pac4j_pac4j,org.pac4j.core.credentials,0,0,0,0,0,4,1,5
pac4j_pac4j,org.pac4j.core.credentials.authenticator,0,0,0,0,0,1,1,2
pac4j_pac4j,org.pac4j.core.credentials.extractor,0,0,0,0,1,1,1,3
pac4j_pac4j,org.pac4j.core.credentials.password,0,0,0,0,0,0,1,1
pac4j_pac4j,org.pac4j.core.engine,0,0,0,0,1,3,1,5
pac4j_pac4j,org.pac4j.core.engine.decision,0,0,0,0,0,0,1,1
pac4j_pac4j,org.pac4j.core.engine.savedrequest,0,0,0,0,0,0,1,1
pac4j_pac4j,org.pac4j.core.exception,0,0,0,0,0,0,1,1
pac4j_pac4j,org.pac4j.core.exception.http,0,0,0,0,0,9,1,10
pac4j_pac4j,org.pac4j.core.http.adapter,0,0,0,0,0,0,1,1
pac4j_pac4j,org.pac4j.core.http.ajax,0,0,0,0,0,0,1,1
pac4j_pac4j,org.pac4j.core.http.callback,0,0,0,0,1,0,1,2
pac4j_pac4j,org.pac4j.core.http.url,0,0,0,0,0,1,1,2
pac4j_pac4j,org.pac4j.core.logout,0,0,0,0,0,0,1,1
pac4j_pac4j,org.pac4j.core.logout.handler,0,0,0,0,0,0,1,1
pac4j_pac4j,org.pac4j.core.matching,0,0,0,0,0,0,1,1
pac4j_pac4j,org.pac4j.core.profile,6,1,0,0,1,8,1,17
pac4j_pac4j,org.pac4j.core.profile.converter,3,1,0,0,1,0,1,6
pac4j_pac4j,org.pac4j.core.profile.creator,0,0,0,0,0,0,1,1
pac4j_pac4j,org.pac4j.core.profile.definition,2,0,0,0,0,0,1,3
pac4j_pac4j,org.pac4j.core.profile.factory,0,0,0,0,0,0,1,1
pac4j_pac4j,org.pac4j.core.profile.jwt,0,0,0,0,0,0,1,1
pac4j_pac4j,org.pac4j.core.profile.service,0,0,0,0,0,0,1,1
pac4j_pac4j,org.pac4j.core.redirect,0,0,0,0,0,0,1,1
pac4j_pac4j,org.pac4j.core.state,0,0,0,0,0,1,1,2
pac4j_pac4j,org.pac4j.core.store,0,0,0,0,0,0,1,1
pac4j_pac4j,org.pac4j.core.util,6,1,0,0,1,5,1,14
pac4j_pac4j,org.pac4j.core.run,0,0,0,0,0,0,1,1
pac4j_pac4j,org.pac4j.couch.profile,0,0,0,0,0,0,1,1
pac4j_pac4j,org.pac4j.couch.profile.service,0,0,0,0,0,0,1,1
pac4j_pac4j,org.pac4j.gae.client,0,0,0,0,0,0,1,1
pac4j_pac4j,org.pac4j.gae.credentials,0,0,0,0,0,0,1,1
pac4j_pac4j,org.pac4j.gae.profile,0,0,0,0,0,0,1,1
pac4j_pac4j,org.pac4j.http.authorization.authorizer,0,0,0,0,0,0,1,1
pac4j_pac4j,org.pac4j.http.authorization.generator,0,0,0,0,0,0,1,1
pac4j_pac4j,org.pac4j.http.client.direct,0,0,0,0,1,1,1,3
pac4j_pac4j,org.pac4j.http.client.indirect,0,0,0,0,0,4,1,5
pac4j_pac4j,org.pac4j.http.credentials.authenticator,0,0,0,0,1,1,1,3
pac4j_pac4j,org.pac4j.http.credentials,0,0,0,0,0,0,1,1
pac4j_pac4j,org.pac4j.http.credentials.extractor,0,1,0,0,1,1,1,4
pac4j_pac4j,org.pac4j.http.profile,0,0,0,0,0,0,1,1
pac4j_pac4j,org.pac4j.jwt.config.encryption,0,0,0,0,1,0,1,2
pac4j_pac4j,org.pac4j.jwt.config.signature,0,0,0,0,1,0,1,2
pac4j_pac4j,org.pac4j.jwt.credentials.authenticator,0,0,0,0,0,0,1,1
pac4j_pac4j,org.pac4j.jwt.profile,0,0,0,0,0,0,1,1
pac4j_pac4j,org.pac4j.jwt.util,0,0,0,0,0,0,1,1
pac4j_pac4j,org.pac4j.jwt,0,0,0,0,0,0,1,1
pac4j_pac4j,org.pac4j.jwt.config,0,0,0,0,0,0,1,1
pac4j_pac4j,org.pac4j.kerberos.client.direct,0,0,0,0,0,0,1,1
pac4j_pac4j,org.pac4j.kerberos.client.indirect,0,0,0,0,0,0,1,1
pac4j_pac4j,org.pac4j.kerberos.credentials.authenticator,0,0,0,0,1,0,1,2
pac4j_pac4j,org.pac4j.kerberos.credentials.extractor,0,0,0,0,0,0,1,1
pac4j_pac4j,org.pac4j.kerberos.credentials,0,0,0,0,0,0,1,1
pac4j_pac4j,org.pac4j.kerberos.profile,0,0,0,0,0,0,1,1
pac4j_pac4j,org.pac4j.ldap.profile,0,0,0,0,0,0,1,1
pac4j_pac4j,org.pac4j.ldap.profile.service,0,0,0,0,0,0,1,1
pac4j_pac4j,org.pac4j.mongo.profile,0,0,0,0,0,0,1,1
pac4j_pac4j,org.pac4j.mongo.profile.service,0,0,0,0,0,0,1,1
pac4j_pac4j,org.pac4j.oauth.client,1,1,0,0,1,4,1,8
pac4j_pac4j,org.pac4j.oauth.config,0,0,0,0,0,1,1,2
pac4j_pac4j,org.pac4j.oauth.credentials.authenticator,0,0,0,0,0,0,1,1
pac4j_pac4j,org.pac4j.oauth.credentials.extractor,0,0,0,0,0,0,1,1
pac4j_pac4j,org.pac4j.oauth.credentials,0,0,0,0,0,0,1,1
pac4j_pac4j,org.pac4j.oauth.exception,0,0,0,0,0,0,1,1
pac4j_pac4j,org.pac4j.oauth.profile.bitbucket,0,0,0,0,0,0,1,1
pac4j_pac4j,org.pac4j.oauth.profile.casoauthwrapper,0,0,0,0,0,1,1,2
pac4j_pac4j,org.pac4j.oauth.profile.converter,0,0,0,0,0,0,1,1
pac4j_pac4j,org.pac4j.oauth.profile.creator,0,0,0,0,0,0,1,1
pac4j_pac4j,org.pac4j.oauth.profile.definition,0,0,0,0,0,0,1,1
pac4j_pac4j,org.pac4j.oauth.profile.dropbox,1,0,0,0,0,0,1,2
pac4j_pac4j,org.pac4j.oauth.profile.facebook.converter,0,0,0,0,0,0,1,1
pac4j_pac4j,org.pac4j.oauth.profile.facebook,0,0,0,0,1,0,1,2
pac4j_pac4j,org.pac4j.oauth.profile.figshare,0,0,0,0,0,0,1,1
pac4j_pac4j,org.pac4j.oauth.profile.foursquare,0,0,0,0,1,0,1,2
pac4j_pac4j,org.pac4j.oauth.profile.generic,0,0,0,0,0,0,1,1
pac4j_pac4j,org.pac4j.oauth.profile.github,1,0,0,0,0,0,1,2
pac4j_pac4j,org.pac4j.oauth.profile.google2,0,0,0,0,0,0,1,1
pac4j_pac4j,org.pac4j.oauth.profile.hiorgserver,1,0,0,0,0,0,1,2
pac4j_pac4j,org.pac4j.oauth.profile,3,1,0,0,1,1,1,7
pac4j_pac4j,org.pac4j.oauth.profile.linkedin2,0,0,0,0,1,0,1,2
pac4j_pac4j,org.pac4j.oauth.profile.ok,0,0,0,0,0,0,1,1
pac4j_pac4j,org.pac4j.oauth.profile.orcid,0,0,0,0,0,0,1,1
pac4j_pac4j,org.pac4j.oauth.profile.paypal,0,0,0,0,0,0,1,1
pac4j_pac4j,org.pac4j.oauth.profile.qq,0,0,0,0,0,0,1,1
pac4j_pac4j,org.pac4j.oauth.profile.strava,0,0,0,0,0,0,1,1
pac4j_pac4j,org.pac4j.oauth.profile.twitter,0,0,0,0,0,0,1,1
pac4j_pac4j,org.pac4j.oauth.profile.vk,0,0,0,0,0,0,1,1
pac4j_pac4j,org.pac4j.oauth.profile.wechat,0,0,0,0,0,0,1,1
pac4j_pac4j,org.pac4j.oauth.profile.weibo,0,0,0,0,0,0,1,1
pac4j_pac4j,org.pac4j.oauth.profile.windowslive,0,0,0,0,0,0,1,1
pac4j_pac4j,org.pac4j.oauth.profile.wordpress,0,0,0,0,0,0,1,1
pac4j_pac4j,org.pac4j.oauth.profile.yahoo,0,0,0,0,1,0,1,2
pac4j_pac4j,org.pac4j.oauth.redirect,0,0,0,0,0,0,1,1
pac4j_pac4j,org.pac4j.scribe.builder.api,1,0,0,0,1,0,1,3
pac4j_pac4j,org.pac4j.scribe.extractors,0,0,0,0,1,0,1,2
pac4j_pac4j,org.pac4j.scribe.model,0,0,0,0,0,0,1,1
pac4j_pac4j,org.pac4j.scribe.service,0,0,0,0,0,0,1,1
pac4j_pac4j,org.pac4j.oauth.run,0,0,0,0,1,2,1,4
pac4j_pac4j,org.pac4j.oidc.authorization.generator,0,0,0,0,0,0,1,1
pac4j_pac4j,org.pac4j.oidc.client.azuread,0,0,0,0,0,0,1,1
pac4j_pac4j,org.pac4j.oidc.client,0,0,0,0,0,0,1,1
pac4j_pac4j,org.pac4j.oidc.config,0,0,0,0,0,0,1,1
pac4j_pac4j,org.pac4j.oidc.credentials.authenticator,0,0,0,0,0,0,1,1
pac4j_pac4j,org.pac4j.oidc.credentials.extractor,0,0,0,0,0,0,1,1
pac4j_pac4j,org.pac4j.oidc.credentials,0,0,0,0,0,0,1,1
pac4j_pac4j,org.pac4j.oidc.logout,0,0,0,0,0,0,1,1
pac4j_pac4j,org.pac4j.oidc.profile.azuread,0,0,0,0,0,0,1,1
pac4j_pac4j,org.pac4j.oidc.profile.converter,0,0,0,0,0,0,1,1
pac4j_pac4j,org.pac4j.oidc.profile.creator,0,0,0,0,0,0,1,1
pac4j_pac4j,org.pac4j.oidc.profile.google,0,0,0,0,0,0,1,1
pac4j_pac4j,org.pac4j.oidc.profile.keycloak,0,0,0,0,0,0,1,1
pac4j_pac4j,org.pac4j.oidc.profile,0,0,0,0,0,0,1,1
pac4j_pac4j,org.pac4j.oidc.redirect,0,0,0,0,0,0,1,1
pac4j_pac4j,org.pac4j.oidc.run,0,0,0,0,1,0,1,2
pac4j_pac4j,org.pac4j.openid.client,0,0,0,0,0,0,1,1
pac4j_pac4j,org.pac4j.openid.credentials.authenticator,0,0,0,0,0,0,1,1
pac4j_pac4j,org.pac4j.openid.credentials.extractor,0,0,0,0,0,0,1,1
pac4j_pac4j,org.pac4j.openid.credentials,0,0,0,0,0,0,1,1
pac4j_pac4j,org.pac4j.openid.profile,0,0,0,0,0,0,1,1
pac4j_pac4j,org.pac4j.openid.profile.yahoo,0,0,0,0,0,0,1,1
pac4j_pac4j,org.pac4j.openid.redirect,0,0,0,0,0,0,1,1
pac4j_pac4j,org.pac4j.openid.run,0,0,0,0,0,0,1,1
pac4j_pac4j,org.pac4j.saml.client,0,0,0,0,1,0,1,2
pac4j_pac4j,org.pac4j.saml.config,0,0,0,0,0,0,1,1
pac4j_pac4j,org.pac4j.saml.context,0,0,0,0,0,0,1,1
pac4j_pac4j,org.pac4j.saml.credentials.authenticator,0,0,0,0,0,0,1,1
pac4j_pac4j,org.pac4j.saml.credentials.extractor,0,0,0,0,0,0,1,1
pac4j_pac4j,org.pac4j.saml.credentials,0,0,0,0,0,0,1,1
pac4j_pac4j,org.pac4j.saml.crypto,0,0,0,0,1,0,1,2
pac4j_pac4j,org.pac4j.saml.exceptions,0,0,0,0,0,0,1,1
pac4j_pac4j,org.pac4j.saml.logout.impl,0,0,0,0,1,0,1,2
pac4j_pac4j,org.pac4j.saml.logout,0,0,0,0,0,0,1,1
pac4j_pac4j,org.pac4j.saml.metadata,0,0,0,0,1,0,1,2
pac4j_pac4j,org.pac4j.saml.profile.api,0,0,0,0,0,0,1,1
pac4j_pac4j,org.pac4j.saml.profile.impl,0,0,0,0,0,0,1,1
pac4j_pac4j,org.pac4j.saml.profile,0,0,0,0,0,0,1,1
pac4j_pac4j,org.pac4j.saml.redirect,0,0,0,0,0,0,1,1
pac4j_pac4j,org.pac4j.saml.replay,0,0,0,0,0,0,1,1
pac4j_pac4j,org.pac4j.saml.sso.artifact,0,0,0,0,1,0,1,2
pac4j_pac4j,org.pac4j.saml.sso.impl,0,0,0,0,1,0,1,2
pac4j_pac4j,org.pac4j.saml.state,0,0,0,0,0,0,1,1
pac4j_pac4j,org.pac4j.saml.store,0,0,0,0,0,0,1,1
pac4j_pac4j,org.pac4j.saml.transport,0,0,0,0,1,0,1,2
pac4j_pac4j,org.pac4j.saml.util,0,0,0,0,1,0,1,2
pac4j_pac4j,org.pac4j.saml.run,0,0,0,0,0,0,1,1
pac4j_pac4j,org.pac4j.sql.profile,0,0,0,0,0,0,1,1
pac4j_pac4j,org.pac4j.sql.profile.service,0,0,0,0,0,0,1,1
pac4j_play-pac4j,org.pac4j.play,1,1,0,0,1,0,0,3
pac4j_play-pac4j,org.pac4j.play.deadbolt2,0,0,0,0,1,0,0,1
pac4j_play-pac4j,org.pac4j.play.http,0,0,0,0,0,0,0,0
pac4j_play-pac4j,org.pac4j.play.java,0,0,0,0,0,0,0,0
pac4j_play-pac4j,org.pac4j.play.store,1,0,0,0,1,0,0,2
pac4j_vertx-pac4j,org.pac4j.context.session,0,0,0,0,0,0,0,0
pac4j_vertx-pac4j,org.pac4j.core.profile,0,0,0,0,0,0,0,0
pac4j_vertx-pac4j,org.pac4j.vertx.auth,0,0,0,0,0,0,0,0
pac4j_vertx-pac4j,org.pac4j.vertx.cas.logout,0,0,0,0,0,0,0,0
pac4j_vertx-pac4j,org.pac4j.vertx.context.session,0,0,0,0,0,0,0,0
pac4j_vertx-pac4j,org.pac4j.vertx.core,0,0,0,0,0,0,0,0
pac4j_vertx-pac4j,org.pac4j.vertx.core.store,0,0,0,0,0,0,0,0
pac4j_vertx-pac4j,org.pac4j.vertx.handler.impl,0,0,0,0,1,0,0,1
pac4j_vertx-pac4j,org.pac4j.vertx.http,0,0,0,0,0,0,0,0
pac4j_vertx-pac4j,org.pac4j.vertx,0,0,0,0,1,0,0,1
pac4j_vertx-pac4j,org.pac4j.vertx.client,0,0,0,0,0,0,0,0
pac4j_vertx-pac4j,org.pac4j.vertx.profile,0,0,0,0,0,0,0,0
PasaLab_Tachyon-Perf,tachyon.perf.basic,5,1,0,0,1,1,0,8
PasaLab_Tachyon-Perf,tachyon.perf.benchmark.connect,0,0,0,0,0,0,0,0
PasaLab_Tachyon-Perf,tachyon.perf.benchmark.createfile,0,0,0,0,0,0,0,0
PasaLab_Tachyon-Perf,tachyon.perf.benchmark,0,0,0,0,0,0,0,0
PasaLab_Tachyon-Perf,tachyon.perf.benchmark.read,2,0,0,0,1,0,0,3
PasaLab_Tachyon-Perf,tachyon.perf.benchmark.write,2,0,0,0,1,0,0,3
PasaLab_Tachyon-Perf,tachyon.perf.conf,0,0,0,0,0,1,0,1
PasaLab_Tachyon-Perf,tachyon.perf,3,1,0,0,0,0,0,4
PasaLab_Tachyon-Perf,tachyon.perf.tools,0,0,0,0,0,1,0,1
PasaLab_Tachyon-Perf,tachyon.perf.util,0,0,0,0,0,0,0,0
pastekit_twist,com.dotweblabs.twirl.common,0,0,0,0,0,0,0,0
pastekit_twist,com.dotweblabs.twirl.gae,0,0,0,0,0,0,0,0
pastekit_twist,com.dotweblabs.twirl,1,1,0,0,1,0,0,3
pastekit_twist,com.dotweblabs.twirl.object,1,0,0,0,1,0,0,2
pastekit_twist,com.dotweblabs.twirl.serializer,0,0,0,0,0,0,0,0
pastekit_twist,com.dotweblabs.twirl.types,0,0,0,0,1,0,0,1
pastekit_twist,com.dotweblabs.twirl.util,0,0,0,0,1,0,0,1
pastekit_twist,com.dotweblabs.twirl.validation,0,0,0,0,0,0,0,0
pastekit_twist,com.dotweblabs.twirl.wrappers,0,0,0,0,0,0,0,0
pastekit_twist,com.google.appengine.api.datastore,0,0,0,0,0,0,0,0
pastekit_twist,com.dotweblabs.twirl.entity,0,0,0,0,1,0,0,1
paukiatwee_budgetapp,io.budgetapp.application,0,0,0,0,1,0,0,1
paukiatwee_budgetapp,io.budgetapp.auth,0,0,0,0,0,0,0,0
paukiatwee_budgetapp,io.budgetapp,0,0,0,0,0,0,0,0
paukiatwee_budgetapp,io.budgetapp.client,0,0,0,0,0,0,0,0
paukiatwee_budgetapp,io.budgetapp.configuration,0,0,0,0,0,0,0,0
paukiatwee_budgetapp,io.budgetapp.crypto,0,0,0,0,0,0,0,0
paukiatwee_budgetapp,io.budgetapp.dao,0,0,0,0,1,0,0,1
paukiatwee_budgetapp,io.budgetapp.filter,0,0,0,0,0,0,0,0
paukiatwee_budgetapp,io.budgetapp.hibernate.dialect,0,0,0,0,0,0,0,0
paukiatwee_budgetapp,io.budgetapp.job,0,0,0,0,0,0,0,0
paukiatwee_budgetapp,io.budgetapp.managed,0,0,0,0,0,0,0,0
paukiatwee_budgetapp,io.budgetapp.model,0,0,0,0,1,2,0,3
paukiatwee_budgetapp,io.budgetapp.model.form.budget,0,0,0,0,0,2,0,2
paukiatwee_budgetapp,io.budgetapp.model.form,0,0,0,0,0,1,0,1
paukiatwee_budgetapp,io.budgetapp.model.form.recurring,0,0,0,0,0,0,0,0
paukiatwee_budgetapp,io.budgetapp.model.form.report,0,0,0,0,0,0,0,0
paukiatwee_budgetapp,io.budgetapp.model.form.user,0,0,0,0,0,0,0,0
paukiatwee_budgetapp,io.budgetapp.resource,0,0,0,0,0,2,0,2
paukiatwee_budgetapp,io.budgetapp.service,0,0,0,0,0,0,0,0
paukiatwee_budgetapp,io.budgetapp.util,0,0,0,0,0,0,0,0
paukiatwee_budgetapp,io.budgetapp.modal,0,0,0,0,0,0,0,0
pavel4n_wowdoge.org,com.google.dogecoin.core,13,1,0,1,0,4,1,20
pavel4n_wowdoge.org,com.google.dogecoin.crypto,5,0,0,0,1,2,1,9
pavel4n_wowdoge.org,com.google.dogecoin.jni,0,0,0,0,1,0,1,2
pavel4n_wowdoge.org,com.google.dogecoin.kits,0,0,0,0,0,0,1,1
pavel4n_wowdoge.org,com.google.dogecoin.net,0,0,0,0,1,0,1,2
pavel4n_wowdoge.org,com.google.dogecoin.net.discovery,0,0,0,0,1,0,1,2
pavel4n_wowdoge.org,com.google.dogecoin.params,2,1,0,0,0,1,1,5
pavel4n_wowdoge.org,com.google.dogecoin.protocols.channels,0,0,0,1,1,0,1,3
pavel4n_wowdoge.org,com.google.dogecoin.protocols.payments,0,0,0,0,1,0,1,2
pavel4n_wowdoge.org,com.google.dogecoin.script,6,0,0,0,0,2,1,9
pavel4n_wowdoge.org,com.google.dogecoin.store,4,1,0,0,1,1,1,8
pavel4n_wowdoge.org,com.google.dogecoin.uri,0,0,0,0,0,0,1,1
pavel4n_wowdoge.org,com.google.dogecoin.utils,4,1,0,0,1,1,1,8
pavel4n_wowdoge.org,com.google.dogecoin.wallet,2,0,0,0,1,0,1,4
pavel4n_wowdoge.org,org.bitcoin,0,0,0,0,0,0,1,1
pavel4n_wowdoge.org,org.bitcoin.paymentchannel,0,0,0,1,0,0,1,2
pavel4n_wowdoge.org,org.bitcoin.protocols.payments,0,0,0,0,0,0,1,1
pavel4n_wowdoge.org,org.bitcoinj.wallet,0,0,0,1,0,0,1,2
pavel4n_wowdoge.org,com.google.dogecoin.core.utils,0,0,0,0,0,0,1,1
pavel4n_wowdoge.org,com.google.dogecoin.payments,0,0,0,0,0,0,1,1
pavel4n_wowdoge.org,com.google.dogecoin.examples,0,0,0,0,1,0,1,2
pavel4n_wowdoge.org,org.wowdoge,1,0,0,1,0,0,1,3
pavel4n_wowdoge.org,org.wowdoge.crypto,0,0,0,0,0,0,1,1
pavel4n_wowdoge.org,org.wowdoge.file,1,1,0,0,0,1,1,4
pavel4n_wowdoge.org,org.wowdoge.utils,0,0,0,0,0,0,1,1
pavel4n_wowdoge.org,org.wowdoge.viewsystem.swing.view,0,0,0,0,0,0,1,1
pavel4n_wowdoge.org,com.google.bitcoin.tools,0,0,0,0,0,0,1,1
pavel4n_wowdoge.org,com.google.dogecoin.tools,0,0,0,0,0,0,1,1
pavel4n_wowdoge.org,wallettemplate,1,0,0,0,1,0,1,3
pavel4n_wowdoge.org,wallettemplate.controls,1,1,0,0,0,0,1,3
pavel4n_wowdoge.org,wallettemplate.utils,0,0,0,0,0,0,1,1
payara_Payara,fish.payara.cdi.auth.roles,0,0,0,0,0,0,1,1
payara_Payara,fish.payara.jacc,0,0,0,0,0,0,1,1
payara_Payara,fish.payara.micro.cdi,0,0,0,0,0,0,1,1
payara_Payara,fish.payara.notification.eventbus,0,0,0,0,0,0,1,1
payara_Payara,fish.payara.notification.healthcheck,0,0,0,0,0,0,1,1
payara_Payara,fish.payara.notification,0,0,0,0,0,0,1,1
payara_Payara,fish.payara.notification.requesttracing,0,0,0,0,1,0,1,2
payara_Payara,fish.payara.security.oauth2.api,0,0,0,0,0,0,1,1
payara_Payara,fish.payara.security.openid.api,0,0,0,0,1,0,1,2
payara_Payara,fish.payara.sql,0,0,0,0,0,0,1,1
payara_Payara,com.sun.enterprise.admin,0,0,0,0,0,0,1,1
payara_Payara,com.sun.enterprise.backup,0,0,0,0,0,0,1,1
payara_Payara,com.sun.enterprise.backup.util,0,0,0,0,0,0,1,1
payara_Payara,org.glassfish.admin.cli,0,0,0,0,0,0,1,1
payara_Payara,com.sun.enterprise.admin.cli.optional,0,0,0,0,1,0,1,2
payara_Payara,org.glassfish.admin.runtime.jsr77,0,0,0,0,1,0,1,2
payara_Payara,org.glassfish.admin.runtime.mgmtinfra,0,0,0,0,0,0,1,1
payara_Payara,org.glassfish.admin.runtime.apt,0,0,0,0,0,0,1,1
payara_Payara,fish.payara.admingui.notifier.cdieventbus,0,0,0,0,0,0,1,1
payara_Payara,fish.payara.cluster.admingui,0,0,0,0,0,0,1,1
payara_Payara,org.glassfish.cluster.admingui,0,0,0,0,0,0,1,1
payara_Payara,fish.payara.admingui.common.handlers,0,0,0,0,0,0,1,1
payara_Payara,org.glassfish.admingui.common.factories,0,0,0,0,0,0,1,1
payara_Payara,org.glassfish.admingui.common.gadget,0,0,0,0,0,0,1,1
payara_Payara,org.glassfish.admingui.common.handlers,2,0,0,0,1,0,1,4
payara_Payara,org.glassfish.admingui.common.help,0,0,0,0,0,0,1,1
payara_Payara,org.glassfish.admingui.common.plugin,0,1,0,0,0,0,1,2
payara_Payara,org.glassfish.admingui.common.security,1,0,0,0,0,0,1,2
payara_Payara,org.glassfish.admingui.common.servlet,0,0,0,0,0,0,1,1
payara_Payara,org.glassfish.admingui.common.tree,1,0,0,0,0,0,1,2
payara_Payara,org.glassfish.admingui.common.util,3,1,0,0,1,0,1,6
payara_Payara,org.glassfish.concurrent.admingui,0,0,0,0,0,0,1,1
payara_Payara,org.glassfish.corba.admingui,0,0,0,0,0,0,1,1
payara_Payara,org.glassfish.admingui.handlers,0,0,0,0,0,0,1,1
payara_Payara,org.glassfish.admingui.theme,0,0,0,0,0,0,1,1
payara_Payara,org.glassfish.admingui.util,0,0,0,0,0,0,1,1
payara_Payara,fish.payara.admingui.notifier.datadog,0,0,0,0,0,0,1,1
payara_Payara,org.glassfish.ejb.admingui,0,0,0,0,0,0,1,1
payara_Payara,org.glassfish.ejblite.admingui,0,0,0,0,0,0,1,1
payara_Payara,fish.payara.admingui.notifier.email,0,0,0,0,0,0,1,1
payara_Payara,fish.payara.admingui.notifier.eventbus,0,0,0,0,0,0,1,1
payara_Payara,fish.payara.full.admingui.handlers,0,0,0,0,0,0,1,1
payara_Payara,org.glassfish.full.admingui.handlers,0,0,0,0,0,0,1,1
payara_Payara,org.glassfish.full.admingui,0,0,0,0,0,0,1,1
payara_Payara,org.glassfish.admingui.connector,0,0,0,0,1,0,1,2
payara_Payara,fish.payara.admingui.healthcheck,0,0,0,0,0,0,1,1
payara_Payara,fish.payara.admingui.notifier.hipchat,0,0,0,0,0,0,1,1
payara_Payara,org.glassfish.jca.admingui.handlers,0,0,0,0,0,0,1,1
payara_Payara,org.glassfish.jca.admingui,0,0,0,0,0,0,1,1
payara_Payara,org.glassfish.jdbc.admingui,0,0,0,0,0,0,1,1
payara_Payara,fish.payara.admingui.notifier.jms,0,0,0,0,0,0,1,1
payara_Payara,org.glassfish.admingui.plugin.jms,0,0,0,0,0,0,1,1
payara_Payara,fish.payara.admingui.jmxmonitoring,0,0,0,0,0,0,1,1
payara_Payara,org.glassfish.jts.admingui,0,0,0,0,0,0,1,1
payara_Payara,fish.payara.admingui.microprofile,0,0,0,0,0,0,1,1
payara_Payara,fish.payara.admingui.notifier.newrelic,0,0,0,0,0,0,1,1
payara_Payara,fish.payara.admingui.extras,0,0,0,0,0,0,1,1
payara_Payara,fish.payara.admingui.extras.rest,0,0,0,0,0,0,1,1
payara_Payara,fish.payara.admingui.support.handlers,0,0,0,0,0,0,1,1
payara_Payara,fish.payara.admingui.support,0,0,0,0,0,0,1,1
payara_Payara,org.glassfish.admingui.customtheme,0,0,0,0,0,0,1,1
payara_Payara,org.glassfish.admingui.plugin,0,0,0,0,0,0,1,1
payara_Payara,org.glassfish.reference.admingui,0,0,0,0,0,0,1,1
payara_Payara,fish.payara.admingui.monitoring.rest,0,0,0,0,0,0,1,1
payara_Payara,fish.payara.admingui.notifier.slack,0,0,0,0,0,0,1,1
payara_Payara,fish.payara.admingui.notifier.snmp,0,0,0,0,0,0,1,1
payara_Payara,org.glassfish.web.admingui.handlers,0,0,0,0,0,0,1,1
payara_Payara,org.glassfish.web.admingui,0,0,0,0,0,0,1,1
payara_Payara,fish.payara.admingui.notifier.xmpp,0,0,0,0,0,0,1,1
payara_Payara,org.glassfish.ant.embedded.tasks,0,0,0,0,0,0,1,1
payara_Payara,org.glassfish.ant.tasks,0,0,0,0,0,0,1,1
payara_Payara,org.glassfish.appclient.client.acc,2,1,0,1,1,0,1,6
payara_Payara,org.glassfish.appclient.client.acc.callbackhandler,0,0,0,0,0,0,1,1
payara_Payara,org.glassfish.appclient.client,2,0,0,0,0,0,1,3
payara_Payara,org.glassfish.appclient.client.jws.boot,1,1,0,0,1,0,1,4
payara_Payara,org.glassfish.appclient.common,0,1,0,0,0,0,1,2
payara_Payara,org.glassfish.appclient.client.acc.config.util,0,0,0,0,0,0,1,1
payara_Payara,org.glassfish.appclient.client.acc.config,0,0,0,0,0,0,1,1
payara_Payara,org.glassfish.appclient.client.acc.agent,0,0,0,0,0,0,1,1
payara_Payara,org.glassfish.appclient.client.packageappclient,0,0,0,0,0,0,1,1
payara_Payara,org.glassfish.appclient.server.connector,0,0,0,0,0,0,1,1
payara_Payara,org.glassfish.appclient.server.admin,0,0,0,0,0,0,1,1
payara_Payara,org.glassfish.appclient.server.core,3,0,0,0,1,0,1,5
payara_Payara,org.glassfish.appclient.server.core.jws,4,1,0,0,1,0,1,7
payara_Payara,org.glassfish.appclient.server.core.jws.servedcontent,3,1,0,0,1,0,1,6
payara_Payara,fish.payara.batch,0,0,0,0,0,0,1,1
payara_Payara,org.glassfish.batch,0,0,0,0,1,0,1,2
payara_Payara,fish.payara.jbatch.persistence.rdbms,0,0,0,0,1,0,1,2
payara_Payara,org.glassfish.batch.spi.impl,0,0,0,0,1,0,1,2
payara_Payara,fish.payara.jbatch.persistence.hazelcast,0,0,0,0,0,0,1,1
payara_Payara,org.glassfish.admin.amx.impl.j2ee,1,0,0,1,0,1,1,4
payara_Payara,org.glassfish.admin.amx.impl.j2ee.loader,1,1,0,0,0,0,1,3
payara_Payara,org.glassfish.admin.amx.j2ee,0,0,0,1,0,0,1,2
payara_Payara,org.glassfish.apf,0,0,0,0,1,15,1,17
payara_Payara,org.glassfish.apf.context,0,0,0,0,0,2,1,3
payara_Payara,org.glassfish.apf.factory,1,0,0,0,0,0,1,2
payara_Payara,org.glassfish.apf.impl,1,1,0,0,0,2,1,5
payara_Payara,com.sun.enterprise.container.common.impl,0,0,0,0,1,0,1,2
payara_Payara,com.sun.enterprise.container.common.impl.managedbean,0,0,0,0,0,0,1,1
payara_Payara,com.sun.enterprise.container.common.impl.util,0,0,0,0,1,0,1,2
payara_Payara,com.sun.enterprise.container.common.spi,0,1,0,0,1,0,1,3
payara_Payara,com.sun.enterprise.container.common.spi.util,0,0,0,0,1,0,1,2
payara_Payara,org.glassfish.ha.commands,0,0,0,0,0,0,1,1
payara_Payara,org.glassfish.ha.common,0,0,0,0,0,0,1,1
payara_Payara,org.glassfish.javaee.services,0,0,0,0,0,0,1,1
payara_Payara,com.sun.appserv,0,0,0,0,0,0,1,1
payara_Payara,com.sun.appserv.connectors.spi,0,0,0,0,0,0,1,1
payara_Payara,com.sun.appserv.security,0,0,0,0,0,0,1,1
payara_Payara,com.sun.enterprise.naming,0,0,0,0,0,0,1,1
payara_Payara,com.sun.enterprise.naming.impl,0,0,0,0,1,0,1,2
payara_Payara,com.sun.enterprise.naming.spi,0,0,0,0,0,0,1,1
payara_Payara,com.sun.enterprise.naming.util,0,0,0,0,1,0,1,2
payara_Payara,org.glassfish.admin.mejb,0,0,0,0,1,0,1,2
payara_Payara,com.sun.enterprise.admin.monitor.registry,0,0,0,0,1,0,1,2
payara_Payara,com.sun.enterprise.admin.monitor.stats,0,0,0,1,1,0,1,3
payara_Payara,com.sun.enterprise.admin.monitor.stats.lb,0,0,0,0,0,0,1,1
payara_Payara,org.glassfish.concurrent.config,0,0,0,0,1,0,1,2
payara_Payara,fish.payara.concurrent.monitoring,0,0,0,0,0,0,1,1
payara_Payara,org.glassfish.concurrent.admin,0,0,0,0,1,0,1,2
payara_Payara,org.glassfish.concurrent,0,0,0,0,0,0,1,1
payara_Payara,org.glassfish.concurrent.runtime,1,1,0,0,1,0,1,4
payara_Payara,org.glassfish.concurrent.runtime.deployer,1,0,0,0,1,0,1,3
payara_Payara,org.glassfish.connectors.admin.cli,0,0,0,1,1,1,1,4
payara_Payara,org.glassfish.connectors.admin.cli.internal,0,0,0,0,1,1,1,3
payara_Payara,com.sun.enterprise.connectors.connector.module,0,0,0,0,0,0,1,1
payara_Payara,com.sun.enterprise.connectors.inbound,0,0,0,0,1,0,1,2
payara_Payara,com.sun.appserv.connectors.internal.api,0,1,0,0,1,2,1,5
payara_Payara,com.sun.appserv.connectors.internal,0,0,0,0,0,0,1,1
payara_Payara,com.sun.appserv.connectors.internal.spi,0,0,0,0,0,0,1,1
payara_Payara,org.glassfish.api.jdbc.validation,0,0,0,0,1,0,1,2
payara_Payara,org.glassfish.connectors.config,0,1,0,1,1,1,1,5
payara_Payara,org.glassfish.connectors.config.validators,0,0,0,0,0,0,1,1
payara_Payara,com.sun.enterprise.connectors,2,1,0,0,1,1,1,6
payara_Payara,com.sun.enterprise.connectors.authentication,0,0,0,0,0,0,1,1
payara_Payara,com.sun.enterprise.connectors.deployment.annotation.handlers,0,0,0,0,1,6,1,8
payara_Payara,com.sun.enterprise.connectors.deployment.util,0,0,0,0,0,0,1,1
payara_Payara,com.sun.enterprise.connectors.module,0,0,0,0,0,0,1,1
payara_Payara,com.sun.enterprise.connectors.naming,0,0,0,0,0,0,1,1
payara_Payara,com.sun.enterprise.connectors.service,0,0,0,0,1,1,1,3
payara_Payara,com.sun.enterprise.connectors.util,1,1,0,0,1,1,1,5
payara_Payara,com.sun.enterprise.resource.allocator,0,0,0,0,1,0,1,2
payara_Payara,com.sun.enterprise.resource,1,0,0,0,1,0,1,3
payara_Payara,com.sun.enterprise.resource.beans,0,0,0,0,0,0,1,1
payara_Payara,com.sun.enterprise.resource.deployer,0,0,0,0,1,1,1,3
payara_Payara,com.sun.enterprise.resource.listener,0,0,0,0,0,0,1,1
payara_Payara,com.sun.enterprise.resource.naming,0,0,0,0,0,0,1,1
payara_Payara,com.sun.enterprise.resource.pool,0,0,0,0,1,0,1,2
payara_Payara,com.sun.enterprise.resource.pool.datastructure,0,0,0,0,0,0,1,1
payara_Payara,com.sun.enterprise.resource.pool.datastructure.strategy,0,0,0,0,0,0,1,1
payara_Payara,com.sun.enterprise.resource.pool.monitor,0,0,0,0,1,0,1,2
payara_Payara,com.sun.enterprise.resource.pool.resizer,0,0,0,0,0,0,1,1
payara_Payara,com.sun.enterprise.resource.pool.waitqueue,0,0,0,0,0,0,1,1
payara_Payara,com.sun.enterprise.resource.recovery,0,0,0,0,0,0,1,1
payara_Payara,com.sun.enterprise.resource.rm,0,0,0,0,0,0,1,1
payara_Payara,com.sun.enterprise.connectors.work,0,0,0,0,1,0,1,2
payara_Payara,com.sun.enterprise.connectors.work.context,0,0,0,0,0,0,1,1
payara_Payara,com.sun.enterprise.connectors.work.monitor,0,0,0,0,0,0,1,1
payara_Payara,org.glassfish.kernel.javaee,0,0,0,0,0,0,1,1
payara_Payara,org.glassfish.deployapi.actions,0,0,0,0,0,0,1,1
payara_Payara,org.glassfish.deployapi.config,0,0,0,0,0,0,1,1
payara_Payara,org.glassfish.deployapi,0,0,0,0,1,0,1,2
payara_Payara,org.glassfish.deployment.client,0,1,0,0,1,0,1,3
payara_Payara,com.sun.enterprise.deployment,15,1,0,1,1,27,1,46
payara_Payara,com.sun.enterprise.deployment.annotation.context,1,0,0,0,0,15,1,17
payara_Payara,com.sun.enterprise.deployment.annotation.factory,1,0,0,0,0,0,1,2
payara_Payara,com.sun.enterprise.deployment.annotation.handlers,0,0,0,0,1,10,1,12
payara_Payara,com.sun.enterprise.deployment.annotation.impl,0,0,0,0,0,0,1,1
payara_Payara,com.sun.enterprise.deployment.annotation.introspection,1,0,0,0,1,0,1,3
payara_Payara,com.sun.enterprise.deployment.archivist,8,1,0,0,1,0,1,11
payara_Payara,com.sun.enterprise.deployment.deploy.spi,0,0,0,0,0,0,1,1
payara_Payara,com.sun.enterprise.deployment.interfaces,0,0,0,0,0,0,1,1
payara_Payara,com.sun.enterprise.deployment.io,3,1,0,0,0,1,1,6
payara_Payara,com.sun.enterprise.deployment.io.runtime,0,0,0,0,1,0,1,2
payara_Payara,com.sun.enterprise.deployment.node,11,1,0,1,1,0,1,15
payara_Payara,com.sun.enterprise.deployment.node.appclient,10,0,0,0,0,0,1,11
payara_Payara,com.sun.enterprise.deployment.node.connector,4,1,0,0,0,0,1,6
payara_Payara,com.sun.enterprise.deployment.node.runtime,5,1,0,0,1,0,1,8
payara_Payara,com.sun.enterprise.deployment.node.runtime.application.gf,0,0,0,0,0,0,1,1
payara_Payara,com.sun.enterprise.deployment.node.runtime.application.wls,0,0,0,0,0,0,1,1
payara_Payara,com.sun.enterprise.deployment.node.runtime.common,3,0,0,0,1,0,1,5
payara_Payara,com.sun.enterprise.deployment.node.runtime.common.wls,0,0,0,0,0,0,1,1
payara_Payara,com.sun.enterprise.deployment.node.runtime.connector,1,0,0,0,0,0,1,2
payara_Payara,com.sun.enterprise.deployment.node.ws,0,0,0,0,0,0,1,1
payara_Payara,com.sun.enterprise.deployment.runtime.application.wls,0,0,0,0,0,0,1,1
payara_Payara,com.sun.enterprise.deployment.runtime,0,0,0,0,0,1,1,2
payara_Payara,com.sun.enterprise.deployment.runtime.common,1,0,0,0,1,0,1,3
payara_Payara,com.sun.enterprise.deployment.runtime.common.wls,0,0,0,0,0,0,1,1
payara_Payara,com.sun.enterprise.deployment.runtime.connector,0,0,0,0,0,0,1,1
payara_Payara,com.sun.enterprise.deployment.runtime.web,0,0,0,0,0,0,1,1
payara_Payara,com.sun.enterprise.deployment.runtime.ws,0,0,0,0,0,0,1,1
payara_Payara,com.sun.enterprise.deployment.types,0,0,0,0,1,3,1,5
payara_Payara,com.sun.enterprise.deployment.util,14,1,0,1,0,4,1,21
payara_Payara,com.sun.enterprise.deployment.util.logging,0,0,0,0,0,0,1,1
payara_Payara,com.sun.enterprise.deployment.util.webservice,0,0,0,0,0,0,1,1
payara_Payara,com.sun.enterprise.deployment.web,0,0,0,0,1,3,1,5
payara_Payara,com.sun.enterprise.deployment.xml,0,0,0,0,1,0,1,2
payara_Payara,com.sun.enterprise.repository,0,0,0,0,0,0,1,1
payara_Payara,org.glassfish.javaee.core.deployment,0,0,0,0,1,0,1,2
payara_Payara,org.glassfish.javaee.full.deployment,0,0,0,0,1,0,1,2
payara_Payara,(default package),0,0,0,2,1,0,1,4
payara_Payara,fish.payara.docker,0,0,0,0,0,0,1,1
payara_Payara,fish.payara.docker.instance.admin,0,0,0,0,1,0,1,2
payara_Payara,fish.payara.docker.instance,0,0,0,0,0,0,1,1
payara_Payara,fish.payara.docker.node.admin,0,0,0,0,0,0,1,1
payara_Payara,com.sun.ejb.portable,0,0,0,0,0,0,1,1
payara_Payara,org.glassfish.ejb.config,0,0,0,0,1,0,1,2
payara_Payara,org.glassfish.ejb.deployment.archive,0,0,0,0,0,0,1,1
payara_Payara,org.glassfish.ejb.deployment,2,1,0,0,1,0,1,5
payara_Payara,com.sun.ejb.base.container.util,0,0,0,0,0,0,1,1
payara_Payara,com.sun.ejb.base.io,2,0,0,0,1,0,1,4
payara_Payara,com.sun.ejb.base.sfsb.util,0,0,0,0,0,0,1,1
payara_Payara,com.sun.ejb.base.stats,0,0,0,0,0,0,1,1
payara_Payara,com.sun.ejb.codegen,0,0,0,0,1,0,1,2
payara_Payara,com.sun.ejb,4,1,0,0,1,1,1,8
payara_Payara,com.sun.ejb.containers,7,1,0,1,1,1,1,12
payara_Payara,com.sun.ejb.containers.interceptors,3,0,0,0,0,1,1,5
payara_Payara,com.sun.ejb.containers.util.cache,0,0,0,0,1,0,1,2
payara_Payara,com.sun.ejb.containers.util,0,0,0,0,0,0,1,1
payara_Payara,com.sun.ejb.containers.util.pool,0,0,0,0,1,0,1,2
payara_Payara,com.sun.ejb.monitoring.probes,0,0,0,0,0,0,1,1
payara_Payara,com.sun.ejb.monitoring.stats,1,1,0,0,1,0,1,4
payara_Payara,com.sun.ejb.spi.container,0,0,0,0,0,0,1,1
payara_Payara,com.sun.ejb.spi.sfsb.util,0,0,0,0,0,0,1,1
payara_Payara,com.sun.ejb.spi.stats,0,0,0,0,0,0,1,1
payara_Payara,org.glassfish.ejb.admin.cli,0,0,0,0,0,0,1,1
payara_Payara,org.glassfish.ejb.deployment.annotation.handlers,0,0,0,1,1,9,1,12
payara_Payara,org.glassfish.ejb.deployment.annotation.impl,0,0,0,0,0,0,1,1
payara_Payara,org.glassfish.ejb.deployment.archivist,0,0,0,0,0,0,1,1
payara_Payara,org.glassfish.ejb.deployment.descriptor,5,1,0,0,1,10,1,18
payara_Payara,org.glassfish.ejb.deployment.descriptor.runtime,0,0,0,0,1,0,1,2
payara_Payara,org.glassfish.ejb.deployment.io,0,0,0,0,0,1,1,2
payara_Payara,org.glassfish.ejb.deployment.node,3,0,0,0,0,0,1,4
payara_Payara,org.glassfish.ejb.deployment.node.runtime,1,1,0,0,0,0,1,3
payara_Payara,org.glassfish.ejb.deployment.util,2,0,0,0,0,1,1,4
payara_Payara,org.glassfish.ejb.embedded,0,0,0,0,1,0,1,2
payara_Payara,org.glassfish.ejb,0,0,0,0,0,0,1,1
payara_Payara,org.glassfish.ejb.security.application,0,1,0,0,0,0,1,2
payara_Payara,org.glassfish.ejb.security.factory,0,0,0,0,0,0,1,1
payara_Payara,org.glassfish.ejb.startup,0,0,0,0,0,0,1,1
payara_Payara,org.glassfish.ejb.upgrade,0,0,0,0,0,0,1,1
payara_Payara,org.glassfish.ejb.mdb.deployment.annotation.handlers,0,0,0,0,0,0,1,1
payara_Payara,org.glassfish.ejb.mdb,0,0,0,0,1,0,1,2
payara_Payara,org.glassfish.ejb.mdb.monitoring.stats,0,0,0,0,0,0,1,1
payara_Payara,org.glassfish.ejb.persistent.timer,0,0,0,0,1,0,1,2
payara_Payara,fish.payara.ejb.http.admin,0,0,0,0,0,0,1,1
payara_Payara,fish.payara.ejb.http.client.adapter,0,0,0,0,0,0,1,1
payara_Payara,fish.payara.ejb.http.client,0,0,0,0,1,0,1,2
payara_Payara,fish.payara.ejb.http.protocol,0,0,0,0,1,0,1,2
payara_Payara,fish.payara.ejb.http.protocol.rs,0,0,0,0,1,0,1,2
payara_Payara,fish.payara.ejb.rest.client,0,0,0,0,0,0,1,1
payara_Payara,fish.payara.ejb.http.client.adapter.example.client,0,0,0,0,0,0,1,1
payara_Payara,fish.payara.ejb.http.client.adapter.example.stub,0,0,0,0,0,0,1,1
payara_Payara,fish.payara.ejb.http.endpoint,0,0,0,0,0,0,1,1
payara_Payara,fish.payara.ejb.invoke,0,0,0,0,0,0,1,1
payara_Payara,fish.payara.ejb.endpoint,0,0,0,0,0,0,1,1
payara_Payara,org.glassfish.ejb.api,0,0,0,0,1,0,1,2
payara_Payara,org.glassfish.ejb.spi,0,0,0,0,1,0,1,2
payara_Payara,com.sun.ejb.timers,0,0,0,0,0,0,1,1
payara_Payara,org.glassfish.uberjar.activator,0,0,0,0,0,0,1,1
payara_Payara,org.glassfish.uberjar.bootstrap,0,0,0,0,0,0,1,1
payara_Payara,org.glassfish.uberjar,0,0,0,0,0,0,1,1
payara_Payara,org.glassfish.uberjar.builder.installroot,0,0,0,0,0,0,1,1
payara_Payara,org.glassfish.uberjar.builder.instanceroot,0,0,0,0,0,0,1,1
payara_Payara,org.glassfish.uberjar.osgimain,0,0,0,0,0,0,1,1
payara_Payara,org.glassfish.uberjar.uninstaller,0,0,0,0,0,0,1,1
payara_Payara,fish.payara.micro.boot.loader.archive,0,0,0,0,0,0,1,1
payara_Payara,fish.payara.micro.boot.loader.data,0,0,0,0,0,0,1,1
payara_Payara,fish.payara.micro.boot.loader,0,0,0,0,0,0,1,1
payara_Payara,fish.payara.micro.boot.loader.jar,0,0,0,0,0,0,1,1
payara_Payara,fish.payara.micro.boot,0,0,0,0,0,0,1,1
payara_Payara,fish.payara.micro,0,1,0,0,0,1,1,3
payara_Payara,fish.payara.micro.data,0,0,0,0,0,1,1,2
payara_Payara,fish.payara.micro.event,0,0,0,0,0,0,1,1
payara_Payara,fish.payara.micro.boot.runtime,0,0,0,0,0,0,1,1
payara_Payara,fish.payara.micro.cmd.options,0,0,0,0,0,0,1,1
payara_Payara,fish.payara.micro.impl,0,0,0,0,0,1,1,2
payara_Payara,org.glassfish.flashlight.client,1,0,0,0,1,0,1,3
payara_Payara,org.glassfish.grizzly.extras.addons,0,0,0,0,0,0,1,1
payara_Payara,org.glassfish.extras.grizzly,0,0,0,0,1,0,1,2
payara_Payara,org.glassfish.ha.store.adapter.file,0,0,0,0,0,0,1,1
payara_Payara,fish.payara.ha.hazelcast.store,0,0,0,0,0,0,1,1
payara_Payara,org.glassfish.installer.conf,1,1,0,0,0,0,1,3
payara_Payara,org.glassfish.installer.util,1,0,0,0,1,0,1,3
payara_Payara,org.openinstaller.provider.conf,0,0,0,0,0,0,1,1
payara_Payara,org.glassfish.jdbc.admin.cli,0,0,0,0,1,0,1,2
payara_Payara,org.glassfish.jdbc.admin.cli.internal,0,0,0,0,0,1,1,2
payara_Payara,org.glassfish.jdbc.config,0,1,0,0,1,0,1,3
payara_Payara,org.glassfish.jdbc.config.validators,0,0,0,0,0,0,1,1
payara_Payara,com.sun.gjc.common,0,0,0,0,0,0,1,1
payara_Payara,com.sun.gjc.monitoring,2,0,0,0,0,1,1,4
payara_Payara,com.sun.gjc.spi.base,0,0,0,0,1,0,1,2
payara_Payara,com.sun.gjc.spi.base.datastructure,0,0,0,0,1,0,1,2
payara_Payara,com.sun.gjc.spi,0,0,0,0,1,0,1,2
payara_Payara,com.sun.gjc.util,2,1,0,0,1,1,1,6
payara_Payara,fish.payara.jdbc,0,0,0,0,0,0,1,1
payara_Payara,fish.payara.jdbc.stats,1,0,0,0,0,1,1,3
payara_Payara,com.sun.gjc.spi.jdbc30,0,0,0,0,1,0,1,2
payara_Payara,com.sun.gjc.spi.jdbc40,0,0,0,0,1,0,1,2
payara_Payara,org.glassfish.jdbc.deployer,0,0,0,0,1,0,1,2
payara_Payara,org.glassfish.jdbc.pool.monitor,0,0,0,0,0,0,1,1
payara_Payara,org.glassfish.jdbc.recovery,0,0,0,0,0,0,1,1
payara_Payara,org.glassfish.jdbc.util,0,0,0,0,0,0,1,1
payara_Payara,org.glassfish.jdbcruntime,0,0,0,0,0,0,1,1
payara_Payara,org.glassfish.jdbcruntime.deployment.annotation.handlers,0,0,0,0,0,0,1,1
payara_Payara,org.glassfish.jdbcruntime.service,0,0,0,0,0,0,1,1
payara_Payara,org.glassfish.jdbcruntime.config,0,0,0,0,0,0,1,1
payara_Payara,org.glassfish.jdbcruntime.config.validation,0,0,0,0,0,0,1,1
payara_Payara,com.sun.messaging.jmq.management,0,0,0,0,0,0,1,1
payara_Payara,org.glassfish.jms.admin.cli,0,0,0,0,1,0,1,2
payara_Payara,com.sun.enterprise.connectors.jms.config,0,0,0,0,1,0,1,2
payara_Payara,org.glassfish.jms.injection,0,0,0,0,1,0,1,2
payara_Payara,com.sun.enterprise.connectors.jms.inflow,0,0,0,0,0,0,1,1
payara_Payara,com.sun.enterprise.connectors.jms,0,0,0,0,0,0,1,1
payara_Payara,com.sun.enterprise.connectors.jms.system,0,0,0,0,1,0,1,2
payara_Payara,com.sun.enterprise.connectors.jms.util,0,0,0,0,0,0,1,1
payara_Payara,com.sun.enterprise.connectors.jms.deployment.annotation.handlers,0,0,0,0,0,3,1,4
payara_Payara,org.glassfish.loadbalancer.admin.cli,1,1,0,0,1,0,1,4
payara_Payara,org.glassfish.loadbalancer.admin.cli.beans,0,0,0,0,0,0,1,1
payara_Payara,org.glassfish.loadbalancer.admin.cli.connection,0,0,0,0,0,0,1,1
payara_Payara,org.glassfish.loadbalancer.admin.cli.helper,1,0,0,0,0,0,1,2
payara_Payara,org.glassfish.loadbalancer.admin.cli.reader.api,0,0,0,0,1,0,1,2
payara_Payara,org.glassfish.loadbalancer.admin.cli.reader.impl,0,0,0,0,1,0,1,2
payara_Payara,org.glassfish.loadbalancer.admin.cli.transform,0,0,0,0,1,0,1,2
payara_Payara,org.glassfish.loadbalancer.upgrade,0,0,0,0,0,0,1,1
payara_Payara,org.glassfish.loadbalancer.config.customvalidators,0,0,0,0,0,0,1,1
payara_Payara,org.glassfish.loadbalancer.config,0,0,0,0,1,0,1,2
payara_Payara,fish.payara.monitoring.model,0,0,0,0,1,0,1,2
payara_Payara,fish.payara.monitoring.store,1,0,0,0,1,0,1,3
payara_Payara,fish.payara.monitoring.collect,1,1,0,0,0,0,1,3
payara_Payara,fish.payara.monitoring.web,0,0,0,0,0,0,1,1
payara_Payara,org.glassfish.enterprise.iiop.api,0,0,0,0,1,0,1,2
payara_Payara,org.glassfish.enterprise.iiop.spi,0,0,0,0,0,0,1,1
payara_Payara,org.glassfish.enterprise.iiop.util,0,0,0,0,1,0,1,2
payara_Payara,org.glassfish.orb.admin.cli,0,0,0,0,1,0,1,2
payara_Payara,org.glassfish.orb.admin.config.handler,0,0,0,0,0,0,1,1
payara_Payara,org.glassfish.enterprise.api.enabler,0,0,0,0,0,0,1,1
payara_Payara,org.glassfish.orb.admin.config,0,0,0,0,1,0,1,2
payara_Payara,org.glassfish.enterprise.iiop.impl,0,0,0,0,1,0,1,2
payara_Payara,org.glassfish.osgi.felixwebconsoleextension,0,0,0,0,0,0,1,1
payara_Payara,org.glassfish.osgi.admingui,0,0,0,0,0,0,1,1
payara_Payara,fish.payara.appserver.cdi.auth.roles,0,0,0,0,0,0,1,1
payara_Payara,fish.payara.appserver.cdi.auth.roles.extension,0,0,0,0,0,0,1,1
payara_Payara,fish.payara.appserver.environment.warning.config.admin,0,0,0,0,0,0,1,1
payara_Payara,fish.payara.appserver.environment.warning.config,0,0,0,0,0,0,1,1
payara_Payara,fish.payara.persistence.eclipselink.cache.coordination,0,0,0,0,1,0,1,2
payara_Payara,fish.payara.ejb.timer.hazelcast,0,0,0,0,0,0,1,1
payara_Payara,fish.payara.healthcheck.mphealth,0,0,0,0,0,0,1,1
payara_Payara,fish.payara.security.jaspic,0,0,0,0,0,0,1,1
payara_Payara,fish.payara.requesttracing.jaxrs.client,0,0,0,0,0,0,1,1
payara_Payara,fish.payara.jmx.monitoring.admin,0,0,0,0,1,0,1,2
payara_Payara,fish.payara.jmx.monitoring.admin.notifier,0,0,0,0,1,0,1,2
payara_Payara,fish.payara.jmx.monitoring.configuration,0,0,0,0,1,0,1,2
payara_Payara,fish.payara.jmx.monitoring,0,0,0,0,0,0,1,1
payara_Payara,fish.payara.microprofile.config.cdi,0,0,0,0,0,0,1,1
payara_Payara,fish.payara.microprofile.faulttolerance.admin,0,0,0,0,0,0,1,1
payara_Payara,fish.payara.microprofile.faulttolerance.cdi,0,0,0,0,0,0,1,1
payara_Payara,fish.payara.microprofile.faulttolerance,0,0,0,0,0,0,1,1
payara_Payara,fish.payara.microprofile.faulttolerance.policy,1,0,0,0,1,0,1,3
payara_Payara,fish.payara.microprofile.faulttolerance.service,0,0,0,0,1,0,1,2
payara_Payara,fish.payara.microprofile.faulttolerance.state,0,0,0,0,0,0,1,1
payara_Payara,fish.payara.microprofile.faulttolerance.policy.sub,0,0,0,0,0,0,1,1
payara_Payara,fish.payara.microprofile.healthcheck.admin,0,0,0,0,0,0,1,1
payara_Payara,fish.payara.microprofile.healthcheck.config,0,0,0,0,0,0,1,1
payara_Payara,fish.payara.microprofile.healthcheck,0,0,0,0,0,0,1,1
payara_Payara,fish.payara.microprofile.healthcheck.response,0,0,0,0,0,0,1,1
payara_Payara,fish.payara.microprofile.healthcheck.servlet,0,0,0,0,0,0,1,1
payara_Payara,fish.payara.microprofile.jwtauth.cdi,0,0,0,0,0,0,1,1
payara_Payara,fish.payara.microprofile.jwtauth.eesecurity,0,0,0,0,0,0,1,1
payara_Payara,fish.payara.microprofile.jwtauth.jaxrs,0,0,0,0,0,0,1,1
payara_Payara,fish.payara.microprofile.jwtauth.jwt,0,0,0,0,0,0,1,1
payara_Payara,fish.payara.microprofile.jwtauth.servlet,0,0,0,0,0,0,1,1
payara_Payara,fish.payara.microprofile.jwtauth.tck,0,0,0,0,0,0,1,1
payara_Payara,fish.payara.microprofile.metrics.admin,1,0,0,0,0,0,1,2
payara_Payara,fish.payara.microprofile.metrics.cdi.extension,0,0,0,0,0,0,1,1
payara_Payara,fish.payara.microprofile.metrics.cdi.interceptor,0,0,1,0,1,0,1,3
payara_Payara,fish.payara.microprofile.metrics.cdi,0,0,0,0,0,0,1,1
payara_Payara,fish.payara.microprofile.metrics.cdi.producer,0,0,0,0,0,0,1,1
payara_Payara,fish.payara.microprofile.metrics.exception,0,0,0,0,0,0,1,1
payara_Payara,fish.payara.microprofile.metrics.impl,0,0,0,0,1,0,1,2
payara_Payara,fish.payara.microprofile.metrics.jmx,0,0,0,0,1,0,1,2
payara_Payara,fish.payara.microprofile.metrics,1,1,0,0,0,0,1,3
payara_Payara,fish.payara.microprofile.metrics.rest,0,0,0,0,0,0,1,1
payara_Payara,fish.payara.microprofile.metrics.writer,0,0,0,0,1,0,1,2
payara_Payara,fish.payara.microprofile,0,0,0,0,0,0,1,1
payara_Payara,fish.payara.microprofile.openapi.api,0,0,0,0,0,0,1,1
payara_Payara,fish.payara.microprofile.openapi.api.processor,0,0,0,0,0,0,1,1
payara_Payara,fish.payara.microprofile.openapi.api.visitor,0,0,0,0,0,0,1,1
payara_Payara,fish.payara.microprofile.openapi.impl.admin,0,0,0,0,0,0,1,1
payara_Payara,fish.payara.microprofile.openapi.impl.config,0,0,0,0,0,0,1,1
payara_Payara,fish.payara.microprofile.openapi.impl.model.callbacks,1,1,0,0,0,0,1,3
payara_Payara,fish.payara.microprofile.openapi.impl.model,8,0,0,0,1,0,1,10
payara_Payara,fish.payara.microprofile.openapi.impl.model.examples,0,0,0,0,0,0,1,1
payara_Payara,fish.payara.microprofile.openapi.impl.model.headers,3,1,0,0,0,0,1,5
payara_Payara,fish.payara.microprofile.openapi.impl.model.info,0,0,0,0,0,0,1,1
payara_Payara,fish.payara.microprofile.openapi.impl.model.links,0,0,0,0,0,0,1,1
payara_Payara,fish.payara.microprofile.openapi.impl.model.media,6,1,0,0,1,0,1,9
payara_Payara,fish.payara.microprofile.openapi.impl.model.parameters,1,0,0,0,0,0,1,2
payara_Payara,fish.payara.microprofile.openapi.impl.model.responses,2,0,0,0,0,0,1,3
payara_Payara,fish.payara.microprofile.openapi.impl.model.security,0,0,0,0,0,0,1,1
payara_Payara,fish.payara.microprofile.openapi.impl.model.servers,0,0,0,0,0,0,1,1
payara_Payara,fish.payara.microprofile.openapi.impl.model.tags,1,1,0,0,0,0,1,3
payara_Payara,fish.payara.microprofile.openapi.impl.model.util,0,0,0,0,0,0,1,1
payara_Payara,fish.payara.microprofile.openapi.impl,0,1,0,0,0,0,1,2
payara_Payara,fish.payara.microprofile.openapi.impl.processor,0,0,0,0,0,0,1,1
payara_Payara,fish.payara.microprofile.openapi.impl.rest.app,0,0,0,0,0,0,1,1
payara_Payara,fish.payara.microprofile.openapi.impl.rest.app.provider,0,1,0,0,0,0,1,2
payara_Payara,fish.payara.microprofile.openapi.impl.rest.app.provider.mixin,0,0,0,0,0,0,1,1
payara_Payara,fish.payara.microprofile.openapi.impl.rest.app.provider.writer,0,0,0,0,0,0,1,1
payara_Payara,fish.payara.microprofile.openapi.impl.rest.app.service,0,1,0,0,0,0,1,2
payara_Payara,fish.payara.microprofile.openapi.impl.rest.init,0,0,0,0,0,0,1,1
payara_Payara,fish.payara.microprofile.openapi.impl.visitor,0,0,0,0,0,0,1,1
payara_Payara,fish.payara.microprofile.openapi.resource.classloader,0,0,0,0,0,0,1,1
payara_Payara,fish.payara.microprofile.openapi.resource.rule,0,0,0,0,0,0,1,1
payara_Payara,fish.payara.microprofile.openapi.spec,1,0,0,0,0,0,1,2
payara_Payara,fish.payara.microprofile.opentracing.cdi,0,0,0,0,0,0,1,1
payara_Payara,fish.payara.microprofile.opentracing.jaxrs.client,0,0,0,0,1,0,1,2
payara_Payara,fish.payara.microprofile.opentracing.jaxrs,0,0,0,0,0,0,1,1
payara_Payara,fish.payara.opentracing.jaxws,0,0,0,0,0,0,1,1
payara_Payara,fish.payara.notification.datadog,0,0,0,0,1,0,1,2
payara_Payara,fish.payara.notification.email,0,0,0,0,1,0,1,2
payara_Payara,fish.payara.notification.hipchat,0,0,0,0,1,0,1,2
payara_Payara,fish.payara.nucleus.notification.domain.execoptions,0,0,0,0,0,0,1,1
payara_Payara,fish.payara.nucleus.notification.service.hipchat,0,0,0,0,0,0,1,1
payara_Payara,fish.payara.notification.jms,0,0,0,0,1,0,1,2
payara_Payara,fish.payara.notification.newrelic,0,0,0,0,1,0,1,2
payara_Payara,fish.payara.notification.slack,0,0,0,0,1,0,1,2
payara_Payara,fish.payara.notification.snmp.exception,0,0,0,0,0,0,1,1
payara_Payara,fish.payara.notification.snmp,0,0,0,0,1,0,1,2
payara_Payara,fish.payara.notification.xmpp,0,0,0,0,1,0,1,2
payara_Payara,fish.payara.opentracing.cdi,0,0,0,0,0,0,1,1
payara_Payara,fish.payara.cdi.jsr107,0,0,0,0,1,0,1,2
payara_Payara,fish.payara.cdi.jsr107.implementation,0,0,0,0,1,0,1,2
payara_Payara,fish.payara.micro.cdi.extension.cluster,0,0,0,0,1,0,1,2
payara_Payara,fish.payara.micro.cdi.extension,0,0,0,0,0,0,1,1
payara_Payara,fish.payara.appserver.micro.services.asadmin,0,0,0,0,0,0,1,1
payara_Payara,fish.payara.appserver.micro.services.command,0,0,0,0,0,0,1,1
payara_Payara,fish.payara.appserver.micro.services.data,0,0,0,0,0,0,1,1
payara_Payara,fish.payara.appserver.micro.services,0,0,0,0,0,0,1,1
payara_Payara,fish.payara.appserver.rest.endpoints.config.admin,0,0,0,0,0,0,1,1
payara_Payara,fish.payara.appserver.rest.endpoints,0,0,0,0,0,0,1,1
payara_Payara,fish.payara.appserver.monitoring.rest.service.adapter,0,0,0,0,0,0,1,1
payara_Payara,fish.payara.appserver.monitoring.rest.service.admin,0,0,0,0,0,0,1,1
payara_Payara,fish.payara.appserver.monitoring.rest.service.configuration,0,0,0,0,0,0,1,1
payara_Payara,fish.payara.appserver.monitoring.rest.service,0,0,0,0,0,0,1,1
payara_Payara,fish.payara.appserver.monitoring.rest.service.security,0,0,0,0,0,0,1,1
payara_Payara,fish.payara.monitoring.rest.app.handler,0,0,0,0,1,0,1,2
payara_Payara,fish.payara.monitoring.rest.app,0,0,0,0,0,0,1,1
payara_Payara,fish.payara.monitoring.rest.app.processor,0,0,0,0,1,0,1,2
payara_Payara,fish.payara.monitoring.rest.app.resource,0,0,0,0,0,0,1,1
payara_Payara,fish.payara.security.oauth2,0,0,0,0,0,0,1,1
payara_Payara,fish.payara.security.openid.azure,0,0,0,0,0,0,1,1
payara_Payara,fish.payara.security.openid.controller,0,0,0,0,1,0,1,2
payara_Payara,fish.payara.security.openid.domain,0,0,0,0,1,0,1,2
payara_Payara,fish.payara.security.openid.google,0,0,0,0,0,0,1,1
payara_Payara,fish.payara.security.openid.http,0,0,0,0,0,0,1,1
payara_Payara,fish.payara.security.openid,0,0,0,0,0,0,1,1
payara_Payara,fish.payara.security.authentication.twoIdentityStore,0,0,0,0,0,0,1,1
payara_Payara,fish.payara.security.identitystores,0,0,0,0,0,0,1,1
payara_Payara,fish.payara.appserver.zendesk.admin,0,0,0,0,0,0,1,1
payara_Payara,fish.payara.appserver.zendesk.config,0,0,0,0,0,0,1,1
payara_Payara,fish.payara.appserver.zendesk,0,0,0,0,0,0,1,1
payara_Payara,com.sun.jdo.api.persistence.mapping.ejb,0,0,0,0,1,3,1,5
payara_Payara,com.sun.jdo.api.persistence.mapping.ejb.beans,0,0,0,0,0,0,1,1
payara_Payara,com.sun.jdo.api.persistence.enhancer,0,0,0,0,0,1,1,2
payara_Payara,com.sun.jdo.api.persistence.enhancer.classfile,0,0,0,1,0,3,1,5
payara_Payara,com.sun.jdo.api.persistence.enhancer.generator,0,0,0,0,0,2,1,3
payara_Payara,com.sun.jdo.api.persistence.enhancer.impl,0,0,0,0,0,4,1,5
payara_Payara,com.sun.jdo.api.persistence.enhancer.meta,0,0,0,0,0,7,1,8
payara_Payara,com.sun.jdo.api.persistence.enhancer.util,0,1,0,0,0,4,1,6
payara_Payara,com.sun.jdo.spi.persistence.generator.database,0,0,0,0,1,0,1,2
payara_Payara,com.sun.jdo.api.persistence.support,0,0,0,0,1,3,1,5
payara_Payara,com.sun.jdo.api.persistence.model,6,1,0,0,1,9,1,18
payara_Payara,com.sun.jdo.api.persistence.model.jdo,3,1,0,0,0,7,1,12
payara_Payara,com.sun.jdo.api.persistence.model.jdo.impl,2,0,0,0,0,0,1,3
payara_Payara,com.sun.jdo.api.persistence.model.mapping.impl,1,0,0,0,1,0,1,3
payara_Payara,com.sun.jdo.api.persistence.model.mapping,0,0,0,0,1,5,1,7
payara_Payara,com.sun.jdo.api.persistence.model.util,2,0,0,0,0,4,1,7
payara_Payara,com.sun.jdo.spi.persistence.support.ejb.cmp,0,0,0,0,1,0,1,2
payara_Payara,com.sun.jdo.spi.persistence.support.ejb.codegen,0,0,0,0,0,0,1,1
payara_Payara,com.sun.jdo.spi.persistence.support.ejb.ejbc,1,0,0,0,1,4,1,7
payara_Payara,com.sun.jdo.spi.persistence.support.ejb.ejbqlc,1,1,0,0,0,1,1,4
payara_Payara,com.sun.jdo.spi.persistence.support.ejb.enhancer.meta,0,0,0,0,0,2,1,3
payara_Payara,com.sun.jdo.spi.persistence.support.ejb.model,0,0,0,0,0,1,1,2
payara_Payara,com.sun.jdo.spi.persistence.support.ejb.model.util,0,0,0,0,0,1,1,2
payara_Payara,com.sun.jdo.spi.persistence.support.ejb.util,0,0,0,0,0,0,1,1
payara_Payara,com.sun.jdo.spi.persistence.support.sqlstore,7,1,0,0,1,12,1,22
payara_Payara,com.sun.jdo.spi.persistence.support.sqlstore.connection,0,0,0,0,0,3,1,4
payara_Payara,com.sun.jdo.spi.persistence.support.sqlstore.database,0,0,0,0,0,0,1,1
payara_Payara,com.sun.jdo.spi.persistence.support.sqlstore.database.oracle,0,0,0,0,0,0,1,1
payara_Payara,com.sun.jdo.spi.persistence.support.sqlstore.ejb,0,1,0,0,1,0,1,3
payara_Payara,com.sun.jdo.spi.persistence.support.sqlstore.impl,0,0,0,0,1,1,1,3
payara_Payara,com.sun.jdo.spi.persistence.support.sqlstore.model,4,1,0,0,1,8,1,15
payara_Payara,com.sun.jdo.spi.persistence.support.sqlstore.query.jqlc,1,0,0,0,0,3,1,5
payara_Payara,com.sun.jdo.spi.persistence.support.sqlstore.query,0,0,0,0,0,0,1,1
payara_Payara,com.sun.jdo.spi.persistence.support.sqlstore.query.util.scope,0,0,0,0,1,1,1,3
payara_Payara,com.sun.jdo.spi.persistence.support.sqlstore.query.util.type,0,0,0,0,0,2,1,3
payara_Payara,com.sun.jdo.spi.persistence.support.sqlstore.sco,0,0,0,0,1,1,1,3
payara_Payara,com.sun.jdo.spi.persistence.support.sqlstore.sql.concurrency,0,0,0,0,0,0,1,1
payara_Payara,com.sun.jdo.spi.persistence.support.sqlstore.sql.constraint,2,0,0,0,0,0,1,3
payara_Payara,com.sun.jdo.spi.persistence.support.sqlstore.sql.generator,5,0,0,0,1,0,1,7
payara_Payara,com.sun.jdo.spi.persistence.support.sqlstore.sql,7,1,0,0,0,5,1,14
payara_Payara,com.sun.jdo.spi.persistence.support.sqlstore.state,1,0,0,0,0,4,1,6
payara_Payara,com.sun.jdo.spi.persistence.support.sqlstore.utility,0,0,0,0,1,2,1,4
payara_Payara,com.sun.jdo.spi.persistence.utility,0,0,0,0,1,3,1,5
payara_Payara,com.sun.jdo.spi.persistence.utility.generator.io,0,0,0,0,0,0,1,1
payara_Payara,com.sun.jdo.spi.persistence.utility.generator,0,0,0,0,0,2,1,3
payara_Payara,com.sun.jdo.spi.persistence.utility.logging,0,1,0,0,0,14,1,16
payara_Payara,org.glassfish.persistence.common.database,1,0,0,0,0,0,1,2
payara_Payara,org.glassfish.persistence.common,1,1,0,0,0,0,1,3
payara_Payara,com.sun.appserv.ejb,0,0,0,0,0,0,1,1
payara_Payara,org.glassfish.persistence.ejb.entitybean.container.cache,0,0,0,0,0,0,1,1
payara_Payara,org.glassfish.persistence.ejb.entitybean.container,0,0,0,0,1,0,1,2
payara_Payara,org.glassfish.persistence.ejb.entitybean.container.distributed,0,0,0,0,1,0,1,2
payara_Payara,org.glassfish.persistence.ejb.entitybean.container.spi,0,0,0,0,0,0,1,1
payara_Payara,org.glassfish.persistence.ejb.entitybean.container.stats,0,0,0,0,0,0,1,1
payara_Payara,org.glassfish.persistence.jpaconnector,0,0,0,0,0,0,1,1
payara_Payara,org.glassfish.persistence.jpa,1,0,0,0,1,0,1,3
payara_Payara,org.glassfish.persistence.jpa.schemageneration,1,1,0,0,0,0,1,3
payara_Payara,com.sun.enterprise.registration.glassfish,0,0,0,0,0,0,1,1
payara_Payara,com.sun.enterprise.registration,0,0,0,0,1,0,1,2
payara_Payara,com.sun.enterprise.registration.impl.environment,0,0,0,0,0,0,1,1
payara_Payara,com.sun.enterprise.registration.impl,0,0,0,0,1,0,1,2
payara_Payara,org.glassfish.resources.javamail.admin.cli,0,0,0,0,1,0,1,2
payara_Payara,org.glassfish.resources.javamail.config,0,0,0,0,0,0,1,1
payara_Payara,org.glassfish.resources.javamail,0,0,0,0,0,0,1,1
payara_Payara,org.glassfish.resources.javamail.annotation.handler,0,0,0,0,0,1,1,2
payara_Payara,org.glassfish.resources.javamail.beans,0,0,0,0,0,0,1,1
payara_Payara,org.glassfish.resources.javamail.deployer,0,0,0,0,0,0,1,1
payara_Payara,org.glassfish.resources.javamail.naming,0,0,0,0,0,0,1,1
payara_Payara,org.glassfish.resources.admin.cli,0,0,0,0,1,0,1,2
payara_Payara,org.glassfish.resources.api,0,0,0,0,1,0,1,2
payara_Payara,org.glassfish.resources.config,0,0,0,0,1,0,1,2
payara_Payara,org.glassfish.resources.connector,0,0,0,0,0,0,1,1
payara_Payara,org.glassfish.resources.custom.factory,0,0,0,0,0,0,1,1
payara_Payara,org.glassfish.resources.listener,0,0,0,0,0,0,1,1
payara_Payara,org.glassfish.resources.naming,0,0,0,0,0,0,1,1
payara_Payara,org.glassfish.resources.util,0,0,0,0,0,0,1,1
payara_Payara,org.glassfish.resources.beans,0,0,0,0,0,0,1,1
payara_Payara,org.glassfish.resources.deployer,0,0,0,0,0,0,1,1
payara_Payara,org.glassfish.resources.module,0,0,0,0,0,0,1,1
payara_Payara,com.sun.enterprise.security.appclient,0,0,0,0,0,0,1,1
payara_Payara,com.sun.enterprise.security.appclient.integration,0,0,0,0,0,0,1,1
payara_Payara,com.sun.enterprise.security.acl,0,0,0,0,1,0,1,2
payara_Payara,com.sun.enterprise.security.auth.digest.impl,0,0,0,0,1,1,1,3
payara_Payara,com.sun.enterprise.security.auth.realm.jdbc,0,0,0,0,0,0,1,1
payara_Payara,com.sun.enterprise.security.auth.realm.pam,0,0,0,0,0,0,1,1
payara_Payara,com.sun.enterprise.security.ee.audit,0,0,0,0,0,0,1,1
payara_Payara,com.sun.enterprise.security.ee,0,0,0,0,1,0,1,2
payara_Payara,com.sun.enterprise.security.ee.auth.login,0,0,0,0,1,0,1,2
payara_Payara,com.sun.enterprise.security.ee.auth.realm,0,0,0,0,0,1,1,2
payara_Payara,com.sun.enterprise.security.ee.authorize,0,0,0,0,0,0,1,1
payara_Payara,com.sun.enterprise.security.jacc.cache,0,0,0,0,0,0,1,1
payara_Payara,com.sun.enterprise.security.jacc.context,0,0,0,0,0,0,1,1
payara_Payara,com.sun.enterprise.security.jacc,0,1,0,0,1,0,1,3
payara_Payara,com.sun.enterprise.security.jaspic,1,1,0,0,0,0,1,3
payara_Payara,com.sun.enterprise.security.jaspic.callback,0,0,0,0,0,0,1,1
payara_Payara,com.sun.enterprise.security.jaspic.config,1,0,0,0,1,0,1,3
payara_Payara,com.sun.enterprise.security.jauth,0,1,0,0,1,0,1,3
payara_Payara,com.sun.enterprise.security.jauth.callback,0,0,0,0,1,0,1,2
payara_Payara,com.sun.enterprise.security.permissionsxml,0,0,0,0,1,1,1,3
payara_Payara,com.sun.enterprise.security.web.integration,0,0,0,0,0,0,1,1
payara_Payara,com.sun.enterprise.iiop.security,0,1,0,0,1,0,1,3
payara_Payara,com.sun.enterprise.security.provider,0,0,0,0,1,0,1,2
payara_Payara,com.sun.enterprise.security.jacc.provider,0,0,0,0,1,0,1,2
payara_Payara,com.sun.jaspic.config.delegate,0,0,0,0,0,0,1,1
payara_Payara,com.sun.jaspic.config.factory,0,0,0,0,0,0,1,1
payara_Payara,com.sun.jaspic.config.helper,0,0,0,0,1,0,1,2
payara_Payara,com.sun.jaspic.config.jaas,0,0,0,0,0,0,1,1
payara_Payara,com.sun.jaspic.config.servlet,0,0,0,0,0,0,1,1
payara_Payara,com.sun.jaspic.services,0,0,0,0,0,0,1,1
payara_Payara,com.sun.web.security,0,0,0,0,1,0,1,2
payara_Payara,com.sun.web.security.realmadapter,0,0,0,0,0,0,1,1
payara_Payara,com.sun.enterprise.security.jauth.jaspic.provider,0,0,0,0,1,0,1,2
payara_Payara,com.sun.enterprise.security.jauth.jaspic.provider.config,1,1,0,0,0,0,1,3
payara_Payara,com.sun.enterprise.security.webservices,1,1,0,0,0,0,1,3
payara_Payara,fish.payara.security.oidc.client,0,0,0,0,0,0,1,1
payara_Payara,fish.payara.security.oidc.server,0,0,0,0,0,0,1,1
payara_Payara,simple_bv_servlet,0,0,0,0,0,0,1,1
payara_Payara,client,0,0,0,0,0,0,1,1
payara_Payara,roster,0,0,0,0,0,0,1,1
payara_Payara,team,0,0,0,0,1,0,1,2
payara_Payara,util,0,0,0,0,0,0,1,1
payara_Payara,com.acme,0,0,0,0,0,0,1,1
payara_Payara,com.sun.mdb.client,0,0,0,0,0,0,1,1
payara_Payara,com.sun.mdb,0,0,0,0,0,0,1,1
payara_Payara,remoteview,0,0,0,0,0,0,1,1
payara_Payara,sfulnoi,0,0,0,0,0,0,1,1
payara_Payara,myapp,0,0,0,0,1,0,1,2
payara_Payara,slsbnicmt,0,0,0,0,0,0,1,1
payara_Payara,myapp.util,0,0,0,0,0,0,1,1
payara_Payara,web.jsf.bean,0,0,0,0,0,0,1,1
payara_Payara,jsfinjection,0,0,0,0,0,0,1,1
payara_Payara,extensions,0,0,0,0,0,0,1,1
payara_Payara,jar,0,0,0,0,0,0,1,1
payara_Payara,numberguess,0,0,0,0,1,0,1,2
payara_Payara,osgiweld,0,0,0,0,0,0,1,1
payara_Payara,jaxwsfromwsdl.client,0,0,0,0,0,0,1,1
payara_Payara,jaxwsfromwsdl.server,0,0,0,0,0,0,1,1
payara_Payara,fromjava.server,0,0,0,0,0,0,1,1
payara_Payara,fromjava.client,0,0,0,0,0,0,1,1
payara_Payara,com.sun.enterprise.transaction.api,0,0,0,0,1,0,1,2
payara_Payara,com.sun.enterprise.transaction.config,0,0,0,0,0,0,1,1
payara_Payara,com.sun.enterprise.transaction.spi,0,0,0,0,1,0,1,2
payara_Payara,com.sun.enterprise.transaction.startup,0,0,0,0,0,0,1,1
payara_Payara,com.sun.enterprise.transaction,0,0,0,0,1,0,1,2
payara_Payara,com.sun.enterprise.transaction.monitoring,0,0,0,0,0,0,1,1
payara_Payara,org.glassfish.jta.admin.cli,0,0,0,0,0,0,1,1
payara_Payara,com.sun.enterprise.transaction.xa,0,0,0,0,0,0,1,1
payara_Payara,com.sun.enterprise.transaction.jts.api,0,0,0,0,0,0,1,1
payara_Payara,com.sun.enterprise.transaction.jts.iiop,0,0,0,0,0,0,1,1
payara_Payara,com.sun.enterprise.transaction.jts,4,0,0,0,1,0,1,6
payara_Payara,com.sun.enterprise.transaction.jts.recovery,0,0,0,0,0,0,1,1
payara_Payara,com.sun.jts.codegen.jtsxa,0,0,0,0,1,0,1,2
payara_Payara,com.sun.jts.codegen.otsidl,0,0,0,0,1,0,1,2
payara_Payara,com.sun.jts.CosTransactions,6,1,0,1,1,0,1,10
payara_Payara,com.sun.jts.jta,2,0,0,0,1,0,1,4
payara_Payara,com.sun.jts.jtsxa,0,0,0,0,0,0,1,1
payara_Payara,com.sun.jts.pi,1,0,0,0,1,0,1,3
payara_Payara,com.sun.jts.trace,1,0,0,0,0,0,1,2
payara_Payara,com.sun.jts.utils,0,0,0,0,0,0,1,1
payara_Payara,com.sun.jts.utils.RecoveryHooks,2,0,0,0,0,0,1,3
payara_Payara,org.glassfish.jts.admin.cli,0,0,0,0,0,0,1,1
payara_Payara,fish.payara.grizzly.config.admin.cli,0,0,0,0,0,0,1,1
payara_Payara,org.glassfish.web.admin.cli,0,0,0,1,1,0,1,3
payara_Payara,org.glassfish.web.admin,0,0,0,0,0,0,1,1
payara_Payara,org.glassfish.web.admin.monitor,0,0,0,0,1,0,1,2
payara_Payara,org.glassfish.web.admin.monitor.statistics,0,0,0,0,0,1,1,2
payara_Payara,fish.payara.appserver.context,0,0,0,0,0,0,1,1
payara_Payara,org.glassfish.web.config.serverbeans,0,0,0,0,1,2,1,4
payara_Payara,org.glassfish.web.sniffer,0,0,0,0,0,0,1,1
payara_Payara,org.glassfish.web,0,1,0,0,0,0,1,2
payara_Payara,org.glassfish.weld.connector,0,1,0,0,1,0,1,3
payara_Payara,org.glassfish.web.plugin.common,0,0,0,0,1,3,1,5
payara_Payara,org.glassfish.main.web.jersey.server.mvc.jsp.integration,0,0,0,0,0,0,1,1
payara_Payara,org.glassfish.faces.integration,0,0,0,0,0,0,1,1
payara_Payara,org.glassfish.jspcaching.integration,0,0,0,0,0,0,1,1
payara_Payara,org.glassfish.jstl.integration,0,0,0,0,0,0,1,1
payara_Payara,com.sun.enterprise.glassfish.web,0,0,0,0,1,0,1,2
payara_Payara,org.glassfish.web.loader,0,1,0,0,1,0,1,3
payara_Payara,org.glassfish.web.util,0,0,0,0,0,0,1,1
payara_Payara,com.sun.enterprise.web.connector.grizzly,0,0,0,0,0,0,1,1
payara_Payara,org.apache.catalina,17,1,0,1,1,4,1,25
payara_Payara,org.apache.catalina.authenticator,2,0,0,0,1,0,1,4
payara_Payara,org.apache.catalina.connector,6,0,0,1,1,0,1,9
payara_Payara,org.apache.catalina.core,17,1,0,1,1,3,1,24
payara_Payara,org.apache.catalina.deploy,1,0,0,0,1,2,1,5
payara_Payara,org.apache.catalina.fileupload,0,0,0,0,0,0,1,1
payara_Payara,org.apache.catalina.filters,0,0,0,0,1,0,1,2
payara_Payara,org.apache.catalina.loader,0,0,0,0,0,0,1,1
payara_Payara,org.apache.catalina.logger,0,0,0,0,0,0,1,1
payara_Payara,org.apache.catalina.net,0,0,0,0,0,0,1,1
payara_Payara,org.apache.catalina.realm,0,0,0,0,0,0,1,1
payara_Payara,org.apache.catalina.security,6,1,0,0,0,0,1,8
payara_Payara,org.apache.catalina.servlets,0,1,0,0,1,0,1,3
payara_Payara,org.apache.catalina.session,0,0,0,0,1,0,1,2
payara_Payara,org.apache.catalina.ssi,0,0,0,1,1,0,1,3
payara_Payara,org.apache.catalina.startup,7,1,0,1,1,2,1,13
payara_Payara,org.apache.catalina.util,5,0,0,0,1,1,1,8
payara_Payara,org.apache.catalina.valves,2,0,0,0,1,0,1,4
payara_Payara,org.apache.tomcat.util.digester,2,0,0,0,0,1,1,4
payara_Payara,org.apache.tomcat.util.security,0,0,0,0,0,0,1,1
payara_Payara,org.glassfish.web.valve,1,0,0,0,0,0,1,2
payara_Payara,org.glassfish.embeddable.web,0,0,0,0,1,0,1,2
payara_Payara,org.glassfish.embeddable.web.config,0,0,0,0,1,0,1,2
payara_Payara,com.sun.appserv.web.cache,0,0,0,0,0,0,1,1
payara_Payara,com.sun.appserv.web.cache.filter,0,0,0,0,0,0,1,1
payara_Payara,com.sun.appserv.web.cache.mapping,0,0,0,0,0,0,1,1
payara_Payara,com.sun.appserv.web.taglibs.cache,0,0,0,0,1,0,1,2
payara_Payara,com.sun.enterprise.security.web,0,0,0,0,0,0,1,1
payara_Payara,com.sun.enterprise.util.logging,0,0,0,0,0,0,1,1
payara_Payara,com.sun.enterprise.web.accesslog,0,0,0,0,0,0,1,1
payara_Payara,com.sun.enterprise.web,0,0,0,1,1,1,1,4
payara_Payara,com.sun.enterprise.web.connector.coyote,0,0,0,0,0,0,1,1
payara_Payara,com.sun.enterprise.web.connector.extension,0,0,0,0,0,0,1,1
payara_Payara,com.sun.enterprise.web.connector,0,0,0,0,0,0,1,1
payara_Payara,com.sun.enterprise.web.deploy,0,0,0,0,1,1,1,3
payara_Payara,com.sun.enterprise.web.jsp,0,0,0,0,0,0,1,1
payara_Payara,com.sun.enterprise.web.logger,0,0,0,0,1,0,1,2
payara_Payara,com.sun.enterprise.web.pluggable,0,0,0,0,0,0,1,1
payara_Payara,com.sun.enterprise.web.pwc.connector.coyote,0,0,0,0,0,0,1,1
payara_Payara,com.sun.enterprise.web.pwc,0,0,0,0,0,0,1,1
payara_Payara,com.sun.enterprise.web.reconfig,0,0,0,0,0,0,1,1
payara_Payara,com.sun.enterprise.web.session,0,0,0,0,0,0,1,1
payara_Payara,com.sun.enterprise.web.util,0,0,0,0,0,0,1,1
payara_Payara,com.sun.web.server,0,0,0,0,0,0,1,1
payara_Payara,org.glassfish.web.config,0,0,0,0,0,0,1,1
payara_Payara,org.glassfish.web.deployment.annotation.handlers,0,0,0,0,1,2,1,4
payara_Payara,org.glassfish.web.deployment.annotation.impl,0,0,0,0,0,0,1,1
payara_Payara,org.glassfish.web.deployment.archivist,0,0,0,0,0,0,1,1
payara_Payara,org.glassfish.web.deployment.descriptor,1,1,0,0,1,2,1,6
payara_Payara,org.glassfish.web.deployment.io.runtime,0,0,0,0,0,0,1,1
payara_Payara,org.glassfish.web.deployment.io,0,0,0,0,0,0,1,1
payara_Payara,org.glassfish.web.deployment.node,1,0,0,0,0,0,1,2
payara_Payara,org.glassfish.web.deployment.node.runtime.gf,0,0,0,0,1,0,1,2
payara_Payara,org.glassfish.web.deployment.runtime,0,0,0,0,1,1,1,3
payara_Payara,org.glassfish.web.deployment.util,0,0,0,0,1,1,1,3
payara_Payara,org.glassfish.web.deployment.xml,0,0,0,0,0,0,1,1
payara_Payara,org.glassfish.web.embed.impl,0,0,0,0,0,0,1,1
payara_Payara,org.glassfish.web.jsp,0,0,0,0,0,0,1,1
payara_Payara,org.glassfish.web.upgrade,0,0,0,0,0,0,1,1
payara_Payara,org.glassfish.web.ha.authenticator,0,0,0,0,0,0,1,1
payara_Payara,org.glassfish.web.ha,0,0,0,0,0,0,1,1
payara_Payara,org.glassfish.web.ha.session.management,0,0,0,0,1,0,1,2
payara_Payara,org.glassfish.web.ha.strategy.builder,0,0,0,0,0,0,1,1
payara_Payara,org.apache.naming,1,1,0,0,1,0,1,4
payara_Payara,org.apache.naming.factory,1,0,0,0,1,0,1,3
payara_Payara,org.apache.naming.java,0,0,0,0,0,0,1,1
payara_Payara,org.apache.naming.resources,0,0,0,0,1,0,1,2
payara_Payara,org.apache.naming.resources.jndi,0,0,0,0,0,0,1,1
payara_Payara,org.glassfish.sse.api,0,0,0,0,0,0,1,1
payara_Payara,org.glassfish.sse.impl,0,0,0,0,1,0,1,2
payara_Payara,org.glassfish.cdi,0,0,0,0,0,0,1,1
payara_Payara,org.glassfish.cdi.hk2,0,0,0,0,1,0,1,2
payara_Payara,org.glassfish.cdi.transaction,0,0,0,1,1,0,1,3
payara_Payara,org.glassfish.weld,0,0,0,0,1,0,1,2
payara_Payara,org.glassfish.weld.ejb,0,0,0,0,0,0,1,1
payara_Payara,org.glassfish.weld.jsf,0,0,0,0,0,0,1,1
payara_Payara,org.glassfish.weld.services,0,0,0,0,1,0,1,2
payara_Payara,org.glassfish.weld.util,0,0,0,0,0,0,1,1
payara_Payara,org.glassfish.webservices.archivist,0,0,0,0,0,0,1,1
payara_Payara,org.glassfish.webservices.config,0,0,0,0,1,0,1,2
payara_Payara,org.glassfish.webservices.connector.annotation.handlers,0,0,0,0,1,0,1,2
payara_Payara,org.glassfish.webservices.connector,0,0,0,0,0,0,1,1
payara_Payara,org.glassfish.webservices.io,0,0,0,0,0,0,1,1
payara_Payara,org.glassfish.webservices.node,0,0,0,0,0,0,1,1
payara_Payara,org.glassfish.webservices,2,1,0,1,1,0,1,6
payara_Payara,org.glassfish.webservices.cli,0,0,0,0,0,0,1,1
payara_Payara,org.glassfish.webservices.codegen,1,0,0,0,0,0,1,2
payara_Payara,org.glassfish.webservices.deployment,0,0,0,0,1,0,1,2
payara_Payara,org.glassfish.webservices.monitoring,1,1,0,0,1,2,1,6
payara_Payara,org.glassfish.webservices.metroglue,0,0,0,0,0,0,1,1
payara_Payara,org.glassfish.webservices.transport.tcp,0,0,0,0,1,0,1,2
payara_Payara,com.sun.enterprise.admin.cli,1,1,0,1,1,3,1,8
payara_Payara,com.sun.enterprise.admin.cli.embeddable,0,0,0,0,0,0,1,1
payara_Payara,com.sun.enterprise.admin.cli.remote,1,1,0,0,1,0,1,4
payara_Payara,com.sun.enterprise.admin.cli.schemadoc,0,0,0,0,1,0,1,2
payara_Payara,com.sun.enterprise.config.modularity.command,0,0,0,0,0,0,1,1
payara_Payara,com.sun.enterprise.config.modularity,1,0,0,0,1,0,1,3
payara_Payara,com.sun.enterprise.config.modularity.customization,1,1,0,0,1,0,1,4
payara_Payara,com.sun.enterprise.config.modularity.parser,0,0,0,0,0,0,1,1
payara_Payara,com.sun.enterprise.config.serverbeans,5,1,0,1,1,10,1,19
payara_Payara,com.sun.enterprise.config.serverbeans.customvalidators,0,0,0,0,1,1,1,3
payara_Payara,com.sun.enterprise.config.util,3,1,0,0,1,0,1,6
payara_Payara,fish.payara.enterprise.config.serverbeans,1,0,0,0,1,0,1,3
payara_Payara,org.glassfish.config.support,3,1,0,1,1,0,1,7
payara_Payara,org.glassfish.config.support.datatypes,0,0,0,0,0,0,1,1
payara_Payara,com.sun.enterprise.admin.launcher,0,0,0,0,0,0,1,1
payara_Payara,fish.payara.admin.launcher,0,0,0,0,0,0,1,1
payara_Payara,com.sun.enterprise.admin.monitor.jndi,0,0,0,0,0,0,1,1
payara_Payara,com.sun.enterprise.management.support,0,0,0,0,0,0,1,1
payara_Payara,fish.payara.admin.monitor.cli,0,0,0,0,1,0,1,2
payara_Payara,org.glassfish.admin.monitor.cli,0,0,0,0,0,0,1,1
payara_Payara,org.glassfish.admin.monitor,0,0,0,0,1,0,1,2
payara_Payara,org.glassfish.admin.monitor.jvm,0,0,0,0,1,0,1,2
payara_Payara,org.glassfish.admin.monitor.jvm.statistics,0,0,0,0,0,0,1,1
payara_Payara,org.glassfish.flashlight.datatree.factory,0,1,0,0,0,0,1,2
payara_Payara,org.glassfish.flashlight.datatree.impl,0,0,0,0,0,0,1,1
payara_Payara,org.glassfish.flashlight.impl,0,0,0,0,0,0,1,1
payara_Payara,org.glassfish.flashlight.statistics,0,0,0,0,0,0,1,1
payara_Payara,org.glassfish.flashlight.statistics.factory,0,0,0,0,0,0,1,1
payara_Payara,org.glassfish.flashlight.statistics.impl,0,0,0,0,1,0,1,2
payara_Payara,org.glassfish.flashlight.datatree,0,0,0,0,0,1,1,2
payara_Payara,org.glassfish.admin.restconnector,0,0,0,0,1,0,1,2
payara_Payara,org.glassfish.admin.rest.client,0,0,0,0,1,0,1,2
payara_Payara,org.glassfish.admin.rest.client.utils,0,0,0,0,0,0,1,1
payara_Payara,fish.payara.admin.rest.resources,0,0,0,0,0,0,1,1
payara_Payara,fish.payara.admin.rest.streams,0,0,0,0,0,0,1,1
payara_Payara,org.glassfish.admin.rest.adapter,7,0,0,0,1,0,1,9
payara_Payara,org.glassfish.admin.rest.annotation.processor,0,0,0,0,0,0,1,1
payara_Payara,org.glassfish.admin.rest.cli,0,0,0,0,1,0,1,2
payara_Payara,org.glassfish.admin.rest.composite,6,1,0,0,1,0,1,9
payara_Payara,org.glassfish.admin.rest.composite.metadata,3,0,0,0,1,0,1,5
payara_Payara,org.glassfish.admin.rest,18,1,0,0,1,0,1,21
payara_Payara,org.glassfish.admin.rest.generator,3,0,0,0,1,0,1,5
payara_Payara,org.glassfish.admin.rest.generator.client,0,0,0,0,1,0,1,2
payara_Payara,org.glassfish.admin.rest.logviewer,0,0,0,0,0,0,1,1
payara_Payara,org.glassfish.admin.rest.model,2,1,0,0,1,0,1,5
payara_Payara,org.glassfish.admin.rest.provider,11,1,0,0,1,0,1,14
payara_Payara,org.glassfish.admin.rest.readers,2,0,0,0,1,0,1,4
payara_Payara,org.glassfish.admin.rest.resources,11,1,0,0,1,0,1,14
payara_Payara,org.glassfish.admin.rest.resources.admin,1,0,0,0,0,0,1,2
payara_Payara,org.glassfish.admin.rest.resources.composite,0,1,0,0,0,0,1,2
payara_Payara,org.glassfish.admin.rest.resources.custom,2,0,0,0,1,0,1,4
payara_Payara,org.glassfish.admin.rest.results,3,1,0,0,0,0,1,5
payara_Payara,org.glassfish.admin.rest.utils,14,1,0,0,1,0,1,17
payara_Payara,org.glassfish.admin.rest.utils.xml,0,0,0,0,0,0,1,1
payara_Payara,org.glassfish.admin.rest.wadl,0,0,0,0,0,0,1,1
payara_Payara,fish.payara.admin.rest.utils,0,0,0,0,0,0,1,1
payara_Payara,org.glassfish.admin.rest.composite.resource,0,0,0,0,0,0,1,1
payara_Payara,com.sun.enterprise.admin.servermgmt,1,1,0,0,1,5,1,9
payara_Payara,com.sun.enterprise.admin.servermgmt.cli,0,0,0,0,1,2,1,4
payara_Payara,com.sun.enterprise.admin.servermgmt.domain,0,0,0,0,0,0,1,1
payara_Payara,com.sun.enterprise.admin.servermgmt.logging,0,0,0,0,0,0,1,1
payara_Payara,com.sun.enterprise.admin.servermgmt.pe,1,0,0,0,1,4,1,7
payara_Payara,com.sun.enterprise.admin.servermgmt.services,0,0,0,0,0,0,1,1
payara_Payara,com.sun.enterprise.admin.servermgmt.stringsubs,2,1,0,0,1,1,1,6
payara_Payara,com.sun.enterprise.admin.servermgmt.stringsubs.impl.algorithm,2,0,0,0,0,0,1,3
payara_Payara,com.sun.enterprise.admin.servermgmt.stringsubs.impl,3,1,0,0,0,1,1,6
payara_Payara,com.sun.enterprise.admin.servermgmt.template,0,0,0,0,0,0,1,1
payara_Payara,com.sun.enterprise.admin.servermgmt.util,0,0,0,0,0,0,1,1
payara_Payara,fish.payara.admin.servermgmt.cli,0,0,0,0,1,0,1,2
payara_Payara,com.sun.enterprise.admin.servermgmt.xml.domaininfo,0,0,0,0,0,0,1,1
payara_Payara,com.sun.enterprise.admin.servermgmt.xml.stringsubs,0,0,0,0,0,1,1,2
payara_Payara,com.sun.enterprise.admin.servermgmt.xml.templateinfo,0,0,0,0,0,0,1,1
payara_Payara,com.sun.enterprise.admin.commands,0,0,0,0,0,0,1,1
payara_Payara,com.sun.enterprise.admin.event,0,0,0,0,0,0,1,1
payara_Payara,com.sun.enterprise.admin.progress,0,0,0,0,0,1,1,2
payara_Payara,com.sun.enterprise.admin.remote,4,1,0,0,1,0,1,7
payara_Payara,com.sun.enterprise.admin.remote.reader,2,0,0,0,1,0,1,4
payara_Payara,com.sun.enterprise.admin.remote.sse,0,0,0,0,0,0,1,1
payara_Payara,com.sun.enterprise.admin.remote.writer,0,0,0,0,0,0,1,1
payara_Payara,com.sun.enterprise.admin.report,0,0,0,0,0,0,1,1
payara_Payara,com.sun.enterprise.admin.util,3,1,0,1,1,0,1,7
payara_Payara,com.sun.enterprise.admin.util.cache,1,0,0,0,1,0,1,3
payara_Payara,com.sun.enterprise.admin.util.jmx,0,0,0,0,0,0,1,1
payara_Payara,com.sun.enterprise.admin.util.proxy,0,0,0,0,1,0,1,2
payara_Payara,org.glassfish.admin.cli.resources,0,0,0,0,1,0,1,2
payara_Payara,com.sun.enterprise.v3.admin.cluster,0,0,0,1,1,1,1,4
payara_Payara,com.sun.enterprise.v3.admin.cluster.dcom,0,0,0,0,1,0,1,2
payara_Payara,fish.payara.admin.cluster,0,0,0,0,1,0,1,2
payara_Payara,com.sun.enterprise.admin.cli.cluster,0,0,0,0,1,1,1,3
payara_Payara,fish.payara.admin.cli.cluster,0,1,0,0,0,0,1,2
payara_Payara,com.sun.enterprise.util.cluster,0,0,0,0,1,0,1,2
payara_Payara,com.sun.enterprise.util.cluster.windows.io,0,0,0,0,0,0,1,1
payara_Payara,com.sun.enterprise.util.cluster.windows.process,0,0,0,0,1,0,1,2
payara_Payara,com.sun.enterprise.util.cluster.windows,0,0,0,0,0,0,1,1
payara_Payara,fish.payara.util.cluster,0,0,0,0,0,0,1,1
payara_Payara,org.glassfish.cluster.ssh.connect,0,0,0,0,0,0,1,1
payara_Payara,org.glassfish.cluster.ssh.launcher,0,0,0,0,0,1,1,2
payara_Payara,org.glassfish.cluster.ssh.sftp,0,0,0,0,0,1,1,2
payara_Payara,org.glassfish.cluster.ssh.util,0,0,0,0,0,1,1,2
payara_Payara,org.glassfish.dcom.cli,0,0,0,0,0,0,1,1
payara_Payara,fish.payara.admin.amx,0,0,0,0,0,0,1,1
payara_Payara,fish.payara.admin.amx.cli,0,0,0,0,0,0,1,1
payara_Payara,fish.payara.admin.amx.config,0,0,0,0,0,0,1,1
payara_Payara,org.glassfish.admin.amx.base,2,0,0,0,1,0,1,4
payara_Payara,org.glassfish.admin.amx.config,0,0,0,0,0,0,1,1
payara_Payara,org.glassfish.admin.amx.core,3,1,0,0,1,2,1,8
payara_Payara,org.glassfish.admin.amx.core.proxy,2,0,0,0,0,1,1,4
payara_Payara,org.glassfish.admin.amx.impl,1,1,0,0,0,0,1,3
payara_Payara,org.glassfish.admin.amx.impl.config,0,0,0,0,1,0,1,2
payara_Payara,org.glassfish.admin.amx.impl.mbean,1,0,0,0,1,2,1,5
payara_Payara,org.glassfish.admin.amx.impl.util,0,1,0,0,1,2,1,5
payara_Payara,org.glassfish.admin.amx.logging,0,0,0,0,1,0,1,2
payara_Payara,org.glassfish.admin.amx.monitoring,0,0,0,0,0,0,1,1
payara_Payara,org.glassfish.admin.amx.util,5,1,0,1,1,1,1,10
payara_Payara,org.glassfish.admin.amx.util.jmx,4,1,0,0,1,0,1,7
payara_Payara,org.glassfish.admin.amx.util.jmx.stringifier,2,0,0,0,0,0,1,3
payara_Payara,org.glassfish.admin.amx.util.stringifier,3,0,0,0,0,0,1,4
payara_Payara,com.sun.appserv.ha.util,0,0,0,0,0,0,1,1
payara_Payara,com.sun.appserv.management.client.prefs,0,0,0,0,0,0,1,1
payara_Payara,com.sun.appserv.server.util,0,0,0,0,0,1,1,2
payara_Payara,com.sun.appserv.util.cache,0,0,0,0,1,1,1,3
payara_Payara,com.sun.appserv.util.cache.mbeans,0,0,0,0,0,0,1,1
payara_Payara,com.sun.common.util.logging,0,0,0,0,1,0,1,2
payara_Payara,com.sun.enterprise.admin.monitor.callflow,0,0,0,0,0,0,1,1
payara_Payara,com.sun.enterprise.loader,0,0,0,0,0,0,1,1
payara_Payara,com.sun.enterprise.security.integration,0,0,0,0,1,0,1,2
payara_Payara,com.sun.enterprise.security.store,0,0,0,0,0,1,1,2
payara_Payara,com.sun.enterprise.spi.io,0,0,0,0,0,0,1,1
payara_Payara,com.sun.enterprise.universal.collections,0,0,0,0,0,0,1,1
payara_Payara,com.sun.enterprise.universal,2,0,0,0,1,0,1,4
payara_Payara,com.sun.enterprise.universal.glassfish,7,1,0,0,1,0,1,10
payara_Payara,com.sun.enterprise.universal.i18n,0,0,0,0,0,0,1,1
payara_Payara,com.sun.enterprise.universal.io,5,1,0,0,0,0,1,7
payara_Payara,com.sun.enterprise.universal.process,0,0,0,0,0,0,1,1
payara_Payara,com.sun.enterprise.universal.security,0,0,0,0,0,0,1,1
payara_Payara,com.sun.enterprise.universal.xml,0,0,0,0,1,0,1,2
payara_Payara,com.sun.enterprise.util,8,1,0,1,1,4,1,16
payara_Payara,com.sun.enterprise.util.i18n,0,0,0,0,0,4,1,5
payara_Payara,com.sun.enterprise.util.io,8,1,0,0,1,1,1,12
payara_Payara,com.sun.enterprise.util.net,2,0,0,0,0,0,1,3
payara_Payara,com.sun.enterprise.util.reflect,0,0,0,0,0,0,1,1
payara_Payara,com.sun.enterprise.util.shared,0,0,0,0,0,0,1,1
payara_Payara,com.sun.enterprise.util.uuid,0,0,0,0,0,0,1,1
payara_Payara,com.sun.enterprise.util.zip,0,0,0,0,0,1,1,2
payara_Payara,com.sun.logging,0,0,0,0,0,0,1,1
payara_Payara,org.glassfish.admin.payload,0,0,0,0,0,0,1,1
payara_Payara,org.glassfish.common.util.admin,0,0,0,1,1,0,1,3
payara_Payara,org.glassfish.common.util,0,0,0,0,1,0,1,2
payara_Payara,org.glassfish.common.util.timer,0,0,0,0,0,0,1,1
payara_Payara,org.glassfish.security.common,0,0,0,0,1,0,1,2
payara_Payara,org.glassfish.server,0,0,0,0,0,0,1,1
payara_Payara,org.glassfish.common.locator,0,0,0,0,0,0,1,1
payara_Payara,org.glassfish.common.util.admin.locking,0,0,0,0,0,0,1,1
payara_Payara,com.sun.appserv.jdbc,0,0,0,0,0,0,1,1
payara_Payara,com.sun.appserv.server,0,0,0,0,0,0,1,1
payara_Payara,fish.payara.api.admin.config,0,0,0,0,0,0,1,1
payara_Payara,org.glassfish.api,1,1,0,0,1,12,1,16
payara_Payara,org.glassfish.api.admin,1,0,0,1,1,11,1,15
payara_Payara,org.glassfish.api.admin.config,0,0,0,0,1,2,1,4
payara_Payara,org.glassfish.api.admin.progress,0,0,0,0,1,1,1,3
payara_Payara,org.glassfish.api.admingui,0,0,0,0,0,0,1,1
payara_Payara,org.glassfish.api.amx,0,0,0,0,0,0,1,1
payara_Payara,org.glassfish.api.container,0,0,0,0,0,1,1,2
payara_Payara,org.glassfish.api.content,0,0,0,0,0,0,1,1
payara_Payara,org.glassfish.api.deployment,0,0,0,0,1,2,1,4
payara_Payara,org.glassfish.api.deployment.archive,0,0,0,0,1,4,1,6
payara_Payara,org.glassfish.api.event,0,0,0,0,0,0,1,1
payara_Payara,org.glassfish.api.invocation,0,0,0,0,1,0,1,2
payara_Payara,org.glassfish.api.jdbc,0,0,0,0,0,0,1,1
payara_Payara,org.glassfish.api.logging,0,0,0,0,0,0,1,1
payara_Payara,org.glassfish.api.monitoring,0,0,0,0,1,0,1,2
payara_Payara,org.glassfish.api.naming,0,0,0,0,1,0,1,2
payara_Payara,org.glassfish.api.virtualization,0,0,0,0,0,0,1,1
payara_Payara,org.glassfish.api.web,0,0,0,0,0,0,1,1
payara_Payara,org.glassfish.flashlight,0,0,0,0,0,1,1,2
payara_Payara,org.glassfish.internal.api,0,1,0,0,1,1,1,4
payara_Payara,org.glassfish.internal.config,0,0,0,0,0,0,1,1
payara_Payara,org.glassfish.internal.data,0,0,0,0,1,1,1,3
payara_Payara,org.glassfish.internal.deployment.analysis,1,0,0,0,0,0,1,2
payara_Payara,org.glassfish.internal.deployment,1,1,0,0,1,0,1,4
payara_Payara,org.glassfish.internal.embedded.admin,0,0,0,0,0,0,1,1
payara_Payara,org.glassfish.internal.embedded,0,0,0,0,1,0,1,2
payara_Payara,org.glassfish.internal.embedded.grizzly,0,0,0,0,0,0,1,1
payara_Payara,org.glassfish.internal.grizzly,0,0,0,0,0,0,1,1
payara_Payara,org.glassfish.internal.logging,0,0,0,0,0,0,1,1
payara_Payara,org.glassfish.admin.mbeanserver,1,1,0,0,1,0,1,4
payara_Payara,org.glassfish.admin.mbeanserver.ssl,1,0,0,0,1,0,1,3
payara_Payara,org.glassfish.embeddable.archive,0,0,0,0,0,0,1,1
payara_Payara,org.glassfish.embeddable,0,0,0,0,1,1,1,3
payara_Payara,org.glassfish.embeddable.spi,0,0,0,0,0,0,1,1
payara_Payara,org.glassfish.main.core.apiexporter,0,0,0,0,0,0,1,1
payara_Payara,com.sun.enterprise.glassfish.bootstrap,0,0,0,0,1,1,1,3
payara_Payara,com.sun.enterprise.glassfish.bootstrap.osgi,0,0,0,0,1,0,1,2
payara_Payara,fish.payara.boot.runtime,0,1,0,0,0,1,1,3
payara_Payara,org.glassfish.contextpropagation.bootstrap,4,1,0,0,1,2,1,9
payara_Payara,org.glassfish.contextpropagation,2,1,0,0,1,2,1,7
payara_Payara,org.glassfish.contextpropagation.internal,9,1,0,0,1,2,1,14
payara_Payara,org.glassfish.contextpropagation.spi,3,1,0,0,0,0,1,5
payara_Payara,org.glassfish.contextpropagation.wireadapters,2,1,0,0,1,1,1,6
payara_Payara,org.glassfish.contextpropagation.wireadapters.glassfish,2,0,0,0,0,0,1,3
payara_Payara,org.glassfish.contextpropagation.wireadapters.wls,4,0,0,0,1,0,1,6
payara_Payara,org.glassfish.contextpropagation.adaptors,0,0,0,0,1,0,1,2
payara_Payara,org.glassfish.contextpropagation.weblogic.workarea,1,1,0,0,0,0,1,3
payara_Payara,org.glassfish.contextpropagation.weblogic.workarea.spi,1,1,0,0,0,0,1,3
payara_Payara,org.glassfish.contextpropagation.weblogic.workarea.utils,0,0,0,0,0,0,1,1
payara_Payara,com.sun.enterprise.v3.admin.adapter,0,1,0,0,0,0,1,2
payara_Payara,com.sun.enterprise.v3.admin,0,0,0,1,1,1,1,4
payara_Payara,com.sun.enterprise.v3.admin.commands,0,1,0,0,1,0,1,3
payara_Payara,com.sun.enterprise.v3.admin.listener,0,0,0,0,0,0,1,1
payara_Payara,com.sun.enterprise.v3.bootstrap,0,0,0,0,0,0,1,1
payara_Payara,com.sun.enterprise.v3.server,0,0,0,1,1,0,1,3
payara_Payara,com.sun.enterprise.v3.services.impl,0,1,0,0,1,0,1,3
payara_Payara,com.sun.enterprise.v3.services.impl.monitor,0,0,0,0,0,0,1,1
payara_Payara,com.sun.enterprise.v3.services.impl.monitor.probes,0,0,0,0,0,0,1,1
payara_Payara,com.sun.enterprise.v3.services.impl.monitor.stats,0,0,0,0,1,0,1,2
payara_Payara,org.glassfish.kernel.bean_validator,0,0,0,0,0,0,1,1
payara_Payara,org.glassfish.kernel.config,0,0,0,0,0,0,1,1
payara_Payara,org.glassfish.kernel.embedded,0,0,0,0,1,0,1,2
payara_Payara,org.glassfish.kernel.event,0,0,0,0,0,0,1,1
payara_Payara,org.glassfish.kernel,0,0,0,0,0,0,1,1
payara_Payara,com.sun.enterprise.v3.common,0,0,0,0,0,0,1,1
payara_Payara,com.sun.enterprise.server.logging,1,1,0,1,1,0,1,5
payara_Payara,com.sun.enterprise.server.logging.commands,0,0,0,0,1,0,1,2
payara_Payara,com.sun.enterprise.server.logging.diagnostics,0,0,0,0,0,0,1,1
payara_Payara,com.sun.enterprise.server.logging.logviewer.backend,0,0,0,0,1,1,1,3
payara_Payara,com.sun.enterprise.server.logging.parser,0,0,0,0,0,0,1,1
payara_Payara,com.sun.enterprise.v3.logging,0,0,0,0,0,0,1,1
payara_Payara,fish.payara.enterprise.server.logging,1,0,0,0,0,0,1,2
payara_Payara,fish.payara.deployment.admin,0,0,0,0,0,0,1,1
payara_Payara,org.glassfish.deployment.admin,0,0,0,1,1,1,1,4
payara_Payara,org.glassfish.deployment.autodeploy,0,0,0,0,1,0,1,2
payara_Payara,com.sun.enterprise.deploy.shared,1,0,0,0,1,0,1,3
payara_Payara,com.sun.enterprise.deployment.deploy.shared,1,0,0,0,1,0,1,3
payara_Payara,fish.payara.deployment.util,0,0,0,0,0,0,1,1
payara_Payara,org.glassfish.deployment.common,4,1,0,0,1,15,1,22
payara_Payara,org.glassfish.deployment.monitor,0,0,0,0,0,0,1,1
payara_Payara,org.glassfish.deployment.versioning,1,1,0,0,0,0,1,3
payara_Payara,org.glassfish.loader.util,2,1,0,0,0,0,1,4
payara_Payara,org.glassfish.diagnostics.context,0,0,0,0,0,0,1,1
payara_Payara,org.glassfish.diagnostics.context.impl,0,0,0,0,1,0,1,2
payara_Payara,org.glassfish.diagnostics.dump,0,0,0,0,0,0,1,1
payara_Payara,org.glassfish.flashlight.agent,0,0,0,0,0,0,1,1
payara_Payara,org.glassfish.flashlight.cli,0,0,0,0,0,0,1,1
payara_Payara,org.glassfish.flashlight.impl.client,1,1,0,0,1,0,1,4
payara_Payara,org.glassfish.flashlight.impl.core,1,0,0,0,1,0,1,3
payara_Payara,org.glassfish.flashlight.impl.provider,0,0,0,0,0,0,1,1
payara_Payara,org.glassfish.flashlight.provider,1,1,0,0,1,0,1,4
payara_Payara,org.glassfish.flashlight.xml,0,0,0,0,1,0,1,2
payara_Payara,org.glassfish.grizzly.config,0,0,0,0,1,0,1,2
payara_Payara,org.glassfish.grizzly.config.dom,0,0,0,1,1,0,1,3
payara_Payara,org.glassfish.grizzly.config.portunif,0,0,0,0,0,0,1,1
payara_Payara,org.glassfish.grizzly.config.ssl,0,0,0,0,1,0,1,2
payara_Payara,com.sun.enterprise.tools.apt,0,0,0,0,1,0,1,2
payara_Payara,com.sun.enterprise.tools.classmodel,0,0,0,0,0,0,1,1
payara_Payara,com.sun.enterprise.tools,0,0,0,0,0,0,1,1
payara_Payara,org.jvnet.hk2.config.generator,0,0,0,0,1,0,1,2
payara_Payara,org.jvnet.hk2.config.generator.maven,0,0,0,0,0,0,1,1
payara_Payara,org.jvnet.hk2.config.types,0,0,0,0,1,3,1,5
payara_Payara,org.jvnet.hk2.config,1,1,0,1,1,1,1,6
payara_Payara,org.jvnet.hk2.config.api,0,0,0,0,0,0,1,1
payara_Payara,org.jvnet.hk2.config.provider,0,0,0,0,0,0,1,1
payara_Payara,org.jvnet.hk2.config.provider.internal,1,0,0,0,0,0,1,2
payara_Payara,org.glassfish.osgi.cli.interactive,0,0,0,0,0,0,1,1
payara_Payara,org.glassfish.osgi.cli.remote,0,0,0,0,0,0,1,1
payara_Payara,org.glassfish.extras.osgicontainer,0,0,0,0,1,0,1,2
payara_Payara,fish.payara.audit.admin,0,0,0,0,0,0,1,1
payara_Payara,fish.payara.audit,0,0,0,0,0,0,1,1
payara_Payara,fish.payara.asadmin.recorder.admin,0,0,0,0,0,0,1,1
payara_Payara,fish.payara.asadmin.recorder,0,0,0,0,0,0,1,1
payara_Payara,fish.payara.nucleus.cluster,0,0,0,0,0,0,1,1
payara_Payara,fish.payara.nucleus.eventbus,0,0,0,0,0,0,1,1
payara_Payara,fish.payara.nucleus.events,0,0,0,0,0,0,1,1
payara_Payara,fish.payara.nucleus.exec,0,0,0,0,0,0,1,1
payara_Payara,fish.payara.nucleus.hazelcast.admin,0,0,0,0,1,0,1,2
payara_Payara,fish.payara.nucleus.hazelcast.contextproxy,0,0,0,0,1,0,1,2
payara_Payara,fish.payara.nucleus.hazelcast,0,0,0,0,1,0,1,2
payara_Payara,fish.payara.nucleus.store,0,0,0,0,0,0,1,1
payara_Payara,fish.payara.nucleus.util,0,0,0,0,0,0,1,1
payara_Payara,fish.payara.nucleus.healthcheck.admin,0,0,0,0,1,0,1,2
payara_Payara,fish.payara.nucleus.healthcheck.admin.notifier,0,0,0,0,1,0,1,2
payara_Payara,fish.payara.nucleus.healthcheck.configuration,1,1,0,0,1,0,1,4
payara_Payara,fish.payara.nucleus.healthcheck.entity,0,0,0,0,0,0,1,1
payara_Payara,fish.payara.nucleus.healthcheck,1,0,0,0,1,0,1,3
payara_Payara,fish.payara.nucleus.healthcheck.preliminary,0,0,0,0,1,0,1,2
payara_Payara,fish.payara.nucleus.healthcheck.cpool.configuration,0,0,0,0,0,0,1,1
payara_Payara,fish.payara.nucleus.healthcheck.cpool,0,0,0,0,0,0,1,1
payara_Payara,fish.payara.nucleus.healthcheck.stuck.admin,0,0,0,0,0,0,1,1
payara_Payara,fish.payara.nucleus.healthcheck.stuck,0,0,0,0,0,0,1,1
payara_Payara,fish.payara.notification.eventbus.core,0,0,0,0,1,0,1,2
payara_Payara,fish.payara.nucleus.notification.admin,0,0,0,0,1,0,1,2
payara_Payara,fish.payara.nucleus.notification,0,0,0,0,1,0,1,2
payara_Payara,fish.payara.nucleus.notification.configuration,0,0,0,0,1,0,1,2
payara_Payara,fish.payara.nucleus.notification.domain,0,0,0,0,1,0,1,2
payara_Payara,fish.payara.nucleus.notification.log,0,1,0,0,1,0,1,3
payara_Payara,fish.payara.nucleus.notification.service,0,0,0,0,1,0,1,2
payara_Payara,fish.payara.nucleus.microprofile.config.admin,0,0,0,0,1,0,1,2
payara_Payara,fish.payara.nucleus.microprofile.config.converters,0,0,0,0,1,0,1,2
payara_Payara,fish.payara.nucleus.microprofile.config.source,0,0,0,0,1,2,1,4
payara_Payara,fish.payara.nucleus.microprofile.config.spi,0,0,0,0,1,0,1,2
payara_Payara,fish.payara.opentracing,0,1,0,0,0,0,1,2
payara_Payara,fish.payara.opentracing.propagation,0,0,0,0,0,0,1,1
payara_Payara,fish.payara.opentracing.span,0,0,0,0,0,0,1,1
payara_Payara,fish.payara.opentracing.tracer,0,0,0,0,0,0,1,1
payara_Payara,fish.payara.nucleus.executorservice.admin,0,0,0,0,0,0,1,1
payara_Payara,fish.payara.nucleus.executorservice,0,0,0,0,0,0,1,1
payara_Payara,fish.payara.nucleus.phonehome.admin,0,0,0,0,0,0,1,1
payara_Payara,fish.payara.nucleus.phonehome,0,0,0,0,0,0,1,1
payara_Payara,fish.payara.nucleus.requesttracing.admin,0,0,0,0,0,0,1,1
payara_Payara,fish.payara.nucleus.requesttracing.admin.notifier,0,0,0,0,1,0,1,2
payara_Payara,fish.payara.nucleus.requesttracing.configuration,0,0,0,0,0,0,1,1
payara_Payara,fish.payara.nucleus.requesttracing.domain.execoptions,0,0,0,0,0,0,1,1
payara_Payara,fish.payara.nucleus.requesttracing.domain,0,0,0,0,0,0,1,1
payara_Payara,fish.payara.nucleus.requesttracing.events,0,0,0,0,0,0,1,1
payara_Payara,fish.payara.nucleus.requesttracing,0,1,0,0,1,0,1,3
payara_Payara,fish.payara.nucleus.requesttracing.sampling,0,0,0,0,0,0,1,1
payara_Payara,fish.payara.nucleus.requesttracing.store,0,0,0,0,0,0,1,1
payara_Payara,fish.payara.nucleus.requesttracing.store.strategy,0,0,0,0,0,0,1,1
payara_Payara,fish.payara.service.example.config.admin,0,0,0,0,0,0,1,1
payara_Payara,fish.payara.service.example.config,0,0,0,0,0,0,1,1
payara_Payara,fish.payara.service.example,0,0,0,0,0,0,1,1
payara_Payara,org.glassfish.resourcebase.resources.admin.cli,0,0,0,0,0,0,1,1
payara_Payara,org.glassfish.resourcebase.resources.api,0,0,0,0,1,1,1,3
payara_Payara,org.glassfish.resourcebase.resources.listener,0,0,0,0,0,0,1,1
payara_Payara,org.glassfish.resourcebase.resources.naming,0,0,0,0,0,1,1,2
payara_Payara,org.glassfish.resourcebase.resources,0,0,0,0,0,0,1,1
payara_Payara,org.glassfish.resourcebase.resources.util,0,0,0,0,0,0,1,1
payara_Payara,com.sun.enterprise.common.iiop.security,0,0,0,0,0,0,1,1
payara_Payara,com.sun.enterprise.security.admin.cli,0,0,0,0,1,0,1,2
payara_Payara,com.sun.enterprise.security,2,1,0,1,1,1,1,7
payara_Payara,com.sun.enterprise.security.audit,0,0,0,0,0,0,1,1
payara_Payara,com.sun.enterprise.security.auth.digest.api,0,0,0,0,0,1,1,2
payara_Payara,com.sun.enterprise.security.auth,0,1,0,0,0,2,1,4
payara_Payara,com.sun.enterprise.security.auth.login,0,0,0,0,1,2,1,4
payara_Payara,com.sun.enterprise.security.auth.login.common,0,1,0,0,0,2,1,4
payara_Payara,com.sun.enterprise.security.auth.realm,0,0,0,0,1,1,1,3
payara_Payara,com.sun.enterprise.security.auth.realm.certificate,1,1,0,0,0,1,1,4
payara_Payara,com.sun.enterprise.security.auth.realm.file,0,0,0,0,0,0,1,1
payara_Payara,com.sun.enterprise.security.auth.realm.ldap,0,0,0,0,0,0,1,1
payara_Payara,com.sun.enterprise.security.auth.realm.solaris,0,0,0,0,0,0,1,1
payara_Payara,com.sun.enterprise.security.cli,0,0,0,0,1,3,1,5
payara_Payara,com.sun.enterprise.security.common,1,1,0,0,1,1,1,5
payara_Payara,com.sun.enterprise.security.embedded,0,0,0,0,0,0,1,1
payara_Payara,com.sun.enterprise.security.factory,0,0,0,0,0,0,1,1
payara_Payara,com.sun.enterprise.security.ssl,0,0,0,0,1,1,1,3
payara_Payara,com.sun.enterprise.security.util,0,0,0,0,0,0,1,1
payara_Payara,org.glassfish.security.services.api.authentication,0,0,0,0,0,0,1,1
payara_Payara,org.glassfish.security.services.api.authorization,1,1,0,0,1,1,1,5
payara_Payara,org.glassfish.security.services.api.common,0,0,0,0,0,0,1,1
payara_Payara,org.glassfish.security.services.api.context,0,0,0,0,0,0,1,1
payara_Payara,org.glassfish.security.services.api,0,0,0,0,0,0,1,1
payara_Payara,org.glassfish.security.services.commands,0,0,0,0,1,1,1,3
payara_Payara,org.glassfish.security.services.common,0,0,0,0,1,0,1,2
payara_Payara,org.glassfish.security.services.config,0,0,0,0,1,1,1,3
payara_Payara,org.glassfish.security.services.impl,0,0,0,0,1,0,1,2
payara_Payara,org.glassfish.security.services.impl.authorization,0,0,0,0,1,0,1,2
payara_Payara,org.glassfish.security.services.impl.common,0,0,0,0,0,0,1,1
payara_Payara,org.glassfish.security.services.impl.context,0,0,0,0,0,0,1,1
payara_Payara,org.glassfish.security.services.provider.authorization,0,0,0,0,1,1,1,3
payara_Payara,org.glassfish.security.services.spi.authentication,0,0,0,0,0,0,1,1
payara_Payara,org.glassfish.security.services.spi.authorization,1,0,0,0,0,0,1,2
payara_Payara,org.glassfish.security.services.spi,0,0,0,0,0,0,1,1
payara_Payara,com.sun.enterprise.security.ssl.impl,0,0,0,0,0,0,1,1
payara_Payara,com.sun.enterprise.security.ssl.manager,0,0,0,0,0,0,1,1
payara_Payara,com.sun.enterprise.server.pluggable,0,1,0,0,0,0,1,2
payara_Payara,org.glassfish.nucleus.admin,0,0,0,0,0,0,1,1
payara_Payara,org.glassfish.nucleus.admin.progress,0,0,0,0,1,0,1,2
payara_Payara,org.glassfish.nucleus.admin.rest,0,0,0,0,0,0,1,1
payara_Payara,org.glassfish.nucleus.quicklook,0,0,0,0,0,0,1,1
PayPal_SeLion,com.paypal.selion.appium.internal.platform.grid.browsercapabilities,0,0,0,0,0,0,0,0
PayPal_SeLion,com.paypal.selion.appium.platform.grid,0,0,0,0,0,0,0,0
PayPal_SeLion,$,0,0,0,1,1,1,0,3
PayPal_SeLion,com.paypal.selion.logging,0,0,0,0,0,1,0,1
PayPal_SeLion,com.paypal.selion.utilities.server,0,0,0,0,0,0,0,0
PayPal_SeLion,com.paypal.selion.configuration,11,1,0,0,1,6,0,19
PayPal_SeLion,com.paypal.selion.internal.configuration,0,0,0,0,0,0,0,0
PayPal_SeLion,com.paypal.selion.internal.platform.asserts,0,0,0,0,0,0,0,0
PayPal_SeLion,com.paypal.selion.internal.platform.grid,13,0,0,0,1,4,0,18
PayPal_SeLion,com.paypal.selion.internal.platform.grid.browsercapabilities,5,1,0,0,1,1,0,8
PayPal_SeLion,com.paypal.selion.internal.platform.pageyaml,0,0,0,0,0,0,0,0
PayPal_SeLion,com.paypal.selion.internal.reports.excelreport,0,0,0,0,1,0,0,1
PayPal_SeLion,com.paypal.selion.internal.reports.html,0,0,0,0,1,0,0,1
PayPal_SeLion,com.paypal.selion.internal.reports.model,0,0,0,0,0,1,0,1
PayPal_SeLion,com.paypal.selion.internal.reports.runtimereport,2,0,0,0,1,0,0,3
PayPal_SeLion,com.paypal.selion.internal.reports.services,0,0,0,0,0,0,0,0
PayPal_SeLion,com.paypal.selion.internal.utils,0,0,0,0,0,0,0,0
PayPal_SeLion,com.paypal.selion.platform.asserts,0,0,0,0,1,0,0,1
PayPal_SeLion,com.paypal.selion.platform.grid,20,1,0,0,1,1,0,23
PayPal_SeLion,com.paypal.selion.platform.grid.browsercapabilities,2,0,0,0,0,0,0,2
PayPal_SeLion,com.paypal.selion.platform.html,3,0,0,1,1,0,0,5
PayPal_SeLion,com.paypal.selion.platform.html.support,4,0,0,0,0,0,0,4
PayPal_SeLion,com.paypal.selion.platform.html.support.events,0,0,0,0,1,0,0,1
PayPal_SeLion,com.paypal.selion.platform.mobile.android,0,0,0,0,1,0,0,1
PayPal_SeLion,com.paypal.selion.platform.mobile.elements,0,0,0,0,1,0,0,1
PayPal_SeLion,com.paypal.selion.platform.mobile,0,0,0,0,0,0,0,0
PayPal_SeLion,com.paypal.selion.platform.mobile.ios,0,0,0,0,1,0,0,1
PayPal_SeLion,com.paypal.selion.platform.utilities,7,1,0,0,0,0,0,8
PayPal_SeLion,com.paypal.selion.reports.runtime,2,1,0,0,0,1,0,4
PayPal_SeLion,com.paypal.selion.reports.services,1,0,0,0,0,0,0,1
PayPal_SeLion,com.paypal.selion.reports.excelreport,0,0,0,0,0,0,0,0
PayPal_SeLion,com.paypal.selion,5,1,0,0,1,1,0,8
PayPal_SeLion,com.paypal.selion.elements,2,1,0,0,0,0,0,3
PayPal_SeLion,com.paypal.selion.plugins,3,1,0,0,1,0,0,5
PayPal_SeLion,com.paypal.selion.reader,2,0,0,0,0,0,0,2
PayPal_SeLion,com.paypal.selion.logger,4,0,0,0,0,2,0,6
PayPal_SeLion,com.paypal.selion.platform.web,0,0,0,0,0,0,0,0
PayPal_SeLion,com.paypal.selion.platform.dataprovider,4,0,0,0,1,2,0,7
PayPal_SeLion,com.paypal.selion.platform.dataprovider.filter,3,1,0,0,0,1,0,5
PayPal_SeLion,com.paypal.selion.platform.dataprovider.impl,3,1,0,0,1,3,0,8
PayPal_SeLion,com.paypal.selion.platform.dataprovider.pojos,0,0,0,0,0,1,0,1
PayPal_SeLion,com.paypal.selion.platform.dataprovider.pojos.excel,0,0,0,0,0,0,0,0
PayPal_SeLion,com.paypal.selion.platform.dataprovider.pojos.xml,0,0,0,0,0,0,0,0
PayPal_SeLion,com.paypal.selion.platform.dataprovider.pojos.yaml,0,0,0,0,0,0,0,0
PayPal_SeLion,com.paypal.selion.iosdriver.internal.platform.grid.browsercapabilities,0,0,0,0,0,0,0,0
PayPal_SeLion,com.paypal.selion.iosdriver.platform.grid,0,0,0,0,0,0,0,0
PayPal_SeLion,com.paypal.selion.pageobjectsdemoapp,0,0,0,0,1,0,0,1
PayPal_SeLion,com.paypal.selion.selendroid.internal.platform.grid.browsercapabilities,0,0,0,0,0,0,0,0
PayPal_SeLion,com.paypal.selion.selendroid.platform.grid,0,0,0,0,0,0,0,0
PayPal_SeLion,com.paypal.selion.grid,1,0,0,1,0,2,0,4
PayPal_SeLion,com.paypal.selion.grid.matchers,0,0,0,0,0,0,0,0
PayPal_SeLion,com.paypal.selion.grid.servlets,2,1,0,0,1,0,0,4
PayPal_SeLion,com.paypal.selion.grid.servlets.transfer,0,0,0,0,0,1,0,1
PayPal_SeLion,com.paypal.selion.node.servlets,1,0,0,0,1,0,0,2
PayPal_SeLion,com.paypal.selion.pojos,0,0,0,0,1,0,0,1
PayPal_SeLion,com.paypal.selion.proxy,2,0,0,0,0,0,0,2
PayPal_SeLion,com.paypal.selion.utils,0,0,0,0,1,1,0,2
PayPal_SeLion,com.paypal.selion.utils.process,0,0,0,0,1,0,0,1
PayPal_SeLion,com.paypal.selion.resources,0,0,0,0,0,0,0,0
pcingola_SnpEff,net.sf.samtools.tabix,0,0,0,0,0,1,1,2
pcingola_SnpEff,org.broad.igv.bbfile,0,0,0,1,0,1,1,3
pcingola_SnpEff,org.broad.tribble.util,0,0,0,0,0,0,1,1
pcingola_SnpEff,org.snpeff.align,1,0,0,0,0,2,1,4
pcingola_SnpEff,org.snpeff.binseq,6,0,0,0,1,8,1,16
pcingola_SnpEff,org.snpeff.binseq.coder,2,1,0,0,0,2,1,6
pcingola_SnpEff,org.snpeff.binseq.comparator,0,0,0,0,0,1,1,2
pcingola_SnpEff,org.snpeff.binseq.indexer,0,0,0,0,1,1,1,3
pcingola_SnpEff,org.snpeff.codons,7,1,0,0,0,3,1,12
pcingola_SnpEff,org.snpeff.collections,0,0,0,0,1,2,1,4
pcingola_SnpEff,org.snpeff.complexity,0,0,0,0,0,0,1,1
pcingola_SnpEff,org.snpeff.coverage,4,0,0,0,1,3,1,9
pcingola_SnpEff,org.snpeff.fastq,0,0,0,0,1,0,1,2
pcingola_SnpEff,org.snpeff,39,1,0,0,1,8,1,50
pcingola_SnpEff,org.snpeff.fileIterator,14,1,0,1,1,12,1,30
pcingola_SnpEff,org.snpeff.fileIterator.microCosm,0,0,0,0,0,0,1,1
pcingola_SnpEff,org.snpeff.fileIterator.parser,0,0,0,0,0,0,1,1
pcingola_SnpEff,org.snpeff.filter,0,0,0,0,0,1,1,2
pcingola_SnpEff,org.snpeff.genBank,1,0,0,0,0,2,1,4
pcingola_SnpEff,org.snpeff.geneOntology,0,0,0,0,0,0,1,1
pcingola_SnpEff,org.snpeff.geneSets.algorithm,1,0,0,0,1,0,1,3
pcingola_SnpEff,org.snpeff.geneSets,1,0,0,0,1,0,1,3
pcingola_SnpEff,org.snpeff.genotypes,0,0,0,0,0,0,1,1
pcingola_SnpEff,org.snpeff.gsa,0,0,0,0,0,1,1,2
pcingola_SnpEff,org.snpeff.gtex,0,0,0,0,0,2,1,3
pcingola_SnpEff,org.snpeff.interval,56,1,0,1,0,36,1,95
pcingola_SnpEff,org.snpeff.interval.codonChange,3,0,0,0,0,3,1,7
pcingola_SnpEff,org.snpeff.interval.tree,9,0,0,0,0,4,1,14
pcingola_SnpEff,org.snpeff.logStatsServer,0,0,0,0,0,0,1,1
pcingola_SnpEff,org.snpeff.motif,4,1,0,0,0,2,1,8
pcingola_SnpEff,org.snpeff.nextProt,2,0,0,0,0,0,1,3
pcingola_SnpEff,org.snpeff.nmer,4,1,0,0,0,2,1,8
pcingola_SnpEff,org.snpeff.osCmd,0,0,0,0,1,0,1,2
pcingola_SnpEff,org.snpeff.outputFormatter,2,0,0,0,0,2,1,5
pcingola_SnpEff,org.snpeff.overlap,0,0,0,0,0,1,1,2
pcingola_SnpEff,org.snpeff.pdb,2,0,0,0,0,0,1,3
pcingola_SnpEff,org.snpeff.ped,0,0,0,0,0,0,1,1
pcingola_SnpEff,org.snpeff.probablility,4,1,0,0,1,1,1,8
pcingola_SnpEff,org.snpeff.probablility.bootstrap,0,0,0,0,0,0,1,1
pcingola_SnpEff,org.snpeff.reactome,1,0,0,0,0,3,1,5
pcingola_SnpEff,org.snpeff.reactome.events,1,1,0,0,0,2,1,5
pcingola_SnpEff,org.snpeff.sam,0,0,0,0,0,1,1,2
pcingola_SnpEff,org.snpeff.serializer,3,0,0,0,0,1,1,5
pcingola_SnpEff,org.snpeff.snpEffect.commandLine,17,1,0,0,1,9,1,29
pcingola_SnpEff,org.snpeff.snpEffect,25,1,0,0,1,23,1,51
pcingola_SnpEff,org.snpeff.snpEffect.factory,2,0,0,0,0,4,1,7
pcingola_SnpEff,org.snpeff.spliceSites,4,0,0,0,0,4,1,9
pcingola_SnpEff,org.snpeff.stats,14,1,0,1,1,7,1,25
pcingola_SnpEff,org.snpeff.stats.plot,0,0,0,0,1,0,1,2
pcingola_SnpEff,org.snpeff.svg,2,0,0,0,0,0,1,3
pcingola_SnpEff,org.snpeff.util,0,0,0,0,1,40,1,42
pcingola_SnpEff,org.snpeff.vcf,7,0,0,0,1,6,1,15
peholmst_vaadin4spring,org.vaadin.spring.events.config,0,0,0,0,0,0,0,0
peholmst_vaadin4spring,org.vaadin.spring.events,0,0,0,0,1,0,0,1
peholmst_vaadin4spring,org.vaadin.spring.events.internal,0,0,0,0,0,0,0,0
peholmst_vaadin4spring,org.vaadin.spring.events.support,0,0,0,0,0,0,0,0
peholmst_vaadin4spring,org.vaadin.spring.events.integration,0,0,0,0,0,0,0,0
peholmst_vaadin4spring,org.vaadin.spring.events.config,0,0,0,0,0,0,0,0
peholmst_vaadin4spring,org.vaadin.spring.events,0,0,0,0,1,0,0,1
peholmst_vaadin4spring,org.vaadin.spring.events.internal,0,0,0,0,0,0,0,0
peholmst_vaadin4spring,org.vaadin.spring.events.support,0,0,0,0,0,0,0,0
peholmst_vaadin4spring,org.vaadin.spring.events.integration,0,0,0,0,0,0,0,0
PhantomYdn_wicket-orientdb,ru.ydn.wicket.wicketorientdb,5,1,0,0,1,0,0,7
PhantomYdn_wicket-orientdb,ru.ydn.wicket.wicketorientdb.behavior,0,0,0,0,0,0,0,0
PhantomYdn_wicket-orientdb,ru.ydn.wicket.wicketorientdb.components,0,0,0,0,0,0,0,0
PhantomYdn_wicket-orientdb,ru.ydn.wicket.wicketorientdb.components.table,0,0,0,0,0,0,0,0
PhantomYdn_wicket-orientdb,ru.ydn.wicket.wicketorientdb.converter,1,0,0,0,1,0,0,2
PhantomYdn_wicket-orientdb,ru.ydn.wicket.wicketorientdb.model,0,0,0,1,1,0,0,2
PhantomYdn_wicket-orientdb,ru.ydn.wicket.wicketorientdb.proto,0,0,0,0,1,0,0,1
PhantomYdn_wicket-orientdb,ru.ydn.wicket.wicketorientdb.rest,2,0,0,0,0,0,0,2
PhantomYdn_wicket-orientdb,ru.ydn.wicket.wicketorientdb.security,1,0,0,0,1,0,0,2
PhantomYdn_wicket-orientdb,ru.ydn.wicket.wicketorientdb.utils,0,0,0,0,1,0,0,1
PhantomYdn_wicket-orientdb,ru.ydn.wicket.wicketorientdb.utils.query.filter,0,0,0,0,1,0,0,1
PhantomYdn_wicket-orientdb,ru.ydn.wicket.wicketorientdb.utils.query,0,0,0,0,0,0,0,0
PhantomYdn_wicket-orientdb,ru.ydn.wicket.wicketorientdb.validation,0,0,0,0,0,0,0,0
PhantomYdn_wicket-orientdb,ru.ydn.wicket.wicketorientdb.filter,0,0,0,0,0,0,0,0
PhantomYdn_wicket-orientdb,ru.ydn.wicket.wicketorientdb.junit,2,1,0,0,0,0,0,3
PhantomYdn_wicket-orientdb,ru.ydn.wicket.wicketorientdb.orientdb,0,0,0,0,0,0,0,0
PhantomYdn_wicket-orientdb,ru.ydn.wicket.wicketorientdb.web,1,0,0,0,0,0,0,1
PhantomYdn_wicket-orientdb,ru.ydn.wicket.wicketorientdb.demo,0,0,0,0,0,0,0,0
phasenraum2010_javaee7-petclinic,org.woehlke.javaee7.petclinic.dao,0,0,0,0,1,3,0,4
phasenraum2010_javaee7-petclinic,org.woehlke.javaee7.petclinic.entities,0,0,0,0,1,2,0,3
phasenraum2010_javaee7-petclinic,org.woehlke.javaee7.petclinic.model,0,0,0,0,0,1,0,1
phasenraum2010_javaee7-petclinic,org.woehlke.javaee7.petclinic.services,0,0,0,0,0,2,0,2
phasenraum2010_javaee7-petclinic,org.woehlke.javaee7.petclinic.web,0,0,0,0,0,1,0,1
phasenraum2010_javaee7-petclinic,org.woehlke.javaee7.petclinic.web.pages,0,0,0,0,1,0,0,1
phax_ph-css,com.helger.css,3,1,0,0,1,0,0,5
phax_ph-css,com.helger.css.decl,3,0,0,1,1,0,0,5
phax_ph-css,com.helger.css.decl.shorthand,0,0,0,0,0,0,0,0
phax_ph-css,com.helger.css.decl.visit,0,0,0,0,1,0,0,1
phax_ph-css,com.helger.css.handler,3,0,0,0,1,0,0,4
phax_ph-css,com.helger.css.media,0,0,0,0,0,0,0,0
phax_ph-css,com.helger.css.parser,5,0,0,0,1,0,0,6
phax_ph-css,com.helger.css.property,4,0,0,0,1,0,0,5
phax_ph-css,com.helger.css.property.customizer,0,0,0,0,1,0,0,1
phax_ph-css,com.helger.css.propertyvalue,6,1,0,0,1,0,0,8
phax_ph-css,com.helger.css.reader,5,1,0,0,1,0,0,7
phax_ph-css,com.helger.css.reader.errorhandler,0,0,0,0,1,0,0,1
phax_ph-css,com.helger.css.tools,0,0,0,0,0,0,0,0
phax_ph-css,com.helger.css.utils,6,1,0,0,1,0,0,8
phax_ph-css,com.helger.css.writer,4,0,0,0,1,0,0,5
phax_ph-css,com.helger.css.supplementary.issues,0,0,0,0,1,0,0,1
phax_ph-css,com.helger.css.supplementary.main,0,0,0,0,0,0,0,0
phax_ph-css,com.helger.css.supplementary.parser,0,0,0,0,0,0,0,0
phax_ph-css,com.helger.css.supplementary.wiki,0,0,0,0,1,0,0,1
phax_ph-css,com.helger.maven.csscompress,0,0,0,0,0,0,0,0
PhonyTive_astivetoolkit,com.fonoster.astive.agi,0,0,0,0,1,2,0,3
PhonyTive_astivetoolkit,com.fonoster.astive.agi.command,0,0,0,1,1,0,0,2
PhonyTive_astivetoolkit,com.fonoster.astive.agi.fastagi,0,0,0,0,0,3,0,3
PhonyTive_astivetoolkit,com.fonoster.astive.astivlet,0,0,0,0,0,0,0,0
PhonyTive_astivetoolkit,com.fonoster.astive,0,0,0,0,0,0,0,0
PhonyTive_astivetoolkit,com.fonoster.astive.server.security,0,0,0,0,0,0,0,0
PhonyTive_astivetoolkit,com.fonoster.astive.server,2,1,0,0,1,4,0,8
PhonyTive_astivetoolkit,com.fonoster.astive.util,0,0,0,0,0,5,0,5
PhonyTive_astivetoolkit,com.fonoster.astive.examples.handlingevents,0,0,0,0,0,1,0,1
PhonyTive_astivetoolkit,com.fonoster.astive.examples.helloworld,0,0,0,0,0,0,0,0
PhonyTive_astivetoolkit,com.fonoster.astive.examples.speechrecognition,0,0,0,0,0,0,0,0
PhonyTive_astivetoolkit,com.fonoster.astive.examples.voicecomposer,0,0,0,0,0,0,0,0
PhonyTive_astivetoolkit,com.fonoster.astive.examples.ws,0,0,0,0,1,0,0,1
PhonyTive_astivetoolkit,com.fonoster.astive.menu.action,0,0,0,0,0,0,0,0
PhonyTive_astivetoolkit,com.fonoster.astive.menu,0,0,0,0,1,1,0,2
PhonyTive_astivetoolkit,com.fonoster.astive.menu.event,0,0,0,0,1,1,0,2
PhonyTive_astivetoolkit,com.fonoster.astive.server.admin,0,0,0,0,0,0,0,0
PhonyTive_astivetoolkit,com.fonoster.astive.server.appmanager,1,0,0,0,0,1,0,2
PhonyTive_astivetoolkit,com.fonoster.astive.server.monitor,1,1,0,0,0,2,0,4
PhonyTive_astivetoolkit,com.fonoster.astive.server.utils,0,0,0,0,0,0,0,0
PhonyTive_astivetoolkit,noNamespace,0,0,0,0,1,0,0,1
PhonyTive_astivetoolkit,noNamespace.impl,0,0,0,0,0,0,0,0
PhonyTive_astivetoolkit,com.fonoster.astive.telnet,0,0,0,0,0,0,0,0
pietermartin_sqlg,org.sqlg.benchmark,0,0,0,0,1,0,0,1
pietermartin_sqlg,org.sqlg.benchmark.generated,0,0,0,1,0,0,0,1
pietermartin_sqlg,org.umlg.sqlg,3,1,0,0,1,0,0,5
pietermartin_sqlg,org.umlg.sqlg.sql.dialect,2,0,0,0,1,0,0,3
pietermartin_sqlg,org.umlg.sqlg.predicate,0,0,0,0,0,0,0,0
pietermartin_sqlg,org.umlg.sqlg.sql.parse,10,0,0,0,1,0,0,11
pietermartin_sqlg,org.umlg.sqlg.step.barrier,0,1,0,0,1,1,0,3
pietermartin_sqlg,org.umlg.sqlg.step,0,0,0,0,1,1,0,2
pietermartin_sqlg,org.umlg.sqlg.strategy.barrier,3,0,0,0,1,0,0,4
pietermartin_sqlg,org.umlg.sqlg.strategy,8,1,0,0,1,0,0,10
pietermartin_sqlg,org.umlg.sqlg.structure,13,1,0,1,1,1,0,17
pietermartin_sqlg,org.umlg.sqlg.structure.ds,4,1,0,0,0,0,0,5
pietermartin_sqlg,org.umlg.sqlg.structure.topology,8,1,0,0,1,0,0,10
pietermartin_sqlg,org.umlg.sqlg.util,10,1,0,0,0,0,0,11
pietermartin_sqlg,org.umlg.sqlg.doc,0,0,0,0,0,0,0,0
pietermartin_sqlg,org.umlg.sqlg.groovy.plugin,0,0,0,0,1,0,0,1
pietermartin_sqlg,org.umlg.sqlg.mssqlserver,0,0,0,0,1,0,0,1
pietermartin_sqlg,org.umlg.sqlg.gis,0,0,0,0,0,0,0,0
pietermartin_sqlg,org.umlg.sqlg.preparedstatement,0,0,0,0,0,0,0,0
pilehvar_ADW,it.uniroma1.lcl.adw,2,1,0,0,0,0,0,3
pilehvar_ADW,it.uniroma1.lcl.adw.comparison,1,0,0,0,1,0,0,2
pilehvar_ADW,it.uniroma1.lcl.adw.semsig,0,0,0,0,0,0,0,0
pilehvar_ADW,it.uniroma1.lcl.adw.textual.similarity,0,0,0,0,0,0,0,0
pilehvar_ADW,it.uniroma1.lcl.adw.utils,2,1,0,0,1,0,0,4
pilehvar_ADW,it.uniroma1.lcl.evaluation,0,0,0,0,0,0,0,0
Plaid_plaid-java,com.plaid.client.internal.gson,0,0,0,0,1,0,0,1
Plaid_plaid-java,com.plaid.client.internal,0,0,0,0,0,0,0,0
Plaid_plaid-java,com.plaid.client,0,0,0,0,1,0,0,1
Plaid_plaid-java,com.plaid.client.request,0,0,0,1,1,1,0,3
Plaid_plaid-java,com.plaid.client.request.common,0,0,0,0,0,0,0,0
Plaid_plaid-java,com.plaid.client.response,0,0,0,1,1,1,0,3
Plaid_plaid-java,com.plaid.client.integration,0,0,0,1,0,1,0,2
Plaid_plaid-java,com.plaid.client.integration.util,0,0,0,0,0,0,0,0
plantuml_plantuml,ext.plantuml.com.ctreber.acearth,0,0,0,0,0,0,1,1
plantuml_plantuml,ext.plantuml.com.ctreber.acearth.gui,0,0,0,0,0,0,1,1
plantuml_plantuml,ext.plantuml.com.ctreber.acearth.plugins.markers,0,0,0,0,0,0,1,1
plantuml_plantuml,ext.plantuml.com.ctreber.acearth.plugins,0,0,0,0,0,0,1,1
plantuml_plantuml,ext.plantuml.com.ctreber.acearth.projection,0,0,0,0,0,2,1,3
plantuml_plantuml,ext.plantuml.com.ctreber.acearth.renderer,0,0,0,0,0,0,1,1
plantuml_plantuml,ext.plantuml.com.ctreber.acearth.scanbit,0,0,0,0,0,1,1,2
plantuml_plantuml,ext.plantuml.com.ctreber.acearth.scandot,0,0,0,0,0,0,1,1
plantuml_plantuml,ext.plantuml.com.ctreber.acearth.shader,0,0,0,0,0,1,1,2
plantuml_plantuml,ext.plantuml.com.ctreber.acearth.util,0,0,0,0,1,2,1,4
plantuml_plantuml,ext.plantuml.com.ctreber.aclib.gui,0,0,0,0,1,0,1,2
plantuml_plantuml,ext.plantuml.com.ctreber.aclib.sort,0,0,0,0,0,0,1,1
plantuml_plantuml,ext.plantuml.com.google.zxing,0,0,0,0,1,2,1,4
plantuml_plantuml,ext.plantuml.com.google.zxing.client.j2se,0,0,0,0,0,0,1,1
plantuml_plantuml,ext.plantuml.com.google.zxing.common,0,0,0,0,1,3,1,5
plantuml_plantuml,ext.plantuml.com.google.zxing.common.reedsolomon,0,0,0,0,0,0,1,1
plantuml_plantuml,ext.plantuml.com.google.zxing.datamatrix.decoder,0,0,0,0,0,1,1,2
plantuml_plantuml,ext.plantuml.com.google.zxing.qrcode.decoder,0,0,0,0,0,2,1,3
plantuml_plantuml,ext.plantuml.com.google.zxing.qrcode.encoder,0,0,0,0,0,1,1,2
plantuml_plantuml,ext.plantuml.com.google.zxing.qrcode,0,1,0,0,0,0,1,2
plantuml_plantuml,gen.lib.cdt,0,0,0,0,1,4,1,6
plantuml_plantuml,gen.lib.cgraph,0,1,0,0,1,10,1,13
plantuml_plantuml,gen.lib.circogen,0,0,0,0,1,0,1,2
plantuml_plantuml,gen.lib.common,0,0,0,0,1,6,1,8
plantuml_plantuml,gen.lib.dotgen,0,0,0,0,0,6,1,7
plantuml_plantuml,gen.lib.fdpgen,0,0,0,0,1,0,1,2
plantuml_plantuml,gen.lib.gvc,0,0,0,0,1,0,1,2
plantuml_plantuml,gen.lib.label,0,0,0,0,1,1,1,3
plantuml_plantuml,gen.lib.ortho,0,0,0,0,1,0,1,2
plantuml_plantuml,gen.lib.pack,0,0,0,0,0,0,1,1
plantuml_plantuml,gen.lib.pathplan,0,0,0,0,1,1,1,3
plantuml_plantuml,gen.lib.xdot,0,0,0,0,0,0,1,1
plantuml_plantuml,gen.plugin.core,0,0,0,0,1,0,1,2
plantuml_plantuml,gen.plugin.dot_layout,0,0,0,0,0,0,1,1
plantuml_plantuml,h,1,1,0,1,1,14,1,19
plantuml_plantuml,net.sourceforge.plantuml,216,1,0,1,0,111,1,330
plantuml_plantuml,net.sourceforge.plantuml.acearth,2,1,0,0,0,0,1,4
plantuml_plantuml,net.sourceforge.plantuml.activitydiagram,5,1,0,0,0,4,1,11
plantuml_plantuml,net.sourceforge.plantuml.activitydiagram.command,3,0,0,0,1,1,1,6
plantuml_plantuml,net.sourceforge.plantuml.activitydiagram3,14,1,0,0,0,16,1,32
plantuml_plantuml,net.sourceforge.plantuml.activitydiagram3.command,3,0,0,1,1,8,1,14
plantuml_plantuml,net.sourceforge.plantuml.activitydiagram3.ftile,15,1,0,1,1,27,1,46
plantuml_plantuml,net.sourceforge.plantuml.activitydiagram3.ftile.vcompact,10,0,0,1,1,15,1,28
plantuml_plantuml,net.sourceforge.plantuml.activitydiagram3.ftile.vcompact.cond,4,1,0,0,1,5,1,12
plantuml_plantuml,net.sourceforge.plantuml.activitydiagram3.ftile.vertical,3,1,0,0,1,11,1,17
plantuml_plantuml,net.sourceforge.plantuml.anim,2,0,0,0,0,0,1,3
plantuml_plantuml,net.sourceforge.plantuml.ant,0,0,0,0,0,0,1,1
plantuml_plantuml,net.sourceforge.plantuml.api,7,1,0,0,1,0,1,10
plantuml_plantuml,net.sourceforge.plantuml.api.mda.option2,0,0,0,0,0,0,1,1
plantuml_plantuml,net.sourceforge.plantuml.api.mda.option3,0,0,0,0,0,0,1,1
plantuml_plantuml,net.sourceforge.plantuml.asciiart,2,0,0,0,0,4,1,7
plantuml_plantuml,net.sourceforge.plantuml.bpm,4,0,0,1,0,1,1,7
plantuml_plantuml,net.sourceforge.plantuml.braille,2,0,0,0,0,0,1,3
plantuml_plantuml,net.sourceforge.plantuml.brotli,0,0,0,0,1,0,1,2
plantuml_plantuml,net.sourceforge.plantuml.classdiagram,9,0,0,0,0,2,1,12
plantuml_plantuml,net.sourceforge.plantuml.classdiagram.command,6,0,0,0,1,6,1,14
plantuml_plantuml,net.sourceforge.plantuml.code,3,0,0,0,1,0,1,5
plantuml_plantuml,net.sourceforge.plantuml.command,27,1,0,1,0,36,1,66
plantuml_plantuml,net.sourceforge.plantuml.command.note,3,0,0,0,0,7,1,11
plantuml_plantuml,net.sourceforge.plantuml.command.note.sequence,3,0,0,0,0,4,1,8
plantuml_plantuml,net.sourceforge.plantuml.command.regex,26,1,0,0,0,54,1,82
plantuml_plantuml,net.sourceforge.plantuml.compositediagram.command,0,0,0,0,0,0,1,1
plantuml_plantuml,net.sourceforge.plantuml.compositediagram,0,0,0,0,0,0,1,1
plantuml_plantuml,net.sourceforge.plantuml.core,14,1,0,0,0,2,1,18
plantuml_plantuml,net.sourceforge.plantuml.creole,7,1,0,1,0,7,1,17
plantuml_plantuml,net.sourceforge.plantuml.cucadiagram,32,1,0,1,0,58,1,93
plantuml_plantuml,net.sourceforge.plantuml.cucadiagram.dot,5,1,0,0,1,6,1,14
plantuml_plantuml,net.sourceforge.plantuml.cucadiagram.entity,2,0,0,0,0,1,1,4
plantuml_plantuml,net.sourceforge.plantuml.cute,2,0,0,1,0,0,1,4
plantuml_plantuml,net.sourceforge.plantuml.dedication,4,0,0,0,0,0,1,5
plantuml_plantuml,net.sourceforge.plantuml.definition,3,0,0,0,0,0,1,4
plantuml_plantuml,net.sourceforge.plantuml.descdiagram,4,0,0,0,1,4,1,10
plantuml_plantuml,net.sourceforge.plantuml.descdiagram.command,4,1,0,0,1,3,1,10
plantuml_plantuml,net.sourceforge.plantuml.directdot,3,0,0,0,0,0,1,4
plantuml_plantuml,net.sourceforge.plantuml.ditaa,3,0,0,0,0,0,1,4
plantuml_plantuml,net.sourceforge.plantuml.donors,4,0,0,0,0,3,1,8
plantuml_plantuml,net.sourceforge.plantuml.eggs,3,0,0,0,1,3,1,8
plantuml_plantuml,net.sourceforge.plantuml.eps,3,0,0,0,0,3,1,7
plantuml_plantuml,net.sourceforge.plantuml.error,4,1,0,0,0,2,1,8
plantuml_plantuml,net.sourceforge.plantuml.evalex,0,0,0,0,0,0,1,1
plantuml_plantuml,net.sourceforge.plantuml.flashcode,2,1,0,0,0,2,1,6
plantuml_plantuml,net.sourceforge.plantuml.flowdiagram,3,0,0,0,0,1,1,5
plantuml_plantuml,net.sourceforge.plantuml.font,3,0,0,0,0,0,1,4
plantuml_plantuml,net.sourceforge.plantuml.ftp,1,0,0,0,0,0,1,2
plantuml_plantuml,net.sourceforge.plantuml.fun,0,0,0,0,0,0,1,1
plantuml_plantuml,net.sourceforge.plantuml.geom,3,0,0,0,0,2,1,6
plantuml_plantuml,net.sourceforge.plantuml.geom.kinetic,0,0,0,0,1,0,1,2
plantuml_plantuml,net.sourceforge.plantuml.golem,2,0,0,0,1,1,1,5
plantuml_plantuml,net.sourceforge.plantuml.graph,0,0,0,1,1,1,1,4
plantuml_plantuml,net.sourceforge.plantuml.graph2,0,0,0,0,1,0,1,2
plantuml_plantuml,net.sourceforge.plantuml.graphic,50,1,0,1,0,80,1,133
plantuml_plantuml,net.sourceforge.plantuml.graphic.color,3,1,0,0,0,24,1,29
plantuml_plantuml,net.sourceforge.plantuml.hector,0,0,0,0,0,1,1,2
plantuml_plantuml,net.sourceforge.plantuml.hector2.continuity,0,0,0,0,0,0,1,1
plantuml_plantuml,net.sourceforge.plantuml.hector2.graphic,0,0,0,0,0,1,1,2
plantuml_plantuml,net.sourceforge.plantuml.hector2.layering,0,0,0,0,0,0,1,1
plantuml_plantuml,net.sourceforge.plantuml.hector2,0,0,0,0,0,0,1,1
plantuml_plantuml,net.sourceforge.plantuml.hector2.mpos,0,0,0,0,0,0,1,1
plantuml_plantuml,net.sourceforge.plantuml.help,4,0,0,0,0,1,1,6
plantuml_plantuml,net.sourceforge.plantuml.html,1,0,0,0,0,0,1,2
plantuml_plantuml,net.sourceforge.plantuml.jasic,0,0,0,0,0,0,1,1
plantuml_plantuml,net.sourceforge.plantuml.jdot,4,0,0,0,0,5,1,10
plantuml_plantuml,net.sourceforge.plantuml.json,0,0,0,0,0,1,1,2
plantuml_plantuml,net.sourceforge.plantuml.jungle,0,0,0,0,0,1,1,2
plantuml_plantuml,net.sourceforge.plantuml.logo,0,0,0,0,0,0,1,1
plantuml_plantuml,net.sourceforge.plantuml.math,5,0,0,0,0,2,1,8
plantuml_plantuml,net.sourceforge.plantuml.mda,0,0,0,0,0,0,1,1
plantuml_plantuml,net.sourceforge.plantuml.mindmap,3,0,0,0,1,2,1,7
plantuml_plantuml,net.sourceforge.plantuml.mjpeg,2,0,0,0,0,0,1,3
plantuml_plantuml,net.sourceforge.plantuml.nwdiag,3,0,0,0,0,1,1,5
plantuml_plantuml,net.sourceforge.plantuml.objectdiagram,2,0,0,0,0,2,1,5
plantuml_plantuml,net.sourceforge.plantuml.objectdiagram.command,3,0,0,0,0,1,1,5
plantuml_plantuml,net.sourceforge.plantuml.openiconic.data,0,0,0,0,0,0,1,1
plantuml_plantuml,net.sourceforge.plantuml.openiconic,2,1,0,0,0,0,1,4
plantuml_plantuml,net.sourceforge.plantuml.oregon,2,0,0,0,1,0,1,4
plantuml_plantuml,net.sourceforge.plantuml.pdf,0,0,0,0,0,0,1,1
plantuml_plantuml,net.sourceforge.plantuml.png,2,0,0,0,1,3,1,7
plantuml_plantuml,net.sourceforge.plantuml.posimo,6,0,0,1,1,1,1,10
plantuml_plantuml,net.sourceforge.plantuml.postit,0,0,0,0,1,1,1,3
plantuml_plantuml,net.sourceforge.plantuml.preproc,7,1,0,0,1,8,1,18
plantuml_plantuml,net.sourceforge.plantuml.preproc2,3,0,0,0,0,5,1,9
plantuml_plantuml,net.sourceforge.plantuml.project3,3,0,0,1,0,4,1,9
plantuml_plantuml,net.sourceforge.plantuml.real,0,0,0,0,0,6,1,7
plantuml_plantuml,net.sourceforge.plantuml.salt,6,1,0,0,1,2,1,11
plantuml_plantuml,net.sourceforge.plantuml.salt.element,4,0,0,1,0,3,1,9
plantuml_plantuml,net.sourceforge.plantuml.salt.factory,4,0,0,0,0,2,1,7
plantuml_plantuml,net.sourceforge.plantuml.sequencediagram,13,1,0,0,0,18,1,33
plantuml_plantuml,net.sourceforge.plantuml.sequencediagram.command,6,0,0,1,1,7,1,16
plantuml_plantuml,net.sourceforge.plantuml.sequencediagram.graphic,4,0,0,1,0,8,1,14
plantuml_plantuml,net.sourceforge.plantuml.sequencediagram.puma,0,0,0,0,0,0,1,1
plantuml_plantuml,net.sourceforge.plantuml.sequencediagram.teoz,5,0,0,1,0,13,1,20
plantuml_plantuml,net.sourceforge.plantuml.skin,5,1,0,0,1,22,1,30
plantuml_plantuml,net.sourceforge.plantuml.skin.rose,4,1,0,0,0,17,1,23
plantuml_plantuml,net.sourceforge.plantuml.sprite,2,1,0,0,1,3,1,8
plantuml_plantuml,net.sourceforge.plantuml.statediagram.command,4,0,0,0,1,2,1,8
plantuml_plantuml,net.sourceforge.plantuml.statediagram,2,0,0,0,0,1,1,4
plantuml_plantuml,net.sourceforge.plantuml.stats.api,0,0,0,0,0,0,1,1
plantuml_plantuml,net.sourceforge.plantuml.stats,3,1,0,0,0,0,1,5
plantuml_plantuml,net.sourceforge.plantuml.style,3,0,0,0,0,16,1,20
plantuml_plantuml,net.sourceforge.plantuml.sudoku,3,0,0,0,0,0,1,4
plantuml_plantuml,net.sourceforge.plantuml.svek,13,1,0,1,1,33,1,50
plantuml_plantuml,net.sourceforge.plantuml.svek.extremity,3,0,0,1,0,0,1,5
plantuml_plantuml,net.sourceforge.plantuml.svek.image,2,0,0,1,1,15,1,20
plantuml_plantuml,net.sourceforge.plantuml.svg,6,0,0,0,0,3,1,10
plantuml_plantuml,net.sourceforge.plantuml.swing,3,0,0,0,0,0,1,4
plantuml_plantuml,net.sourceforge.plantuml.syntax,2,0,0,0,0,2,1,5
plantuml_plantuml,net.sourceforge.plantuml.telnet,0,0,0,0,0,0,1,1
plantuml_plantuml,net.sourceforge.plantuml.tikz,2,1,0,0,0,2,1,6
plantuml_plantuml,net.sourceforge.plantuml.tim,7,1,0,1,0,4,1,14
plantuml_plantuml,net.sourceforge.plantuml.tim.expression,2,1,0,0,1,2,1,7
plantuml_plantuml,net.sourceforge.plantuml.tim.stdlib,2,0,0,0,0,1,1,4
plantuml_plantuml,net.sourceforge.plantuml.timingdiagram,3,0,0,1,0,5,1,10
plantuml_plantuml,net.sourceforge.plantuml.ugraphic,80,1,0,1,0,79,1,162
plantuml_plantuml,net.sourceforge.plantuml.ugraphic.arc,0,0,0,0,0,0,1,1
plantuml_plantuml,net.sourceforge.plantuml.ugraphic.comp,3,0,0,0,1,1,1,6
plantuml_plantuml,net.sourceforge.plantuml.ugraphic.crossing,3,1,0,0,0,1,1,6
plantuml_plantuml,net.sourceforge.plantuml.ugraphic.eps,4,0,0,0,0,2,1,7
plantuml_plantuml,net.sourceforge.plantuml.ugraphic.g2d,5,1,0,0,0,4,1,11
plantuml_plantuml,net.sourceforge.plantuml.ugraphic.hand,1,0,0,0,0,0,1,2
plantuml_plantuml,net.sourceforge.plantuml.ugraphic.html5,2,0,0,0,0,0,1,3
plantuml_plantuml,net.sourceforge.plantuml.ugraphic.svg,2,1,0,0,0,3,1,7
plantuml_plantuml,net.sourceforge.plantuml.ugraphic.tikz,2,0,0,0,0,2,1,5
plantuml_plantuml,net.sourceforge.plantuml.ugraphic.txt,2,0,0,0,0,3,1,6
plantuml_plantuml,net.sourceforge.plantuml.ugraphic.visio,2,0,0,0,0,0,1,3
plantuml_plantuml,net.sourceforge.plantuml.utils,3,1,0,0,0,6,1,11
plantuml_plantuml,net.sourceforge.plantuml.version,32,1,0,0,0,8,1,42
plantuml_plantuml,net.sourceforge.plantuml.vizjs,3,0,0,0,0,1,1,5
plantuml_plantuml,net.sourceforge.plantuml.wbs,3,0,0,0,0,2,1,6
plantuml_plantuml,net.sourceforge.plantuml.webp,0,0,0,0,0,0,1,1
plantuml_plantuml,net.sourceforge.plantuml.xmi,3,0,0,0,0,2,1,6
plantuml_plantuml,net.sourceforge.plantuml.xmlsc,2,0,0,0,0,0,1,3
plantuml_plantuml,net.sourceforge.plantuml.zopfli,0,0,0,0,0,0,1,1
plantuml_plantuml,org.stathissideris.ascii2image.core,2,1,0,0,1,0,1,5
plantuml_plantuml,org.stathissideris.ascii2image.graphics,2,0,0,0,0,0,1,3
plantuml_plantuml,org.stathissideris.ascii2image.text,1,0,0,0,0,0,1,2
plantuml_plantuml,smetana.core,1,0,0,1,1,17,1,21
plantuml_plantuml,smetana.core.amiga,0,0,0,0,1,1,1,3
plantuml_plantuml,smetana.core.debug,0,0,0,0,0,0,1,1
pmd_pmd-eclipse-plugin,(default package),0,0,0,0,0,0,1,1
pmd_pmd-eclipse-plugin,name.herlin.command,0,0,0,0,1,0,1,2
pmd_pmd-eclipse-plugin,net.sourceforge.pmd.eclipse.core.ext,0,0,0,0,0,0,1,1
pmd_pmd-eclipse-plugin,net.sourceforge.pmd.eclipse.core.impl,0,0,0,0,0,0,1,1
pmd_pmd-eclipse-plugin,net.sourceforge.pmd.eclipse.core,0,0,0,0,0,0,1,1
pmd_pmd-eclipse-plugin,net.sourceforge.pmd.eclipse.plugin,34,1,0,0,0,0,1,36
pmd_pmd-eclipse-plugin,net.sourceforge.pmd.eclipse.runtime.builder,5,1,0,0,0,0,1,7
pmd_pmd-eclipse-plugin,net.sourceforge.pmd.eclipse.runtime.cmd,3,0,0,0,1,0,1,5
pmd_pmd-eclipse-plugin,net.sourceforge.pmd.eclipse.runtime,6,1,0,0,0,0,1,8
pmd_pmd-eclipse-plugin,net.sourceforge.pmd.eclipse.runtime.preferences.impl,4,0,0,0,0,1,1,6
pmd_pmd-eclipse-plugin,net.sourceforge.pmd.eclipse.runtime.preferences,0,0,0,0,0,0,1,1
pmd_pmd-eclipse-plugin,net.sourceforge.pmd.eclipse.runtime.properties.impl,0,0,0,0,1,0,1,2
pmd_pmd-eclipse-plugin,net.sourceforge.pmd.eclipse.runtime.properties,0,0,0,0,0,0,1,1
pmd_pmd-eclipse-plugin,net.sourceforge.pmd.eclipse.runtime.writer,0,0,0,0,0,0,1,1
pmd_pmd-eclipse-plugin,net.sourceforge.pmd.eclipse.runtime.writer.impl,0,0,0,0,0,0,1,1
pmd_pmd-eclipse-plugin,net.sourceforge.pmd.eclipse.search,0,0,0,0,0,0,1,1
pmd_pmd-eclipse-plugin,net.sourceforge.pmd.eclipse.ui,21,1,0,0,1,1,1,25
pmd_pmd-eclipse-plugin,net.sourceforge.pmd.eclipse.ui.actions,8,1,0,0,1,0,1,11
pmd_pmd-eclipse-plugin,net.sourceforge.pmd.eclipse.ui.dialogs,0,0,0,0,0,0,1,1
pmd_pmd-eclipse-plugin,net.sourceforge.pmd.eclipse.ui.editors,0,0,0,0,0,0,1,1
pmd_pmd-eclipse-plugin,net.sourceforge.pmd.eclipse.ui.filters,0,0,0,0,0,0,1,1
pmd_pmd-eclipse-plugin,net.sourceforge.pmd.eclipse.ui.model,3,0,0,0,1,0,1,5
pmd_pmd-eclipse-plugin,net.sourceforge.pmd.eclipse.ui.nls,14,1,0,0,0,0,1,16
pmd_pmd-eclipse-plugin,net.sourceforge.pmd.eclipse.ui.preferences,0,0,0,0,1,0,1,2
pmd_pmd-eclipse-plugin,net.sourceforge.pmd.eclipse.ui.preferences.br,11,1,0,1,1,1,1,16
pmd_pmd-eclipse-plugin,net.sourceforge.pmd.eclipse.ui.preferences.editors,6,1,0,0,1,0,1,9
pmd_pmd-eclipse-plugin,net.sourceforge.pmd.eclipse.ui.preferences.panelmanagers,5,0,0,0,1,0,1,7
pmd_pmd-eclipse-plugin,net.sourceforge.pmd.eclipse.ui.priority,13,1,0,0,0,0,1,15
pmd_pmd-eclipse-plugin,net.sourceforge.pmd.eclipse.ui.properties,0,0,0,0,1,0,1,2
pmd_pmd-eclipse-plugin,net.sourceforge.pmd.eclipse.ui.quickfix,2,0,0,0,1,0,1,4
pmd_pmd-eclipse-plugin,net.sourceforge.pmd.eclipse.ui.reports,2,1,0,0,0,0,1,4
pmd_pmd-eclipse-plugin,net.sourceforge.pmd.eclipse.ui.views,26,1,0,0,1,0,1,29
pmd_pmd-eclipse-plugin,net.sourceforge.pmd.eclipse.ui.views.actions,8,0,0,0,1,0,1,10
pmd_pmd-eclipse-plugin,net.sourceforge.pmd.eclipse.ui.views.ast,3,0,0,0,1,0,1,5
pmd_pmd-eclipse-plugin,net.sourceforge.pmd.eclipse.ui.views.cpd,0,0,0,0,0,0,1,1
pmd_pmd-eclipse-plugin,net.sourceforge.pmd.eclipse.ui.views.cpd2,0,0,0,0,0,0,1,1
pmd_pmd-eclipse-plugin,net.sourceforge.pmd.eclipse.ui.views.dataflow,0,0,0,0,1,0,1,2
pmd_pmd-eclipse-plugin,net.sourceforge.pmd.eclipse.ui.views.rules,0,0,0,0,0,0,1,1
pmd_pmd-eclipse-plugin,net.sourceforge.pmd.eclipse.util,15,1,0,0,1,0,1,18
pmd_pmd-eclipse-plugin,net.sourceforge.pmd.eclipse,1,0,0,0,0,0,1,2
pmd_pmd-eclipse-plugin,first,0,0,0,0,0,0,1,1
pmd_pmd-eclipse-plugin,second,0,0,0,0,0,0,1,1
pmd_pmd-eclipse-plugin,third,0,0,0,0,0,0,1,1
pmd_pmd-eclipse-plugin,project1,0,0,0,0,0,0,1,1
pmd_pmd-eclipse-plugin,project2,0,0,0,0,0,0,1,1
pmd_pmd-eclipse-plugin,project3,0,0,0,0,0,0,1,1
pmd_pmd-eclipse-plugin,project4.first,0,0,0,0,0,0,1,1
pmd_pmd-eclipse-plugin,project4.second,0,0,0,0,0,0,1,1
pmd_pmd-eclipse-plugin,project4.third,0,0,0,0,0,0,1,1
poetix_octarine,com.codepoetics.octarine.bson.deserialisation,0,1,0,0,1,0,0,2
poetix_octarine,com.codepoetics.octarine.bson.serialisation,0,0,0,0,0,0,0,0
poetix_octarine,com.codepoetics.octarine.bson,0,0,0,0,0,0,0,0
poetix_octarine,com.codepoetics.octarine.bson.data,0,0,0,0,0,0,0,0
poetix_octarine,com.codepoetics.octarine,0,0,0,0,0,0,0,0
poetix_octarine,com.codepoetics.octarine.records,1,0,0,0,1,0,0,2
poetix_octarine,com.codepoetics.octarine.functional.matching,0,0,0,0,0,0,0,0
poetix_octarine,com.codepoetics.octarine.records.example,1,1,0,0,0,0,0,2
poetix_octarine,com.codepoetics.octarine.functional.consumers,0,0,0,0,1,0,0,1
poetix_octarine,com.codepoetics.octarine.functional.extractors,0,0,0,0,0,0,0,0
poetix_octarine,com.codepoetics.octarine.functional.functions,0,0,0,0,0,0,0,0
poetix_octarine,com.codepoetics.octarine.functional.lenses,0,0,0,0,0,0,0,0
poetix_octarine,com.codepoetics.octarine.functional.morphisms,0,0,0,0,0,0,0,0
poetix_octarine,com.codepoetics.octarine.functional.paths,0,0,0,0,0,0,0,0
poetix_octarine,com.codepoetics.octarine.functional.tuples,0,0,0,0,1,0,0,1
poetix_octarine,com.codepoetics.octarine.jdbc,0,0,0,0,1,0,0,1
poetix_octarine,com.codepoetics.octarine.joins,0,0,0,0,1,0,0,1
poetix_octarine,com.codepoetics.octarine.json.deserialisation,0,0,0,0,0,0,0,0
poetix_octarine,com.codepoetics.octarine.json.serialisation,0,0,0,0,0,0,0,0
poetix_octarine,com.codepoetics.octarine.json,0,0,0,0,0,0,0,0
poetix_octarine,com.codepoetics.octarine.json.example,0,1,0,0,0,0,0,1
poetix_octarine,com.codepoetics.octarine.matchers,0,0,0,0,0,0,0,0
poetix_protonpack,com.codepoetics.protonpack,0,0,0,1,1,0,0,2
poetix_protonpack,com.codepoetics.protonpack.collectors,0,0,0,0,1,0,0,1
poetix_protonpack,com.codepoetics.protonpack.comparators,0,0,0,0,0,0,0,0
poetix_protonpack,com.codepoetics.protonpack.functions,0,0,0,0,0,0,0,0
poetix_protonpack,com.codepoetics.protonpack.maps,0,0,0,0,0,0,0,0
poetix_protonpack,com.codepoetics.protonpack.selectors,0,0,0,0,0,0,0,0
poetix_protonpack,com.codepoetics.protonpack.stateful,0,0,0,0,0,0,0,0
policeman-tools_forbidden-apis,de.thetaphi.forbiddenapis.ant,0,0,0,0,0,0,0,0
policeman-tools_forbidden-apis,de.thetaphi.forbiddenapis,0,0,0,0,1,0,0,1
policeman-tools_forbidden-apis,de.thetaphi.forbiddenapis.cli,0,0,0,0,0,0,0,0
policeman-tools_forbidden-apis,de.thetaphi.forbiddenapis.gradle,0,0,0,0,0,0,0,0
policeman-tools_forbidden-apis,de.thetaphi.forbiddenapis.maven,0,0,0,0,0,0,0,0
policeman-tools_forbidden-apis,(default package),0,0,0,0,1,0,0,1
polyglot-compiler_polyglot,carray.ast,0,0,0,0,0,2,1,3
polyglot-compiler_polyglot,carray,0,0,0,0,0,0,1,1
polyglot-compiler_polyglot,carray.types,0,0,0,0,1,0,1,2
polyglot-compiler_polyglot,coffer.ast,3,0,0,1,0,5,1,10
polyglot-compiler_polyglot,coffer.extension,2,1,0,0,0,0,1,4
polyglot-compiler_polyglot,coffer,0,0,0,0,1,0,1,2
polyglot-compiler_polyglot,coffer.types,2,1,0,1,0,0,1,5
polyglot-compiler_polyglot,coffer.visit,0,0,0,0,0,4,1,5
polyglot-compiler_polyglot,covarRet,0,0,0,0,1,4,1,6
polyglot-compiler_polyglot,pao.ast,1,1,0,0,1,0,1,4
polyglot-compiler_polyglot,pao.extension,1,0,0,0,1,2,1,5
polyglot-compiler_polyglot,pao,0,0,0,0,1,0,1,2
polyglot-compiler_polyglot,pao.types,0,0,0,0,1,0,1,2
polyglot-compiler_polyglot,pao.visit,0,0,0,0,0,2,1,3
polyglot-compiler_polyglot,pao.runtime,0,0,0,0,1,0,1,2
polyglot-compiler_polyglot,carray_jl5.ast,0,0,0,0,0,0,1,1
polyglot-compiler_polyglot,carray_jl5,0,0,0,0,0,0,1,1
polyglot-compiler_polyglot,carray_jl5.types,0,0,0,0,0,0,1,1
polyglot-compiler_polyglot,skelpkg.ast,0,0,0,0,0,0,1,1
polyglot-compiler_polyglot,skelpkg,0,0,0,0,0,0,1,1
polyglot-compiler_polyglot,skelpkg.types,0,0,0,0,0,0,1,1
polyglot-compiler_polyglot,polyglot.ast,7,1,0,1,0,86,1,96
polyglot-compiler_polyglot,polyglot.ext.jl5,0,0,0,0,0,4,1,5
polyglot-compiler_polyglot,polyglot.ext.jl5.ast,1,1,0,1,0,31,1,35
polyglot-compiler_polyglot,polyglot.ext.jl5.parse,0,0,0,0,1,10,1,12
polyglot-compiler_polyglot,polyglot.ext.jl5.qq,0,0,0,0,0,2,1,3
polyglot-compiler_polyglot,polyglot.ext.jl5.translate,0,0,0,1,0,4,1,6
polyglot-compiler_polyglot,polyglot.ext.jl5.types,3,1,0,1,0,34,1,40
polyglot-compiler_polyglot,polyglot.ext.jl5.types.inference,1,0,0,0,1,2,1,5
polyglot-compiler_polyglot,polyglot.ext.jl5.types.reflect,1,0,0,0,0,3,1,5
polyglot-compiler_polyglot,polyglot.ext.jl5.visit,0,1,0,0,1,13,1,16
polyglot-compiler_polyglot,polyglot.ext.jl7.ast,0,0,0,0,0,11,1,12
polyglot-compiler_polyglot,polyglot.ext.jl7,0,0,0,0,0,0,1,1
polyglot-compiler_polyglot,polyglot.ext.jl7.parse,0,0,0,0,0,3,1,4
polyglot-compiler_polyglot,polyglot.ext.jl7.translate,0,0,0,0,0,0,1,1
polyglot-compiler_polyglot,polyglot.ext.jl7.types,0,0,0,0,0,0,1,1
polyglot-compiler_polyglot,polyglot.ext.jl7.types.inference,0,0,0,0,0,1,1,2
polyglot-compiler_polyglot,polyglot.ext.param,0,0,0,0,0,0,1,1
polyglot-compiler_polyglot,polyglot.ext.param.types,0,0,0,0,0,6,1,7
polyglot-compiler_polyglot,polyglot.filemanager,3,0,0,0,0,1,1,5
polyglot-compiler_polyglot,polyglot.frontend,22,1,0,1,0,17,1,42
polyglot-compiler_polyglot,polyglot.frontend.goals,5,0,0,1,0,10,1,17
polyglot-compiler_polyglot,polyglot.frontend.passes,1,1,0,0,1,1,1,5
polyglot-compiler_polyglot,polyglot.lex,0,0,0,0,1,10,1,12
polyglot-compiler_polyglot,polyglot.main,17,1,0,0,0,14,1,33
polyglot-compiler_polyglot,polyglot.parse,3,0,0,0,1,14,1,19
polyglot-compiler_polyglot,polyglot.qq,0,0,0,0,0,3,1,4
polyglot-compiler_polyglot,polyglot.translate.ext,1,0,0,1,0,4,1,7
polyglot-compiler_polyglot,polyglot.translate,0,1,0,0,0,8,1,10
polyglot-compiler_polyglot,polyglot.types,8,1,0,1,0,72,1,83
polyglot-compiler_polyglot,polyglot.types.reflect,6,0,0,0,0,3,1,10
polyglot-compiler_polyglot,polyglot.util,12,1,0,1,1,38,1,54
polyglot-compiler_polyglot,polyglot.util.typedump,0,0,0,0,0,0,1,1
polyglot-compiler_polyglot,polyglot.visit,4,1,0,1,0,47,1,54
polyglot-compiler_polyglot,(default package),0,0,0,0,1,0,1,2
polyglot-compiler_polyglot,efg.ast,0,0,0,0,0,0,1,1
polyglot-compiler_polyglot,efg.config.ast,0,0,0,0,0,0,1,1
polyglot-compiler_polyglot,efg.config.parse,0,0,0,0,0,1,1,2
polyglot-compiler_polyglot,efg,1,1,0,0,0,1,1,4
polyglot-compiler_polyglot,efg.filemanager,0,1,0,0,0,0,1,2
polyglot-compiler_polyglot,efg.frontend,1,1,0,0,0,0,1,3
polyglot-compiler_polyglot,efg.parse,0,0,0,0,0,3,1,4
polyglot-compiler_polyglot,efg.translate,0,1,0,0,0,1,1,3
polyglot-compiler_polyglot,efg.types,0,0,0,0,0,1,1,2
polyglot-compiler_polyglot,efg.util,0,0,0,0,0,0,1,1
polyglot-compiler_polyglot,efg.visit,0,0,0,0,0,0,1,1
polyglot-compiler_polyglot,java_cup,1,1,0,1,0,0,1,4
polyglot-compiler_polyglot,java_cup.runtime,0,0,0,0,1,16,1,18
polyglot-compiler_polyglot,parser,1,0,0,0,0,0,1,2
polyglot-compiler_polyglot,ppg.atoms,0,0,0,0,1,2,1,4
polyglot-compiler_polyglot,ppg.cmds,0,0,0,0,0,2,1,3
polyglot-compiler_polyglot,ppg.code,0,0,0,0,0,0,1,1
polyglot-compiler_polyglot,ppg.lex,3,1,0,0,0,1,1,6
polyglot-compiler_polyglot,ppg.parse,5,0,0,0,1,1,1,8
polyglot-compiler_polyglot,ppg,2,1,0,0,0,0,1,4
polyglot-compiler_polyglot,ppg.spec,4,0,0,0,0,1,1,6
polyglot-compiler_polyglot,ppg.util,0,0,0,0,1,1,1,3
polyglot-compiler_polyglot,polyglot.pth,1,0,0,0,0,1,1,3
polyglot-compiler_polyglot,polyglot.pth.polyglot,1,0,0,0,0,1,1,3
Pragmatists_junitparams,junitparams.converters,0,0,0,0,1,0,0,1
Pragmatists_junitparams,junitparams.custom.combined,0,0,0,0,1,0,0,1
Pragmatists_junitparams,junitparams.custom,0,0,0,0,1,0,0,1
Pragmatists_junitparams,junitparams,2,1,0,1,1,0,0,5
Pragmatists_junitparams,junitparams.internal.annotation,0,0,0,0,0,0,0,0
Pragmatists_junitparams,junitparams.internal,0,0,0,0,1,0,0,1
Pragmatists_junitparams,junitparams.internal.parameters,1,0,0,0,1,0,0,2
Pragmatists_junitparams,junitparams.internal.parameters.toarray,0,0,0,0,1,0,0,1
Pragmatists_junitparams,junitparams.mappers,0,0,0,0,0,0,0,0
Pragmatists_junitparams,junitparams.naming,0,0,0,0,0,0,0,0
Pragmatists_junitparams,junitparams.missingparams,0,0,0,0,0,0,0,0
Pragmatists_junitparams,junitparams.rules,0,0,0,0,0,0,0,0
Pragmatists_junitparams,junitparams.usage.person_example,0,0,0,0,0,0,0,0
Pragmatists_junitparams,junitparams.usage,1,0,0,0,0,0,0,1
primecloud-controller-org_primecloud-controller,jp.primecloud.auto.api.address,0,0,0,0,0,1,0,1
primecloud-controller-org_primecloud-controller,jp.primecloud.auto.api,0,1,0,0,1,9,0,11
primecloud-controller-org_primecloud-controller,jp.primecloud.auto.api.component,0,0,0,0,1,2,0,3
primecloud-controller-org_primecloud-controller,jp.primecloud.auto.api.eventlog,0,0,0,0,0,0,0,0
primecloud-controller-org_primecloud-controller,jp.primecloud.auto.api.farm,0,0,0,0,0,1,0,1
primecloud-controller-org_primecloud-controller,jp.primecloud.auto.api.image,0,0,0,0,0,0,0,0
primecloud-controller-org_primecloud-controller,jp.primecloud.auto.api.instance,0,0,0,0,1,6,0,7
primecloud-controller-org_primecloud-controller,jp.primecloud.auto.api.lb,0,0,0,0,1,2,0,3
primecloud-controller-org_primecloud-controller,jp.primecloud.auto.api.mock,0,0,0,0,0,0,0,0
primecloud-controller-org_primecloud-controller,jp.primecloud.auto.api.platform,0,0,0,0,0,0,0,0
primecloud-controller-org_primecloud-controller,jp.primecloud.auto.api.response,0,0,0,0,0,0,0,0
primecloud-controller-org_primecloud-controller,jp.primecloud.auto.api.response.address,0,0,0,0,0,0,0,0
primecloud-controller-org_primecloud-controller,jp.primecloud.auto.api.response.component,0,0,0,0,1,1,0,2
primecloud-controller-org_primecloud-controller,jp.primecloud.auto.api.response.eventlog,0,0,0,0,0,0,0,0
primecloud-controller-org_primecloud-controller,jp.primecloud.auto.api.response.farm,0,0,0,0,0,0,0,0
primecloud-controller-org_primecloud-controller,jp.primecloud.auto.api.response.image,0,0,0,0,0,0,0,0
primecloud-controller-org_primecloud-controller,jp.primecloud.auto.api.response.instance,0,0,0,0,1,0,0,1
primecloud-controller-org_primecloud-controller,jp.primecloud.auto.api.response.lb,0,0,0,0,1,0,0,1
primecloud-controller-org_primecloud-controller,jp.primecloud.auto.api.response.platform,0,0,0,0,1,0,0,1
primecloud-controller-org_primecloud-controller,jp.primecloud.auto.api.response.template,0,0,0,0,0,0,0,0
primecloud-controller-org_primecloud-controller,jp.primecloud.auto.api.template,0,0,0,0,0,1,0,1
primecloud-controller-org_primecloud-controller,jp.primecloud.auto.api.util,0,0,0,0,0,0,0,0
primecloud-controller-org_primecloud-controller,jp.primecloud.auto.aws.amazon,0,0,0,0,0,0,0,0
primecloud-controller-org_primecloud-controller,jp.primecloud.auto.aws,0,0,0,0,0,0,0,0
primecloud-controller-org_primecloud-controller,jp.primecloud.auto.aws.typica.converter,0,0,0,0,1,0,0,1
primecloud-controller-org_primecloud-controller,jp.primecloud.auto.aws.typica,0,0,0,0,0,0,0,0
primecloud-controller-org_primecloud-controller,jp.primecloud.auto.aws.wrapper,0,0,0,0,0,0,0,0
primecloud-controller-org_primecloud-controller,jp.primecloud.auto.common.component,0,0,0,0,1,1,0,2
primecloud-controller-org_primecloud-controller,jp.primecloud.auto.common.constant,0,0,0,0,0,0,0,0
primecloud-controller-org_primecloud-controller,jp.primecloud.auto.common.interceptor,0,0,0,0,0,0,0,0
primecloud-controller-org_primecloud-controller,jp.primecloud.auto.common.log,0,0,0,0,1,0,0,1
primecloud-controller-org_primecloud-controller,jp.primecloud.auto.config,0,0,0,0,0,0,0,0
primecloud-controller-org_primecloud-controller,jp.primecloud.auto.exception,0,0,0,0,0,2,0,2
primecloud-controller-org_primecloud-controller,jp.primecloud.auto.util,0,0,0,0,1,1,0,2
primecloud-controller-org_primecloud-controller,jp.primecloud.auto.dao.crud,0,0,0,1,1,25,0,27
primecloud-controller-org_primecloud-controller,jp.primecloud.auto.dao.crud.impl,0,0,0,1,1,0,0,2
primecloud-controller-org_primecloud-controller,jp.primecloud.auto.entity.crud,0,0,0,1,1,30,0,32
primecloud-controller-org_primecloud-controller,jp.primecloud.auto.service,0,0,0,0,1,10,0,11
primecloud-controller-org_primecloud-controller,jp.primecloud.auto.log.dao.crud,0,0,0,0,0,0,0,0
primecloud-controller-org_primecloud-controller,jp.primecloud.auto.log.dao.crud.impl,0,0,0,0,0,0,0,0
primecloud-controller-org_primecloud-controller,jp.primecloud.auto.log.entity.crud,0,0,0,0,0,0,0,0
primecloud-controller-org_primecloud-controller,jp.primecloud.auto.log,0,0,0,0,0,1,0,1
primecloud-controller-org_primecloud-controller,jp.primecloud.auto.log.service,0,0,0,0,0,0,0,0
primecloud-controller-org_primecloud-controller,jp.primecloud.auto.log.service.impl,0,0,0,0,0,0,0,0
primecloud-controller-org_primecloud-controller,jp.primecloud.auto.nifty.dto,0,0,0,0,0,1,0,1
primecloud-controller-org_primecloud-controller,jp.primecloud.auto.nifty.process,0,0,0,0,0,1,0,1
primecloud-controller-org_primecloud-controller,jp.primecloud.auto.component.apache,0,0,0,0,0,0,0,0
primecloud-controller-org_primecloud-controller,jp.primecloud.auto.component.apache.process,0,0,0,0,0,0,0,0
primecloud-controller-org_primecloud-controller,jp.primecloud.auto.component.geronimo,0,0,0,0,0,0,0,0
primecloud-controller-org_primecloud-controller,jp.primecloud.auto.component.geronimo.process,0,0,0,0,0,0,0,0
primecloud-controller-org_primecloud-controller,jp.primecloud.auto.component.mysql,0,0,0,0,0,0,0,0
primecloud-controller-org_primecloud-controller,jp.primecloud.auto.component.mysql.process,0,0,0,0,0,1,0,1
primecloud-controller-org_primecloud-controller,jp.primecloud.auto.component.prjserver,0,0,0,0,0,0,0,0
primecloud-controller-org_primecloud-controller,jp.primecloud.auto.component.prjserver.process,0,0,0,0,0,0,0,0
primecloud-controller-org_primecloud-controller,jp.primecloud.auto.component.tomcat,0,0,0,0,0,0,0,0
primecloud-controller-org_primecloud-controller,jp.primecloud.auto.component.tomcat.process,0,0,0,0,0,0,0,0
primecloud-controller-org_primecloud-controller,jp.primecloud.auto.component.ultramonkey,0,0,0,0,0,0,0,0
primecloud-controller-org_primecloud-controller,jp.primecloud.auto.component.ultramonkey.process,0,0,0,0,0,0,0,0
primecloud-controller-org_primecloud-controller,jp.primecloud.auto.component.windows,0,0,0,0,0,0,0,0
primecloud-controller-org_primecloud-controller,jp.primecloud.auto.component.windows.process,0,0,0,0,0,0,0,0
primecloud-controller-org_primecloud-controller,jp.primecloud.auto.iaasgw,0,0,0,0,0,4,0,4
primecloud-controller-org_primecloud-controller,jp.primecloud.auto.process.aws,0,0,0,0,1,2,0,3
primecloud-controller-org_primecloud-controller,jp.primecloud.auto.process.azure,0,0,0,0,0,2,0,2
primecloud-controller-org_primecloud-controller,jp.primecloud.auto.process.cloudstack,0,0,0,0,0,2,0,2
primecloud-controller-org_primecloud-controller,jp.primecloud.auto.process,0,0,0,0,1,8,0,9
primecloud-controller-org_primecloud-controller,jp.primecloud.auto.process.hook,0,0,0,0,0,0,0,0
primecloud-controller-org_primecloud-controller,jp.primecloud.auto.process.iaasgw,0,0,0,0,0,1,0,1
primecloud-controller-org_primecloud-controller,jp.primecloud.auto.process.lb,0,0,0,0,0,0,0,0
primecloud-controller-org_primecloud-controller,jp.primecloud.auto.process.nifty,0,0,0,0,0,2,0,2
primecloud-controller-org_primecloud-controller,jp.primecloud.auto.process.openstack,0,0,0,0,0,2,0,2
primecloud-controller-org_primecloud-controller,jp.primecloud.auto.process.puppet,0,0,0,0,0,0,0,0
primecloud-controller-org_primecloud-controller,jp.primecloud.auto.process.vcloud,0,0,0,0,0,2,0,2
primecloud-controller-org_primecloud-controller,jp.primecloud.auto.process.vmware,0,0,0,0,1,1,0,2
primecloud-controller-org_primecloud-controller,jp.primecloud.auto.process.zabbix,0,0,0,0,0,6,0,6
primecloud-controller-org_primecloud-controller,jp.primecloud.auto.puppet,0,0,0,0,0,0,0,0
primecloud-controller-org_primecloud-controller,jp.primecloud.auto.puppet.report,0,0,0,0,0,0,0,0
primecloud-controller-org_primecloud-controller,jp.primecloud.auto.service.dto,0,0,0,0,1,8,0,9
primecloud-controller-org_primecloud-controller,jp.primecloud.auto.service.impl,0,0,0,0,1,8,0,9
primecloud-controller-org_primecloud-controller,jp.primecloud.auto.ui,0,0,0,1,1,1,0,3
primecloud-controller-org_primecloud-controller,jp.primecloud.auto.ui.data,0,0,0,0,1,0,0,1
primecloud-controller-org_primecloud-controller,jp.primecloud.auto.ui.mock.process,0,0,0,0,0,0,0,0
primecloud-controller-org_primecloud-controller,jp.primecloud.auto.ui.mock.service,0,0,0,0,0,0,0,0
primecloud-controller-org_primecloud-controller,jp.primecloud.auto.ui.server,0,0,0,0,0,0,0,0
primecloud-controller-org_primecloud-controller,jp.primecloud.auto.ui.util,0,1,0,0,1,1,0,3
primecloud-controller-org_primecloud-controller,jp.primecloud.auto.ui.validator,0,0,0,0,0,0,0,0
primecloud-controller-org_primecloud-controller,jp.primecloud.auto.vmware,0,0,0,0,0,0,0,0
primecloud-controller-org_primecloud-controller,jp.primecloud.auto.web.spring,0,0,0,0,0,0,0,0
primecloud-controller-org_primecloud-controller,com.vaadin,15,1,0,0,1,0,0,17
primecloud-controller-org_primecloud-controller,com.vaadin.data,3,0,0,1,0,0,0,4
primecloud-controller-org_primecloud-controller,com.vaadin.data.util,2,0,0,1,0,0,0,3
primecloud-controller-org_primecloud-controller,com.vaadin.data.validator,0,0,0,0,1,0,0,1
primecloud-controller-org_primecloud-controller,com.vaadin.event,10,1,0,1,0,0,0,12
primecloud-controller-org_primecloud-controller,com.vaadin.event.dd.acceptcriteria,4,0,0,0,0,0,0,4
primecloud-controller-org_primecloud-controller,com.vaadin.event.dd,5,1,0,0,1,0,0,7
primecloud-controller-org_primecloud-controller,com.vaadin.service,5,0,0,0,0,0,0,5
primecloud-controller-org_primecloud-controller,com.vaadin.terminal,11,1,0,1,1,0,0,14
primecloud-controller-org_primecloud-controller,com.vaadin.terminal.gwt.client,9,1,0,1,1,0,0,12
primecloud-controller-org_primecloud-controller,com.vaadin.terminal.gwt.client.ui,8,1,0,2,0,0,0,11
primecloud-controller-org_primecloud-controller,com.vaadin.terminal.gwt.client.ui.dd,4,1,0,0,0,0,0,5
primecloud-controller-org_primecloud-controller,com.vaadin.terminal.gwt.client.ui.layout,3,0,0,0,0,0,0,3
primecloud-controller-org_primecloud-controller,com.vaadin.terminal.gwt.client.ui.richtextarea,0,0,0,0,1,0,0,1
primecloud-controller-org_primecloud-controller,com.vaadin.terminal.gwt.server,10,0,0,1,0,0,0,11
primecloud-controller-org_primecloud-controller,com.vaadin.terminal.gwt.widgetsetutils,0,0,0,0,0,0,0,0
primecloud-controller-org_primecloud-controller,com.vaadin.tools,0,0,0,0,0,0,0,0
primecloud-controller-org_primecloud-controller,com.vaadin.ui,22,1,0,1,0,0,0,24
primecloud-controller-org_primecloud-controller,com.vaadin.ui.themes,0,0,0,0,0,0,0,0
primecloud-controller-org_primecloud-controller,com.vaadin.util,0,0,0,0,0,0,0,0
primecloud-controller-org_primecloud-controller,jp.primecloud.auto.zabbix.client,0,0,0,0,1,20,0,21
primecloud-controller-org_primecloud-controller,jp.primecloud.auto.zabbix.model.application,0,0,0,0,0,1,0,1
primecloud-controller-org_primecloud-controller,jp.primecloud.auto.zabbix.model.host,0,0,0,0,0,5,0,5
primecloud-controller-org_primecloud-controller,jp.primecloud.auto.zabbix.model.hostgroup,0,0,0,0,0,4,0,4
primecloud-controller-org_primecloud-controller,jp.primecloud.auto.zabbix.model.hostinterface,0,0,0,0,0,0,0,0
primecloud-controller-org_primecloud-controller,jp.primecloud.auto.zabbix.model.item,0,0,0,0,0,2,0,2
primecloud-controller-org_primecloud-controller,jp.primecloud.auto.zabbix.model.maintenance,0,0,0,0,0,0,0,0
primecloud-controller-org_primecloud-controller,jp.primecloud.auto.zabbix.model,0,0,0,0,0,0,0,0
primecloud-controller-org_primecloud-controller,jp.primecloud.auto.zabbix.model.proxy,0,0,0,0,0,1,0,1
primecloud-controller-org_primecloud-controller,jp.primecloud.auto.zabbix.model.right,0,0,0,0,0,0,0,0
primecloud-controller-org_primecloud-controller,jp.primecloud.auto.zabbix.model.template,0,0,0,0,0,2,0,2
primecloud-controller-org_primecloud-controller,jp.primecloud.auto.zabbix.model.timeperiod,0,0,0,0,0,0,0,0
primecloud-controller-org_primecloud-controller,jp.primecloud.auto.zabbix.model.trigger,0,0,0,0,0,1,0,1
primecloud-controller-org_primecloud-controller,jp.primecloud.auto.zabbix.model.user,0,0,0,0,0,3,0,3
primecloud-controller-org_primecloud-controller,jp.primecloud.auto.zabbix.model.usergroup,0,0,0,0,0,4,0,4
primecloud-controller-org_primecloud-controller,jp.primecloud.auto.zabbix,0,0,0,0,0,20,0,20
primecloud-controller-org_primecloud-controller,jp.primecloud.auto.zabbix.util,0,0,0,0,0,0,0,0
primecloud-controller-org_primecloud-controller,jp.primecloud.auto.tool.management.db,0,0,0,0,0,0,0,0
primecloud-controller-org_primecloud-controller,jp.primecloud.auto.tool.management.iaasgw,1,0,0,0,0,1,0,2
primecloud-controller-org_primecloud-controller,jp.primecloud.auto.tool.management.main,2,1,0,0,0,1,0,4
primecloud-controller-org_primecloud-controller,jp.primecloud.auto.tool.management.pccapi,0,0,0,0,0,0,0,0
primecloud-controller-org_primecloud-controller,jp.primecloud.auto.tool.management.service,1,1,0,0,0,0,0,2
primecloud-controller-org_primecloud-controller,jp.primecloud.auto.tool.management.util,0,0,0,0,0,0,0,0
primecloud-controller-org_primecloud-controller,jp.primecloud.auto.tool.management.zabbix,0,0,0,0,0,4,0,4
project-ncl_pnc,org.jboss.pnc.auth,0,0,0,0,1,0,0,1
project-ncl_pnc,org.jboss.pnc.auth.keycloakutil.httpcomponents,0,0,0,0,0,0,0,0
project-ncl_pnc,org.jboss.pnc.auth.keycloakutil.operations,1,0,0,0,1,0,0,2
project-ncl_pnc,org.jboss.pnc.auth.keycloakutil.util,1,1,0,0,1,0,0,3
project-ncl_pnc,org.jboss.pnc,0,1,0,0,0,0,0,1
project-ncl_pnc,org.jboss.pnc.bpm,0,0,0,0,0,0,0,0
project-ncl_pnc,org.jboss.pnc.bpm.causeway,0,0,0,0,0,0,0,0
project-ncl_pnc,org.jboss.pnc.bpm.model,0,0,0,0,1,0,0,1
project-ncl_pnc,org.jboss.pnc.bpm.model.causeway,0,0,0,0,0,0,0,0
project-ncl_pnc,org.jboss.pnc.bpm.model.mapper,0,0,0,0,0,0,0,0
project-ncl_pnc,org.jboss.pnc.bpm.notification,0,0,0,0,0,0,0,0
project-ncl_pnc,org.jboss.pnc.bpm.task,0,0,0,0,0,0,0,0
project-ncl_pnc,org.jboss.pnc.coordinator,0,0,0,0,0,0,0,0
project-ncl_pnc,org.jboss.pnc.coordinator.builder.bpm,0,0,0,0,0,0,0,0
project-ncl_pnc,org.jboss.pnc.coordinator.builder,0,0,0,0,1,0,0,1
project-ncl_pnc,org.jboss.pnc.coordinator.builder.datastore,0,0,0,0,0,0,0,0
project-ncl_pnc,org.jboss.pnc.coordinator.builder.local,0,0,0,0,0,0,0,0
project-ncl_pnc,org.jboss.pnc.coordinator.maintenance,0,0,0,0,1,0,0,1
project-ncl_pnc,org.jboss.pnc.coordinator.notifications.buildSetTask,0,0,0,0,0,0,0,0
project-ncl_pnc,org.jboss.pnc.coordinator.notifications.buildTask,0,0,0,0,1,0,0,1
project-ncl_pnc,org.jboss.pnc.executor,0,0,0,0,1,0,0,1
project-ncl_pnc,org.jboss.pnc.executor.exceptions,0,0,0,0,0,0,0,0
project-ncl_pnc,org.jboss.pnc.executor.servicefactories,0,0,0,0,0,0,0,0
project-ncl_pnc,org.jboss.pnc.causewayclient,0,0,0,0,0,0,0,0
project-ncl_pnc,org.jboss.pnc.causewayclient.remotespi,0,0,0,0,1,0,0,1
project-ncl_pnc,org.jboss.pnc.common.concurrent,0,0,0,0,1,0,0,1
project-ncl_pnc,org.jboss.pnc.common,0,0,0,0,0,0,0,0
project-ncl_pnc,org.jboss.pnc.common.Date,0,0,0,0,0,0,0,0
project-ncl_pnc,org.jboss.pnc.common.gerrit,0,0,0,0,0,0,0,0
project-ncl_pnc,org.jboss.pnc.common.graph,0,0,0,0,0,0,0,0
project-ncl_pnc,org.jboss.pnc.common.json,0,0,0,0,1,0,0,1
project-ncl_pnc,org.jboss.pnc.common.json.moduleprovider,1,0,0,0,0,0,0,1
project-ncl_pnc,org.jboss.pnc.common.logging,0,0,0,0,0,0,0,0
project-ncl_pnc,org.jboss.pnc.common.maven,0,0,0,0,0,0,0,0
project-ncl_pnc,org.jboss.pnc.common.monitor,0,0,0,0,0,0,0,0
project-ncl_pnc,org.jboss.pnc.common.security,0,0,0,0,0,0,0,0
project-ncl_pnc,org.jboss.pnc.common.tree,0,0,0,0,0,0,0,0
project-ncl_pnc,org.jboss.pnc.common.util,0,0,0,0,1,0,0,1
project-ncl_pnc,org.jboss.pnc.constants,0,0,0,0,0,0,0,0
project-ncl_pnc,org.jboss.pnc.datastore.audit,0,0,0,0,0,0,0,0
project-ncl_pnc,org.jboss.pnc.datastore.configuration,0,0,0,0,0,0,0,0
project-ncl_pnc,org.jboss.pnc.datastore,0,0,0,0,0,0,0,0
project-ncl_pnc,org.jboss.pnc.datastore.limits,0,0,0,0,1,0,0,1
project-ncl_pnc,org.jboss.pnc.datastore.limits.rsql,0,0,0,0,0,0,0,0
project-ncl_pnc,org.jboss.pnc.datastore.predicates.rsql,0,0,0,0,1,0,0,1
project-ncl_pnc,org.jboss.pnc.datastore.predicates,0,0,0,0,0,0,0,0
project-ncl_pnc,org.jboss.pnc.datastore.repositories,0,0,0,0,1,0,0,1
project-ncl_pnc,org.jboss.pnc.datastore.repositories.audited,0,0,0,0,0,0,0,0
project-ncl_pnc,org.jboss.pnc.datastore.repositories.internal,0,0,0,0,1,0,0,1
project-ncl_pnc,org.jboss.pnc.demo.data,0,0,0,0,0,0,0,0
project-ncl_pnc,org.jboss.pnc.client.patch,0,0,0,0,1,1,0,2
project-ncl_pnc,org.jboss.pnc.dto,0,0,0,1,1,0,0,2
project-ncl_pnc,org.jboss.pnc.dto.notification,0,0,0,0,0,0,0,0
project-ncl_pnc,org.jboss.pnc.dto.requests,0,0,0,0,1,0,0,1
project-ncl_pnc,org.jboss.pnc.dto.response,0,0,0,0,1,0,0,1
project-ncl_pnc,org.jboss.pnc.dto.validation.groups,0,0,0,0,0,0,0,0
project-ncl_pnc,org.jboss.pnc.dto.validation.validators,0,0,0,0,0,0,0,0
project-ncl_pnc,org.jboss.pnc.auth.client,0,0,0,0,0,0,0,0
project-ncl_pnc,org.jboss.pnc.facade,0,0,0,0,0,1,0,1
project-ncl_pnc,org.jboss.pnc.facade.executor,0,0,0,0,0,0,0,0
project-ncl_pnc,org.jboss.pnc.facade.impl,0,0,0,0,0,0,0,0
project-ncl_pnc,org.jboss.pnc.facade.providers,0,0,0,1,1,0,0,2
project-ncl_pnc,org.jboss.pnc.facade.providers.api,0,0,0,0,1,1,0,2
project-ncl_pnc,org.jboss.pnc.facade.rsql,0,0,0,0,1,0,0,1
project-ncl_pnc,org.jboss.pnc.facade.rsql.mapper,0,0,0,0,1,0,0,1
project-ncl_pnc,org.jboss.pnc.facade.util,0,0,0,0,0,0,0,0
project-ncl_pnc,org.jboss.pnc.facade.validation,0,0,0,0,1,0,0,1
project-ncl_pnc,org.jboss.pnc.facade.validation.model,0,0,0,0,0,0,0,0
project-ncl_pnc,org.jboss.pnc.indyrepositorymanager,0,0,0,0,1,2,0,3
project-ncl_pnc,org.jboss.pnc.indyrepositorymanager.fixture,0,0,0,0,0,0,0,0
project-ncl_pnc,org.jboss.pnc.integration,0,0,0,0,1,0,0,1
project-ncl_pnc,org.jboss.pnc.integration.assertions,0,0,0,0,0,0,0,0
project-ncl_pnc,org.jboss.pnc.integration.client,0,1,0,0,0,0,0,1
project-ncl_pnc,org.jboss.pnc.integration.client.util,0,0,0,0,0,0,0,0
project-ncl_pnc,org.jboss.pnc.integration.deployments,0,1,0,0,0,0,0,1
project-ncl_pnc,org.jboss.pnc.integration.env,0,0,0,0,0,0,0,0
project-ncl_pnc,org.jboss.pnc.integration.matchers,0,0,0,0,0,0,0,0
project-ncl_pnc,org.jboss.pnc.integration.mock,0,1,0,0,0,0,0,1
project-ncl_pnc,org.jboss.pnc.integration.remote,0,0,0,0,0,0,0,0
project-ncl_pnc,org.jboss.pnc.integration.template,0,0,0,0,0,0,0,0
project-ncl_pnc,org.jboss.pnc.integration.utils,0,0,0,0,0,0,0,0
project-ncl_pnc,org.jboss.pnc.integration.websockets,0,0,0,0,0,0,0,0
project-ncl_pnc,org.jboss.pnc.integration_new.endpoint,0,0,0,0,1,1,0,2
project-ncl_pnc,org.jboss.pnc.integration_new,0,0,0,0,0,0,0,0
project-ncl_pnc,org.jboss.pnc.integration_new.setup,0,0,0,0,0,0,0,0
project-ncl_pnc,org.jboss.pnc.mock.auth,0,0,0,0,0,0,0,0
project-ncl_pnc,org.jboss.pnc.jenkinsbuilddriver,0,0,0,0,0,0,0,0
project-ncl_pnc,org.jboss.pnc.mapper,1,0,0,0,1,1,0,3
project-ncl_pnc,org.jboss.pnc.mapper.api,1,1,0,0,1,1,0,4
project-ncl_pnc,org.jboss.pnc.messaging,0,0,0,0,1,0,0,1
project-ncl_pnc,org.jboss.pnc.messaging.spi,0,0,0,0,1,0,0,1
project-ncl_pnc,org.jboss.pnc.model,0,0,0,1,1,2,0,4
project-ncl_pnc,org.jboss.pnc.model.utils,0,0,0,0,0,0,0,0
project-ncl_pnc,org.jboss.pnc.common.json.moduleconfig,1,1,0,0,1,0,0,3
project-ncl_pnc,org.jboss.pnc.common.json.moduleconfig.helper,0,0,0,0,0,0,0,0
project-ncl_pnc,org.jboss.pnc.notification,0,0,0,0,0,0,0,0
project-ncl_pnc,org.jboss.pnc.notification.websockets,0,0,0,0,0,0,0,0
project-ncl_pnc,org.jboss.pnc.environment.openshift,0,0,0,0,1,0,0,1
project-ncl_pnc,org.jboss.pnc.environment.openshift.exceptions,0,0,0,0,0,0,0,0
project-ncl_pnc,org.jboss.pnc.mock.builddriver,0,1,0,0,0,0,0,1
project-ncl_pnc,org.jboss.pnc.mock.common,0,0,0,0,0,0,0,0
project-ncl_pnc,org.jboss.pnc.mock.coordinator,0,0,0,0,0,0,0,0
project-ncl_pnc,org.jboss.pnc.mock.datastore,0,0,0,0,0,0,0,0
project-ncl_pnc,org.jboss.pnc.mock.dto,0,0,0,0,0,0,0,0
project-ncl_pnc,org.jboss.pnc.mock.environmentdriver,0,0,0,0,0,0,0,0
project-ncl_pnc,org.jboss.pnc.mock.executor,0,0,0,0,0,0,0,0
project-ncl_pnc,org.jboss.pnc.mock.model,0,0,0,0,0,0,0,0
project-ncl_pnc,org.jboss.pnc.mock.model.builders,0,0,0,0,0,0,0,0
project-ncl_pnc,org.jboss.pnc.mock.repository,0,0,0,0,1,0,0,1
project-ncl_pnc,org.jboss.pnc.mock.repositorymanager,0,0,0,0,0,0,0,0
project-ncl_pnc,org.jboss.pnc.mock.repour,0,0,0,0,0,0,0,0
project-ncl_pnc,org.jboss.pnc.mock.spi,0,0,0,0,0,0,0,0
project-ncl_pnc,org.jboss.pnc.processor,0,0,0,0,0,0,0,0
project-ncl_pnc,org.jboss.pnc.rest.configuration,0,0,0,0,1,0,0,1
project-ncl_pnc,org.jboss.pnc.rest.debug,0,0,0,0,0,0,0,0
project-ncl_pnc,org.jboss.pnc.rest.endpoint,1,1,0,0,1,0,0,3
project-ncl_pnc,org.jboss.pnc.rest.notifications.websockets,0,0,0,0,1,0,0,1
project-ncl_pnc,org.jboss.pnc.rest.provider,1,0,0,1,1,0,0,3
project-ncl_pnc,org.jboss.pnc.rest.swagger.response,0,0,0,1,1,0,0,2
project-ncl_pnc,org.jboss.pnc.rest.trigger,0,0,0,0,0,0,0,0
project-ncl_pnc,org.jboss.pnc.rest.utils,0,0,0,0,1,0,0,1
project-ncl_pnc,org.jboss.pnc.rest.serialization,0,0,0,0,0,0,0,0
project-ncl_pnc,org.jboss.pnc.rest.utils.mock,0,0,0,0,0,0,0,0
project-ncl_pnc,org.jboss.pnc.rest.validation.helpers,0,0,0,0,0,0,0,0
project-ncl_pnc,org.jboss.pnc.rest.validation,0,0,0,0,0,0,0,0
project-ncl_pnc,org.jboss.pnc.client,0,0,0,1,1,1,0,3
project-ncl_pnc,org.jboss.pnc.rest.api.endpoints,0,0,0,0,1,0,0,1
project-ncl_pnc,org.jboss.pnc.rest.api.parameters,0,0,0,0,0,0,0,0
project-ncl_pnc,org.jboss.pnc.rest.api.swagger.response,0,0,0,0,1,0,0,1
project-ncl_pnc,org.jboss.pnc.rest.jackson,0,0,0,0,0,0,0,0
project-ncl_pnc,org.jboss.pnc.rest.provider.collection,0,0,0,0,0,0,0,0
project-ncl_pnc,org.jboss.pnc.rest.restmodel,0,0,0,0,1,0,0,1
project-ncl_pnc,org.jboss.pnc.rest.restmodel.bpm,0,0,0,0,0,0,0,0
project-ncl_pnc,org.jboss.pnc.rest.restmodel.causeway,0,0,0,0,0,0,0,0
project-ncl_pnc,org.jboss.pnc.rest.restmodel.graph,0,0,0,0,0,0,0,0
project-ncl_pnc,org.jboss.pnc.rest.restmodel.mock,0,0,0,0,0,0,0,0
project-ncl_pnc,org.jboss.pnc.rest.restmodel.response,0,0,0,0,0,0,0,0
project-ncl_pnc,org.jboss.pnc.rest.restmodel.response.error,0,0,0,0,0,0,0,0
project-ncl_pnc,org.jboss.pnc.rest.validation.exceptions,0,0,0,0,0,0,0,0
project-ncl_pnc,org.jboss.pnc.rest.validation.exceptions.model,0,0,0,0,0,0,0,0
project-ncl_pnc,org.jboss.pnc.rest.validation.groups,0,0,0,0,0,0,0,0
project-ncl_pnc,org.jboss.pnc.rest.validation.validators,0,0,0,0,0,0,0,0
project-ncl_pnc,org.jboss.pnc.restmodel.serialization,0,0,0,0,0,0,0,0
project-ncl_pnc,org.jboss.pnc.rest.endpoints,0,0,0,0,0,1,0,1
project-ncl_pnc,org.jboss.pnc.rest.endpoints.internal.api,0,0,0,0,0,0,0,0
project-ncl_pnc,org.jboss.pnc.rest.endpoints.internal,0,0,0,0,0,0,0,0
project-ncl_pnc,org.jboss.pnc.rest,0,0,0,0,0,0,0,0
project-ncl_pnc,org.jboss.pnc.spi.builddriver,0,0,0,0,0,0,0,0
project-ncl_pnc,org.jboss.pnc.spi.builddriver.exception,0,0,0,0,0,0,0,0
project-ncl_pnc,org.jboss.pnc.spi,0,0,0,0,0,0,0,0
project-ncl_pnc,org.jboss.pnc.spi.coordinator,0,0,0,0,0,0,0,0
project-ncl_pnc,org.jboss.pnc.spi.coordinator.events,0,0,0,0,0,0,0,0
project-ncl_pnc,org.jboss.pnc.spi.datastore.audit,0,0,0,0,0,0,0,0
project-ncl_pnc,org.jboss.pnc.spi.datastore,0,0,0,0,0,0,0,0
project-ncl_pnc,org.jboss.pnc.spi.datastore.predicates,0,0,0,0,1,0,0,1
project-ncl_pnc,org.jboss.pnc.spi.datastore.repositories.api.impl,0,0,0,0,0,0,0,0
project-ncl_pnc,org.jboss.pnc.spi.datastore.repositories.api,0,0,0,0,1,0,0,1
project-ncl_pnc,org.jboss.pnc.spi.datastore.repositories,0,0,0,0,1,0,0,1
project-ncl_pnc,org.jboss.pnc.spi.environment,0,0,0,0,1,0,0,1
project-ncl_pnc,org.jboss.pnc.spi.environment.exception,0,0,0,0,0,0,0,0
project-ncl_pnc,org.jboss.pnc.spi.events,0,0,0,0,0,0,0,0
project-ncl_pnc,org.jboss.pnc.spi.exception,0,0,0,0,0,0,0,0
project-ncl_pnc,org.jboss.pnc.spi.executor,0,0,0,0,0,0,0,0
project-ncl_pnc,org.jboss.pnc.spi.executor.exceptions,0,0,0,0,0,0,0,0
project-ncl_pnc,org.jboss.pnc.spi.notifications,0,0,0,0,0,0,0,0
project-ncl_pnc,org.jboss.pnc.spi.repositorymanager,0,0,0,0,1,2,0,3
project-ncl_pnc,org.jboss.pnc.spi.repositorymanager.model,0,0,0,0,1,2,0,3
project-ncl_pnc,org.jboss.pnc.spi.repour,0,0,0,0,0,0,0,0
project-ncl_pnc,org.jboss.pnc.termdbuilddriver,0,0,0,0,1,0,0,1
project-ncl_pnc,org.jboss.pnc.termdbuilddriver.transfer,0,0,0,0,0,0,0,0
project-ncl_pnc,org.jboss.pnc.web,0,0,0,0,0,0,0,0
prometheus_jmx_exporter,io.prometheus.jmx,0,0,0,1,1,0,0,2
protostuff_protostuff,io.protostuff,1,1,0,1,0,0,0,3
protostuff_protostuff,io.protostuff.benchmarks,0,0,0,0,1,0,0,1
protostuff_protostuff,io.protostuff.benchmarks.generated,0,0,0,0,0,0,0,0
protostuff_protostuff,org.openjdk.jmh.infra.generated,0,0,0,0,0,0,0,0
protostuff_protostuff,io.protostuff.compiler,0,0,0,0,0,0,0,0
protostuff_protostuff,io.protostuff.compiler.core,0,0,0,0,0,0,0,0
protostuff_protostuff,io.protostuff.compiler.custom,0,0,0,0,0,0,0,0
protostuff_protostuff,io.protostuff.compiler.java_bean,0,0,0,0,0,0,0,0
protostuff_protostuff,io.protostuff.compiler.java_bean_model,0,0,0,0,0,0,0,0
protostuff_protostuff,io.protostuff.compiler.java_bean_primitives,0,0,0,0,0,0,0,0
protostuff_protostuff,core.imports,0,0,0,0,0,0,0,0
protostuff_protostuff,io.protostuff.compiler.it.custom,0,0,0,0,0,0,0,0
protostuff_protostuff,io.protostuff.compiler.it.java_bean,0,0,0,0,1,0,0,1
protostuff_protostuff,io.protostuff.compiler.it.java_bean_model,0,0,0,0,0,0,0,0
protostuff_protostuff,io.protostuff.compiler.it.java_bean_primitives,0,0,0,0,0,0,0,0
protostuff_protostuff,io.protostuff.mojo,0,0,0,0,0,0,0,0
protostuff_protostuff,io.protostuff.parser,0,0,0,1,1,0,0,2
protostuff_protostuff,io.protostuff.runtime,1,0,0,2,0,0,0,3
pschirmacher_webster,webster.decisions,0,0,0,0,1,0,0,1
pschirmacher_webster,webster.links,0,0,0,0,0,0,0,0
pschirmacher_webster,webster.netty,0,0,0,0,0,0,0,0
pschirmacher_webster,webster.requestresponse,0,0,0,0,0,0,0,0
pschirmacher_webster,webster.requestresponse.parsing,0,0,0,0,1,0,0,1
pschirmacher_webster,webster.resource,0,0,0,0,0,0,0,0
pschirmacher_webster,webster.routing,0,0,0,0,1,0,0,1
pschirmacher_webster,webster.spark,0,0,0,0,0,0,0,0
pschirmacher_webster,webster.util,0,0,0,0,0,0,0,0
pschirmacher_webster,webster,0,0,0,0,0,0,0,0
psidnell_ofexport2,org.psidnell.omnifocus,7,1,0,0,1,1,0,10
psidnell_ofexport2,org.psidnell.omnifocus.cli,0,0,0,0,0,0,0,0
psidnell_ofexport2,org.psidnell.omnifocus.expr,4,0,0,0,1,0,0,5
psidnell_ofexport2,org.psidnell.omnifocus.format,0,0,0,0,0,0,0,0
psidnell_ofexport2,org.psidnell.omnifocus.model,7,1,0,0,0,1,0,9
psidnell_ofexport2,org.psidnell.omnifocus.sqlite,2,0,0,0,0,0,0,2
psidnell_ofexport2,org.psidnell.omnifocus.util,0,0,0,0,0,0,0,0
psidnell_ofexport2,org.psidnell.omnifocus.visitor,3,0,0,0,0,1,0,4
psidnell_ofexport2,org.psidnell.omnifocus.filter,0,0,0,0,0,0,0,0
ptgoetz_storm-hdfs,org.apache.storm.hdfs.bolt,0,0,0,0,1,0,0,1
ptgoetz_storm-hdfs,org.apache.storm.hdfs.bolt.format,0,0,0,0,1,0,0,1
ptgoetz_storm-hdfs,org.apache.storm.hdfs.bolt.rotation,0,0,0,0,0,0,0,0
ptgoetz_storm-hdfs,org.apache.storm.hdfs.bolt.sync,0,0,0,0,0,0,0,0
ptgoetz_storm-hdfs,org.apache.storm.hdfs.common.rotation,0,0,0,0,0,0,0,0
ptgoetz_storm-hdfs,org.apache.storm.hdfs.common.security,0,0,0,0,0,0,0,0
ptgoetz_storm-hdfs,org.apache.storm.hdfs.trident.format,0,0,0,0,1,0,0,1
ptgoetz_storm-hdfs,org.apache.storm.hdfs.trident,0,0,0,0,1,0,0,1
ptgoetz_storm-hdfs,org.apache.storm.hdfs.trident.rotation,0,0,0,0,0,0,0,0
ptgoetz_storm-hdfs,org.apache.storm.hdfs.trident.sync,0,0,0,0,0,0,0,0
pulsarIO_realtime-analytics,com.ebay.pulsar.collector.servlet,0,0,0,0,0,0,0,0
pulsarIO_realtime-analytics,com.ebay.pulsar.collector.simulator,0,0,0,0,0,0,0,0
pulsarIO_realtime-analytics,com.ebay.pulsar.collector.udf,0,0,0,0,0,0,0,0
pulsarIO_realtime-analytics,com.ebay.pulsar.collector.validation,0,0,0,0,0,0,0,0
pulsarIO_realtime-analytics,com.ebay.pulsar.collector,0,0,0,0,0,0,0,0
pulsarIO_realtime-analytics,com.ebay.pulsar.metric.core,0,0,0,0,1,0,0,1
pulsarIO_realtime-analytics,com.ebay.pulsar.metric.impl.cassandra,0,0,0,0,0,0,0,0
pulsarIO_realtime-analytics,com.ebay.pulsar.metric.servlet,0,0,0,0,0,0,0,0
pulsarIO_realtime-analytics,com.ebay.pulsar.metric.controller,0,0,0,0,0,0,0,0
pulsarIO_realtime-analytics,com.ebay.pulsar.metric.data,0,0,0,0,0,0,0,0
pulsarIO_realtime-analytics,com.ebay.pulsar.metric.esper.aggregator,0,0,0,0,0,0,0,0
pulsarIO_realtime-analytics,com.ebay.pulsar.metric.processor,0,0,0,0,0,0,0,0
pulsarIO_realtime-analytics,com.ebay.pulsar.metric.server,0,0,0,0,0,0,0,0
pulsarIO_realtime-analytics,com.ebay.pulsar.metric.util,0,0,0,0,0,0,0,0
pulsarIO_realtime-analytics,com.ebay.pulsar.websocket,0,0,0,0,0,0,0,0
pulsarIO_realtime-analytics,com.ebay.pulsar.distributor.epl.func,0,0,0,0,0,0,0,0
pulsarIO_realtime-analytics,com.ebay.pulsar.distributor.replay,0,0,0,0,0,0,0,0
pulsarIO_realtime-analytics,com.ebay.pulsar.metriccalculator.cache,0,0,0,0,0,0,0,0
pulsarIO_realtime-analytics,com.ebay.pulsar.metriccalculator.cassandra,0,0,0,0,0,0,0,0
pulsarIO_realtime-analytics,com.ebay.pulsar.metriccalculator.esper.aggregator,0,0,0,0,0,0,0,0
pulsarIO_realtime-analytics,com.ebay.pulsar.metriccalculator.metric,0,0,0,0,0,0,0,0
pulsarIO_realtime-analytics,com.ebay.pulsar.metriccalculator.offheap.serializer,0,0,0,0,0,0,0,0
pulsarIO_realtime-analytics,com.ebay.pulsar.metriccalculator.processor.configuration,0,0,0,0,0,0,0,0
pulsarIO_realtime-analytics,com.ebay.pulsar.metriccalculator.processor,0,0,0,0,1,0,0,1
pulsarIO_realtime-analytics,com.ebay.pulsar.metriccalculator.replay,0,0,0,0,0,0,0,0
pulsarIO_realtime-analytics,com.ebay.pulsar.metriccalculator.statistics.basic,0,0,0,0,0,0,0,0
pulsarIO_realtime-analytics,com.ebay.pulsar.metriccalculator.util,0,0,0,0,0,0,0,0
pulsarIO_realtime-analytics,com.ebay.pulsar.replay.processor,0,0,0,0,0,0,0,0
pulsarIO_realtime-analytics,com.ebay.pulsar.sessionizer.cache.impl,0,0,0,0,0,0,0,0
pulsarIO_realtime-analytics,com.ebay.pulsar.sessionizer.cache,0,0,0,0,0,0,0,0
pulsarIO_realtime-analytics,com.ebay.pulsar.sessionizer.cluster,0,0,0,0,0,0,0,0
pulsarIO_realtime-analytics,com.ebay.pulsar.sessionizer.config,0,0,0,0,0,0,0,0
pulsarIO_realtime-analytics,com.ebay.pulsar.sessionizer.esper.impl,1,0,0,0,1,0,0,2
pulsarIO_realtime-analytics,com.ebay.pulsar.sessionizer.impl,1,1,0,0,1,0,0,3
pulsarIO_realtime-analytics,com.ebay.pulsar.sessionizer.model,0,0,0,0,0,0,0,0
pulsarIO_realtime-analytics,com.ebay.pulsar.sessionizer.spi,0,0,0,0,0,0,0,0
pulsarIO_realtime-analytics,com.ebay.pulsar.sessionizer.util,0,0,0,0,0,0,0,0
pumadong_cl-privilege,com.cl.privilege.api,0,0,0,0,0,1,0,1
pumadong_cl-privilege,com.cl.privilege.api.impl,0,0,0,0,0,0,0,0
pumadong_cl-privilege,com.cl.privilege.utils,0,0,0,0,1,0,0,1
pumadong_cl-privilege,com.cl.privilege.mapper,0,0,0,0,1,1,0,2
pumadong_cl-privilege,com.cl.privilege.model,0,0,0,0,1,2,0,3
pumadong_cl-privilege,com.cl.privilege.biz,0,0,0,0,0,0,0,0
pumadong_cl-privilege,com.cl.privilege.biz.impl,0,0,0,0,1,1,0,2
pumadong_cl-privilege,com.cl.privilege.controller,0,0,0,0,0,1,0,1
pumadong_cl-privilege,com.cl.privilege.interceptor,0,0,0,0,0,0,0,0
pusher_pusher-http-java,com.pusher.rest.data,0,0,0,0,1,0,0,1
pusher_pusher-http-java,com.pusher.rest.marshaller,0,0,0,0,0,0,0,0
pusher_pusher-http-java,com.pusher.rest,0,0,0,0,1,0,0,1
pusher_pusher-http-java,com.pusher.rest.util,0,0,0,0,0,0,0,0
pusher_pusher-websocket-java,com.pusher.client,4,1,0,0,1,0,1,7
pusher_pusher-websocket-java,com.pusher.client.channel,0,0,0,0,0,0,1,1
pusher_pusher-websocket-java,com.pusher.client.channel.impl,4,0,0,0,0,0,1,5
pusher_pusher-websocket-java,com.pusher.client.connection,0,0,0,0,0,0,1,1
pusher_pusher-websocket-java,com.pusher.client.connection.impl,0,0,0,0,0,0,1,1
pusher_pusher-websocket-java,com.pusher.client.connection.websocket,2,1,0,0,0,0,1,4
pusher_pusher-websocket-java,com.pusher.client.example,0,0,0,0,0,0,1,1
pusher_pusher-websocket-java,com.pusher.client.util,5,1,0,0,1,0,1,8
querydsl_codegen,com.mysema.codegen,0,0,0,1,1,0,0,2
querydsl_codegen,com.mysema.codegen.model,0,0,0,0,1,0,0,1
querydsl_codegen,com.mysema.codegen.support,0,0,0,0,0,0,0,0
querydsl_codegen,(default package),0,0,0,0,0,0,0,0
querydsl_querydsl,com.querydsl.apt,0,0,0,1,1,0,0,2
querydsl_querydsl,com.querydsl.apt.hibernate,0,0,0,0,0,0,0,0
querydsl_querydsl,com.querydsl.apt.jdo,0,0,0,0,0,0,0,0
querydsl_querydsl,com.querydsl.apt.jpa,0,1,0,0,0,0,0,1
querydsl_querydsl,com.querydsl.apt.morphia,0,0,0,0,0,0,0,0
querydsl_querydsl,com.querydsl.apt.roo,0,0,0,0,0,0,0,0
querydsl_querydsl,com.querydsl,0,0,0,0,1,0,0,1
querydsl_querydsl,com.querydsl.eclipse,0,0,0,0,0,0,0,0
querydsl_querydsl,com.querydsl.apt.domain,0,0,0,1,1,1,0,3
querydsl_querydsl,com.querydsl.apt.domain.custom,0,0,0,0,1,0,0,1
querydsl_querydsl,com.querydsl.apt.domain.p1,0,0,0,0,0,0,0,0
querydsl_querydsl,com.querydsl.apt.domain.p10,0,0,0,0,1,0,0,1
querydsl_querydsl,com.querydsl.apt.domain.p2,0,0,0,0,0,0,0,0
querydsl_querydsl,com.querydsl.apt.domain.p3,0,0,0,0,0,0,0,0
querydsl_querydsl,com.querydsl.apt.domain.p4,0,0,0,0,0,0,0,0
querydsl_querydsl,com.querydsl.apt.domain.p6,0,0,0,0,0,0,0,0
querydsl_querydsl,com.querydsl.apt.domain.p7,0,0,0,0,0,0,0,0
querydsl_querydsl,com.querydsl.apt.domain.p8,0,0,0,0,0,0,0,0
querydsl_querydsl,com.querydsl.apt.domain.p9,0,0,0,0,1,1,0,2
querydsl_querydsl,com.querydsl.apt.domain.rel,0,0,0,0,0,0,0,0
querydsl_querydsl,com.querydsl.apt.domain2,0,0,0,0,0,0,0,0
querydsl_querydsl,com.querydsl.apt.inheritance,0,0,0,1,1,1,0,3
querydsl_querydsl,(default package),0,0,0,0,1,0,0,1
querydsl_querydsl,com.querydsl.core.domain,2,0,0,1,1,0,0,4
querydsl_querydsl,com.querydsl.core,4,0,0,1,1,3,0,9
querydsl_querydsl,com.querydsl.core.types,15,1,0,1,1,10,0,28
querydsl_querydsl,ext.java.sql,0,0,0,0,0,0,0,0
querydsl_querydsl,org.hibernate.envers,0,0,0,0,0,0,0,0
querydsl_querydsl,org.joda.money,0,0,0,0,0,0,0,0
querydsl_querydsl,com.querydsl.codegen,0,0,0,1,1,0,0,2
querydsl_querydsl,com.applejuice,0,0,0,0,0,0,0,0
querydsl_querydsl,com.querydsl.codegen.sub,0,0,0,0,0,0,0,0
querydsl_querydsl,com,0,0,0,0,0,0,0,0
querydsl_querydsl,com.suntanning,0,0,0,0,0,0,0,0
querydsl_querydsl,com.querydsl.collections,0,0,0,1,1,2,0,4
querydsl_querydsl,com.querydsl.core.alias,3,0,0,0,1,0,0,4
querydsl_querydsl,com.querydsl.core.dml,0,0,0,0,0,0,0,0
querydsl_querydsl,com.querydsl.core.group,2,0,0,1,1,0,0,4
querydsl_querydsl,com.querydsl.core.support,4,0,0,0,1,6,0,11
querydsl_querydsl,com.querydsl.core.types.dsl,12,1,0,1,1,10,0,25
querydsl_querydsl,com.querydsl.core.util,5,0,0,0,1,0,0,6
querydsl_querydsl,com.querydsl.core.domain.query,0,0,0,0,1,0,0,1
querydsl_querydsl,com.querydsl.core.domain.query2,0,0,0,0,1,0,0,1
querydsl_querydsl,com.querydsl.core.domain.query3,0,0,0,0,1,0,0,1
querydsl_querydsl,com.querydsl.core.domain2,0,0,0,0,1,0,0,1
querydsl_querydsl,com.querydsl.core.serialization,0,0,0,0,0,0,0,0
querydsl_querydsl,com.querydsl.example.jpa.guice,0,0,0,0,0,0,0,0
querydsl_querydsl,com.querydsl.example.jpa.model,0,0,0,0,0,0,0,0
querydsl_querydsl,com.querydsl.example.jpa.repository,0,1,0,0,1,0,0,2
querydsl_querydsl,com.querydsl.example.sql.guice,0,0,0,0,0,0,0,0
querydsl_querydsl,com.querydsl.example.sql.repository,0,0,0,0,0,0,0,0
querydsl_querydsl,com.querydsl.example.config,0,0,0,0,0,0,0,0
querydsl_querydsl,com.querydsl.example.dao,0,0,0,0,1,1,0,2
querydsl_querydsl,com.querydsl.example.dto,0,0,0,0,1,0,0,1
querydsl_querydsl,com.querydsl.hibernate.search,0,0,0,0,1,0,0,1
querydsl_querydsl,com.querydsl.jdo,0,0,0,0,1,0,0,1
querydsl_querydsl,com.querydsl.jdo.dml,0,0,0,0,0,0,0,0
querydsl_querydsl,com.querydsl.jdo.sql,0,0,0,0,0,0,0,0
querydsl_querydsl,com.querydsl.jdo.models.company,0,0,0,1,1,1,0,3
querydsl_querydsl,com.querydsl.jdo.models.fitness,0,0,0,0,1,1,0,2
querydsl_querydsl,com.querydsl.jdo.serialization,0,0,0,0,1,0,0,1
querydsl_querydsl,com.querydsl.jpa,2,0,0,1,1,2,0,6
querydsl_querydsl,com.querydsl.jpa.hibernate,1,1,0,0,1,0,0,3
querydsl_querydsl,com.querydsl.jpa.hibernate.sql,0,0,0,0,0,0,0,0
querydsl_querydsl,com.querydsl.jpa.impl,1,1,0,0,1,0,0,3
querydsl_querydsl,com.querydsl.jpa.sql,0,0,0,0,0,0,0,0
querydsl_querydsl,com.querydsl.jpa.support,0,0,0,0,1,0,0,1
querydsl_querydsl,com.querydsl.jpa.domain,0,0,0,1,1,1,0,3
querydsl_querydsl,com.querydsl.jpa.domain.sql,0,0,0,1,1,0,0,2
querydsl_querydsl,com.querydsl.jpa.domain2,0,0,0,0,1,0,0,1
querydsl_querydsl,com.querydsl.jpa.domain3,0,0,0,0,0,0,0,0
querydsl_querydsl,com.querydsl.jpa.domain4,0,0,0,0,1,0,0,1
querydsl_querydsl,com.querydsl.jpa.domain5,0,0,0,0,1,1,0,2
querydsl_querydsl,com.querydsl.jpa.suites,0,0,0,1,1,0,0,2
querydsl_querydsl,com.querydsl.jpa.codegen,0,0,0,0,1,0,0,1
querydsl_querydsl,com.querydsl.jpa.codegen.ant,0,0,0,0,0,0,0,0
querydsl_querydsl,com.querydsl.lucene3,0,0,0,0,1,0,0,1
querydsl_querydsl,com.querydsl.lucene4,0,0,0,0,1,0,0,1
querydsl_querydsl,com.querydsl.lucene5,0,0,0,0,1,0,0,1
querydsl_querydsl,com.querydsl.maven,0,0,0,0,1,0,0,1
querydsl_querydsl,com.querydsl.mongodb,0,0,0,0,1,0,0,1
querydsl_querydsl,com.querydsl.mongodb.morphia,0,0,0,0,0,0,0,0
querydsl_querydsl,com.querydsl.mongodb.domain,0,0,0,0,0,0,0,0
querydsl_querydsl,com.querydsl.mongodb.domain2,0,0,0,0,0,0,0,0
querydsl_querydsl,com.querydsl.spatial,0,0,0,1,1,0,0,2
querydsl_querydsl,com.querydsl.spatial.hibernate,0,0,0,0,0,0,0,0
querydsl_querydsl,com.querydsl.spatial.jts,0,0,0,1,1,0,0,2
querydsl_querydsl,com.querydsl.sql,3,1,0,1,1,6,0,12
querydsl_querydsl,com.querydsl.sql.dml,2,0,0,0,1,2,0,5
querydsl_querydsl,com.querydsl.sql.mssql,0,0,0,0,1,0,0,1
querydsl_querydsl,com.querydsl.sql.mysql,0,0,0,0,1,0,0,1
querydsl_querydsl,com.querydsl.sql.namemapping,0,0,0,0,0,0,0,0
querydsl_querydsl,com.querydsl.sql.oracle,0,0,0,0,1,0,0,1
querydsl_querydsl,com.querydsl.sql.postgresql,0,0,0,0,0,0,0,0
querydsl_querydsl,com.querydsl.sql.support,0,0,0,0,0,0,0,0
querydsl_querydsl,com.querydsl.sql.teradata,0,0,0,0,0,0,0,0
querydsl_querydsl,com.querydsl.sql.types,0,0,0,1,1,0,0,2
querydsl_querydsl,com.example,0,0,0,0,0,0,0,0
querydsl_querydsl,com.querydsl.sql.ddl,0,0,0,0,1,0,0,1
querydsl_querydsl,com.querydsl.sql.domain,2,1,0,0,1,0,0,4
querydsl_querydsl,com.querydsl.sql.h2,0,0,0,0,0,0,0,0
querydsl_querydsl,com.querydsl.sql.hsqldb,0,0,0,0,0,0,0,0
querydsl_querydsl,com.querydsl.sql.suites,0,0,0,1,1,0,0,2
querydsl_querydsl,com.querydsl.sql.codegen,0,0,0,1,1,0,0,2
querydsl_querydsl,com.querydsl.sql.codegen.ant,0,0,0,0,0,0,0,0
querydsl_querydsl,com.querydsl.sql.codegen.support,0,0,0,0,1,0,0,1
querydsl_querydsl,com.querydsl.sql.spatial,0,0,0,1,1,1,0,3
querydsl_querydsl,com.querydsl.sql.spatial.suites,0,0,0,0,1,1,0,2
querydsl_querydsl,com.querydsl.sql.spring,0,0,0,0,0,0,0,0
rabbitmq_hop,com.rabbitmq.http.client,0,0,0,0,1,0,0,1
rabbitmq_hop,com.rabbitmq.http.client.domain,0,0,0,1,1,0,0,2
radcortez_wow-auctions,com.radcortez.wow.auctions.batch.files,0,0,0,0,0,1,0,1
radcortez_wow-auctions,com.radcortez.wow.auctions.batch.prepare,0,0,0,0,0,1,0,1
radcortez_wow-auctions,com.radcortez.wow.auctions.batch.process,0,0,0,0,0,2,0,2
radcortez_wow-auctions,com.radcortez.wow.auctions.batch.process.data,0,0,0,0,1,0,0,1
radcortez_wow-auctions,com.radcortez.wow.auctions.batch.process.download,0,0,0,0,0,0,0,0
radcortez_wow-auctions,com.radcortez.wow.auctions.batch.process.move,0,0,0,0,0,0,0,0
radcortez_wow-auctions,com.radcortez.wow.auctions.batch.process.purge,0,0,0,0,0,0,0,0
radcortez_wow-auctions,com.radcortez.wow.auctions.batch.process.statistics,0,0,0,0,0,1,0,1
radcortez_wow-auctions,com.radcortez.wow.auctions.business,0,0,0,0,0,3,0,3
radcortez_wow-auctions,com.radcortez.wow.auctions.configuration,0,0,0,0,0,0,0,0
radcortez_wow-auctions,com.radcortez.wow.auctions.entity,0,0,0,0,1,4,0,5
radcortez_wow-auctions,com.radcortez.wow.auctions.servlet,0,0,0,0,0,0,0,0
radcortez_wow-auctions,com.radcortez.wow.auctions.batch.util,0,0,0,0,0,0,0,0
radcortez_wow-auctions,com.radcortez.wow.auctions.batch.business,0,0,0,0,0,0,0,0
radcortez_wow-auctions,com.radcortez.wow.auctions.batch,0,0,0,0,0,0,0,0
radkovo_jStyleParser,cz.vutbr.web.css,1,1,0,1,0,2,0,5
radkovo_jStyleParser,cz.vutbr.web.csskit,1,0,0,1,0,2,0,4
radkovo_jStyleParser,cz.vutbr.web.csskit.antlr4,1,0,0,1,0,0,0,2
radkovo_jStyleParser,cz.vutbr.web.csskit.fn,1,1,0,1,1,1,0,5
radkovo_jStyleParser,cz.vutbr.web.domassign,0,1,0,1,0,1,0,3
radkovo_jStyleParser,org.fit.net,0,0,0,0,0,0,0,0
rancherio_cattle,io.cattle.platform.api.action,0,0,0,0,0,0,1,1
rancherio_cattle,io.cattle.platform.api.auth,0,0,0,0,0,2,1,3
rancherio_cattle,io.cattle.platform.api.auth.impl,0,0,0,0,0,1,1,2
rancherio_cattle,io.cattle.platform.api.formatter,0,0,0,0,0,0,1,1
rancherio_cattle,io.cattle.platform.api.handler,0,0,0,0,0,0,1,1
rancherio_cattle,io.cattle.platform.api.html,0,0,0,0,0,0,1,1
rancherio_cattle,io.cattle.platform.api.link,0,0,0,0,0,0,1,1
rancherio_cattle,io.cattle.platform.api.parser,0,0,0,0,0,0,1,1
rancherio_cattle,io.cattle.platform.api.proxy,0,0,0,0,0,0,1,1
rancherio_cattle,io.cattle.platform.api.resource,0,0,0,0,0,1,1,2
rancherio_cattle,io.cattle.platform.api.resource.jooq,0,0,0,0,0,0,1,1
rancherio_cattle,io.cattle.platform.api.schema,0,0,0,0,0,1,1,2
rancherio_cattle,io.cattle.platform.api.servlet,0,0,0,0,0,0,1,1
rancherio_cattle,io.cattle.platform.api.utils,0,1,0,0,0,1,1,3
rancherio_cattle,io.cattle.platform.iaas.api.infrastructure,0,0,0,0,0,0,1,1
rancherio_cattle,io.cattle.platform.api.pubsub.manager,0,0,0,0,0,0,1,1
rancherio_cattle,io.cattle.platform.api.pubsub.model,0,0,0,0,0,0,1,1
rancherio_cattle,io.cattle.platform.api.pubsub.subscribe,0,0,0,0,0,0,1,1
rancherio_cattle,io.cattle.platform.api.pubsub.util,0,0,0,0,0,0,1,1
rancherio_cattle,io.cattle.platform.api.pubsub.subscribe.jetty,0,0,0,0,0,0,1,1
rancherio_cattle,io.cattle.platform.archaius.polling,0,0,0,0,0,0,1,1
rancherio_cattle,io.cattle.platform.archaius.sources,0,0,0,0,1,0,1,2
rancherio_cattle,io.cattle.platform.archaius.util,0,0,0,0,0,0,1,1
rancherio_cattle,io.cattle.platform.async.retry,0,0,0,0,0,0,1,1
rancherio_cattle,io.cattle.platform.async.retry.impl,0,0,0,0,0,0,1,1
rancherio_cattle,io.cattle.platform.async.utils,0,0,0,0,0,0,1,1
rancherio_cattle,io.cattle.platform.iaas.api.auditing,0,0,0,0,1,0,1,2
rancherio_cattle,io.cattle.platform.iaas.api.auditing.dao,0,0,0,0,0,0,1,1
rancherio_cattle,io.cattle.platform.iaas.api.auditing.dao.impl,0,0,0,0,0,0,1,1
rancherio_cattle,io.cattle.platform.datasource,0,0,0,0,0,0,1,1
rancherio_cattle,io.cattle.platform.liquibase,0,0,0,0,0,0,1,1
rancherio_cattle,io.cattle.platform.deferred.context,0,0,0,0,0,0,1,1
rancherio_cattle,io.cattle.platform.deferred.util,0,0,0,0,0,0,1,1
rancherio_cattle,io.cattle.platform.framework.encryption,0,0,0,0,0,0,1,1
rancherio_cattle,io.cattle.platform.framework.encryption.handler.impl,1,0,0,0,0,0,1,2
rancherio_cattle,io.cattle.platform.framework.encryption.impl,1,1,0,0,0,1,1,4
rancherio_cattle,io.cattle.platform.framework.encryption.request.handler,0,0,0,0,0,0,1,1
rancherio_cattle,io.cattle.platform.framework.secret,0,0,0,0,0,0,1,1
rancherio_cattle,io.cattle.platform.engine.context,0,0,0,0,0,0,1,1
rancherio_cattle,io.cattle.platform.engine.eventing,0,0,0,0,0,0,1,1
rancherio_cattle,io.cattle.platform.engine.eventing.impl,0,0,0,0,0,0,1,1
rancherio_cattle,io.cattle.platform.engine.handler,0,0,0,0,1,1,1,3
rancherio_cattle,io.cattle.platform.engine.idempotent,0,0,0,0,0,0,1,1
rancherio_cattle,io.cattle.platform.engine.manager.impl,0,0,0,0,0,0,1,1
rancherio_cattle,io.cattle.platform.engine.manager,0,0,0,0,0,0,1,1
rancherio_cattle,io.cattle.platform.engine.process,0,0,0,0,1,3,1,5
rancherio_cattle,io.cattle.platform.engine.process.impl,0,0,0,0,1,0,1,2
rancherio_cattle,io.cattle.platform.engine.process.log,0,0,0,0,1,0,1,2
rancherio_cattle,io.cattle.platform.engine.process.util,0,0,0,0,0,0,1,1
rancherio_cattle,io.cattle.platform.engine.server.impl,0,0,0,0,0,0,1,1
rancherio_cattle,io.cattle.platform.engine.server,0,0,0,0,0,0,1,1
rancherio_cattle,io.cattle.platform.eventing.annotation,0,0,0,0,0,0,1,1
rancherio_cattle,io.cattle.platform.eventing,0,0,0,0,1,3,1,5
rancherio_cattle,io.cattle.platform.eventing.exception,0,0,0,0,0,0,1,1
rancherio_cattle,io.cattle.platform.eventing.impl,0,0,0,0,0,0,1,1
rancherio_cattle,io.cattle.platform.eventing.lock,0,0,0,0,0,0,1,1
rancherio_cattle,io.cattle.platform.eventing.memory,0,0,0,0,0,0,1,1
rancherio_cattle,io.cattle.platform.eventing.model,0,0,0,0,0,4,1,5
rancherio_cattle,io.cattle.platform.eventing.util,0,0,0,0,0,1,1,2
rancherio_cattle,io.cattle.platform.framework.event.data,0,0,0,0,0,1,1,2
rancherio_cattle,io.cattle.platform.framework.event,0,0,0,0,0,1,1,2
rancherio_cattle,io.cattle.platform.extension,0,0,0,0,0,0,1,1
rancherio_cattle,io.cattle.platform.extension.impl,0,0,0,0,1,0,1,2
rancherio_cattle,io.cattle.platform.extension.spring,0,0,0,0,0,0,1,1
rancherio_cattle,io.github.ibuildthecloud.gdapi.condition,0,0,0,0,0,0,1,1
rancherio_cattle,io.github.ibuildthecloud.gdapi.context,1,1,0,0,0,6,1,9
rancherio_cattle,io.github.ibuildthecloud.gdapi.doc,0,0,0,0,0,0,1,1
rancherio_cattle,io.github.ibuildthecloud.gdapi.doc.handler,0,0,0,0,0,0,1,1
rancherio_cattle,io.github.ibuildthecloud.gdapi.exception,0,1,0,0,0,1,1,3
rancherio_cattle,io.github.ibuildthecloud.gdapi.factory.impl,0,0,0,0,1,2,1,4
rancherio_cattle,io.github.ibuildthecloud.gdapi.factory,0,0,0,0,0,3,1,4
rancherio_cattle,io.github.ibuildthecloud.gdapi.id,0,0,0,0,0,2,1,3
rancherio_cattle,io.github.ibuildthecloud.gdapi.json,0,0,0,0,1,0,1,2
rancherio_cattle,io.github.ibuildthecloud.gdapi.model,0,0,0,0,1,6,1,8
rancherio_cattle,io.github.ibuildthecloud.gdapi.model.impl,0,0,0,0,1,2,1,4
rancherio_cattle,io.github.ibuildthecloud.gdapi.request,0,0,0,0,0,6,1,7
rancherio_cattle,io.github.ibuildthecloud.gdapi.request.handler,0,0,0,0,1,0,1,2
rancherio_cattle,io.github.ibuildthecloud.gdapi.request.handler.write,0,0,0,0,0,0,1,1
rancherio_cattle,io.github.ibuildthecloud.gdapi.request.parser,0,0,0,0,0,0,1,1
rancherio_cattle,io.github.ibuildthecloud.gdapi.request.resource,0,0,0,0,0,0,1,1
rancherio_cattle,io.github.ibuildthecloud.gdapi.request.resource.impl,0,0,0,0,0,2,1,3
rancherio_cattle,io.github.ibuildthecloud.gdapi.response,0,0,0,0,1,0,1,2
rancherio_cattle,io.github.ibuildthecloud.gdapi.response.impl,0,0,0,0,0,0,1,1
rancherio_cattle,io.github.ibuildthecloud.gdapi.server.model,0,0,0,0,0,0,1,1
rancherio_cattle,io.github.ibuildthecloud.gdapi.servlet,0,0,0,0,0,0,1,1
rancherio_cattle,io.github.ibuildthecloud.gdapi.url,1,0,0,0,0,3,1,5
rancherio_cattle,io.github.ibuildthecloud.gdapi.util,0,0,0,0,1,1,1,3
rancherio_cattle,io.github.ibuildthecloud.gdapi.validation,0,1,0,0,1,1,1,4
rancherio_cattle,io.github.ibuildthecloud.gdapi.version,0,0,0,0,0,0,1,1
rancherio_cattle,io.cattle.platform.jmx,0,0,0,0,0,0,1,1
rancherio_cattle,io.cattle.platform.db.jooq.config,0,0,0,0,0,0,1,1
rancherio_cattle,io.cattle.platform.db.jooq.converter,0,0,0,0,0,0,1,1
rancherio_cattle,io.cattle.platform.db.jooq.converter.impl,0,0,0,0,0,0,1,1
rancherio_cattle,io.cattle.platform.db.jooq.dao.impl,0,0,0,0,0,0,1,1
rancherio_cattle,io.cattle.platform.db.jooq.generator,0,0,0,0,0,0,1,1
rancherio_cattle,io.cattle.platform.db.jooq.logging,0,0,0,0,0,0,1,1
rancherio_cattle,io.cattle.platform.db.jooq.mapper,0,0,0,0,0,0,1,1
rancherio_cattle,io.cattle.platform.db.jooq.utils,0,0,0,0,0,0,1,1
rancherio_cattle,io.cattle.platform.json,0,0,0,0,0,0,1,1
rancherio_cattle,io.cattle.platform.launcher.jetty,0,0,0,0,0,0,1,1
rancherio_cattle,io.cattle.platform.launcher,0,0,0,0,0,0,1,1
rancherio_cattle,io.cattle.platform.launcher.url,0,0,0,0,0,0,1,1
rancherio_cattle,io.cattle.platform.lock.definition,0,0,0,0,0,0,1,1
rancherio_cattle,io.cattle.platform.lock.exception,0,0,0,0,0,0,1,1
rancherio_cattle,io.cattle.platform.lock.impl,0,0,0,0,1,0,1,2
rancherio_cattle,io.cattle.platform.lock,0,0,0,0,1,0,1,2
rancherio_cattle,io.cattle.platform.lock.provider.impl,0,0,0,0,0,0,1,1
rancherio_cattle,io.cattle.platform.lock.provider,0,0,0,0,0,0,1,1
rancherio_cattle,io.cattle.platform.lock.util,0,0,0,0,0,0,1,1
rancherio_cattle,io.cattle.platform.logback,0,0,0,0,0,0,1,1
rancherio_cattle,org.apache.cloudstack.managed.context,0,0,0,0,1,0,1,2
rancherio_cattle,org.apache.cloudstack.managed.context.impl,0,0,0,0,0,0,1,1
rancherio_cattle,org.apache.cloudstack.managed.threadlocal,0,0,0,0,0,0,1,1
rancherio_cattle,io.cattle.platform.metrics.util,0,0,0,0,0,0,1,1
rancherio_cattle,io.cattle.platform.spring.web,0,0,0,0,0,0,1,1
rancherio_cattle,io.cattle.platform.object.defaults,0,0,0,0,0,0,1,1
rancherio_cattle,io.cattle.platform.object.impl,0,0,0,0,1,0,1,2
rancherio_cattle,io.cattle.platform.object.jooq.utils,0,0,0,0,0,0,1,1
rancherio_cattle,io.cattle.platform.object.lifecycle,0,0,0,0,0,0,1,1
rancherio_cattle,io.cattle.platform.object.meta,0,0,0,0,0,0,1,1
rancherio_cattle,io.cattle.platform.object.meta.impl,0,0,0,0,0,0,1,1
rancherio_cattle,io.cattle.platform.object,0,0,0,0,0,3,1,4
rancherio_cattle,io.cattle.platform.object.postinit,0,0,0,0,0,0,1,1
rancherio_cattle,io.cattle.platform.object.process.impl,0,0,0,0,0,0,1,1
rancherio_cattle,io.cattle.platform.object.process,0,0,0,0,0,1,1,2
rancherio_cattle,io.cattle.platform.object.purge.impl,0,0,0,0,0,0,1,1
rancherio_cattle,io.cattle.platform.object.purge,0,0,0,0,0,0,1,1
rancherio_cattle,io.cattle.platform.object.serialization.impl,0,0,0,0,0,0,1,1
rancherio_cattle,io.cattle.platform.object.serialization,0,0,0,0,0,0,1,1
rancherio_cattle,io.cattle.platform.object.util,0,1,0,0,1,5,1,8
rancherio_cattle,io.cattle.platform.pool,0,0,0,0,0,0,1,1
rancherio_cattle,io.cattle.platform.object.monitor.impl,0,0,0,0,0,0,1,1
rancherio_cattle,io.cattle.platform.object.resource,0,0,0,0,0,0,1,1
rancherio_cattle,io.cattle.platform.schema.doc,0,0,0,0,0,0,1,1
rancherio_cattle,io.cattle.platform.schema.processor,0,0,0,0,1,0,1,2
rancherio_cattle,io.cattle.platform.server.context,0,0,0,0,0,0,1,1
rancherio_cattle,io.cattle.platform.spring.resource,0,0,0,0,0,0,1,1
rancherio_cattle,io.cattle.platform.task,0,0,0,0,0,0,1,1
rancherio_cattle,io.cattle.platform.task.dao,0,0,0,0,0,0,1,1
rancherio_cattle,io.cattle.platform.task.eventing.impl,0,0,0,0,0,0,1,1
rancherio_cattle,io.cattle.platform.task.eventing,0,0,0,0,0,0,1,1
rancherio_cattle,io.cattle.platform.task.impl,0,0,0,0,0,0,1,1
rancherio_cattle,io.cattle.platform.token,0,0,0,0,0,0,1,1
rancherio_cattle,io.cattle.platform.token.impl,0,0,0,0,0,0,1,1
rancherio_cattle,io.cattle.platform.util.concurrent,0,0,0,0,0,0,1,1
rancherio_cattle,io.cattle.platform.util.exception,0,0,0,0,1,0,1,2
rancherio_cattle,io.cattle.platform.util.lifecycle,0,0,0,0,0,0,1,1
rancherio_cattle,io.cattle.platform.util.net,0,0,0,0,0,0,1,1
rancherio_cattle,io.cattle.platform.util.resource,0,0,0,0,0,0,1,1
rancherio_cattle,io.cattle.platform.util.time,0,0,0,0,0,0,1,1
rancherio_cattle,io.cattle.platform.util.type,0,0,0,0,1,1,1,3
rancherio_cattle,io.cattle.platform.agent,0,0,0,0,0,0,1,1
rancherio_cattle,io.cattle.platform.agent.impl,0,0,0,0,0,0,1,1
rancherio_cattle,io.cattle.platform.agent.util,0,0,0,0,0,0,1,1
rancherio_cattle,io.cattle.platform.agent.instance.dao,0,0,0,0,0,0,1,1
rancherio_cattle,io.cattle.platform.agent.instance.dao.impl,0,0,0,0,0,0,1,1
rancherio_cattle,io.cattle.platform.agent.instance.factory,0,0,0,0,0,0,1,1
rancherio_cattle,io.cattle.platform.agent.instance.factory.impl,0,0,0,0,0,0,1,1
rancherio_cattle,io.cattle.platform.agent.instance.factory.lock,0,0,0,0,0,0,1,1
rancherio_cattle,io.cattle.platform.agent.instance.process,0,0,0,0,0,0,1,1
rancherio_cattle,io.cattle.platform.agent.instance.serialization,0,0,0,0,0,0,1,1
rancherio_cattle,io.cattle.platform.agent.instance.service,0,0,0,0,0,0,1,1
rancherio_cattle,io.cattle.platform.agent.server.lock,0,0,0,0,0,0,1,1
rancherio_cattle,io.cattle.platform.agent.server.ping.dao.impl,0,0,0,0,0,0,1,1
rancherio_cattle,io.cattle.platform.agent.server.ping.dao,0,0,0,0,0,0,1,1
rancherio_cattle,io.cattle.platform.agent.server.ping.impl,0,0,0,0,0,0,1,1
rancherio_cattle,io.cattle.platform.agent.server.ping,0,0,0,0,0,0,1,1
rancherio_cattle,io.cattle.platform.agent.server.resource.impl,0,0,0,0,0,0,1,1
rancherio_cattle,io.cattle.platform.agent.server.util,0,0,0,0,0,0,1,1
rancherio_cattle,io.cattle.platform.allocator.constraint,0,0,0,0,1,2,1,4
rancherio_cattle,io.cattle.platform.allocator.dao,0,0,0,0,0,1,1,2
rancherio_cattle,io.cattle.platform.allocator.dao.impl,0,0,0,0,0,0,1,1
rancherio_cattle,io.cattle.platform.allocator.exception,0,0,0,0,0,0,1,1
rancherio_cattle,io.cattle.platform.allocator.lock,0,0,0,0,0,0,1,1
rancherio_cattle,io.cattle.platform.allocator.service,0,0,0,0,1,2,1,4
rancherio_cattle,io.cattle.platform.allocator.service.impl,0,0,0,0,0,0,1,1
rancherio_cattle,io.cattle.platform.allocator.util,0,0,0,0,0,0,1,1
rancherio_cattle,io.cattle.platform.iaas.api.account,0,0,0,0,0,0,1,1
rancherio_cattle,io.cattle.platform.iaas.api.change.impl,0,0,0,0,0,0,1,1
rancherio_cattle,io.cattle.platform.iaas.api.change,0,0,0,0,0,0,1,1
rancherio_cattle,io.cattle.platform.iaas.api.credential,0,0,0,0,0,1,1,2
rancherio_cattle,io.cattle.platform.iaas.api.filter.account,0,0,0,0,0,0,1,1
rancherio_cattle,io.cattle.platform.iaas.api.filter.agent,0,0,0,0,0,0,1,1
rancherio_cattle,io.cattle.platform.iaas.api.filter.apikey,0,0,0,0,0,0,1,1
rancherio_cattle,io.cattle.platform.iaas.api.filter.common,0,0,0,0,0,0,1,1
rancherio_cattle,io.cattle.platform.iaas.api.filter.compat,0,0,0,0,0,0,1,1
rancherio_cattle,io.cattle.platform.iaas.api.filter.containerevent,0,0,0,0,0,0,1,1
rancherio_cattle,io.cattle.platform.iaas.api.filter.dynamic.schema,0,0,0,0,0,0,1,1
rancherio_cattle,io.cattle.platform.iaas.api.filter.externalevent,0,0,0,0,0,0,1,1
rancherio_cattle,io.cattle.platform.iaas.api.filter.hosts,0,0,0,0,0,0,1,1
rancherio_cattle,io.cattle.platform.iaas.api.filter.instance,0,0,0,0,0,0,1,1
rancherio_cattle,io.cattle.platform.iaas.api.filter.machinedriver,0,0,0,0,0,0,1,1
rancherio_cattle,io.cattle.platform.iaas.api.filter.registry,0,0,0,0,0,0,1,1
rancherio_cattle,io.cattle.platform.iaas.api.filter.secret,0,0,0,0,0,0,1,1
rancherio_cattle,io.cattle.platform.iaas.api.filter.service,0,0,0,0,0,0,1,1
rancherio_cattle,io.cattle.platform.iaas.api.filter.serviceevent,0,0,0,0,0,0,1,1
rancherio_cattle,io.cattle.platform.iaas.api.filter.snapshot,0,0,0,0,0,0,1,1
rancherio_cattle,io.cattle.platform.iaas.api.filter.ssl,0,0,0,0,0,0,1,1
rancherio_cattle,io.cattle.platform.iaas.api.filter.stack,0,0,0,0,0,0,1,1
rancherio_cattle,io.cattle.platform.iaas.api.filter.storagepool,0,0,0,0,0,0,1,1
rancherio_cattle,io.cattle.platform.iaas.api.filter.volume,0,0,0,0,0,0,1,1
rancherio_cattle,io.cattle.platform.iaas.api.host,0,0,0,0,0,0,1,1
rancherio_cattle,io.cattle.platform.iaas.api.manager,0,0,0,0,1,1,1,3
rancherio_cattle,io.cattle.platform.iaas.api.object.postinit,0,0,0,0,0,0,1,1
rancherio_cattle,io.cattle.platform.iaas.api.process,0,0,0,0,0,0,1,1
rancherio_cattle,io.cattle.platform.iaas.api.request.handler,1,0,0,0,1,0,1,3
rancherio_cattle,io.cattle.platform.iaas.api.servlet.filter,1,1,0,0,0,0,1,3
rancherio_cattle,io.cattle.platform.iaas.api.snapshot,0,0,0,0,0,0,1,1
rancherio_cattle,io.cattle.platform.iaas.api.user.preference,0,0,0,0,0,0,1,1
rancherio_cattle,io.cattle.platform.iaas.api.volume,0,0,0,0,0,0,1,1
rancherio_cattle,io.cattle.platform.archaius.eventing,0,0,0,0,0,0,1,1
rancherio_cattle,io.cattle.platform.archaius.eventing.impl,0,0,0,0,0,0,1,1
rancherio_cattle,io.cattle.platform.archaius.startup,0,0,0,0,0,0,1,1
rancherio_cattle,io.cattle.platform.iaas.api.auth,4,1,0,0,0,1,1,7
rancherio_cattle,io.cattle.platform.iaas.api.auth.dao,0,0,0,0,0,2,1,3
rancherio_cattle,io.cattle.platform.iaas.api.auth.dao.impl,0,0,0,0,0,0,1,1
rancherio_cattle,io.cattle.platform.iaas.api.auth.dynamic,0,0,0,0,0,0,1,1
rancherio_cattle,io.cattle.platform.iaas.api.auth.identity,0,0,0,0,0,0,1,1
rancherio_cattle,io.cattle.platform.iaas.api.auth.impl,0,0,0,0,0,2,1,3
rancherio_cattle,io.cattle.platform.iaas.api.auth.integration.azure,1,0,0,0,1,0,1,3
rancherio_cattle,io.cattle.platform.iaas.api.auth.integration.external,0,0,0,0,0,0,1,1
rancherio_cattle,io.cattle.platform.iaas.api.auth.integration,0,0,0,0,0,0,1,1
rancherio_cattle,io.cattle.platform.iaas.api.auth.integration.interfaces,0,0,0,0,0,0,1,1
rancherio_cattle,io.cattle.platform.iaas.api.auth.integration.internal.rancher,0,0,0,0,0,1,1,2
rancherio_cattle,io.cattle.platform.iaas.api.auth.integration.ldap.interfaces,0,0,0,0,0,0,1,1
rancherio_cattle,io.cattle.platform.iaas.api.auth.integration.ldap,1,0,0,0,0,0,1,2
rancherio_cattle,io.cattle.platform.iaas.api.auth.integration.ldap.OpenLDAP,2,0,0,0,1,0,1,4
rancherio_cattle,io.cattle.platform.iaas.api.auth.integration.local,1,0,0,0,1,0,1,3
rancherio_cattle,io.cattle.platform.iaas.api.auth.projects,0,0,0,0,0,0,1,1
rancherio_cattle,io.cattle.platform.bootstrap.script,0,0,0,0,0,0,1,1
rancherio_cattle,io.cattle.platform.configitem.api.manager,0,0,0,0,0,0,1,1
rancherio_cattle,io.cattle.platform.configitem.api.model,0,0,0,0,0,0,1,1
rancherio_cattle,io.cattle.platform.configitem.api.request,0,0,0,0,0,0,1,1
rancherio_cattle,io.cattle.platform.configitem.events,0,0,0,0,0,0,1,1
rancherio_cattle,io.cattle.platform.configitem.exception,0,0,0,0,0,0,1,1
rancherio_cattle,io.cattle.platform.configitem.model,0,0,0,0,0,2,1,3
rancherio_cattle,io.cattle.platform.configitem.request,0,0,0,0,0,0,1,1
rancherio_cattle,io.cattle.platform.configitem.request.util,0,0,0,0,0,1,1,2
rancherio_cattle,io.cattle.platform.configitem.spring,0,0,0,0,0,0,1,1
rancherio_cattle,io.cattle.platform.configitem.version,0,0,0,0,0,1,1,2
rancherio_cattle,io.cattle.platform.configitem.version.dao,0,0,0,0,0,0,1,1
rancherio_cattle,io.cattle.platform.configitem.version.dao.impl,0,0,0,0,0,0,1,1
rancherio_cattle,io.cattle.platform.configitem.version.impl,0,0,0,0,0,0,1,1
rancherio_cattle,io.cattle.platform.configitem.context,0,0,0,0,0,0,1,1
rancherio_cattle,io.cattle.platform.configitem.context.dao.impl,0,0,0,0,0,0,1,1
rancherio_cattle,io.cattle.platform.configitem.context.dao,0,0,0,0,0,0,1,1
rancherio_cattle,io.cattle.platform.configitem.context.data.metadata.common,0,0,0,0,1,1,1,3
rancherio_cattle,io.cattle.platform.configitem.context.impl,0,0,0,0,1,0,1,2
rancherio_cattle,io.cattle.platform.configitem.freemarker,0,0,0,0,0,0,1,1
rancherio_cattle,io.cattle.platform.configitem.registry,0,0,0,0,0,0,1,1
rancherio_cattle,io.cattle.platform.configitem.registry.impl,0,0,0,0,0,0,1,1
rancherio_cattle,io.cattle.platform.configitem.server.agentinclude,0,0,0,0,0,0,1,1
rancherio_cattle,io.cattle.platform.configitem.server.agentinclude.impl,0,0,0,0,0,0,1,1
rancherio_cattle,io.cattle.platform.configitem.server.impl,0,0,0,0,0,1,1,2
rancherio_cattle,io.cattle.platform.configitem.server.model,0,0,0,0,0,0,1,1
rancherio_cattle,io.cattle.platform.configitem.server.model.impl,1,1,0,0,1,0,1,4
rancherio_cattle,io.cattle.platform.configitem.server.model.util,1,1,0,0,0,0,1,3
rancherio_cattle,io.cattle.platform.configitem.server.resource,0,0,0,0,0,0,1,1
rancherio_cattle,io.cattle.platform.configitem.server.service,0,0,0,0,0,0,1,1
rancherio_cattle,io.cattle.platform.configitem.server.task,0,0,0,0,0,0,1,1
rancherio_cattle,io.cattle.platform.configitem.server.template.impl,0,0,0,0,1,0,1,2
rancherio_cattle,io.cattle.platform.configitem.server.template,0,0,0,0,0,0,1,1
rancherio_cattle,org.apache.cloudstack.configitem.server.impl,0,0,0,0,0,1,1,2
rancherio_cattle,org.apache.cloudstack.configitem.server.model.impl,0,0,0,0,0,0,1,1
rancherio_cattle,io.cattle.platform.engine.manager.impl.jooq,0,0,0,0,0,0,1,1
rancherio_cattle,io.cattle.platform.iaas.event.delegate,0,0,0,0,0,0,1,1
rancherio_cattle,io.cattle.platform.iaas.event,0,1,0,0,0,0,1,2
rancherio_cattle,io.cattle.platform.extension.dynamic.api.addon,0,0,0,0,0,0,1,1
rancherio_cattle,io.cattle.platform.extension.dynamic.dao,0,0,0,0,0,0,1,1
rancherio_cattle,io.cattle.platform.extension.dynamic.dao.impl,0,0,0,0,0,0,1,1
rancherio_cattle,io.cattle.platform.extension.dynamic.data,0,0,0,0,0,0,1,1
rancherio_cattle,io.cattle.platform.extension.dynamic,0,0,0,0,0,0,1,1
rancherio_cattle,io.cattle.platform.extension.dynamic.impl,0,0,0,0,0,0,1,1
rancherio_cattle,io.cattle.platform.extension.dynamic.process,0,0,0,0,0,0,1,1
rancherio_cattle,io.cattle.platform.ha.monitor.dao.impl,0,0,0,0,0,0,1,1
rancherio_cattle,io.cattle.platform.ha.monitor.dao,0,0,0,0,0,0,1,1
rancherio_cattle,io.cattle.platform.ha.monitor.event,0,0,0,0,0,0,1,1
rancherio_cattle,io.cattle.platform.ha.monitor.impl,0,0,0,0,1,0,1,2
rancherio_cattle,io.cattle.platform.ha.monitor.model,0,0,0,0,0,0,1,1
rancherio_cattle,io.cattle.platform.ha.monitor,0,0,0,0,0,0,1,1
rancherio_cattle,io.cattle.iaas.healthcheck.process,0,0,0,0,1,0,1,2
rancherio_cattle,io.cattle.iaas.healthcheck.service,0,0,0,0,0,0,1,1
rancherio_cattle,io.cattle.iaas.healthcheck.service.impl,0,0,0,0,1,0,1,2
rancherio_cattle,io.cattle.iaas.labels.service.impl,0,0,0,0,0,0,1,1
rancherio_cattle,io.cattle.iaas.labels.service,0,0,0,0,0,0,1,1
rancherio_cattle,io.cattle.platform.process.account,0,0,0,0,0,0,1,1
rancherio_cattle,io.cattle.platform.process.agent,0,0,0,0,1,0,1,2
rancherio_cattle,io.cattle.platform.process.base,0,0,0,0,0,0,1,1
rancherio_cattle,io.cattle.platform.process.cache,0,0,0,0,0,1,1,2
rancherio_cattle,io.cattle.platform.process.containerevent,0,0,0,0,0,0,1,1
rancherio_cattle,io.cattle.platform.process.credential,0,0,0,0,0,0,1,1
rancherio_cattle,io.cattle.platform.process.driver,0,0,0,0,1,1,1,3
rancherio_cattle,io.cattle.platform.process.dynamicSchema,0,0,0,0,0,0,1,1
rancherio_cattle,io.cattle.platform.process.externalevent,0,0,0,0,0,0,1,1
rancherio_cattle,io.cattle.platform.process.generic,0,0,0,0,0,0,1,1
rancherio_cattle,io.cattle.platform.process.host,0,0,0,0,0,0,1,1
rancherio_cattle,io.cattle.platform.process.hosttemplate,0,0,0,0,0,0,1,1
rancherio_cattle,io.cattle.platform.process.image,0,0,0,0,0,0,1,1
rancherio_cattle,io.cattle.platform.process.instance,0,0,0,0,1,1,1,3
rancherio_cattle,io.cattle.platform.process.ipaddress,0,0,0,0,0,0,1,1
rancherio_cattle,io.cattle.platform.process.link,0,0,0,0,0,0,1,1
rancherio_cattle,io.cattle.platform.process.lock,0,0,0,0,1,0,1,2
rancherio_cattle,io.cattle.platform.process.metadata,0,0,0,0,0,0,1,1
rancherio_cattle,io.cattle.platform.process.mount,0,0,0,0,0,0,1,1
rancherio_cattle,io.cattle.platform.process.network,0,0,0,0,1,0,1,2
rancherio_cattle,io.cattle.platform.process.nic,0,0,0,0,0,0,1,1
rancherio_cattle,io.cattle.platform.process.port,0,0,0,0,0,0,1,1
rancherio_cattle,io.cattle.platform.process.secret,0,0,0,0,0,0,1,1
rancherio_cattle,io.cattle.platform.process.stack,0,0,0,0,0,0,1,1
rancherio_cattle,io.cattle.platform.process.storagepool,0,0,0,0,0,0,1,1
rancherio_cattle,io.cattle.platform.process.subnet,0,0,0,0,0,0,1,1
rancherio_cattle,io.cattle.platform.process.util,0,0,0,0,0,0,1,1
rancherio_cattle,io.cattle.platform.process.volume,0,0,0,0,1,0,1,2
rancherio_cattle,io.cattle.platform.network.impl,0,0,0,0,0,0,1,1
rancherio_cattle,io.cattle.platform.network,0,0,0,0,0,0,1,1
rancherio_cattle,io.cattle.platform.process.common.generic,0,0,0,0,0,0,1,1
rancherio_cattle,io.cattle.platform.process.common.handler,0,0,0,0,1,0,1,2
rancherio_cattle,io.cattle.platform.process.common.lock,0,0,0,0,0,0,1,1
rancherio_cattle,io.cattle.platform.process.common.spring,0,0,0,0,0,0,1,1
rancherio_cattle,io.cattle.platform.process.common.util,0,0,0,0,0,0,1,1
rancherio_cattle,io.cattle.platform.process.monitor,0,0,0,0,0,0,1,1
rancherio_cattle,io.cattle.platform.process.progress,0,0,0,0,0,0,1,1
rancherio_cattle,io.cattle.platform.service.account,0,0,0,0,0,0,1,1
rancherio_cattle,io.cattle.platform.service.launcher,0,0,0,0,0,0,1,1
rancherio_cattle,io.cattle.platform.metadata.dao.impl,0,0,0,0,0,0,1,1
rancherio_cattle,io.cattle.platform.metadata.dao,0,0,0,0,0,0,1,1
rancherio_cattle,io.cattle.platform.metadata.data,0,0,0,0,0,0,1,1
rancherio_cattle,io.cattle.platform.metadata.service.impl,0,0,0,0,0,1,1,2
rancherio_cattle,io.cattle.platform.metadata.service,0,0,0,0,0,0,1,1
rancherio_cattle,io.cattle.platform.core.addon,0,0,0,1,1,1,1,4
rancherio_cattle,io.cattle.platform.core.cache,0,0,0,0,0,1,1,2
rancherio_cattle,io.cattle.platform.core.cleanup,0,0,0,0,0,0,1,1
rancherio_cattle,io.cattle.platform.core.constants,0,1,0,1,1,1,1,5
rancherio_cattle,io.cattle.platform.core.dao,0,0,0,0,1,1,1,3
rancherio_cattle,io.cattle.platform.core.dao.impl,0,0,0,0,1,1,1,3
rancherio_cattle,io.cattle.platform.core.json,0,0,0,0,0,0,1,1
rancherio_cattle,io.cattle.platform.core.model,1,0,0,1,1,7,1,11
rancherio_cattle,io.cattle.platform.core.model.tables,1,1,0,1,1,0,1,5
rancherio_cattle,io.cattle.platform.core.model.tables.records,0,0,0,2,1,0,1,4
rancherio_cattle,io.cattle.platform.core.util,0,1,0,0,1,1,1,4
rancherio_cattle,io.cattle.platform.resource.pool.impl,0,0,0,0,0,0,1,1
rancherio_cattle,io.cattle.platform.resource.pool.mac,0,0,0,0,0,0,1,1
rancherio_cattle,io.cattle.platform.resource.pool,0,0,0,0,0,0,1,1
rancherio_cattle,io.cattle.platform.resource.pool.port,0,0,0,0,0,0,1,1
rancherio_cattle,io.cattle.platform.resource.pool.subnet,0,0,0,0,0,0,1,1
rancherio_cattle,io.cattle.platform.resource.pool.util,0,0,0,0,0,0,1,1
rancherio_cattle,io.cattle.platform.servicediscovery.api.action,0,0,0,0,1,1,1,3
rancherio_cattle,io.cattle.platform.servicediscovery.api.dao,0,0,0,0,0,0,1,1
rancherio_cattle,io.cattle.platform.servicediscovery.api.filter,0,0,0,0,1,0,1,2
rancherio_cattle,io.cattle.platform.servicediscovery.api.lock,0,0,0,0,0,0,1,1
rancherio_cattle,io.cattle.platform.servicediscovery.api.resource,0,0,0,0,0,0,1,1
rancherio_cattle,io.cattle.platform.servicediscovery.api.service.impl,0,0,0,0,1,0,1,2
rancherio_cattle,io.cattle.platform.servicediscovery.api.service,0,0,0,0,0,1,1,2
rancherio_cattle,io.cattle.platform.servicediscovery.api.util.selector,0,0,0,0,0,0,1,1
rancherio_cattle,io.cattle.platform.servicediscovery.api.util,0,0,0,0,0,0,1,1
rancherio_cattle,io.cattle.platform.servicediscovery.dao.impl,0,0,0,0,0,0,1,1
rancherio_cattle,io.cattle.platform.servicediscovery.deployment,0,0,0,0,1,0,1,2
rancherio_cattle,io.cattle.platform.servicediscovery.deployment.impl,0,0,0,0,0,0,1,1
rancherio_cattle,io.cattle.platform.servicediscovery.deployment.impl.healthaction,0,0,0,0,0,0,1,1
rancherio_cattle,io.cattle.platform.servicediscovery.deployment.impl.lock,0,0,0,0,0,0,1,1
rancherio_cattle,io.cattle.platform.servicediscovery.deployment.impl.planner,0,0,0,0,0,0,1,1
rancherio_cattle,io.cattle.platform.servicediscovery.deployment.impl.unit,0,0,0,0,1,0,1,2
rancherio_cattle,io.cattle.platform.servicediscovery.process,0,0,0,1,1,1,1,4
rancherio_cattle,io.cattle.platform.servicediscovery.service.impl,0,0,0,0,1,0,1,2
rancherio_cattle,io.cattle.platform.servicediscovery.service,0,0,0,0,0,0,1,1
rancherio_cattle,io.cattle.platform.servicediscovery.upgrade.impl,0,0,0,0,0,0,1,1
rancherio_cattle,io.cattle.platform.servicediscovery.upgrade,0,0,0,0,0,0,1,1
rancherio_cattle,io.cattle.platform.servicediscovery.selector,0,0,0,0,0,0,1,1
rancherio_cattle,io.cattle.platform.ssh.common,0,0,0,0,0,0,1,1
rancherio_cattle,io.cattle.platform.storage.api.filter,0,0,0,0,0,0,1,1
rancherio_cattle,io.cattle.platform.storage,0,0,0,0,0,0,1,1
rancherio_cattle,io.cattle.platform.storage.pool,0,0,0,0,0,0,1,1
rancherio_cattle,io.cattle.platform.storage.service.dao,0,0,0,0,0,0,1,1
rancherio_cattle,io.cattle.platform.storage.service.dao.impl,0,0,0,0,0,0,1,1
rancherio_cattle,io.cattle.platform.storage.service.impl,0,0,0,0,0,0,1,1
rancherio_cattle,io.cattle.platform.storage.service,0,0,0,0,0,0,1,1
rancherio_cattle,io.cattle.platform.task.action,0,0,0,0,0,0,1,1
rancherio_cattle,io.cattle.platform.task.cleanup,0,0,0,0,0,0,1,1
rancherio_cattle,io.cattle.platform.task.dao.impl,0,0,0,0,0,0,1,1
rancherio_cattle,io.cattle.platform.activity,0,1,0,0,0,0,1,2
rancherio_cattle,io.cattle.platform.activity.impl,0,0,0,0,0,0,1,1
rancherio_cattle,io.cattle.platform.agent.instance.link.process,0,0,0,0,0,0,1,1
rancherio_cattle,io.cattle.platform.docker.api.container,0,0,0,0,0,0,1,1
rancherio_cattle,io.cattle.platform.docker.api,0,0,0,0,0,0,1,1
rancherio_cattle,io.cattle.platform.docker.api.transform,0,0,0,0,0,0,1,1
rancherio_cattle,io.cattle.platform.docker.api.model,0,0,0,0,1,0,1,2
rancherio_cattle,io.cattle.platform.docker.client,0,0,0,0,0,0,1,1
rancherio_cattle,io.cattle.platform.docker.constants,0,0,0,0,0,0,1,1
rancherio_cattle,io.cattle.platform.docker.process.lock,0,0,0,0,0,0,1,1
rancherio_cattle,io.cattle.platform.docker.transform,0,0,0,0,0,0,1,1
rancherio_cattle,io.cattle.platform.docker.util,0,0,0,0,0,0,1,1
rancherio_cattle,io.cattle.platform.docker.process.account,0,0,0,0,0,0,1,1
rancherio_cattle,io.cattle.platform.docker.process.dao,0,0,0,0,0,0,1,1
rancherio_cattle,io.cattle.platform.docker.process.dao.impl,0,0,0,0,0,0,1,1
rancherio_cattle,io.cattle.platform.docker.process.instance,0,0,0,0,0,0,1,1
rancherio_cattle,io.cattle.platform.docker.process.instancehostmap,0,0,0,0,0,0,1,1
rancherio_cattle,io.cattle.platform.docker.process.ipaddress,0,0,0,0,0,0,1,1
rancherio_cattle,io.cattle.platform.docker.process.serializer,0,0,0,0,0,0,1,1
rancherio_cattle,io.cattle.platform.docker.process.stack,0,0,0,0,0,0,1,1
rancherio_cattle,io.cattle.platform.docker.process.util,0,0,0,0,0,0,1,1
rancherio_cattle,io.cattle.platform.docker.service,0,0,0,0,0,0,1,1
rancherio_cattle,io.cattle.platform.docker.service.impl,0,0,0,0,0,0,1,1
rancherio_cattle,io.cattle.platform.docker.machine.api.addon,0,0,0,0,0,0,1,1
rancherio_cattle,io.cattle.platform.docker.machine.api.filter,0,0,0,0,0,0,1,1
rancherio_cattle,io.cattle.platform.docker.machine.api,0,0,0,0,0,0,1,1
rancherio_cattle,io.cattle.platform.docker.machine.launch,0,1,0,0,1,0,1,3
rancherio_cattle,io.cattle.platform.docker.machine.process,0,0,0,0,0,0,1,1
rancherio_cattle,io.cattle.platform.docker.storage.dao,0,0,0,0,0,0,1,1
rancherio_cattle,io.cattle.platform.docker.storage.dao.impl,0,0,0,0,0,0,1,1
rancherio_cattle,io.cattle.platform.docker.storage,0,0,0,0,0,0,1,1
rancherio_cattle,io.cattle.platform.docker.storage.process,0,0,0,0,0,0,1,1
rancherio_cattle,io.cattle.platform.extension.api.dot,0,0,0,0,0,1,1,2
rancherio_cattle,io.cattle.platform.extension.api.manager,0,0,0,0,0,0,1,1
rancherio_cattle,io.cattle.platform.extension.api.model,0,0,0,0,0,0,1,1
rancherio_cattle,io.cattle.platform.extension.api.util,0,0,0,0,0,0,1,1
rancherio_cattle,io.cattle.platform.hazelcast.dao,0,0,0,0,0,0,1,1
rancherio_cattle,io.cattle.platform.hazelcast.dao.impl,0,0,0,0,0,0,1,1
rancherio_cattle,io.cattle.platform.hazelcast.factory,0,0,0,0,0,0,1,1
rancherio_cattle,io.cattle.platform.hazelcast.membership,0,0,0,0,1,0,1,2
rancherio_cattle,io.cattle.platform.hazelcast.membership.dao,0,0,0,0,0,0,1,1
rancherio_cattle,io.cattle.platform.hazelcast.membership.dao.impl,0,0,0,0,0,0,1,1
rancherio_cattle,io.cattle.platform.hazelcast.eventing,0,0,0,0,0,0,1,1
rancherio_cattle,io.cattle.platform.hazelcast.lock,0,0,0,0,0,0,1,1
rancherio_cattle,io.cattle.platform.host.api,0,0,0,0,1,0,1,2
rancherio_cattle,io.cattle.platform.host.model,0,0,0,0,0,0,1,1
rancherio_cattle,io.cattle.platform.host.service,0,0,0,0,0,0,1,1
rancherio_cattle,io.cattle.platform.host.service.impl,0,0,0,0,0,0,1,1
rancherio_cattle,io.cattle.platform.host.stats.api,0,0,0,0,1,0,1,2
rancherio_cattle,io.cattle.platform.host.stats.utils,0,0,0,0,0,0,1,1
rancherio_cattle,io.cattle.platform.register.api,0,0,0,0,0,0,1,1
rancherio_cattle,io.cattle.platform.register.auth.impl,0,0,0,0,0,0,1,1
rancherio_cattle,io.cattle.platform.register.auth,0,0,0,0,0,0,1,1
rancherio_cattle,io.cattle.platform.register.dao.impl,0,0,0,0,0,0,1,1
rancherio_cattle,io.cattle.platform.register.dao,0,0,0,0,0,0,1,1
rancherio_cattle,io.cattle.platform.register.process,0,0,0,0,0,0,1,1
rancherio_cattle,io.cattle.platform.register.util,0,0,0,0,0,0,1,1
rancherio_cattle,io.cattle.platform.api.settings.manager,0,0,0,0,0,0,1,1
rancherio_cattle,io.cattle.platform.api.settings.model,0,0,0,0,0,0,1,1
rancherio_cattle,io.cattle.platform.agent.connection.simulator,0,1,0,0,1,0,1,3
rancherio_cattle,io.cattle.platform.agent.connection.simulator.impl,0,0,0,0,1,0,1,2
rancherio_cattle,io.cattle.platform.storage.simulator.lock,0,0,0,0,0,0,1,1
rancherio_cattle,io.cattle.platform.storage.simulator.pool,0,0,0,0,0,0,1,1
rancherio_cattle,io.cattle.platform.storage.simulator.process,0,0,0,0,0,0,1,1
rancherio_cattle,io.cattle.platform.systemstack.api,0,0,0,0,0,0,1,1
rancherio_cattle,io.cattle.platform.systemstack.catalog,0,0,0,0,0,0,1,1
rancherio_cattle,io.cattle.platform.systemstack.catalog.impl,0,0,0,0,0,0,1,1
rancherio_cattle,io.cattle.platform.systemstack.listener,1,1,0,0,0,0,1,3
rancherio_cattle,io.cattle.platform.systemstack.lock,0,0,0,0,0,0,1,1
rancherio_cattle,io.cattle.platform.systemstack.model,0,0,0,0,0,0,1,1
rancherio_cattle,io.cattle.platform.systemstack.process,1,0,0,0,1,0,1,3
rancherio_cattle,io.cattle.platform.systemstack.service,0,0,0,0,0,0,1,1
rancherio_cattle,io.cattle.platform.systemstack.task,0,0,0,0,0,0,1,1
rancherio_cattle,io.cattle.platform.vm.api,0,0,0,0,0,0,1,1
rancherio_cattle,io.cattle.platform.vm.process,0,0,0,0,0,0,1,1
rancherio_cattle,io.cattle.platform.app,0,0,0,0,1,0,1,2
rancherio_cattle,io.cattle.platform.packaging,0,0,0,0,0,0,1,1
raphaeljolivet_java2typescript,java2typescript.jackson.module.conf.typename,0,0,0,0,0,0,0,0
raphaeljolivet_java2typescript,java2typescript.jackson.module,0,0,0,1,1,0,0,2
raphaeljolivet_java2typescript,java2typescript.jackson.module.grammar,0,0,0,0,1,2,0,3
raphaeljolivet_java2typescript,java2typescript.jackson.module.grammar.base,0,0,0,0,0,2,0,2
raphaeljolivet_java2typescript,java2typescript.jackson.module.visitors,0,0,0,0,1,0,0,1
raphaeljolivet_java2typescript,java2typescript.jackson.module.writer,0,0,0,0,0,2,0,2
raphaeljolivet_java2typescript,java2typescript.jackson.module.util,0,0,0,0,0,0,0,0
raphaeljolivet_java2typescript,java2typescript.jaxrs.model,0,0,0,0,0,0,0,0
raphaeljolivet_java2typescript,java2typescript.jaxrs,0,0,0,0,0,0,0,0
raphaeljolivet_java2typescript,org.java2typescript.maven.plugin,0,0,0,0,0,0,0,0
raphaeljolivet_java2typescript,com.example.config,0,0,0,0,0,0,0,0
raphaeljolivet_java2typescript,com.example.exceptions,0,0,0,0,0,0,0,0
raphaeljolivet_java2typescript,com.example.model,0,0,0,0,0,1,0,1
raphaeljolivet_java2typescript,com.example.rs,0,0,0,0,0,1,0,1
raphaeljolivet_java2typescript,com.example.services,0,0,0,0,0,1,0,1
raphaeljolivet_java2typescript,com.example,0,0,0,0,0,0,0,0
raydac_java-binary-block-parser,com.igormaznitsa.jbbp.compiler.conversion,4,0,0,0,1,1,1,7
raydac_java-binary-block-parser,com.igormaznitsa.jbbp.compiler,7,1,0,0,1,6,1,16
raydac_java-binary-block-parser,com.igormaznitsa.jbbp.compiler.tokenizer,2,0,0,0,0,6,1,9
raydac_java-binary-block-parser,com.igormaznitsa.jbbp.compiler.varlen,3,0,0,0,0,2,1,6
raydac_java-binary-block-parser,com.igormaznitsa.jbbp.exceptions,0,0,0,0,0,1,1,2
raydac_java-binary-block-parser,com.igormaznitsa.jbbp.io,6,1,0,1,1,14,1,24
raydac_java-binary-block-parser,com.igormaznitsa.jbbp,13,1,0,0,1,10,1,26
raydac_java-binary-block-parser,com.igormaznitsa.jbbp.mapper,4,0,0,1,1,2,1,9
raydac_java-binary-block-parser,com.igormaznitsa.jbbp.model,11,1,0,1,0,8,1,22
raydac_java-binary-block-parser,com.igormaznitsa.jbbp.model.finder,0,0,0,0,0,0,1,1
raydac_java-binary-block-parser,com.igormaznitsa.jbbp.utils,13,1,0,1,1,6,1,23
raydac_java-binary-block-parser,com.igormaznitsa.jbbp.it,0,0,0,1,0,6,1,8
raydac_java-binary-block-parser,com.igormaznitsa.jbbp.benchmarks,0,0,0,0,0,0,1,1
raydac_java-binary-block-parser,com.igormaznitsa.jbbp.plugin.gradle,0,0,0,0,0,0,1,1
raydac_java-binary-block-parser,com.igormaznitsa.jbbp.plugin.mvn,0,0,0,0,0,0,1,1
raydac_java-binary-block-parser,com.igormaznitsa.jbbp.plugin.common.converters,0,1,0,0,0,0,1,2
raydac_java-binary-block-parser,com.igormaznitsa.mvn.tst,0,0,0,0,0,3,1,4
raydac_java-binary-block-parser,com.igormaznitsa.jbbp.plugin.common.utils,0,0,0,0,0,0,1,1
Rayman2200_PDFA3,org.mustangproject.toecount,0,0,0,0,0,0,0,0
Rayman2200_PDFA3,org.mustangproject,0,0,0,0,0,0,0,0
Rayman2200_PDFA3,org.mustangproject.ZUGFeRD,0,0,0,1,0,0,0,1
Rayman2200_PDFA3,org.mustangproject.ZUGFeRD.model,0,0,0,1,0,0,0,1
reactive-streams_reactive-streams-jvm,org.reactivestreams,0,0,0,0,0,0,0,0
reactive-streams_reactive-streams-jvm,org.reactivestreams.example.unicast,0,0,0,0,1,0,0,1
reactive-streams_reactive-streams-jvm,org.reactivestreams.tck.flow.support,0,0,0,0,1,0,0,1
reactive-streams_reactive-streams-jvm,org.reactivestreams.tck,0,0,0,1,0,0,0,1
reactive-streams_reactive-streams-jvm,org.reactivestreams.tck.flow,0,0,0,0,1,0,0,1
ReactiveX_RxJava,io.reactivex.rxjava3.core,41,1,0,1,0,0,1,44
ReactiveX_RxJava,io.reactivex.rxjava3.parallel,6,1,0,0,0,0,1,8
ReactiveX_RxJava,io.reactivex.rxjava3.xmapz,0,0,0,0,1,0,1,2
ReactiveX_RxJava,io.reactivex.rxjava3.disposables,10,1,0,0,0,0,1,12
ReactiveX_RxJava,io.reactivex.rxjava3.exceptions,9,1,0,0,1,0,1,12
ReactiveX_RxJava,io.reactivex.rxjava3.flowables,10,0,0,0,0,0,1,11
ReactiveX_RxJava,io.reactivex.rxjava3.functions,0,0,0,0,1,0,1,2
ReactiveX_RxJava,io.reactivex.rxjava3.internal.disposables,3,0,0,0,1,0,1,5
ReactiveX_RxJava,io.reactivex.rxjava3.internal.functions,8,1,0,1,1,0,1,12
ReactiveX_RxJava,io.reactivex.rxjava3.internal.fuseable,0,0,0,0,1,0,1,2
ReactiveX_RxJava,io.reactivex.rxjava3.internal.observers,6,1,0,1,1,0,1,10
ReactiveX_RxJava,io.reactivex.rxjava3.internal.operators.completable,0,0,0,1,1,0,1,3
ReactiveX_RxJava,io.reactivex.rxjava3.internal.operators.flowable,3,0,0,2,1,0,1,7
ReactiveX_RxJava,io.reactivex.rxjava3.internal.operators.maybe,0,0,0,1,1,0,1,3
ReactiveX_RxJava,io.reactivex.rxjava3.internal.operators.mixed,0,0,0,1,1,0,1,3
ReactiveX_RxJava,io.reactivex.rxjava3.internal.operators.observable,0,0,0,2,1,0,1,4
ReactiveX_RxJava,io.reactivex.rxjava3.internal.operators.parallel,0,0,0,1,1,0,1,3
ReactiveX_RxJava,io.reactivex.rxjava3.internal.operators.single,0,0,0,1,1,0,1,3
ReactiveX_RxJava,io.reactivex.rxjava3.internal.queue,3,1,0,0,0,0,1,5
ReactiveX_RxJava,io.reactivex.rxjava3.internal.schedulers,4,0,0,1,0,0,1,6
ReactiveX_RxJava,io.reactivex.rxjava3.internal.subscribers,5,1,0,1,1,0,1,9
ReactiveX_RxJava,io.reactivex.rxjava3.internal.subscriptions,4,0,0,0,1,0,1,6
ReactiveX_RxJava,io.reactivex.rxjava3.internal.util,38,1,0,1,1,0,1,42
ReactiveX_RxJava,io.reactivex.rxjava3.observables,4,0,0,0,0,0,1,5
ReactiveX_RxJava,io.reactivex.rxjava3.observers,5,0,0,1,1,0,1,8
ReactiveX_RxJava,io.reactivex.rxjava3.plugins,23,1,0,0,0,0,1,25
ReactiveX_RxJava,io.reactivex.rxjava3.processors,3,1,0,1,0,0,1,6
ReactiveX_RxJava,io.reactivex.rxjava3.schedulers,15,1,0,1,0,0,1,18
ReactiveX_RxJava,io.reactivex.rxjava3.subjects,9,1,0,1,0,0,1,12
ReactiveX_RxJava,io.reactivex.rxjava3.subscribers,6,1,0,0,0,0,1,8
ReactiveX_RxJava,io.reactivex.rxjava3.completable,0,0,0,0,1,0,1,2
ReactiveX_RxJava,io.reactivex.rxjava3.flowable,0,0,0,1,1,0,1,3
ReactiveX_RxJava,io.reactivex.rxjava3.internal,0,0,0,0,0,0,1,1
ReactiveX_RxJava,io.reactivex.rxjava3.maybe,0,0,0,0,0,0,1,1
ReactiveX_RxJava,io.reactivex.rxjava3.observable,0,0,0,1,1,0,1,3
ReactiveX_RxJava,io.reactivex.rxjava3.single,0,0,0,0,1,0,1,2
ReactiveX_RxJava,io.reactivex.rxjava3.tck,0,0,0,1,0,0,1,2
ReactiveX_RxJava,io.reactivex.rxjava3.validators,0,0,0,0,1,0,1,2
readydev_retrogram,com.getinch.retrogram.endpoints,0,0,0,0,1,0,0,1
readydev_retrogram,com.getinch.retrogram,0,0,0,0,1,0,0,1
readydev_retrogram,com.getinch.retrogram.model,0,0,0,1,1,0,0,2
real-logic_Aeron,io.aeron.agent,0,0,0,1,1,0,1,3
real-logic_Aeron,io.aeron.archive.codecs,0,0,0,1,0,0,1,2
real-logic_Aeron,io.aeron.archive.codecs.mark,0,0,0,0,1,0,1,2
real-logic_Aeron,io.aeron.archive,0,0,0,1,0,0,1,2
real-logic_Aeron,io.aeron.archive.checksum,0,0,0,0,1,0,1,2
real-logic_Aeron,io.aeron.archive.client,0,1,0,0,0,0,1,2
real-logic_Aeron,io.aeron.archive.status,0,1,0,0,0,0,1,2
real-logic_Aeron,io.aeron.archive.workloads,0,0,0,0,0,0,1,1
real-logic_Aeron,io.aeron,14,1,0,1,0,0,1,17
real-logic_Aeron,io.aeron.command,0,0,0,0,1,0,1,2
real-logic_Aeron,io.aeron.exceptions,0,0,0,0,0,0,1,1
real-logic_Aeron,io.aeron.logbuffer,3,1,0,0,1,0,1,6
real-logic_Aeron,io.aeron.protocol,0,0,0,0,0,0,1,1
real-logic_Aeron,io.aeron.security,0,0,0,0,1,0,1,2
real-logic_Aeron,io.aeron.status,4,1,0,0,0,0,1,6
real-logic_Aeron,io.aeron.cluster.codecs,0,0,0,2,0,0,1,3
real-logic_Aeron,io.aeron.cluster.codecs.mark,0,0,0,0,1,0,1,2
real-logic_Aeron,io.aeron.cluster.client,0,0,0,0,1,0,1,2
real-logic_Aeron,io.aeron.cluster,0,0,0,1,0,0,1,2
real-logic_Aeron,io.aeron.cluster.service,0,1,0,0,0,0,1,2
real-logic_Aeron,io.aeron.driver,14,0,0,1,0,0,1,16
real-logic_Aeron,io.aeron.driver.buffer,3,1,0,0,1,0,1,6
real-logic_Aeron,io.aeron.driver.exceptions,0,0,0,0,0,0,1,1
real-logic_Aeron,io.aeron.driver.ext,3,0,0,0,1,0,1,5
real-logic_Aeron,io.aeron.driver.media,6,1,0,0,0,0,1,8
real-logic_Aeron,io.aeron.driver.reports,0,0,0,0,1,0,1,2
real-logic_Aeron,io.aeron.driver.status,3,1,0,0,1,0,1,6
real-logic_Agrona,org.agrona,4,1,0,1,1,0,0,7
real-logic_Agrona,org.agrona.collections,2,0,0,1,0,0,0,3
real-logic_Agrona,org.agrona.concurrent,4,1,0,1,1,0,0,7
real-logic_Agrona,org.agrona.concurrent.broadcast,0,0,0,0,1,0,0,1
real-logic_Agrona,org.agrona.concurrent.errors,0,0,0,0,0,0,0,0
real-logic_Agrona,org.agrona.concurrent.ringbuffer,0,0,0,0,1,0,0,1
real-logic_Agrona,org.agrona.concurrent.status,2,0,0,0,0,0,0,2
real-logic_Agrona,org.agrona.console,0,0,0,0,0,0,0,0
real-logic_Agrona,org.agrona.generation,0,0,0,0,1,0,0,1
real-logic_Agrona,org.agrona.hints,0,0,0,0,0,0,0,0
real-logic_Agrona,org.agrona.io,0,0,0,0,0,0,0,0
real-logic_Agrona,org.agrona.nio,0,0,0,0,0,0,0,0
real-logic_Agrona,org.agrona.sbe,0,0,0,0,0,0,0,0
real-logic_Agrona,org.agrona.agent,0,0,0,0,0,0,0,0
real-logic_simple-binary-encoding,uk.co.real_logic.sbe.generated,0,0,0,0,0,0,0,0
real-logic_simple-binary-encoding,uk.co.real_logic.sbe.benchmarks,0,0,0,0,0,0,0,0
real-logic_simple-binary-encoding,uk.co.real_logic.sbe.benchmarks.fix,0,0,0,1,0,0,0,1
real-logic_simple-binary-encoding,uk.co.real_logic.sbe,6,1,0,0,1,0,0,8
real-logic_simple-binary-encoding,baseline,0,0,0,0,0,0,0,0
real-logic_simple-binary-encoding,extension,0,0,0,0,0,0,0,0
real-logic_simple-binary-encoding,uk.co.real_logic.sbe.examples,0,0,0,0,0,0,0,0
real-logic_simple-binary-encoding,uk.co.real_logic.sbe.codec.java,0,0,0,0,0,0,0,0
real-logic_simple-binary-encoding,uk.co.real_logic.sbe.generation.c,0,0,0,0,0,0,0,0
real-logic_simple-binary-encoding,uk.co.real_logic.sbe.generation,2,1,0,0,0,0,0,3
real-logic_simple-binary-encoding,uk.co.real_logic.sbe.generation.cpp,0,0,0,0,0,0,0,0
real-logic_simple-binary-encoding,uk.co.real_logic.sbe.generation.csharp,0,0,0,0,0,0,0,0
real-logic_simple-binary-encoding,uk.co.real_logic.sbe.generation.golang,0,0,0,0,0,0,0,0
real-logic_simple-binary-encoding,uk.co.real_logic.sbe.generation.java,0,0,0,0,1,0,0,1
real-logic_simple-binary-encoding,uk.co.real_logic.sbe.generation.rust,0,0,0,0,0,0,0,0
real-logic_simple-binary-encoding,uk.co.real_logic.sbe.ir,5,1,0,0,0,0,0,6
real-logic_simple-binary-encoding,uk.co.real_logic.sbe.ir.generated,0,0,0,0,1,0,0,1
real-logic_simple-binary-encoding,uk.co.real_logic.sbe.json,0,0,0,0,0,0,0,0
real-logic_simple-binary-encoding,uk.co.real_logic.sbe.otf,0,0,0,0,0,0,0,0
real-logic_simple-binary-encoding,uk.co.real_logic.sbe.util,0,0,0,0,0,0,0,0
real-logic_simple-binary-encoding,uk.co.real_logic.sbe.xml,4,0,0,0,0,0,0,4
recruit-tech_redpen,cc.redpen,13,1,0,0,1,13,1,29
recruit-tech_redpen,cc.redpen.config,8,1,0,0,0,18,1,28
recruit-tech_redpen,cc.redpen.formatter,4,0,0,0,1,2,1,8
recruit-tech_redpen,cc.redpen.model,4,1,0,0,0,22,1,28
recruit-tech_redpen,cc.redpen.parser.asciidoc,0,0,0,0,0,0,1,1
recruit-tech_redpen,cc.redpen.parser,8,1,0,0,0,1,1,11
recruit-tech_redpen,cc.redpen.parser.common,0,0,0,0,0,0,1,1
recruit-tech_redpen,cc.redpen.parser.latex,2,1,0,0,1,0,1,5
recruit-tech_redpen,cc.redpen.parser.markdown,2,0,0,0,0,0,1,3
recruit-tech_redpen,cc.redpen.parser.rest,0,0,1,0,1,0,1,3
recruit-tech_redpen,cc.redpen.parser.review,0,0,1,0,0,0,1,2
recruit-tech_redpen,cc.redpen.tokenizer,0,0,0,0,0,5,1,6
recruit-tech_redpen,cc.redpen.util,9,1,0,0,1,3,1,15
recruit-tech_redpen,cc.redpen.validator,7,1,0,0,1,19,1,29
recruit-tech_redpen,cc.redpen.validator.document,0,0,0,0,1,5,1,7
recruit-tech_redpen,cc.redpen.validator.section,0,0,0,0,1,4,1,6
recruit-tech_redpen,cc.redpen.validator.sentence,3,0,0,1,1,12,1,18
recruit-tech_redpen,cc.redpen.server.api,0,0,0,0,1,0,1,2
recruit-tech_redpen,(default package),0,0,0,0,0,0,1,1
red5_red5-websocket,org.red5.net.websocket.codec.extension,0,0,0,0,0,0,0,0
red5_red5-websocket,org.red5.net.websocket.codec,0,0,0,0,0,0,0,0
red5_red5-websocket,org.red5.net.websocket,0,0,0,0,1,0,0,1
red5_red5-websocket,org.red5.net.websocket.listener,0,0,0,0,0,0,0,0
red5_red5-websocket,org.red5.net.websocket.model,0,0,0,0,0,0,0,0
red5_red5-websocket,org.red5.net.websocket.util,0,0,0,0,0,0,0,0
redraiment_jactiverecord,me.zzp.ar,0,0,0,0,0,0,0,0
redraiment_jactiverecord,me.zzp.ar.d,0,0,0,0,0,0,0,0
redraiment_jactiverecord,me.zzp.ar.ex,0,0,0,0,1,0,0,1
redraiment_jactiverecord,me.zzp.ar.pool,0,0,0,0,0,0,0,0
redraiment_jactiverecord,me.zzp.ar.sql,0,0,0,0,0,0,0,0
redraiment_jactiverecord,me.zzp.util,0,0,0,0,0,0,0,0
redwarp_9-Patch-Resizer,net.iharder.dnd,0,0,0,0,0,0,0,0
redwarp_9-Patch-Resizer,net.redwarp.tool.resizer,0,0,0,0,0,0,0,0
redwarp_9-Patch-Resizer,net.redwarp.tool.resizer.misc,1,1,0,0,1,1,0,4
redwarp_9-Patch-Resizer,net.redwarp.tool.resizer.table,0,0,0,0,0,0,0,0
redwarp_9-Patch-Resizer,net.redwarp.tool.resizer.views,0,0,0,0,0,1,0,1
redwarp_9-Patch-Resizer,net.redwarp.tool.resizer.worker,1,0,0,0,0,1,0,2
reinert_requestor,io.reinert.requestor.examples.showcase.activity,0,0,0,0,1,0,0,1
reinert_requestor,io.reinert.requestor.examples.showcase,0,1,0,0,1,0,0,2
reinert_requestor,io.reinert.requestor.examples.showcase.place,0,0,0,0,1,0,0,1
reinert_requestor,io.reinert.requestor.examples.showcase.ui,0,0,0,0,1,0,0,1
reinert_requestor,io.reinert.requestor.examples.showcase.ui.loading.event,0,0,0,0,0,0,0,0
reinert_requestor,io.reinert.requestor.examples.showcase.ui.loading,0,0,0,0,0,0,0,0
reinert_requestor,io.reinert.requestor.examples.showcase.util,0,0,0,0,0,0,0,0
reinert_requestor,io.reinert.requestor,0,0,0,1,1,2,0,4
reinert_requestor,com.google.gwt.http.client,0,0,0,0,0,0,0,0
reinert_requestor,io.reinert.requestor.auth,0,1,0,0,1,2,0,4
reinert_requestor,io.reinert.requestor.deferred,0,0,0,0,1,0,0,1
reinert_requestor,io.reinert.requestor.form,0,0,0,0,1,0,0,1
reinert_requestor,io.reinert.requestor.header,0,0,0,1,0,0,0,1
reinert_requestor,io.reinert.requestor.rebind,0,0,0,0,0,0,0,0
reinert_requestor,io.reinert.requestor.serialization,0,0,0,0,1,0,0,1
reinert_requestor,io.reinert.requestor.serialization.json,0,0,0,0,1,0,0,1
reinert_requestor,io.reinert.requestor.serialization.misc,0,0,0,0,0,0,0,0
reinert_requestor,io.reinert.requestor.uri,0,0,0,1,1,1,0,3
reinert_requestor,io.reinert.requestor.oauth2,0,0,0,1,1,1,0,3
reinert_requestor,io.reinert.requestor.turbogwt,0,0,0,0,0,0,0,0
reinert_requestor,io.reinert.requestor.turbogwt.serialization,0,0,0,0,0,0,0,0
reinert_requestor,io.reinert.requestor.gdeferred,0,0,0,0,1,0,0,1
reinert_requestor,io.reinert.requestor.tools.checkstyle,0,0,0,0,0,0,0,0
reines_dropwizard-debpkg-maven-plugin,com.jamierf.dropwizard.debpkg.config,0,0,0,0,1,0,0,1
reines_dropwizard-debpkg-maven-plugin,com.jamierf.dropwizard.debpkg,0,0,0,0,0,0,0,0
reines_dropwizard-debpkg-maven-plugin,com.jamierf.dropwizard.debpkg.filter,0,0,0,0,0,0,0,0
reines_dropwizard-debpkg-maven-plugin,com.jamierf.dropwizard.debpkg.packaging,0,0,0,0,0,0,0,0
reines_dropwizard-debpkg-maven-plugin,com.jamierf.dropwizard.debpkg.resource,0,0,0,0,0,0,0,0
reines_dropwizard-debpkg-maven-plugin,com.jamierf.dropwizard.debpkg.template,1,0,0,0,0,0,0,1
reines_dropwizard-debpkg-maven-plugin,com.jamierf.dropwizard.debpkg.template.mustache,1,0,0,0,0,0,0,1
reines_dropwizard-debpkg-maven-plugin,com.jamierf.dropwizard.debpkg.transforms,0,0,0,0,0,0,0,0
reines_dropwizard-debpkg-maven-plugin,com.jamierf.dropwizard.debpkg.util,0,0,0,0,0,0,0,0
reines_dropwizard-debpkg-maven-plugin,com.jamierf.dropwizard.debpkg.validation,0,0,0,0,0,0,0,0
reines_dropwizard-debpkg-maven-plugin,com.jamierf.dropwizard.debpkg.stub,0,0,0,0,0,0,0,0
reines_dropwizard-debpkg-maven-plugin,org.vafer.jdeb.ant,0,0,0,0,0,0,0,0
reines_dropwizard-debpkg-maven-plugin,org.vafer.jdeb.changes,1,0,0,0,0,0,0,1
reines_dropwizard-debpkg-maven-plugin,org.vafer.jdeb,0,0,0,0,0,0,0,0
reines_dropwizard-debpkg-maven-plugin,org.vafer.jdeb.debian,1,1,0,0,0,0,0,2
reines_dropwizard-debpkg-maven-plugin,org.vafer.jdeb.mapping,0,0,0,0,0,0,0,0
reines_dropwizard-debpkg-maven-plugin,org.vafer.jdeb.maven,0,0,0,0,0,0,0,0
reines_dropwizard-debpkg-maven-plugin,org.vafer.jdeb.producers,0,0,0,0,0,0,0,0
reines_dropwizard-debpkg-maven-plugin,org.vafer.jdeb.signing,0,0,0,0,0,0,0,0
reines_dropwizard-debpkg-maven-plugin,org.vafer.jdeb.utils,0,0,0,0,1,0,0,1
release-engineering_pom-manipulation-ext,org.commonjava.maven.ext.cli,0,0,0,0,0,0,0,0
release-engineering_pom-manipulation-ext,org.commonjava.maven.ext.common.json,1,0,0,0,1,0,0,2
release-engineering_pom-manipulation-ext,org.commonjava.maven.ext.common,0,0,0,0,0,0,0,0
release-engineering_pom-manipulation-ext,org.commonjava.maven.ext.common.model,0,0,0,0,1,0,0,1
release-engineering_pom-manipulation-ext,org.commonjava.maven.ext.common.session,0,0,0,0,0,0,0,0
release-engineering_pom-manipulation-ext,org.commonjava.maven.ext.common.util,1,1,0,0,1,0,0,3
release-engineering_pom-manipulation-ext,org.commonjava.maven.ext.core.groovy,0,0,0,0,1,0,0,1
release-engineering_pom-manipulation-ext,org.commonjava.maven.ext.core.impl,4,0,0,1,1,0,0,6
release-engineering_pom-manipulation-ext,org.commonjava.maven.ext.core,4,0,0,0,0,0,0,4
release-engineering_pom-manipulation-ext,org.commonjava.maven.ext.core.state,6,1,0,1,1,0,0,9
release-engineering_pom-manipulation-ext,org.commonjava.maven.ext.core.util,7,1,0,0,1,0,0,9
release-engineering_pom-manipulation-ext,org.commonjava.maven.ext.core.fixture,2,1,0,0,0,0,0,3
release-engineering_pom-manipulation-ext,org.commonjava.maven.ext.core.io,0,0,0,0,0,0,0,0
release-engineering_pom-manipulation-ext,org.commonjava.maven.ext.manip,0,0,0,0,0,0,0,0
release-engineering_pom-manipulation-ext,org.commonjava.maven.ext.io,0,1,0,0,1,0,0,2
release-engineering_pom-manipulation-ext,org.commonjava.maven.ext.io.resolver,0,0,0,0,0,0,0,0
release-engineering_pom-manipulation-ext,org.commonjava.maven.ext.io.rest,2,0,0,0,1,0,0,3
release-engineering_pom-manipulation-ext,org.commonjava.maven.ext.io.rest.exception,0,0,0,0,0,0,0,0
release-engineering_pom-manipulation-ext,org.commonjava.maven.ext.io.rest.mapper,2,1,0,0,0,0,0,3
release-engineering_pom-manipulation-ext,org.commonjava.maven.ext.io.rest.handler,1,1,0,0,0,0,0,2
release-engineering_pom-manipulation-ext,org.commonjava.maven.ext.io.rest.rule,0,0,0,0,0,0,0,0
release-engineering_pom-manipulation-ext,org.commonjava.maven.ext.io.server.exception,0,0,0,0,0,0,0,0
release-engineering_pom-manipulation-ext,org.commonjava.maven.ext.io.server,0,0,0,0,0,0,0,0
remibantos_jeeshop,org.rembx.jeeshop.admin,0,0,0,0,0,0,0,0
remibantos_jeeshop,com.df.angularfileupload,0,0,0,0,0,0,0,0
remibantos_jeeshop,org.rembx.jeeshop.catalog,0,0,0,0,1,0,0,1
remibantos_jeeshop,org.rembx.jeeshop.catalog.model,0,0,0,0,1,0,0,1
remibantos_jeeshop,org.rembx.jeeshop.configuration,0,0,0,0,0,0,0,0
remibantos_jeeshop,org.rembx.jeeshop.mail,0,0,0,0,0,0,0,0
remibantos_jeeshop,org.rembx.jeeshop.rest,0,0,0,0,0,0,0,0
remibantos_jeeshop,org.rembx.jeeshop.role,0,0,0,0,0,0,0,0
remibantos_jeeshop,org.rembx.jeeshop.util,0,0,0,0,0,0,0,0
remibantos_jeeshop,org.rembx.jeeshop.media,0,0,0,0,0,0,0,0
remibantos_jeeshop,org.rembx.jeeshop.media.model,0,0,0,0,0,0,0,0
remibantos_jeeshop,org.rembx.jeeshop.order,0,0,0,0,1,0,0,1
remibantos_jeeshop,org.rembx.jeeshop.store,0,0,0,0,0,0,0,0
remibantos_jeeshop,org.rembx.jeeshop.order.model,0,0,0,0,1,0,0,1
remibantos_jeeshop,org.rembx.jeeshop.user,0,0,0,0,1,0,0,1
remibantos_jeeshop,org.rembx.jeeshop.user.model,0,0,0,0,1,0,0,1
remibantos_jeeshop,org.rembx.jeeshop.user.tools,0,0,0,0,0,0,0,0
renekrie_querqy,querqy.antlr,1,0,0,0,0,0,0,1
renekrie_querqy,querqy.antlr.parser,1,1,0,0,1,0,0,3
renekrie_querqy,querqy,0,0,0,0,0,1,0,1
renekrie_querqy,querqy.infologging,0,0,0,0,0,0,0,0
renekrie_querqy,querqy.model,0,0,0,0,1,2,0,3
renekrie_querqy,querqy.parser,0,0,0,0,0,0,0,0
renekrie_querqy,querqy.rewrite.commonrules,2,0,0,0,0,2,0,4
renekrie_querqy,querqy.rewrite.commonrules.model,2,1,0,1,0,2,0,6
renekrie_querqy,querqy.rewrite.commonrules.select,1,1,0,0,0,1,0,3
renekrie_querqy,querqy.rewrite,0,0,0,0,0,1,0,1
renekrie_querqy,querqy.rewrite.contrib,0,0,0,0,0,0,0,0
renekrie_querqy,querqy.trie,0,0,0,0,0,0,0,0
renekrie_querqy,querqy.lucene.contrib.parser,0,0,0,0,0,0,0,0
renekrie_querqy,querqy.lucene.contrib.rewrite,0,0,0,0,1,0,0,1
renekrie_querqy,querqy.lucene,0,0,0,0,1,0,0,1
renekrie_querqy,querqy.lucene.rewrite,1,0,0,1,1,0,0,3
renekrie_querqy,querqy.lucene.rewrite.cache,0,0,0,0,0,0,0,0
renekrie_querqy,querqy.lucene.rewrite.prms,1,0,0,0,1,0,0,2
renekrie_querqy,querqy.solr,0,0,0,1,1,0,0,2
renekrie_querqy,querqy.solr.contrib,0,0,0,0,1,0,0,1
RentTheRunway2_alchemy,io.rtr.alchemy.dto.identities,0,0,0,0,0,0,0,0
RentTheRunway2_alchemy,io.rtr.alchemy.dto.models,0,0,0,0,1,0,0,1
RentTheRunway2_alchemy,io.rtr.alchemy.dto.requests,0,0,0,0,1,0,0,1
RentTheRunway2_alchemy,io.rtr.alchemy.dto,0,0,0,0,0,0,0,0
RentTheRunway2_alchemy,io.rtr.alchemy.client,0,0,0,0,0,0,0,0
RentTheRunway2_alchemy,io.rtr.alchemy.client.builder,0,0,0,0,0,0,0,0
RentTheRunway2_alchemy,io.rtr.alchemy.client.dto,0,0,0,0,0,0,0,0
RentTheRunway2_alchemy,io.rtr.alchemy.client.identities,0,0,0,0,0,0,0,0
RentTheRunway2_alchemy,io.rtr.alchemy.client.mappers,0,0,0,0,0,0,0,0
RentTheRunway2_alchemy,io.rtr.alchemy.client.providers,0,0,0,0,0,0,0,0
RentTheRunway2_alchemy,io.rtr.alchemy.caching,2,0,0,0,1,2,0,5
RentTheRunway2_alchemy,io.rtr.alchemy.db,2,1,0,0,1,2,0,6
RentTheRunway2_alchemy,io.rtr.alchemy.filtering,0,0,0,0,1,1,0,2
RentTheRunway2_alchemy,io.rtr.alchemy.identities,0,0,0,0,1,1,0,2
RentTheRunway2_alchemy,io.rtr.alchemy.models,3,1,0,0,0,2,0,6
RentTheRunway2_alchemy,io.rtr.alchemy.db.memory,0,0,0,0,1,0,0,1
RentTheRunway2_alchemy,io.rtr.alchemy.db.mongo.models,0,1,0,0,1,0,0,2
RentTheRunway2_alchemy,io.rtr.alchemy.db.mongo,0,0,0,0,1,0,0,1
RentTheRunway2_alchemy,io.rtr.alchemy.db.mongo.util,0,0,0,0,0,0,0,0
RentTheRunway2_alchemy,io.rtr.alchemy.example,0,0,0,0,0,0,0,0
RentTheRunway2_alchemy,io.rtr.alchemy.example.config,0,0,0,0,0,0,0,0
RentTheRunway2_alchemy,io.rtr.alchemy.example.dto,0,0,0,0,0,0,0,0
RentTheRunway2_alchemy,io.rtr.alchemy.example.identities,0,0,0,0,0,0,0,0
RentTheRunway2_alchemy,io.rtr.alchemy.example.mappers,0,0,0,0,0,0,0,0
RentTheRunway2_alchemy,io.rtr.alchemy.mapping,0,0,0,0,0,0,0,0
RentTheRunway2_alchemy,io.rtr.alchemy.service,0,0,0,0,0,0,0,0
RentTheRunway2_alchemy,io.rtr.alchemy.service.config,0,0,0,0,0,0,0,0
RentTheRunway2_alchemy,io.rtr.alchemy.service.exceptions,0,0,0,0,0,0,0,0
RentTheRunway2_alchemy,io.rtr.alchemy.service.filters,0,0,0,0,0,0,0,0
RentTheRunway2_alchemy,io.rtr.alchemy.service.guice,0,0,0,0,0,0,0,0
RentTheRunway2_alchemy,io.rtr.alchemy.service.health,0,0,0,0,0,0,0,0
RentTheRunway2_alchemy,io.rtr.alchemy.service.jackson,0,0,0,0,0,0,0,0
RentTheRunway2_alchemy,io.rtr.alchemy.service.mapping,0,0,0,0,0,0,0,0
RentTheRunway2_alchemy,io.rtr.alchemy.service.metadata,0,0,0,0,0,0,0,0
RentTheRunway2_alchemy,io.rtr.alchemy.service.metrics,0,0,0,0,0,0,0,0
RentTheRunway2_alchemy,io.rtr.alchemy.service.resources,0,0,0,0,1,0,0,1
RestExpress_RestExpress-Examples,org.restexpress.example.benchmark,0,0,0,0,0,0,0,0
RestExpress_RestExpress-Examples,org.restexpress.example.blogging,1,0,0,0,1,0,0,2
RestExpress_RestExpress-Examples,org.restexpress.example.blogging.controller,0,0,0,0,0,0,0,0
RestExpress_RestExpress-Examples,org.restexpress.example.blogging.domain,1,1,0,0,0,0,0,2
RestExpress_RestExpress-Examples,org.restexpress.example.blogging.domain.event,0,0,0,0,1,0,0,1
RestExpress_RestExpress-Examples,org.restexpress.example.blogging.event,0,0,0,0,0,0,0,0
RestExpress_RestExpress-Examples,org.restexpress.example.blogging.persistence,0,0,0,0,0,0,0,0
RestExpress_RestExpress-Examples,org.restexpress.example.blogging.postprocessor,0,0,0,0,0,0,0,0
RestExpress_RestExpress-Examples,org.restexpress.example.blogging.serialization,0,0,0,0,0,0,0,0
RestExpress_RestExpress-Examples,org.restexpress.example.echo,0,0,0,0,0,0,0,0
RestExpress_RestExpress-Examples,org.restexpress.example.echo.controller,0,0,0,0,0,0,0,0
RestExpress_RestExpress-Examples,org.restexpress.example.echo.serialization,0,0,0,0,0,0,0,0
RestExpress_RestExpress-Examples,com.example,0,0,0,0,1,0,0,1
resty-gwt_resty-gwt,org.fusesource.restygwt.client,1,1,0,1,1,0,0,4
resty-gwt_resty-gwt,org.fusesource.restygwt.client.cache,0,0,0,0,1,0,0,1
resty-gwt_resty-gwt,org.fusesource.restygwt.client.callback,0,0,0,0,1,0,0,1
resty-gwt_resty-gwt,org.fusesource.restygwt.client.dispatcher,1,0,0,0,1,0,0,2
resty-gwt_resty-gwt,org.fusesource.restygwt.client.util,0,0,0,0,0,0,0,0
resty-gwt_resty-gwt,org.fusesource.restygwt.rebind,0,0,0,1,1,0,0,2
resty-gwt_resty-gwt,org.fusesource.restygwt.rebind.util,0,0,0,0,1,0,0,1
resty-gwt_resty-gwt,org.fusesource.restygwt.client.basic,0,0,0,1,1,0,0,2
resty-gwt_resty-gwt,org.fusesource.restygwt.client.codec,0,0,0,1,1,0,0,2
resty-gwt_resty-gwt,org.fusesource.restygwt.client.complex,0,0,0,0,1,0,0,1
resty-gwt_resty-gwt,org.fusesource.restygwt.client.complex.string.service,0,0,0,0,0,0,0,0
resty-gwt_resty-gwt,org.fusesource.restygwt.client.complex.string,0,0,0,0,0,0,0,0
resty-gwt_resty-gwt,org.fusesource.restygwt.client.event,0,0,0,0,0,0,0,0
resty-gwt_resty-gwt,org.fusesource.restygwt.client.event.type,0,0,0,0,0,0,0,0
resty-gwt_resty-gwt,org.fusesource.restygwt.example.client.dispatcher,0,0,0,0,0,0,0,0
resty-gwt_resty-gwt,org.fusesource.restygwt.example.client.event,0,0,0,0,0,0,0,0
resty-gwt_resty-gwt,org.fusesource.restygwt,0,0,0,0,0,0,0,0
resty-gwt_resty-gwt,org.fusesource.restygwt.mocking,0,0,0,0,0,0,0,0
resty-gwt_resty-gwt,org.fusesource.restygwt.server.basic,0,0,0,0,0,0,0,0
resty-gwt_resty-gwt,org.fusesource.restygwt.server,0,0,0,0,0,0,0,0
resty-gwt_resty-gwt,org.fusesource.restygwt.server.complex,0,0,0,0,1,0,0,1
resty-gwt_resty-gwt,org.fusesource.restygwt.server.event,0,0,0,0,0,0,0,0
resty-gwt_resty-gwt,org.fusesource.restygwt.examples.client,0,0,0,1,1,0,0,2
resty-gwt_resty-gwt,org.fusesource.restygwt.examples.server,0,0,0,0,1,0,0,1
revapi_revapi,org.revapi,2,1,0,1,0,0,0,4
revapi_revapi,org.revapi.configuration,1,0,0,0,0,0,0,1
revapi_revapi,org.revapi.query,1,0,0,0,0,0,0,1
revapi_revapi,org.revapi.simple,0,0,0,0,1,0,0,1
revapi_revapi,org.revapi.ant,0,0,0,0,0,0,0,0
revapi_revapi,org.revapi.basic,0,0,0,0,1,0,0,1
revapi_revapi,comparison.annotations,0,0,0,0,0,0,0,0
revapi_revapi,comparison.classes,0,0,0,1,1,0,0,2
revapi_revapi,comparison.fields,0,0,0,0,1,0,0,1
revapi_revapi,comparison.methods,0,0,0,0,1,0,0,1
revapi_revapi,org.revapi.java,3,0,0,1,0,0,0,4
revapi_revapi,org.revapi.java.checks.annotations,0,0,0,0,0,0,0,0
revapi_revapi,org.revapi.java.checks.classes,0,0,0,0,1,0,0,1
revapi_revapi,org.revapi.java.checks.common,0,0,0,0,0,0,0,0
revapi_revapi,org.revapi.java.checks.fields,0,0,0,0,1,0,0,1
revapi_revapi,org.revapi.java.checks.generics,0,0,0,0,0,0,0,0
revapi_revapi,org.revapi.java.checks.methods,0,0,0,0,1,0,0,1
revapi_revapi,org.revapi.java.compilation,3,1,0,0,0,0,0,4
revapi_revapi,org.revapi.java.extract,0,0,0,0,0,0,0,0
revapi_revapi,org.revapi.java.filters,0,0,0,0,0,0,0,0
revapi_revapi,org.revapi.java.model,3,1,0,0,1,0,0,5
revapi_revapi,org.revapi.java.transforms.annotations,0,0,0,0,1,0,0,1
revapi_revapi,org.revapi.java.transforms.methods,0,0,0,0,0,0,0,0
revapi_revapi,org.revapi.java.suid,0,0,0,0,0,0,0,0
revapi_revapi,annotationfilter,0,0,0,0,0,0,0,0
revapi_revapi,classfilter,0,0,0,0,1,0,0,1
revapi_revapi,misc,0,0,0,0,1,0,0,1
revapi_revapi,(default package),0,0,0,1,1,0,0,2
revapi_revapi,packagefilter.a.a.a,0,0,0,0,0,0,0,0
revapi_revapi,packagefilter.a.b,0,0,0,0,0,0,0,0
revapi_revapi,packagefilter.b.a,0,0,0,0,0,0,0,0
revapi_revapi,packagefilter.b.b,0,0,0,0,0,0,0,0
revapi_revapi,org.revapi.java.spi,0,1,0,0,1,0,0,2
revapi_revapi,pkg1.pkg2,0,0,0,0,0,0,0,0
revapi_revapi,org.revapi.maven,0,0,0,1,1,0,0,2
revapi_revapi,org.revapi.maven.utils,0,0,0,0,0,0,0,0
revapi_revapi,org.revapi.reporter.text,0,0,0,0,0,0,0,0
revapi_revapi,org.revapi.standalone,0,0,0,0,0,0,0,0
reveal-technologies_sitewhere,com.sitewhere.asset,0,0,0,0,0,0,0,0
reveal-technologies_sitewhere,com.sitewhere.asset.configuration,0,0,0,0,0,0,0,0
reveal-technologies_sitewhere,com.sitewhere.asset.grpc,0,0,0,0,0,0,0,0
reveal-technologies_sitewhere,com.sitewhere.asset.initializer,0,0,0,0,0,0,0,0
reveal-technologies_sitewhere,com.sitewhere.asset.microservice,0,0,0,0,0,0,0,0
reveal-technologies_sitewhere,com.sitewhere.asset.modules.wso2.ksoap2,0,0,0,0,0,0,0,0
reveal-technologies_sitewhere,com.sitewhere.asset.modules.wso2.scim,0,0,0,0,0,0,0,0
reveal-technologies_sitewhere,com.sitewhere.asset.modules.wso2.ws,0,0,0,1,0,0,0,1
reveal-technologies_sitewhere,com.sitewhere.asset.persistence,0,0,0,0,0,0,0,0
reveal-technologies_sitewhere,com.sitewhere.asset.persistence.mongodb,0,0,0,0,1,0,0,1
reveal-technologies_sitewhere,com.sitewhere.asset.spi.grpc,0,0,0,0,0,0,0,0
reveal-technologies_sitewhere,com.sitewhere.asset.spi,0,0,0,0,0,0,0,0
reveal-technologies_sitewhere,com.sitewhere.asset.spi.microservice,0,0,0,0,0,0,0,0
reveal-technologies_sitewhere,com.sitewhere.asset.spring,0,0,0,0,0,0,0,0
reveal-technologies_sitewhere,com.sitewhere.batch,0,0,0,0,1,0,0,1
reveal-technologies_sitewhere,com.sitewhere.batch.configuration,0,0,0,0,0,0,0,0
reveal-technologies_sitewhere,com.sitewhere.batch.handler,0,0,0,0,0,0,0,0
reveal-technologies_sitewhere,com.sitewhere.batch.microservice,0,0,0,0,0,0,0,0
reveal-technologies_sitewhere,com.sitewhere.batch.persistence,0,1,0,0,0,0,0,1
reveal-technologies_sitewhere,com.sitewhere.batch.persistence.mongodb,0,0,0,0,1,0,0,1
reveal-technologies_sitewhere,com.sitewhere.batch.spi.grpc,0,0,0,0,0,0,0,0
reveal-technologies_sitewhere,com.sitewhere.batch.spi,0,0,0,0,0,0,0,0
reveal-technologies_sitewhere,com.sitewhere.batch.spi.kafka,0,0,0,0,0,0,0,0
reveal-technologies_sitewhere,com.sitewhere.batch.spi.microservice,0,0,0,0,0,0,0,0
reveal-technologies_sitewhere,com.sitewhere.batch.spring,0,0,0,0,0,0,0,0
reveal-technologies_sitewhere,com.sitewhere.microservice.grpc,0,0,0,0,1,0,0,1
reveal-technologies_sitewhere,com.sitewhere.microservice.kafka,0,0,0,1,0,0,0,1
reveal-technologies_sitewhere,com.sitewhere.commands,0,0,0,0,1,0,0,1
reveal-technologies_sitewhere,com.sitewhere.commands.configuration,0,0,0,0,0,0,0,0
reveal-technologies_sitewhere,com.sitewhere.commands.destination.coap,0,0,0,0,0,0,0,0
reveal-technologies_sitewhere,com.sitewhere.commands.destination,0,0,0,0,0,0,0,0
reveal-technologies_sitewhere,com.sitewhere.commands.destination.mqtt,0,0,0,0,0,0,0,0
reveal-technologies_sitewhere,com.sitewhere.commands.destination.sms,0,0,0,0,0,0,0,0
reveal-technologies_sitewhere,com.sitewhere.commands.encoding,0,0,0,0,0,0,0,0
reveal-technologies_sitewhere,com.sitewhere.commands.encoding.json,0,0,0,0,0,0,0,0
reveal-technologies_sitewhere,com.sitewhere.commands.encoding.protobuf,0,0,0,0,0,0,0,0
reveal-technologies_sitewhere,com.sitewhere.commands.encoding.string,0,0,0,0,0,0,0,0
reveal-technologies_sitewhere,com.sitewhere.commands.groovy,0,0,0,0,0,0,0,0
reveal-technologies_sitewhere,com.sitewhere.commands.microservice,0,0,0,0,0,0,0,0
reveal-technologies_sitewhere,com.sitewhere.commands.routing,0,0,0,0,0,0,0,0
reveal-technologies_sitewhere,com.sitewhere.commands.spi,0,0,0,0,1,0,0,1
reveal-technologies_sitewhere,com.sitewhere.commands.spi.kafka,0,0,0,0,0,0,0,0
reveal-technologies_sitewhere,com.sitewhere.commands.spi.microservice,0,0,0,0,0,0,0,0
reveal-technologies_sitewhere,com.sitewhere.commands.spring,0,0,0,0,0,0,0,0
reveal-technologies_sitewhere,com.sitewhere.commands.twilio,0,0,0,0,0,0,0,0
reveal-technologies_sitewhere,com.sitewhere.device.configuration,0,0,0,0,0,0,0,0
reveal-technologies_sitewhere,com.sitewhere.device,0,0,0,0,0,0,0,0
reveal-technologies_sitewhere,com.sitewhere.device.initializer,0,0,0,0,0,0,0,0
reveal-technologies_sitewhere,com.sitewhere.device.microservice,0,0,0,0,0,0,0,0
reveal-technologies_sitewhere,com.sitewhere.device.persistence,0,0,0,0,0,0,0,0
reveal-technologies_sitewhere,com.sitewhere.device.persistence.mongodb,0,0,0,0,0,0,0,0
reveal-technologies_sitewhere,com.sitewhere.device.spi.grpc,0,0,0,0,0,0,0,0
reveal-technologies_sitewhere,com.sitewhere.device.spi.initializer,0,0,0,0,0,0,0,0
reveal-technologies_sitewhere,com.sitewhere.device.spi.kafka,0,0,0,0,0,0,0,0
reveal-technologies_sitewhere,com.sitewhere.device.spi.microservice,0,0,0,0,0,0,0,0
reveal-technologies_sitewhere,com.sitewhere.device.spring,0,0,0,0,0,0,0,0
reveal-technologies_sitewhere,com.sitewhere.registration.configuration,0,0,0,0,0,0,0,0
reveal-technologies_sitewhere,com.sitewhere.registration,0,0,0,0,0,0,0,0
reveal-technologies_sitewhere,com.sitewhere.registration.microservice,0,0,0,0,0,0,0,0
reveal-technologies_sitewhere,com.sitewhere.registration.spi,0,0,0,0,0,0,0,0
reveal-technologies_sitewhere,com.sitewhere.registration.spi.kafka,0,0,0,0,0,0,0,0
reveal-technologies_sitewhere,com.sitewhere.registration.spi.microservice,0,0,0,0,0,0,0,0
reveal-technologies_sitewhere,com.sitewhere.registration.spring,0,0,0,0,0,0,0,0
reveal-technologies_sitewhere,com.sitewhere.devicestate.configuration,0,0,0,0,0,0,0,0
reveal-technologies_sitewhere,com.sitewhere.devicestate,0,0,0,0,0,0,0,0
reveal-technologies_sitewhere,com.sitewhere.devicestate.microservice,0,0,0,0,0,0,0,0
reveal-technologies_sitewhere,com.sitewhere.devicestate.persistence,0,0,0,0,0,0,0,0
reveal-technologies_sitewhere,com.sitewhere.devicestate.persistence.mongodb,0,0,0,0,0,0,0,0
reveal-technologies_sitewhere,com.sitewhere.devicestate.presence,0,0,0,0,0,0,0,0
reveal-technologies_sitewhere,com.sitewhere.devicestate.processing,0,0,0,0,0,0,0,0
reveal-technologies_sitewhere,com.sitewhere.devicestate.spi.grpc,0,0,0,0,0,0,0,0
reveal-technologies_sitewhere,com.sitewhere.devicestate.spi,0,0,0,0,0,0,0,0
reveal-technologies_sitewhere,com.sitewhere.devicestate.spi.kafka,0,0,0,0,0,0,0,0
reveal-technologies_sitewhere,com.sitewhere.devicestate.spi.microservice,0,0,0,0,0,0,0,0
reveal-technologies_sitewhere,com.sitewhere.devicestate.spi.processing,0,0,0,0,0,0,0,0
reveal-technologies_sitewhere,com.sitewhere.devicestate.spring,0,0,0,0,0,0,0,0
reveal-technologies_sitewhere,com.sitewhere.event.configuration,0,0,0,0,0,0,0,0
reveal-technologies_sitewhere,com.sitewhere.event,0,0,0,0,0,0,0,0
reveal-technologies_sitewhere,com.sitewhere.event.initializer,0,0,0,0,0,0,0,0
reveal-technologies_sitewhere,com.sitewhere.event.microservice,0,0,0,0,0,0,0,0
reveal-technologies_sitewhere,com.sitewhere.event.persistence.cassandra,0,0,0,0,0,0,0,0
reveal-technologies_sitewhere,com.sitewhere.event.persistence,0,0,0,0,0,0,0,0
reveal-technologies_sitewhere,com.sitewhere.event.persistence.influxdb,0,0,0,0,0,0,0,0
reveal-technologies_sitewhere,com.sitewhere.event.persistence.mongodb,0,0,0,0,0,0,0,0
reveal-technologies_sitewhere,com.sitewhere.event.processing,0,0,0,0,0,0,0,0
reveal-technologies_sitewhere,com.sitewhere.event.spi.grpc,0,0,0,0,0,0,0,0
reveal-technologies_sitewhere,com.sitewhere.event.spi.initializer,0,0,0,0,0,0,0,0
reveal-technologies_sitewhere,com.sitewhere.event.spi.kafka,0,0,0,0,0,0,0,0
reveal-technologies_sitewhere,com.sitewhere.event.spi.microservice,0,0,0,0,0,0,0,0
reveal-technologies_sitewhere,com.sitewhere.event.spring,0,0,0,0,0,0,0,0
reveal-technologies_sitewhere,com.sitewhere.search.configuration,0,0,0,0,0,0,0,0
reveal-technologies_sitewhere,com.sitewhere.search,0,0,0,0,0,0,0,0
reveal-technologies_sitewhere,com.sitewhere.search.microservice,0,0,0,0,0,0,0,0
reveal-technologies_sitewhere,com.sitewhere.search.solr,0,0,0,0,0,0,0,0
reveal-technologies_sitewhere,com.sitewhere.search.spi,0,0,0,0,0,0,0,0
reveal-technologies_sitewhere,com.sitewhere.search.spi.microservice,0,0,0,0,0,0,0,0
reveal-technologies_sitewhere,com.sitewhere.search.spring,0,0,0,0,0,0,0,0
reveal-technologies_sitewhere,com.sitewhere.sources.activemq,0,0,0,0,1,0,0,1
reveal-technologies_sitewhere,com.sitewhere.sources.azure,0,0,0,0,0,0,0,0
reveal-technologies_sitewhere,com.sitewhere.sources,0,1,0,0,1,0,0,2
reveal-technologies_sitewhere,com.sitewhere.sources.coap,0,0,0,0,0,0,0,0
reveal-technologies_sitewhere,com.sitewhere.sources.configuration,0,0,0,0,0,0,0,0
reveal-technologies_sitewhere,com.sitewhere.sources.decoder.coap,0,1,0,0,0,0,0,1
reveal-technologies_sitewhere,com.sitewhere.sources.decoder.composite,0,0,0,0,1,0,0,1
reveal-technologies_sitewhere,com.sitewhere.sources.decoder.debug,0,0,0,0,0,0,0,0
reveal-technologies_sitewhere,com.sitewhere.sources.decoder,0,0,0,0,0,0,0,0
reveal-technologies_sitewhere,com.sitewhere.sources.decoder.json,0,1,0,0,0,0,0,1
reveal-technologies_sitewhere,com.sitewhere.sources.decoder.protobuf,0,0,0,0,0,0,0,0
reveal-technologies_sitewhere,com.sitewhere.sources.deduplicator,0,0,0,0,0,0,0,0
reveal-technologies_sitewhere,com.sitewhere.sources.microservice,0,0,0,0,0,0,0,0
reveal-technologies_sitewhere,com.sitewhere.sources.mqtt,0,0,0,0,1,0,0,1
reveal-technologies_sitewhere,com.sitewhere.sources.rabbitmq,0,0,0,0,0,0,0,0
reveal-technologies_sitewhere,com.sitewhere.sources.rest,0,0,0,0,0,0,0,0
reveal-technologies_sitewhere,com.sitewhere.sources.socket,0,0,0,0,1,0,0,1
reveal-technologies_sitewhere,com.sitewhere.sources.spi,0,0,0,0,1,0,0,1
reveal-technologies_sitewhere,com.sitewhere.sources.spi.microservice,0,0,0,0,0,0,0,0
reveal-technologies_sitewhere,com.sitewhere.sources.spi.socket,0,0,0,0,0,0,0,0
reveal-technologies_sitewhere,com.sitewhere.sources.spring,0,0,0,0,0,0,0,0
reveal-technologies_sitewhere,com.sitewhere.sources.websocket,0,0,0,0,1,0,0,1
reveal-technologies_sitewhere,com.sitewhere.inbound.configuration,0,0,0,0,0,0,0,0
reveal-technologies_sitewhere,com.sitewhere.inbound,0,0,0,0,0,0,0,0
reveal-technologies_sitewhere,com.sitewhere.inbound.microservice,0,0,0,0,0,0,0,0
reveal-technologies_sitewhere,com.sitewhere.inbound.processing,0,0,0,0,0,0,0,0
reveal-technologies_sitewhere,com.sitewhere.inbound.spi,0,0,0,0,0,0,0,0
reveal-technologies_sitewhere,com.sitewhere.inbound.spi.kafka,0,0,0,0,0,0,0,0
reveal-technologies_sitewhere,com.sitewhere.inbound.spi.microservice,0,0,0,0,0,0,0,0
reveal-technologies_sitewhere,com.sitewhere.inbound.spi.processing,0,0,0,0,0,0,0,0
reveal-technologies_sitewhere,com.sitewhere.inbound.spring,0,0,0,0,0,0,0,0
reveal-technologies_sitewhere,com.sitewhere.instance.configuration,0,0,0,0,0,0,0,0
reveal-technologies_sitewhere,com.sitewhere.instance.initializer,0,0,0,0,0,0,0,0
reveal-technologies_sitewhere,com.sitewhere.instance,0,0,0,0,0,0,0,0
reveal-technologies_sitewhere,com.sitewhere.instance.microservice,0,0,0,0,0,0,0,0
reveal-technologies_sitewhere,com.sitewhere.instance.spi.initializer,0,0,0,0,0,0,0,0
reveal-technologies_sitewhere,com.sitewhere.instance.spi.instance.grpc,0,0,0,0,0,0,0,0
reveal-technologies_sitewhere,com.sitewhere.instance.spi.microservice,0,0,0,0,0,0,0,0
reveal-technologies_sitewhere,com.sitewhere.instance.spi.templates,0,0,0,0,0,0,0,0
reveal-technologies_sitewhere,com.sitewhere.instance.spi.tenant.grpc,0,0,0,0,0,0,0,0
reveal-technologies_sitewhere,com.sitewhere.instance.spi.tenant.kafka,0,0,0,0,0,0,0,0
reveal-technologies_sitewhere,com.sitewhere.instance.spi.tenant.templates,0,0,0,0,0,0,0,0
reveal-technologies_sitewhere,com.sitewhere.instance.spi.user.grpc,0,0,0,0,0,0,0,0
reveal-technologies_sitewhere,com.sitewhere.instance.templates,0,0,0,0,0,0,0,0
reveal-technologies_sitewhere,com.sitewhere.instance.tenant.templates,0,0,0,0,0,0,0,0
reveal-technologies_sitewhere,com.sitewhere.instance.user.persistence,0,0,0,0,0,0,0,0
reveal-technologies_sitewhere,com.sitewhere.microservice.grpc.instance,0,0,0,0,0,0,0,0
reveal-technologies_sitewhere,com.sitewhere.microservice.grpc.tenant,0,0,0,0,0,0,0,0
reveal-technologies_sitewhere,com.sitewhere.microservice.grpc.user,0,0,0,0,0,0,0,0
reveal-technologies_sitewhere,com.sitewhere.microservice.kafka.tenant,0,0,0,0,0,0,0,0
reveal-technologies_sitewhere,com.sitewhere.microservice.kafka.user,0,0,0,0,0,0,0,0
reveal-technologies_sitewhere,com.sitewhere.labels.configuration,0,0,0,0,0,0,0,0
reveal-technologies_sitewhere,com.sitewhere.labels,0,0,0,0,0,0,0,0
reveal-technologies_sitewhere,com.sitewhere.labels.microservice,0,0,0,0,0,0,0,0
reveal-technologies_sitewhere,com.sitewhere.labels.spi.grpc,0,0,0,0,0,0,0,0
reveal-technologies_sitewhere,com.sitewhere.labels.spi.microservice,0,0,0,0,0,0,0,0
reveal-technologies_sitewhere,com.sitewhere.labels.spring,0,0,0,0,0,0,0,0
reveal-technologies_sitewhere,com.sitewhere.labels.symbology,0,0,0,0,0,0,0,0
reveal-technologies_sitewhere,com.sitewhere.connectors.aws.sqs,0,0,0,0,0,0,0,0
reveal-technologies_sitewhere,com.sitewhere.connectors.azure,0,0,0,0,0,0,0,0
reveal-technologies_sitewhere,com.sitewhere.connectors.configuration,0,0,0,0,0,0,0,0
reveal-technologies_sitewhere,com.sitewhere.connectors.dweetio,0,0,0,0,0,0,0,0
reveal-technologies_sitewhere,com.sitewhere.connectors.filter,0,0,0,0,0,0,0,0
reveal-technologies_sitewhere,com.sitewhere.connectors,0,1,0,0,0,0,0,1
reveal-technologies_sitewhere,com.sitewhere.connectors.groovy.common,0,0,0,0,0,0,0,0
reveal-technologies_sitewhere,com.sitewhere.connectors.groovy.filter,0,0,0,0,0,0,0,0
reveal-technologies_sitewhere,com.sitewhere.connectors.groovy,0,0,0,0,0,0,0,0
reveal-technologies_sitewhere,com.sitewhere.connectors.groovy.multicast,0,0,0,0,0,0,0,0
reveal-technologies_sitewhere,com.sitewhere.connectors.groovy.routing,0,0,0,0,0,0,0,0
reveal-technologies_sitewhere,com.sitewhere.connectors.http,0,0,0,0,0,0,0,0
reveal-technologies_sitewhere,com.sitewhere.connectors.initialstate,0,0,0,0,0,0,0,0
reveal-technologies_sitewhere,com.sitewhere.connectors.microservice,0,0,0,0,0,0,0,0
reveal-technologies_sitewhere,com.sitewhere.connectors.mqtt,0,0,0,0,0,0,0,0
reveal-technologies_sitewhere,com.sitewhere.connectors.rabbitmq,0,0,0,0,0,0,0,0
reveal-technologies_sitewhere,com.sitewhere.connectors.solr,0,0,0,0,0,0,0,0
reveal-technologies_sitewhere,com.sitewhere.connectors.spi.common,0,0,0,0,0,0,0,0
reveal-technologies_sitewhere,com.sitewhere.connectors.spi,0,0,0,0,1,0,0,1
reveal-technologies_sitewhere,com.sitewhere.connectors.spi.microservice,0,0,0,0,0,0,0,0
reveal-technologies_sitewhere,com.sitewhere.connectors.spi.multicast,0,0,0,0,0,0,0,0
reveal-technologies_sitewhere,com.sitewhere.connectors.spi.routing,0,0,0,0,0,0,0,0
reveal-technologies_sitewhere,com.sitewhere.connectors.spring,0,0,0,0,0,0,0,0
reveal-technologies_sitewhere,com.sitewhere.rules.configuration,0,0,0,0,0,0,0,0
reveal-technologies_sitewhere,com.sitewhere.rules.microservice,0,0,0,0,0,0,0,0
reveal-technologies_sitewhere,com.sitewhere.rules.processors.geospatial,0,0,0,0,0,0,0,0
reveal-technologies_sitewhere,com.sitewhere.rules,0,1,0,0,0,0,0,1
reveal-technologies_sitewhere,com.sitewhere.rules.spi,0,0,0,0,0,0,0,0
reveal-technologies_sitewhere,com.sitewhere.rules.spi.microservice,0,0,0,0,0,0,0,0
reveal-technologies_sitewhere,com.sitewhere.rules.spring,0,0,0,0,0,0,0,0
reveal-technologies_sitewhere,com.sitewhere.schedule.configuration,0,0,0,0,0,0,0,0
reveal-technologies_sitewhere,com.sitewhere.schedule,1,1,0,0,1,0,0,3
reveal-technologies_sitewhere,com.sitewhere.schedule.initializer,0,0,0,0,0,0,0,0
reveal-technologies_sitewhere,com.sitewhere.schedule.jobs,1,0,0,0,0,0,0,1
reveal-technologies_sitewhere,com.sitewhere.schedule.microservice,0,0,0,0,0,0,0,0
reveal-technologies_sitewhere,com.sitewhere.schedule.persistence.mongodb,0,0,0,0,1,0,0,1
reveal-technologies_sitewhere,com.sitewhere.schedule.persistence,0,0,0,0,0,0,0,0
reveal-technologies_sitewhere,com.sitewhere.schedule.spi.grpc,0,0,0,0,0,0,0,0
reveal-technologies_sitewhere,com.sitewhere.schedule.spi.initializer,0,0,0,0,0,0,0,0
reveal-technologies_sitewhere,com.sitewhere.schedule.spi,0,0,0,0,0,0,0,0
reveal-technologies_sitewhere,com.sitewhere.schedule.spi.microservice,0,0,0,0,0,0,0,0
reveal-technologies_sitewhere,com.sitewhere.schedule.spring,0,0,0,0,0,0,0,0
reveal-technologies_sitewhere,com.sitewhere.media.configuration,0,0,0,0,0,0,0,0
reveal-technologies_sitewhere,com.sitewhere.media,0,0,0,0,0,0,0,0
reveal-technologies_sitewhere,com.sitewhere.media.microservice,0,0,0,0,0,0,0,0
reveal-technologies_sitewhere,com.sitewhere.media.persistence.cassandra,0,0,0,0,0,0,0,0
reveal-technologies_sitewhere,com.sitewhere.media.persistence,0,0,0,0,0,0,0,0
reveal-technologies_sitewhere,com.sitewhere.media.persistence.influxdb,0,0,0,0,0,0,0,0
reveal-technologies_sitewhere,com.sitewhere.media.persistence.mongodb,0,0,0,0,1,0,0,1
reveal-technologies_sitewhere,com.sitewhere.media.spi.microservice,0,0,0,0,0,0,0,0
reveal-technologies_sitewhere,com.sitewhere.media.spring,0,0,0,0,0,0,0,0
reveal-technologies_sitewhere,com.sitewhere.web.auth.controllers,0,0,0,0,0,0,0,0
reveal-technologies_sitewhere,com.sitewhere.web.auth,0,0,0,0,0,0,0,0
reveal-technologies_sitewhere,com.sitewhere.web.configuration,0,0,0,0,0,0,0,0
reveal-technologies_sitewhere,com.sitewhere.web.filters,0,0,0,0,1,0,0,1
reveal-technologies_sitewhere,com.sitewhere.web.microservice,0,0,0,0,0,0,0,0
reveal-technologies_sitewhere,com.sitewhere.web,0,0,0,0,0,0,0,0
reveal-technologies_sitewhere,com.sitewhere.web.rest.controllers,0,0,0,0,1,0,0,1
reveal-technologies_sitewhere,com.sitewhere.web.rest.marshaling,0,0,0,0,0,0,0,0
reveal-technologies_sitewhere,com.sitewhere.web.rest.model,0,0,0,0,0,0,0,0
reveal-technologies_sitewhere,com.sitewhere.web.rest,0,0,0,0,0,0,0,0
reveal-technologies_sitewhere,com.sitewhere.web.rest.view,0,0,0,0,0,0,0,0
reveal-technologies_sitewhere,com.sitewhere.web.security,0,0,0,0,1,0,0,1
reveal-technologies_sitewhere,com.sitewhere.web.security.basic,0,0,0,0,0,0,0,0
reveal-technologies_sitewhere,com.sitewhere.web.security.jwt,0,0,0,0,0,0,0,0
reveal-technologies_sitewhere,com.sitewhere.web.spi.microservice,0,0,0,0,0,0,0,0
reveal-technologies_sitewhere,com.sitewhere.web.spring,0,0,0,0,0,0,0,0
reveal-technologies_sitewhere,com.sitewhere.web.ws.components.topology,0,0,0,0,0,0,0,0
reveal-technologies_sitewhere,com.sitewhere.web.ws.components,0,0,0,0,0,0,0,0
reveal-technologies_sitewhere,com.sitewhere.web.ws,0,0,0,0,0,0,0,0
reveal-technologies_sitewhere,com.sitewhere.cassandra,0,0,0,0,0,0,0,0
reveal-technologies_sitewhere,com.sitewhere.communication.mqtt,0,0,0,0,0,0,0,0
reveal-technologies_sitewhere,com.sitewhere.communication.protobuf,0,0,0,0,0,0,0,0
reveal-technologies_sitewhere,com.sitewhere.configuration,0,0,0,0,0,0,0,0
reveal-technologies_sitewhere,com.sitewhere.configuration.content,0,0,0,0,0,0,0,0
reveal-technologies_sitewhere,com.sitewhere.configuration.datastore,0,0,0,0,0,0,0,0
reveal-technologies_sitewhere,com.sitewhere.configuration.instance.cassandra,0,0,0,0,0,0,0,0
reveal-technologies_sitewhere,com.sitewhere.configuration.instance.influxdb,0,0,0,0,0,0,0,0
reveal-technologies_sitewhere,com.sitewhere.configuration.instance.mongodb,0,0,0,0,0,0,0,0
reveal-technologies_sitewhere,com.sitewhere.configuration.instance.solr,0,0,0,0,0,0,0,0
reveal-technologies_sitewhere,com.sitewhere.configuration.model,0,0,0,0,0,0,0,0
reveal-technologies_sitewhere,com.sitewhere.configuration.old,0,0,0,0,0,0,0,0
reveal-technologies_sitewhere,com.sitewhere.configuration.parser,0,0,0,0,1,0,0,1
reveal-technologies_sitewhere,com.sitewhere.asset.marshaling,0,0,0,0,0,0,0,0
reveal-technologies_sitewhere,com.sitewhere.batch.marshaling,0,0,0,0,0,0,0,0
reveal-technologies_sitewhere,com.sitewhere.core,0,0,0,0,0,0,0,0
reveal-technologies_sitewhere,com.sitewhere.device.charting,0,0,0,0,0,0,0,0
reveal-technologies_sitewhere,com.sitewhere.device.group,0,0,0,0,0,0,0,0
reveal-technologies_sitewhere,com.sitewhere.device.marshaling,0,0,0,0,0,0,0,0
reveal-technologies_sitewhere,com.sitewhere.device.marshaling.invalid,0,0,0,0,0,0,0,0
reveal-technologies_sitewhere,com.sitewhere.geospatial,0,0,0,0,0,0,0,0
reveal-technologies_sitewhere,com.sitewhere.groovy,0,0,0,0,0,0,0,0
reveal-technologies_sitewhere,com.sitewhere.persistence,0,0,0,0,0,0,0,0
reveal-technologies_sitewhere,com.sitewhere.security,0,0,0,0,0,0,0,0
reveal-technologies_sitewhere,com.sitewhere.server,0,0,0,0,0,0,0,0
reveal-technologies_sitewhere,com.sitewhere.tenant,0,0,0,0,0,0,0,0
reveal-technologies_sitewhere,com.sitewhere.user,0,0,0,0,0,0,0,0
reveal-technologies_sitewhere,com.sitewhere,0,0,0,0,0,0,0,0
reveal-technologies_sitewhere,com.sitewhere.common,0,0,0,0,0,0,0,0
reveal-technologies_sitewhere,com.sitewhere.rest.model.asset.request.scripting,0,0,0,0,0,0,0,0
reveal-technologies_sitewhere,com.sitewhere.rest.model.configuration,0,0,0,0,1,0,0,1
reveal-technologies_sitewhere,com.sitewhere.rest.model.device.asset,0,0,0,0,0,0,0,0
reveal-technologies_sitewhere,com.sitewhere.rest.model.device.event.request.scripting,0,0,0,0,0,0,0,0
reveal-technologies_sitewhere,com.sitewhere.rest.model.device.request.scripting,0,0,0,0,0,0,0,0
reveal-technologies_sitewhere,com.sitewhere.rest.model.microservice.scripting,0,0,0,0,0,0,0,0
reveal-technologies_sitewhere,com.sitewhere.rest.model.microservice.state,0,0,0,0,1,0,0,1
reveal-technologies_sitewhere,com.sitewhere.rest.model.monitoring,0,0,0,0,0,0,0,0
reveal-technologies_sitewhere,com.sitewhere.rest.model.resource,0,0,0,0,0,0,0,0
reveal-technologies_sitewhere,com.sitewhere.rest.model.resource.request,0,0,0,0,0,0,0,0
reveal-technologies_sitewhere,com.sitewhere.rest.model.scheduling.request.scripting,0,0,0,0,0,0,0,0
reveal-technologies_sitewhere,com.sitewhere.rest.model.search.external,0,0,0,0,0,0,0,0
reveal-technologies_sitewhere,com.sitewhere.rest.model,0,0,0,0,0,0,0,0
reveal-technologies_sitewhere,com.sitewhere.rest.model.tenant,0,0,0,0,0,0,0,0
reveal-technologies_sitewhere,com.sitewhere.rest.model.tenant.request.scripting,0,0,0,0,0,0,0,0
reveal-technologies_sitewhere,com.sitewhere.rest.model.user.request,0,0,0,0,0,0,0,0
reveal-technologies_sitewhere,com.sitewhere.spi.asset,0,0,0,0,0,0,0,0
reveal-technologies_sitewhere,com.sitewhere.spi.batch,0,0,0,0,0,0,0,0
reveal-technologies_sitewhere,com.sitewhere.spi.configuration,0,0,0,0,0,0,0,0
reveal-technologies_sitewhere,com.sitewhere.spi.device.communication,0,0,0,0,0,0,0,0
reveal-technologies_sitewhere,com.sitewhere.spi.device.event,0,0,0,0,0,0,0,0
reveal-technologies_sitewhere,com.sitewhere.spi.device,0,0,0,0,0,0,0,0
reveal-technologies_sitewhere,com.sitewhere.spi.device.state,0,0,0,0,0,0,0,0
reveal-technologies_sitewhere,com.sitewhere.spi.device.streaming,0,0,0,0,0,0,0,0
reveal-technologies_sitewhere,com.sitewhere.spi.instance,0,0,0,0,0,0,0,0
reveal-technologies_sitewhere,com.sitewhere.spi,0,0,0,0,0,0,0,0
reveal-technologies_sitewhere,com.sitewhere.spi.label,0,0,0,0,0,0,0,0
reveal-technologies_sitewhere,com.sitewhere.spi.microservice.configuration,1,0,0,0,0,0,0,1
reveal-technologies_sitewhere,com.sitewhere.spi.microservice.configuration.model,0,0,0,0,1,0,0,1
reveal-technologies_sitewhere,com.sitewhere.spi.microservice.groovy,0,0,0,0,0,0,0,0
reveal-technologies_sitewhere,com.sitewhere.spi.microservice.grpc,0,0,0,0,0,0,0,0
reveal-technologies_sitewhere,com.sitewhere.spi.microservice,0,0,0,0,1,0,0,1
reveal-technologies_sitewhere,com.sitewhere.spi.microservice.instance,0,0,0,0,0,0,0,0
reveal-technologies_sitewhere,com.sitewhere.spi.microservice.kafka,0,0,0,0,0,0,0,0
reveal-technologies_sitewhere,com.sitewhere.spi.microservice.kafka.tenant,0,0,0,0,0,0,0,0
reveal-technologies_sitewhere,com.sitewhere.spi.microservice.metrics,0,0,0,0,0,0,0,0
reveal-technologies_sitewhere,com.sitewhere.spi.microservice.multitenant,2,1,0,0,1,0,0,4
reveal-technologies_sitewhere,com.sitewhere.spi.microservice.scripting,0,0,0,0,1,0,0,1
reveal-technologies_sitewhere,com.sitewhere.spi.microservice.security,0,0,0,0,0,0,0,0
reveal-technologies_sitewhere,com.sitewhere.spi.microservice.spring,0,0,0,0,1,0,0,1
reveal-technologies_sitewhere,com.sitewhere.spi.microservice.state,0,0,0,0,1,0,0,1
reveal-technologies_sitewhere,com.sitewhere.spi.monitoring,0,0,0,0,0,0,0,0
reveal-technologies_sitewhere,com.sitewhere.spi.resource,0,0,0,0,0,0,0,0
reveal-technologies_sitewhere,com.sitewhere.spi.resource.request,0,0,0,0,0,0,0,0
reveal-technologies_sitewhere,com.sitewhere.spi.scheduling,0,0,0,0,0,0,0,0
reveal-technologies_sitewhere,com.sitewhere.spi.search,0,0,0,0,0,0,0,0
reveal-technologies_sitewhere,com.sitewhere.spi.security,0,0,0,0,0,0,0,0
reveal-technologies_sitewhere,com.sitewhere.spi.server,0,0,0,0,0,0,0,0
reveal-technologies_sitewhere,com.sitewhere.spi.server.lifecycle,2,1,0,0,1,0,0,4
reveal-technologies_sitewhere,com.sitewhere.spi.tenant,0,0,0,0,0,0,0,0
reveal-technologies_sitewhere,com.sitewhere.spi.user,0,0,0,0,0,0,0,0
reveal-technologies_sitewhere,com.sitewhere.server.lifecycle,0,0,0,0,1,0,0,1
reveal-technologies_sitewhere,com.sitewhere.server.lifecycle.parameters,0,0,0,0,0,0,0,0
reveal-technologies_sitewhere,com.sitewhere.grpc.client,0,1,0,0,1,0,0,2
reveal-technologies_sitewhere,com.sitewhere.grpc.client.asset,0,0,0,0,0,0,0,0
reveal-technologies_sitewhere,com.sitewhere.grpc.client.batch,0,0,0,0,0,0,0,0
reveal-technologies_sitewhere,com.sitewhere.grpc.client.cache,0,0,0,0,1,0,0,1
reveal-technologies_sitewhere,com.sitewhere.grpc.client.common.converter,0,0,0,0,0,0,0,0
reveal-technologies_sitewhere,com.sitewhere.grpc.client.common.marshaler,0,0,0,0,0,0,0,0
reveal-technologies_sitewhere,com.sitewhere.grpc.client.common.security,0,0,0,0,0,0,0,0
reveal-technologies_sitewhere,com.sitewhere.grpc.client.common.tracing,0,0,0,0,0,0,0,0
reveal-technologies_sitewhere,com.sitewhere.grpc.client.device,0,0,0,0,1,0,0,1
reveal-technologies_sitewhere,com.sitewhere.grpc.client.devicestate,0,0,0,0,0,0,0,0
reveal-technologies_sitewhere,com.sitewhere.grpc.client.event,0,1,0,0,1,0,0,2
reveal-technologies_sitewhere,com.sitewhere.grpc.client.instance,0,0,0,0,0,0,0,0
reveal-technologies_sitewhere,com.sitewhere.grpc.client.label,0,0,0,0,0,0,0,0
reveal-technologies_sitewhere,com.sitewhere.grpc.client.microservice,0,0,0,0,0,0,0,0
reveal-technologies_sitewhere,com.sitewhere.grpc.client.schedule,0,0,0,0,0,0,0,0
reveal-technologies_sitewhere,com.sitewhere.grpc.client.spi.cache,0,0,0,0,0,0,0,0
reveal-technologies_sitewhere,com.sitewhere.grpc.client.spi.client,0,0,0,0,1,0,0,1
reveal-technologies_sitewhere,com.sitewhere.grpc.client.spi,0,0,0,0,0,0,0,0
reveal-technologies_sitewhere,com.sitewhere.grpc.client.spi.multitenant,0,0,0,0,0,0,0,0
reveal-technologies_sitewhere,com.sitewhere.grpc.client.spi.server,0,0,0,0,0,0,0,0
reveal-technologies_sitewhere,com.sitewhere.grpc.client.stream,0,0,0,0,0,0,0,0
reveal-technologies_sitewhere,com.sitewhere.grpc.client.tenant,0,0,0,0,1,0,0,1
reveal-technologies_sitewhere,com.sitewhere.grpc.client.user,0,0,0,0,1,0,0,1
reveal-technologies_sitewhere,com.sitewhere.influxdb,0,0,0,0,0,0,0,0
reveal-technologies_sitewhere,com.sitewhere.microservice.configuration,0,0,0,0,1,0,0,1
reveal-technologies_sitewhere,com.sitewhere.microservice,0,0,0,0,1,0,0,1
reveal-technologies_sitewhere,com.sitewhere.microservice.groovy,0,0,0,0,0,0,0,0
reveal-technologies_sitewhere,com.sitewhere.microservice.health,0,0,0,0,0,0,0,0
reveal-technologies_sitewhere,com.sitewhere.microservice.instance,0,0,0,0,0,0,0,0
reveal-technologies_sitewhere,com.sitewhere.microservice.management,0,0,0,0,0,0,0,0
reveal-technologies_sitewhere,com.sitewhere.microservice.metrics,0,0,0,0,0,0,0,0
reveal-technologies_sitewhere,com.sitewhere.microservice.multitenant,0,0,0,0,1,0,0,1
reveal-technologies_sitewhere,com.sitewhere.microservice.scripting,0,0,0,0,1,0,0,1
reveal-technologies_sitewhere,com.sitewhere.microservice.security,0,0,0,0,1,0,0,1
reveal-technologies_sitewhere,com.sitewhere.microservice.spring,0,0,0,0,0,0,0,0
reveal-technologies_sitewhere,com.sitewhere.microservice.state,0,0,0,0,1,0,0,1
reveal-technologies_sitewhere,com.sitewhere.microservice.tenant.persistence,0,0,0,0,0,0,0,0
reveal-technologies_sitewhere,com.sitewhere.microservice.zookeeper,0,0,0,0,0,0,0,0
reveal-technologies_sitewhere,com.sitewhere.mongodb.common,0,0,0,0,0,0,0,0
reveal-technologies_sitewhere,com.sitewhere.mongodb,0,1,0,0,1,0,0,2
reveal-technologies_sitewhere,com.sitewhere.solr,0,0,0,0,0,0,0,0
rhlabs_louie,com.rhythm.louie.activemq,0,0,0,0,0,0,0,0
rhlabs_louie,$,0,0,0,0,0,0,0,0
rhlabs_louie,com.rhythm.louie.async,0,0,0,0,0,0,0,0
rhlabs_louie,com.rhythm.louie.cache,0,0,0,0,0,0,0,0
rhlabs_louie,com.rhythm.louie.client.connection,0,0,0,0,0,0,0,0
rhlabs_louie,com.rhythm.louie.connection,5,1,0,0,0,0,0,6
rhlabs_louie,com.rhythm.louie,0,0,0,0,0,0,0,0
rhlabs_louie,com.rhythm.louie.email,0,0,0,0,0,0,0,0
rhlabs_louie,com.rhythm.louie.exception,0,0,0,0,0,0,0,0
rhlabs_louie,com.rhythm.louie.jdbc,0,0,0,0,0,0,0,0
rhlabs_louie,com.rhythm.louie.jdbc.query,0,0,0,0,0,0,0,0
rhlabs_louie,com.rhythm.louie.jms,1,0,0,0,0,0,0,1
rhlabs_louie,com.rhythm.louie.pb,0,0,0,0,0,0,0,0
rhlabs_louie,com.rhythm.louie.request.data,0,0,0,0,1,0,0,1
rhlabs_louie,com.rhythm.louie.request,4,1,0,0,0,0,0,5
rhlabs_louie,com.rhythm.louie.server,7,1,0,0,0,0,0,8
rhlabs_louie,com.rhythm.louie.service,5,1,0,0,1,0,0,7
rhlabs_louie,com.rhythm.louie.service.command,4,1,0,0,0,0,0,5
rhlabs_louie,com.rhythm.louie.service.layer,3,0,0,0,0,0,0,3
rhlabs_louie,com.rhythm.louie.services.auth,2,0,0,0,1,0,0,3
rhlabs_louie,com.rhythm.louie.services.info,0,0,0,0,0,0,0,0
rhlabs_louie,com.rhythm.louie.services.sql,0,0,0,0,0,0,0,0
rhlabs_louie,com.rhythm.louie.services.status,0,0,0,0,0,0,0,0
rhlabs_louie,com.rhythm.louie.stream,0,0,0,0,0,0,0,0
rhlabs_louie,com.rhythm.louie.topology,0,0,0,0,0,0,0,0
rhlabs_louie,com.rhythm.louie.util,0,0,0,0,1,0,0,1
rhlabs_louie,com.rhythm.louie.util.tree,0,0,0,0,0,0,0,0
rhlabs_louie,com.rhythm.louie.json,0,0,0,0,0,0,0,0
rhlabs_louie,com.rhythm.util,0,0,0,0,1,0,0,1
rhlabs_louie,com.rhythm.util.tree,0,0,0,0,0,0,0,0
rhlabs_louie,com.rhythm.louie.clientgen,0,0,0,0,0,0,0,0
rhlabs_louie,com.rhythm.louie.devgen,0,0,0,0,0,0,0,0
rhlabs_louie,com.rhythm.louie.manifest,0,0,0,0,0,0,0,0
rhlabs_louie,com.rhythm.louie.pbcompiler,0,0,0,0,0,0,0,0
rhlabs_louie,com.rhythm.louie.generator,0,0,0,0,1,0,0,1
rhlabs_louie,com.rhythm.swagr.datasource,0,0,0,0,0,0,0,0
rhlabs_louie,com.rhythm.swagr,0,0,0,0,1,0,0,1
rhlabs_louie,com.rhythm.louie.info,0,0,0,0,0,0,0,0
rhlabs_louie,com.rhythm.louie.servlet,0,0,0,0,0,0,0,0
RichardWarburton_java-8-lambdas-exercises,com.insightfullogic.java8.answers.chapter2,0,0,0,0,0,0,0,0
RichardWarburton_java-8-lambdas-exercises,com.insightfullogic.java8.answers.chapter3,0,0,0,0,1,0,0,1
RichardWarburton_java-8-lambdas-exercises,com.insightfullogic.java8.answers.chapter4,0,0,0,0,0,0,0,0
RichardWarburton_java-8-lambdas-exercises,com.insightfullogic.java8.answers.chapter5,0,0,0,0,1,0,0,1
RichardWarburton_java-8-lambdas-exercises,com.insightfullogic.java8.answers.chapter6,0,0,0,0,1,0,0,1
RichardWarburton_java-8-lambdas-exercises,com.insightfullogic.java8.answers.chapter9,0,0,0,0,1,0,0,1
RichardWarburton_java-8-lambdas-exercises,com.insightfullogic.java8.examples.chapter1,0,0,0,0,1,0,0,1
RichardWarburton_java-8-lambdas-exercises,com.insightfullogic.java8.examples.chapter2,0,0,0,0,1,0,0,1
RichardWarburton_java-8-lambdas-exercises,com.insightfullogic.java8.examples.chapter3,0,0,0,0,1,0,0,1
RichardWarburton_java-8-lambdas-exercises,com.insightfullogic.java8.examples.chapter4,0,0,0,0,1,0,0,1
RichardWarburton_java-8-lambdas-exercises,com.insightfullogic.java8.examples.chapter5,0,0,0,0,1,0,0,1
RichardWarburton_java-8-lambdas-exercises,com.insightfullogic.java8.examples.chapter5.mutable_custom,0,0,0,0,0,0,0,0
RichardWarburton_java-8-lambdas-exercises,com.insightfullogic.java8.examples.chapter6,0,0,0,0,1,0,0,1
RichardWarburton_java-8-lambdas-exercises,com.insightfullogic.java8.examples.chapter7,0,0,0,0,0,0,0,0
RichardWarburton_java-8-lambdas-exercises,com.insightfullogic.java8.examples.chapter8.command,0,0,0,0,0,0,0,0
RichardWarburton_java-8-lambdas-exercises,com.insightfullogic.java8.examples.chapter8,0,0,0,0,1,0,0,1
RichardWarburton_java-8-lambdas-exercises,com.insightfullogic.java8.examples.chapter8.observer,0,0,0,0,0,0,0,0
RichardWarburton_java-8-lambdas-exercises,com.insightfullogic.java8.examples.chapter8.strategy,0,0,0,0,0,0,0,0
RichardWarburton_java-8-lambdas-exercises,com.insightfullogic.java8.examples.chapter8.template_method,0,0,0,0,0,0,0,0
RichardWarburton_java-8-lambdas-exercises,com.insightfullogic.java8.examples.chapter8.template_method.lambdas,0,0,0,0,0,0,0,0
RichardWarburton_java-8-lambdas-exercises,com.insightfullogic.java8.examples.chapter8.template_method.traditional,0,0,0,0,0,0,0,0
RichardWarburton_java-8-lambdas-exercises,com.insightfullogic.java8.examples.chapter9,0,0,0,0,1,0,0,1
RichardWarburton_java-8-lambdas-exercises,com.insightfullogic.java8.exercises.chapter2,0,0,0,0,0,0,0,0
RichardWarburton_java-8-lambdas-exercises,com.insightfullogic.java8.exercises.chapter3,0,0,0,0,1,0,0,1
RichardWarburton_java-8-lambdas-exercises,com.insightfullogic.java8.exercises.chapter4,0,0,0,0,0,0,0,0
RichardWarburton_java-8-lambdas-exercises,com.insightfullogic.java8.exercises.chapter5,0,0,0,0,1,0,0,1
RichardWarburton_java-8-lambdas-exercises,com.insightfullogic.java8.exercises.chapter6,0,0,0,0,0,0,0,0
RichardWarburton_java-8-lambdas-exercises,com.insightfullogic.java8.exercises.chapter9,0,0,0,0,1,0,0,1
RichardWarburton_java-8-lambdas-exercises,com.insightfullogic.java8.exercises,0,0,0,0,0,0,0,0
RichardWarburton_java-8-lambdas-exercises,com.insightfullogic.java8.examples.chapter8.lambdabehave,0,0,0,0,0,0,0,0
RichardWarburton_java-8-lambdas-exercises,com.insightfullogic.java8.examples.chapter8.lambdabehave.example,0,0,0,0,0,0,0,0
RichardWarburton_java-8-lambdas-exercises,com.insightfullogic.java8.examples.chapter8.lambdabehave.expectations,0,0,0,0,0,0,0,0
RichardWarburton_java-8-lambdas-exercises,com.insightfullogic.java8.examples.chapter8.lambdabehave.reporting,0,0,0,0,0,0,0,0
rjenkins_ursus,com.aceevo.ursus.client,0,0,0,0,0,0,0,0
rjenkins_ursus,com.aceevo.ursus.config,0,0,0,0,1,0,0,1
rjenkins_ursus,com.aceevo.ursus.core,0,0,0,0,1,0,0,1
rjenkins_ursus,com.aceevo.ursus.util,0,0,0,0,0,0,0,0
rjenkins_ursus,com.aceevo.ursus.websockets,0,0,0,0,0,0,0,0
rjenkins_ursus,com.aceevo.ursus.db.liquibase,0,0,0,0,0,0,0,0
rjenkins_ursus,com.aceevo.ursus.db,0,0,0,0,0,0,0,0
rjenkins_ursus,com.aceevo.ursus.example.api,1,0,0,0,0,0,0,1
rjenkins_ursus,com.aceevo.ursus.example,1,1,0,0,1,0,0,3
rjenkins_ursus,com.aceevo.ursus.example.model,0,0,0,0,0,0,0,0
rjenkins_ursus,com.aceevo.ursus.example.simplehttpclient,0,0,0,0,0,0,0,0
rjenkins_ursus,com.aceevo.ursus.example.simplejerseyclient,0,0,0,0,0,0,0,0
rjenkins_ursus,com.aceevo.ursus,0,0,0,0,0,0,0,0
rjenkins_ursus,com.aceevo.ursus.example.websocketclient,0,0,0,0,0,0,0,0
rjenkins_ursus,com.aceevo.ursus.spi.liquibase,0,0,0,0,0,0,0,0
RNCryptor_JNCryptor,org.cryptonode.jncryptor,0,0,0,1,0,0,0,1
robert-bor_aho-corasick,org.ahocorasick.interval,0,0,0,0,0,1,0,1
robert-bor_aho-corasick,org.ahocorasick.trie,1,0,0,0,0,1,0,2
robert-bor_aho-corasick,org.ahocorasick.trie.handler,1,1,0,0,1,1,0,4
robert-bor_aho-corasick,org.ahocorasick.util,0,0,0,0,0,0,0,0
roboconf_roboconf-platform,net.roboconf.agent,0,0,0,0,0,0,1,1
roboconf_roboconf-platform,net.roboconf.agent.internal,2,1,0,0,0,8,1,12
roboconf_roboconf-platform,net.roboconf.agent.internal.lifecycle,1,0,0,0,0,2,1,4
roboconf_roboconf-platform,net.roboconf.agent.internal.misc,2,1,0,0,1,1,1,6
roboconf_roboconf-platform,net.roboconf.agent.internal.sync,0,0,0,0,0,0,1,1
roboconf_roboconf-platform,net.roboconf.agent.jmx,0,0,0,0,0,1,1,2
roboconf_roboconf-platform,net.roboconf.agent.monitoring.internal,0,0,0,0,0,0,1,1
roboconf_roboconf-platform,net.roboconf.agent.monitoring.internal.file,0,0,0,0,0,0,1,1
roboconf_roboconf-platform,net.roboconf.agent.monitoring.internal.nagios,0,0,0,0,0,0,1,1
roboconf_roboconf-platform,net.roboconf.agent.monitoring.internal.rest,0,0,0,0,0,0,1,1
roboconf_roboconf-platform,net.roboconf.agent.monitoring.api,0,0,0,0,0,0,1,1
roboconf_roboconf-platform,net.roboconf.agent.monitoring.docker.internal,0,0,0,0,0,0,1,1
roboconf_roboconf-platform,net.roboconf.core.autonomic,4,0,0,0,0,0,1,5
roboconf_roboconf-platform,net.roboconf.core.commands,3,0,0,0,0,3,1,7
roboconf_roboconf-platform,net.roboconf.core,6,1,0,0,0,0,1,8
roboconf_roboconf-platform,net.roboconf.core.dsl.converters,4,0,0,0,0,5,1,10
roboconf_roboconf-platform,net.roboconf.core.dsl.parsing,2,1,0,0,0,6,1,10
roboconf_roboconf-platform,net.roboconf.core.dsl,4,1,0,0,1,3,1,10
roboconf_roboconf-platform,net.roboconf.core.errors,12,1,0,0,0,10,1,24
roboconf_roboconf-platform,net.roboconf.core.errors.i18n,2,0,0,0,0,0,1,3
roboconf_roboconf-platform,net.roboconf.core.internal.dsl.parsing,7,1,0,0,1,2,1,12
roboconf_roboconf-platform,net.roboconf.core.logging,0,0,0,0,0,0,1,1
roboconf_roboconf-platform,net.roboconf.core.model,15,1,0,0,0,9,1,26
roboconf_roboconf-platform,net.roboconf.core.model.beans,7,1,0,0,1,35,1,45
roboconf_roboconf-platform,net.roboconf.core.model.comparators,3,0,0,0,0,0,1,4
roboconf_roboconf-platform,net.roboconf.core.model.helpers,19,1,0,0,0,0,1,21
roboconf_roboconf-platform,net.roboconf.core.model.runtime,0,0,0,0,1,3,1,5
roboconf_roboconf-platform,net.roboconf.core.runtime,0,0,0,0,0,0,1,1
roboconf_roboconf-platform,net.roboconf.core.urlresolvers,0,0,0,0,0,0,1,1
roboconf_roboconf-platform,net.roboconf.core.userdata,0,1,0,0,0,0,1,2
roboconf_roboconf-platform,net.roboconf.core.utils,23,1,0,0,0,1,1,26
roboconf_roboconf-platform,net.roboconf.dm.internal.api.impl,11,1,0,1,1,17,1,32
roboconf_roboconf-platform,net.roboconf.dm.internal.api.impl.beans,0,0,0,0,0,2,1,3
roboconf_roboconf-platform,net.roboconf.dm.internal.api,0,0,0,0,0,2,1,3
roboconf_roboconf-platform,net.roboconf.dm.internal.commands,2,0,0,0,0,3,1,6
roboconf_roboconf-platform,net.roboconf.dm.internal.environment.messaging,3,0,0,0,0,2,1,6
roboconf_roboconf-platform,net.roboconf.dm.internal.tasks,4,0,0,0,1,1,1,7
roboconf_roboconf-platform,net.roboconf.dm.internal.utils,8,1,0,0,1,1,1,12
roboconf_roboconf-platform,net.roboconf.dm.jmx,0,0,0,0,0,0,1,1
roboconf_roboconf-platform,net.roboconf.dm.management.api,4,1,0,0,1,30,1,37
roboconf_roboconf-platform,net.roboconf.dm.management.events,0,0,0,0,0,2,1,3
roboconf_roboconf-platform,net.roboconf.dm.management.exceptions,0,0,0,0,0,0,1,1
roboconf_roboconf-platform,net.roboconf.dm.management,11,1,0,0,0,29,1,42
roboconf_roboconf-platform,net.roboconf.dm.internal.autonomic,0,0,0,0,0,0,1,1
roboconf_roboconf-platform,net.roboconf.dm.management.legacy,0,0,0,0,0,5,1,6
roboconf_roboconf-platform,net.roboconf.dm,0,0,0,0,0,0,1,1
roboconf_roboconf-platform,net.roboconf.dm.rest.commons.beans,0,0,0,0,0,0,1,1
roboconf_roboconf-platform,net.roboconf.dm.rest.commons,0,0,0,0,0,1,1,2
roboconf_roboconf-platform,net.roboconf.dm.rest.commons.json,0,0,0,1,1,0,1,3
roboconf_roboconf-platform,net.roboconf.dm.rest.commons.security,0,0,0,0,0,0,1,1
roboconf_roboconf-platform,net.roboconf.dm.rest.services.cors,0,0,0,0,0,0,1,1
roboconf_roboconf-platform,net.roboconf.dm.rest.services.internal.annotations,0,0,0,0,0,0,1,1
roboconf_roboconf-platform,net.roboconf.dm.rest.services.internal.audit,0,0,0,0,0,0,1,1
roboconf_roboconf-platform,net.roboconf.dm.rest.services.internal.errors,0,0,0,0,0,0,1,1
roboconf_roboconf-platform,net.roboconf.dm.rest.services.internal.filters,1,0,0,0,0,0,1,2
roboconf_roboconf-platform,net.roboconf.dm.rest.services.internal.icons,0,0,0,0,0,0,1,1
roboconf_roboconf-platform,net.roboconf.dm.rest.services.internal.resources,0,0,0,0,1,0,1,2
roboconf_roboconf-platform,net.roboconf.dm.rest.services.internal.resources.impl,0,0,0,0,1,0,1,2
roboconf_roboconf-platform,net.roboconf.dm.rest.services.internal,2,1,0,0,0,0,1,4
roboconf_roboconf-platform,net.roboconf.dm.rest.services.internal.utils,0,0,0,0,0,0,1,1
roboconf_roboconf-platform,net.roboconf.dm.rest.services.internal.websocket,1,0,0,0,0,0,1,2
roboconf_roboconf-platform,net.roboconf.dm.rest.services.jmx,0,0,0,0,0,0,1,1
roboconf_roboconf-platform,net.roboconf.dm.scheduler.internal,0,0,0,0,0,1,1,2
roboconf_roboconf-platform,net.roboconf.dm.scheduler,0,0,0,0,0,0,1,1
roboconf_roboconf-platform,net.roboconf.dm.templating.internal.contexts,0,0,0,0,0,0,1,1
roboconf_roboconf-platform,net.roboconf.dm.templating.internal.helpers,1,0,0,0,1,0,1,3
roboconf_roboconf-platform,net.roboconf.dm.templating.internal.resolvers,0,0,0,0,0,0,1,1
roboconf_roboconf-platform,net.roboconf.dm.templating.internal.templates,2,1,0,0,1,0,1,5
roboconf_roboconf-platform,net.roboconf.dm.templating.internal,1,1,0,0,0,1,1,4
roboconf_roboconf-platform,net.roboconf.dm.web.administration,0,0,0,0,0,0,1,1
roboconf_roboconf-platform,net.roboconf.messaging.api,0,0,0,0,0,1,1,2
roboconf_roboconf-platform,net.roboconf.messaging.api.business,0,0,0,0,0,4,1,5
roboconf_roboconf-platform,net.roboconf.messaging.api.client.idle,0,1,0,0,0,0,1,2
roboconf_roboconf-platform,net.roboconf.messaging.api.extensions,0,0,0,0,1,1,1,3
roboconf_roboconf-platform,net.roboconf.messaging.api.factory,1,1,0,0,0,3,1,6
roboconf_roboconf-platform,net.roboconf.messaging.api.internal.client.dismiss,0,0,0,0,0,0,1,1
roboconf_roboconf-platform,net.roboconf.messaging.api.internal.client.in_memory,0,0,0,0,0,0,1,1
roboconf_roboconf-platform,net.roboconf.messaging.api.internal.jmx,0,0,0,0,0,0,1,1
roboconf_roboconf-platform,net.roboconf.messaging.api.jmx,0,0,0,0,0,0,1,1
roboconf_roboconf-platform,net.roboconf.messaging.api.messages.from_agent_to_agent,0,0,0,0,0,1,1,2
roboconf_roboconf-platform,net.roboconf.messaging.api.messages.from_agent_to_dm,0,1,0,0,1,3,1,6
roboconf_roboconf-platform,net.roboconf.messaging.api.messages.from_dm_to_agent,0,1,0,0,1,5,1,8
roboconf_roboconf-platform,net.roboconf.messaging.api.messages.from_dm_to_dm,0,0,0,0,0,1,1,2
roboconf_roboconf-platform,net.roboconf.messaging.api.messages,0,0,0,0,0,0,1,1
roboconf_roboconf-platform,net.roboconf.messaging.api.reconfigurables,1,1,0,0,1,12,1,16
roboconf_roboconf-platform,net.roboconf.messaging.api.utils,0,0,0,0,0,0,1,1
roboconf_roboconf-platform,net.roboconf.messaging.api.internal.client,0,0,0,0,0,2,1,3
roboconf_roboconf-platform,net.roboconf.messaging.api.processors,0,0,0,0,0,0,1,1
roboconf_roboconf-platform,net.roboconf.messaging.http,0,0,0,0,0,0,1,1
roboconf_roboconf-platform,net.roboconf.messaging.http.internal.clients,1,0,0,0,0,0,1,2
roboconf_roboconf-platform,net.roboconf.messaging.http.internal,2,1,0,0,1,0,1,5
roboconf_roboconf-platform,net.roboconf.messaging.http.internal.messages,0,0,0,0,0,0,1,1
roboconf_roboconf-platform,net.roboconf.messaging.http.internal.sockets,1,1,0,0,1,0,1,4
roboconf_roboconf-platform,net.roboconf.messaging.rabbitmq.internal.impl,0,0,0,0,1,0,1,2
roboconf_roboconf-platform,net.roboconf.messaging.rabbitmq.internal,1,0,0,0,1,0,1,3
roboconf_roboconf-platform,net.roboconf.messaging.rabbitmq.internal.utils,1,1,0,0,0,0,1,3
roboconf_roboconf-platform,net.roboconf.messaging.rabbitmq,0,0,0,0,0,0,1,1
roboconf_roboconf-platform,net.roboconf.plugin.api,0,0,0,0,0,2,1,3
roboconf_roboconf-platform,net.roboconf.plugin.file.internal,0,0,0,0,0,0,1,1
roboconf_roboconf-platform,net.roboconf.plugin.logger.internal,0,0,0,0,0,0,1,1
roboconf_roboconf-platform,net.roboconf.plugin.puppet.internal,0,0,0,0,0,0,1,1
roboconf_roboconf-platform,net.roboconf.plugin.script.internal,0,0,0,0,0,0,1,1
roboconf_roboconf-platform,net.roboconf.plugin.script.internal.templating,0,0,0,0,0,0,1,1
roboconf_roboconf-platform,net.roboconf.target.api,1,1,0,0,1,1,1,5
roboconf_roboconf-platform,net.roboconf.target.api.internal,1,0,0,0,0,0,1,2
roboconf_roboconf-platform,net.roboconf.target.docker.internal,0,0,0,0,1,0,1,2
roboconf_roboconf-platform,net.roboconf.target.embedded.internal,0,0,0,0,1,0,1,2
roboconf_roboconf-platform,net.roboconf.target.embedded.internal.verifiers,0,0,0,0,0,0,1,1
roboconf_roboconf-platform,net.roboconf.target.azure.internal,0,0,0,0,0,0,1,1
roboconf_roboconf-platform,net.roboconf.target.ec2.internal,0,0,0,0,0,0,1,1
roboconf_roboconf-platform,net.roboconf.target.occi.internal,0,0,0,0,0,0,1,1
roboconf_roboconf-platform,net.roboconf.target.openstack.internal,0,0,0,0,1,0,1,2
roboconf_roboconf-platform,net.roboconf.target.vmware.internal,0,0,0,0,0,0,1,1
roboconf_roboconf-platform,net.roboconf.target.in_memory,0,0,0,0,0,0,1,1
roboconf_roboconf-platform,net.roboconf.target.jclouds.internal,0,0,0,0,0,0,1,1
roboconf_roboconf-platform,net.roboconf.karaf.commands.agent.plugins,0,0,0,0,0,0,1,1
roboconf_roboconf-platform,net.roboconf.karaf.commands.agent.status,0,0,0,0,0,0,1,1
roboconf_roboconf-platform,net.roboconf.karaf.commands.common.plugins,0,0,0,0,0,0,1,1
roboconf_roboconf-platform,net.roboconf.karaf.commands.common,0,0,0,0,0,0,1,1
roboconf_roboconf-platform,net.roboconf.karaf.commands.dm.completers,0,0,0,0,1,1,1,3
roboconf_roboconf-platform,net.roboconf.karaf.commands.dm.diagnostics,0,0,0,0,0,0,1,1
roboconf_roboconf-platform,net.roboconf.karaf.commands.dm.history,0,0,0,0,0,0,1,1
roboconf_roboconf-platform,net.roboconf.karaf.commands.dm,0,0,0,0,0,1,1,2
roboconf_roboconf-platform,net.roboconf.karaf.commands.dm.logs,0,0,0,0,0,2,1,3
roboconf_roboconf-platform,net.roboconf.karaf.commands.dm.targets,0,0,0,0,0,0,1,1
roboconf_roboconf-platform,net.roboconf.karaf.decanter.collector.dm,0,0,0,0,0,0,1,1
roboconf_roboconf-platform,net.roboconf.karaf.prepare,0,0,0,0,0,0,1,1
roboconf_roboconf-platform,net.roboconf.dm.rest.client.delegates,0,0,0,0,1,9,1,11
roboconf_roboconf-platform,net.roboconf.dm.rest.client.exceptions,0,0,0,0,0,2,1,3
roboconf_roboconf-platform,net.roboconf.dm.rest.client,0,1,0,0,0,8,1,10
roboconf_roboconf-platform,net.roboconf.doc.generator,1,1,0,0,0,0,1,3
roboconf_roboconf-platform,net.roboconf.doc.generator.internal,0,0,0,0,1,0,1,2
roboconf_roboconf-platform,net.roboconf.doc.generator.internal.nls,0,0,0,0,0,1,1,2
roboconf_roboconf-platform,net.roboconf.doc.generator.internal.renderers,1,0,0,0,0,1,1,3
roboconf_roboconf-platform,net.roboconf.doc.generator.internal.transformers,0,0,0,0,0,0,1,1
roboconf_roboconf-platform,net.roboconf.maven,0,0,0,0,1,0,1,2
roboconf_roboconf-platform,net.roboconf.swagger,0,0,0,0,0,0,1,1
roboconf_roboconf-platform,net.roboconf.tooling.core.autocompletion,0,0,0,0,0,1,1,2
roboconf_roboconf-platform,net.roboconf.tooling.core,0,1,0,0,1,3,1,6
roboconf_roboconf-platform,net.roboconf.tooling.core.textactions,0,0,0,0,0,0,1,1
roboconf_roboconf-platform,net.roboconf.tooling.core.validation,0,0,0,0,0,1,1,2
roboconf_roboconf-platform,net.roboconf.webextension.kibana.internal,0,0,0,0,0,0,1,1
roboconf_roboconf-platform,net.roboconf.webextension.kibana,0,0,0,0,0,0,1,1
RobotiumTech_robotium,com.robotium.solo,0,0,0,1,1,0,0,2
rocketscience-projects_javaslang,io.vavr,5,1,0,1,0,0,0,7
rocketscience-projects_javaslang,io.vavr.collection,6,1,0,2,0,0,0,9
rocketscience-projects_javaslang,io.vavr.concurrent,2,0,0,0,0,0,0,2
rocketscience-projects_javaslang,io.vavr.control,4,1,0,1,0,0,0,6
rocketscience-projects_javaslang,io.vavr.collection.euler,0,0,0,1,1,0,0,2
rocketscience-projects_javaslang,linter,0,0,0,0,0,0,0,0
rocketscience-projects_javaslang,outside_of_vavr,0,0,0,0,0,0,0,0
roikku_swift-explorer,org.swiftexplorer.auth,0,0,0,0,0,0,0,0
roikku_swift-explorer,org.swiftexplorer.auth.builder.api,0,0,0,0,0,0,0,0
roikku_swift-explorer,org.swiftexplorer.auth.extractors,0,0,0,0,0,0,0,0
roikku_swift-explorer,org.swiftexplorer.auth.oauth,0,0,0,0,0,0,0,0
roikku_swift-explorer,org.swiftexplorer.auth.server,0,0,0,0,0,0,0,0
roikku_swift-explorer,org.swiftexplorer.auth.webbrowser,0,0,0,0,0,0,0,0
roikku_swift-explorer,org.swiftexplorer.config.auth,0,0,0,0,0,0,0,0
roikku_swift-explorer,org.swiftexplorer.config,0,0,0,0,0,0,0,0
roikku_swift-explorer,org.swiftexplorer.config.localization,0,0,0,0,0,0,0,0
roikku_swift-explorer,org.swiftexplorer.config.proxy,0,0,0,0,0,0,0,0
roikku_swift-explorer,org.swiftexplorer.config.swift,0,0,0,0,0,0,0,0
roikku_swift-explorer,org.swiftexplorer.gui,1,1,0,0,1,0,0,3
roikku_swift-explorer,org.swiftexplorer.gui.diff,0,0,0,0,0,0,0,0
roikku_swift-explorer,org.swiftexplorer.gui.localization,0,0,0,0,0,0,0,0
roikku_swift-explorer,org.swiftexplorer.gui.log,0,0,0,0,0,0,0,0
roikku_swift-explorer,org.swiftexplorer.gui.login,0,0,0,0,1,0,0,1
roikku_swift-explorer,org.swiftexplorer.gui.preview,0,0,0,0,1,0,0,1
roikku_swift-explorer,org.swiftexplorer.gui.settings,1,0,0,0,1,0,0,2
roikku_swift-explorer,org.swiftexplorer.gui.util,2,1,0,0,1,0,0,4
roikku_swift-explorer,org.swiftexplorer.swift.client.factory,0,1,0,0,0,0,0,1
roikku_swift-explorer,org.swiftexplorer.swift.client.impl,0,0,0,0,0,0,0,0
roikku_swift-explorer,org.swiftexplorer.swift.instructions,0,0,0,0,0,0,0,0
roikku_swift-explorer,org.swiftexplorer.swift.operations,2,0,0,0,1,0,0,3
roikku_swift-explorer,org.swiftexplorer.swift,0,0,0,0,0,0,0,0
roikku_swift-explorer,org.swiftexplorer.swift.util,0,0,0,0,0,0,0,0
roikku_swift-explorer,org.swiftexplorer,0,0,0,0,0,0,0,0
roikku_swift-explorer,org.swiftexplorer.util,1,1,0,0,1,0,0,3
rpau_walkmod-core,org.walkmod,0,1,0,0,1,2,0,4
rpau_walkmod-core,org.walkmod.commands,0,0,0,1,1,0,0,2
rpau_walkmod-core,org.walkmod.conf,1,1,0,0,1,1,0,4
rpau_walkmod-core,org.walkmod.conf.entities,1,0,0,0,1,3,0,5
rpau_walkmod-core,org.walkmod.conf.entities.impl,1,1,0,0,1,0,0,3
rpau_walkmod-core,org.walkmod.conf.providers,2,0,0,0,1,1,0,4
rpau_walkmod-core,org.walkmod.conf.providers.xml,1,1,0,0,0,1,0,3
rpau_walkmod-core,org.walkmod.conf.providers.yml,0,0,0,0,1,0,0,1
rpau_walkmod-core,org.walkmod.exceptions,1,1,0,0,0,0,0,2
rpau_walkmod-core,org.walkmod.impl,0,0,0,0,1,1,0,2
rpau_walkmod-core,org.walkmod.patches,0,0,0,0,0,0,0,0
rpau_walkmod-core,org.walkmod.query,0,0,0,0,0,0,0,0
rpau_walkmod-core,org.walkmod.readers,0,0,0,0,0,0,0,0
rpau_walkmod-core,org.walkmod.scripting,0,0,0,0,0,0,0,0
rpau_walkmod-core,org.walkmod.templates,0,0,0,0,0,0,0,0
rpau_walkmod-core,org.walkmod.util,2,0,0,0,1,0,0,3
rpau_walkmod-core,org.walkmod.util.location,2,1,0,0,1,0,0,4
rpau_walkmod-core,org.walkmod.walkers,0,0,0,0,1,0,0,1
rpau_walkmod-core,org.walkmod.writers,0,0,0,0,1,0,0,1
rpau_walkmod-core,org.walkmod.utils,0,0,0,0,0,0,0,0
rpau_walkmod-core,(default package),0,0,0,0,1,0,0,1
rpau_walkmod-core,foo,0,0,0,0,0,0,0,0
RuedigerMoeller_kontraktor,org.nustaq.kontraktor.impl,2,0,0,0,1,1,1,5
RuedigerMoeller_kontraktor,kontraktor.krouter,0,0,0,0,0,0,1,1
RuedigerMoeller_kontraktor,kontraktor.krouter.service,0,0,0,0,0,0,1,1
RuedigerMoeller_kontraktor,org.nustaq.kontraktor.remoting.http_old,0,0,0,0,1,0,1,2
RuedigerMoeller_kontraktor,microservice.impl,0,0,0,0,0,0,1,1
RuedigerMoeller_kontraktor,microservice.pub,0,0,0,0,0,0,1,1
RuedigerMoeller_kontraktor,microservice.client,0,0,0,0,0,1,1,2
RuedigerMoeller_kontraktor,org.nustaq.kontraktor.examples,0,0,0,0,0,0,1,1
RuedigerMoeller_kontraktor,service.client,0,0,0,0,0,0,1,1
RuedigerMoeller_kontraktor,service.common,0,0,0,0,0,0,1,1
RuedigerMoeller_kontraktor,service.server,0,0,0,0,0,0,1,1
RuedigerMoeller_kontraktor,pubsub.point2point,0,0,0,0,0,1,1,2
RuedigerMoeller_kontraktor,knode,0,0,0,0,0,0,1,1
RuedigerMoeller_kontraktor,examples.rest,0,0,0,0,0,0,1,1
RuedigerMoeller_kontraktor,org.nustaq.intrinsicreact,0,0,0,0,0,0,1,1
RuedigerMoeller_kontraktor,org.nustaq.http.example,0,0,0,0,0,0,1,1
RuedigerMoeller_kontraktor,org.nustaq.http.example.websocketexperimental,0,0,0,0,0,0,1,1
RuedigerMoeller_kontraktor,org.nustaq.http.servlet,0,0,0,0,0,0,1,1
RuedigerMoeller_kontraktor,org.nustaq.http.undertow,0,0,0,0,0,0,1,1
RuedigerMoeller_kontraktor,reactinstrinsic.servlet,0,0,0,0,0,0,1,1
RuedigerMoeller_kontraktor,org.nustaq.kluster.processes,0,0,0,0,0,0,1,1
RuedigerMoeller_kontraktor,org.nustaq.kontraktor.barebone,0,0,0,0,0,0,1,1
RuedigerMoeller_kontraktor,needs_kontraktor_http_js_example_server,0,0,0,0,0,0,1,1
RuedigerMoeller_kontraktor,org.nustaq.kontraktor.loggingadapter,0,0,0,0,0,0,1,1
RuedigerMoeller_kontraktor,org.nustaq.kontraktor.remoting.http,0,0,0,0,0,0,1,1
RuedigerMoeller_kontraktor,org.nustaq.kontraktor.remoting.http.servlet,0,0,0,0,0,0,1,1
RuedigerMoeller_kontraktor,org.nustaq.kontraktor.remoting.http.undertow.builder,1,1,0,0,0,0,1,3
RuedigerMoeller_kontraktor,org.nustaq.kontraktor.remoting.http.undertow,1,1,0,0,1,0,1,4
RuedigerMoeller_kontraktor,org.nustaq.kontraktor.remoting.websockets,0,0,0,0,1,1,1,3
RuedigerMoeller_kontraktor,org.nustaq.kontraktor.rest,0,0,0,0,0,0,1,1
RuedigerMoeller_kontraktor,org.nustaq.kontraktor.routing,0,0,0,0,0,0,1,1
RuedigerMoeller_kontraktor,org.nustaq.kontraktor.security,0,0,0,0,0,0,1,1
RuedigerMoeller_kontraktor,org.nustaq.kontraktor.webapp.babel,0,0,0,0,0,0,1,1
RuedigerMoeller_kontraktor,org.nustaq.kontraktor.webapp.javascript,2,1,0,0,0,0,1,4
RuedigerMoeller_kontraktor,org.nustaq.kontraktor.webapp.javascript.clojure,0,0,0,0,0,0,1,1
RuedigerMoeller_kontraktor,org.nustaq.kontraktor.webapp.javascript.jsmin,1,0,0,0,0,0,1,2
RuedigerMoeller_kontraktor,org.nustaq.kontraktor.webapp.javascript.minbingen,0,0,0,0,0,0,1,1
RuedigerMoeller_kontraktor,org.nustaq.kontraktor.webapp.npm,0,0,0,0,0,1,1,2
RuedigerMoeller_kontraktor,org.nustaq.kontraktor.webapp.transpiler,1,1,0,0,0,0,1,3
RuedigerMoeller_kontraktor,org.nustaq.kontraktor.webapp.transpiler.jsx,0,0,0,0,1,0,1,2
RuedigerMoeller_kontraktor,org.nustaq.utils,0,0,0,0,0,1,1,2
RuedigerMoeller_kontraktor,org.slf4j.impl,0,0,0,0,0,0,1,1
RuedigerMoeller_kontraktor,(default package),0,0,0,0,0,0,1,1
RuedigerMoeller_kontraktor,kontraktor,0,0,0,1,1,5,1,8
RuedigerMoeller_kontraktor,remoting,0,0,0,0,0,1,1,2
RuedigerMoeller_kontraktor,org.nustaq.reallive.api,2,1,0,0,0,0,1,4
RuedigerMoeller_kontraktor,org.nustaq.reallive.client,0,0,0,0,0,0,1,1
RuedigerMoeller_kontraktor,org.nustaq.reallive.impl.actors,0,1,0,0,0,1,1,3
RuedigerMoeller_kontraktor,org.nustaq.reallive.impl,3,0,0,0,1,0,1,5
RuedigerMoeller_kontraktor,org.nustaq.reallive.impl.storage,0,0,0,0,0,0,1,1
RuedigerMoeller_kontraktor,org.nustaq.reallive.impl.tablespace,0,1,0,0,0,0,1,2
RuedigerMoeller_kontraktor,org.nustaq.reallive.messages,0,0,0,0,1,0,1,2
RuedigerMoeller_kontraktor,org.nustaq.reallive.query,1,0,0,0,0,0,1,2
RuedigerMoeller_kontraktor,org.nustaq.reallive.records,4,1,0,0,0,0,1,6
RuedigerMoeller_kontraktor,newimpl,0,0,0,0,0,3,1,4
RuedigerMoeller_kontraktor,org.nustaq.kontraktor.weblication,1,1,0,0,1,0,1,4
RuedigerMoeller_kontraktor,org.nustaq.kontraktor.weblication.model,1,0,0,0,0,0,1,2
RuedigerMoeller_kontraktor,org.nustaq.kontraktor.reactivestreams,1,1,0,0,0,0,1,3
RuedigerMoeller_kontraktor,org.nustaq.kontraktor.reactivestreams.impl,1,0,0,0,1,0,1,3
RuedigerMoeller_kontraktor,examples.akka,0,0,0,0,0,0,1,1
RuedigerMoeller_kontraktor,examples.http4k,0,0,0,0,0,0,1,1
RuedigerMoeller_kontraktor,examples,0,0,0,0,0,1,1,2
RuedigerMoeller_kontraktor,examples.rxjava,0,0,0,0,0,1,1,2
RuedigerMoeller_kontraktor,examples.rxstreamserver,0,0,0,0,0,1,1,2
RuedigerMoeller_kontraktor,misc,0,0,0,0,0,0,1,1
RuedigerMoeller_kontraktor,remotetreams,0,0,0,0,0,0,1,1
RuedigerMoeller_kontraktor,tck,0,0,0,0,0,0,1,1
RuedigerMoeller_kontraktor,org.nustaq.kontraktor.apputil.comments,0,0,0,0,0,0,1,1
RuedigerMoeller_kontraktor,org.nustaq.kontraktor.apputil,0,0,0,0,1,0,1,2
RuedigerMoeller_kontraktor,org.nustaq.kontraktor.apputil.recordwrappermixins,0,0,0,0,1,0,1,2
RuedigerMoeller_kontraktor,org.nustaq.kontraktor.frontend,0,0,0,0,0,0,1,1
RuedigerMoeller_kontraktor,org.nustaq.kontraktor.services,1,0,0,0,0,1,1,3
RuedigerMoeller_kontraktor,org.nustaq.kontraktor.services.rlclient,1,1,0,0,0,1,1,4
RuedigerMoeller_kontraktor,remotegc,0,0,0,0,0,1,1,2
RuedigerMoeller_kontraktor,rlcluster,0,0,0,0,1,0,1,2
RuedigerMoeller_kontraktor,org.eclipse.jetty.util,0,0,0,0,0,0,1,1
RuedigerMoeller_kontraktor,org.nustaq.kontraktor,3,1,0,0,1,23,1,29
RuedigerMoeller_kontraktor,org.nustaq.kontraktor.asyncio,0,0,0,0,1,1,1,3
RuedigerMoeller_kontraktor,org.nustaq.kontraktor.monitoring,0,0,0,0,0,0,1,1
RuedigerMoeller_kontraktor,org.nustaq.kontraktor.remoting.base,0,0,0,0,1,12,1,14
RuedigerMoeller_kontraktor,org.nustaq.kontraktor.remoting.base.messagestore,0,0,0,0,0,0,1,1
RuedigerMoeller_kontraktor,org.nustaq.kontraktor.remoting.encoding,0,0,0,0,1,1,1,3
RuedigerMoeller_kontraktor,org.nustaq.kontraktor.remoting.tcp,0,1,0,0,1,6,1,9
RuedigerMoeller_kontraktor,org.nustaq.kontraktor.routers,0,0,0,0,1,2,1,4
RuedigerMoeller_kontraktor,org.nustaq.kontraktor.util,2,0,0,0,1,14,1,18
RuedigerMoeller_kontraktor,kontraktor.scheduling,0,0,0,0,0,0,1,1
ruediste1_btrbck,com.github.ruediste1.btrbck.cli,0,0,0,0,0,1,0,1
ruediste1_btrbck,com.github.ruediste1.btrbck,0,0,0,0,1,1,0,2
ruediste1_btrbck,com.github.ruediste1.btrbck.dom,0,0,0,0,1,1,0,2
ruediste1_btrbck,com.github.ruediste1.btrbck.dto,0,0,0,0,0,0,0,0
ruediste_btrbck,com.github.ruediste1.btrbck.cli,0,0,0,0,0,1,0,1
ruediste_btrbck,com.github.ruediste1.btrbck,0,0,0,0,1,1,0,2
ruediste_btrbck,com.github.ruediste1.btrbck.dom,0,0,0,0,1,1,0,2
ruediste_btrbck,com.github.ruediste1.btrbck.dto,0,0,0,0,0,0,0,0
sailorgeoffrey_ddp-client-java,io.advantageous.ddp,0,0,0,0,1,0,0,1
sailorgeoffrey_ddp-client-java,io.advantageous.ddp.repository,0,1,0,0,0,0,0,1
sailorgeoffrey_ddp-client-java,io.advantageous.ddp.rpc,0,0,0,0,1,0,0,1
sailorgeoffrey_ddp-client-java,io.advantageous.ddp.subscription,0,0,0,0,0,0,0,0
sailorgeoffrey_ddp-client-java,io.advantageous.ddp.subscription.message,0,0,0,0,1,0,0,1
sailorgeoffrey_ddp-client-java,io.advantageous.ddp.example,0,0,0,0,0,0,0,0
salyh_elasticsearch-river-imap,de.saly.elasticsearch.importer.imap,0,0,0,0,0,0,0,0
salyh_elasticsearch-river-imap,de.saly.elasticsearch.importer.imap.impl,1,0,0,0,0,0,0,1
salyh_elasticsearch-river-imap,de.saly.elasticsearch.importer.imap.ldap,0,0,0,0,0,0,0,0
salyh_elasticsearch-river-imap,de.saly.elasticsearch.importer.imap.maildestination,0,0,0,0,0,0,0,0
salyh_elasticsearch-river-imap,de.saly.elasticsearch.importer.imap.mailsource,0,0,0,0,0,0,0,0
salyh_elasticsearch-river-imap,de.saly.elasticsearch.importer.imap.state,0,0,0,0,0,0,0,0
salyh_elasticsearch-river-imap,de.saly.elasticsearch.importer.imap.support,1,1,0,0,1,0,0,3
salyh_elasticsearch-river-imap,org.elasticsearch.node,0,0,0,0,0,0,0,0
salyh_elasticsearch-river-imap,de.saly.elasticsearch.imap,0,0,0,0,0,0,0,0
salyh_javamail-mock2,com.sun.mail.pop3,0,0,0,0,0,0,0,0
salyh_javamail-mock2,de.saly.javamail.mock2,0,0,0,0,1,0,0,1
SanderGielisse_Enderstone,org.enderstone.server.api,0,0,0,0,0,2,0,2
SanderGielisse_Enderstone,org.enderstone.server.api.entity,0,0,0,0,0,0,0,0
SanderGielisse_Enderstone,org.enderstone.server.api.event,0,0,0,0,0,0,0,0
SanderGielisse_Enderstone,org.enderstone.server.api.event.entity,0,0,0,0,0,0,0,0
SanderGielisse_Enderstone,org.enderstone.server.api.event.player,0,0,0,0,1,0,0,1
SanderGielisse_Enderstone,org.enderstone.server.api.messages,0,0,0,0,0,2,0,2
SanderGielisse_Enderstone,org.enderstone.server.blocks,1,0,0,0,0,1,0,2
SanderGielisse_Enderstone,org.enderstone.server.commands,1,0,0,0,0,1,0,2
SanderGielisse_Enderstone,org.enderstone.server.commands.enderstone,0,0,0,0,1,0,0,1
SanderGielisse_Enderstone,org.enderstone.server.commands.vanilla,0,0,0,0,0,1,0,1
SanderGielisse_Enderstone,org.enderstone.server,5,1,0,0,0,7,0,13
SanderGielisse_Enderstone,org.enderstone.server.entity,0,1,0,0,1,3,0,5
SanderGielisse_Enderstone,org.enderstone.server.entity.pathfinding,0,0,0,0,0,0,0,0
SanderGielisse_Enderstone,org.enderstone.server.entity.player,6,1,0,0,0,6,0,13
SanderGielisse_Enderstone,org.enderstone.server.inventory,6,1,0,0,0,2,0,9
SanderGielisse_Enderstone,org.enderstone.server.items,0,0,0,0,0,1,0,1
SanderGielisse_Enderstone,org.enderstone.server.packet.codec,1,0,0,0,0,0,0,1
SanderGielisse_Enderstone,org.enderstone.server.packet,3,1,0,0,1,4,0,9
SanderGielisse_Enderstone,org.enderstone.server.packet.login,0,0,0,0,1,1,0,2
SanderGielisse_Enderstone,org.enderstone.server.packet.play,4,0,0,1,1,8,0,14
SanderGielisse_Enderstone,org.enderstone.server.packet.status,0,0,0,0,0,0,0,0
SanderGielisse_Enderstone,org.enderstone.server.regions,1,1,0,0,1,2,0,5
SanderGielisse_Enderstone,org.enderstone.server.regions.generators,1,0,0,0,0,0,0,1
SanderGielisse_Enderstone,org.enderstone.server.regions.generators.util,0,0,0,0,0,0,0,0
SanderGielisse_Enderstone,org.enderstone.server.regions.io,0,0,0,0,0,1,0,1
SanderGielisse_Enderstone,org.enderstone.server.regions.tileblocks,0,0,0,0,0,0,0,0
SanderGielisse_Enderstone,org.enderstone.server.util,0,0,0,0,1,1,0,2
SanderGielisse_Enderstone,org.enderstone.server.uuid,0,0,0,0,0,0,0,0
SanderGielisse_Enderstone,org.jnbt,0,0,0,0,0,1,0,1
sanity_quickml,quickml.collections,0,0,0,0,0,0,0,0
sanity_quickml,quickml.data,0,0,0,0,0,10,0,10
sanity_quickml,quickml.data.instances,5,1,0,0,0,6,0,12
sanity_quickml,quickml.experiments,0,0,0,0,0,0,0,0
sanity_quickml,quickml,10,1,0,0,1,0,0,12
sanity_quickml,quickml.supervised.calibratedPredictiveModel,0,0,0,0,0,2,0,2
sanity_quickml,quickml.supervised.classifier,0,0,0,0,0,3,0,3
sanity_quickml,quickml.supervised.classifier.downsampling,0,0,0,0,0,0,0,0
sanity_quickml,quickml.supervised.classifier.logisticRegression,5,0,0,0,1,0,0,6
sanity_quickml,quickml.supervised.classifier.splitOnAttribute,0,0,0,0,0,0,0,0
sanity_quickml,quickml.supervised.classifier.temporallyWeightClassifier,0,0,0,0,0,0,0,0
sanity_quickml,quickml.supervised.classifier.twoStageModel,0,0,0,0,0,1,0,1
sanity_quickml,quickml.supervised.collaborativeFiltering,0,0,0,0,0,0,0,0
sanity_quickml,quickml.supervised.collaborativeFiltering.gradientDescent,0,0,0,0,0,0,0,0
sanity_quickml,quickml.supervised.crossValidation.attributeImportance,0,0,0,0,0,3,0,3
sanity_quickml,quickml.supervised.crossValidation,7,1,0,0,1,3,0,12
sanity_quickml,quickml.supervised.crossValidation.data,0,0,0,0,1,4,0,5
sanity_quickml,quickml.supervised.crossValidation.genAttributeImportance,0,0,0,0,0,2,0,2
sanity_quickml,quickml.supervised.crossValidation.lossfunctions.classifierLossFunctions,3,1,0,0,0,2,0,6
sanity_quickml,quickml.supervised.crossValidation.lossfunctions,3,0,0,0,1,1,0,5
sanity_quickml,quickml.supervised.crossValidation.lossfunctions.rankingLossFunctions,0,0,0,0,0,1,0,1
sanity_quickml,quickml.supervised.crossValidation.lossfunctions.regressionLossFunctions,0,1,0,0,0,0,0,1
sanity_quickml,quickml.supervised.crossValidation.movingAverages,0,0,0,0,0,0,0,0
sanity_quickml,quickml.supervised.crossValidation.utils,0,0,0,0,0,0,0,0
sanity_quickml,quickml.supervised.dataProcessing,0,0,0,0,0,0,0,0
sanity_quickml,quickml.supervised.dataProcessing.instanceTranformer,0,0,0,0,1,2,0,3
sanity_quickml,quickml.supervised,13,1,0,0,1,4,0,19
sanity_quickml,quickml.supervised.ensembles.randomForest.randomDecisionForest,3,1,0,0,0,1,0,5
sanity_quickml,quickml.supervised.ensembles.randomForest,0,0,0,0,0,0,0,0
sanity_quickml,quickml.supervised.ensembles.randomForest.randomRegressionForest,0,0,0,0,0,0,0,0
sanity_quickml,quickml.supervised.featureEngineering1,0,0,0,0,0,0,0,0
sanity_quickml,quickml.supervised.featureEngineering1.enrichStrategies.attributeCombiner,0,0,0,0,0,0,0,0
sanity_quickml,quickml.supervised.featureEngineering1.enrichStrategies.probabilityInjector,0,0,0,0,0,0,0,0
sanity_quickml,quickml.supervised.inspection,0,0,0,0,1,1,0,2
sanity_quickml,quickml.supervised.parametricModels,0,0,0,0,0,0,0,0
sanity_quickml,quickml.supervised.predictiveModelOptimizer,0,0,0,0,1,0,0,1
sanity_quickml,quickml.supervised.predictiveModelOptimizer.fieldValueRecommenders,0,0,0,0,0,0,0,0
sanity_quickml,quickml.supervised.PredictiveModelsFromPreviousVersionsToBenchMarkAgainst,0,0,0,0,1,0,0,1
sanity_quickml,quickml.supervised.PredictiveModelsFromPreviousVersionsToBenchMarkAgainst.oldScorers,0,0,0,0,0,0,0,0
sanity_quickml,quickml.supervised.PredictiveModelsFromPreviousVersionsToBenchMarkAgainst.oldTree.oldAttributeIgnoringStrategies,0,0,0,0,1,0,0,1
sanity_quickml,quickml.supervised.PredictiveModelsFromPreviousVersionsToBenchMarkAgainst.oldTree,0,0,0,0,0,0,0,0
sanity_quickml,quickml.supervised.rankingModels,0,0,0,0,1,1,0,2
sanity_quickml,quickml.supervised.regressionModel.IsotonicRegression,0,0,0,0,0,2,0,2
sanity_quickml,quickml.supervised.regressionModel.LinearRegression,0,0,0,0,0,0,0,0
sanity_quickml,quickml.supervised.regressionModel.LinearRegression2,0,0,0,0,0,0,0,0
sanity_quickml,quickml.supervised.regressionModel,0,0,0,0,0,0,0,0
sanity_quickml,quickml.supervised.tree.attributeIgnoringStrategies,0,0,0,0,0,0,0,0
sanity_quickml,quickml.supervised.tree.attributeValueIgnoringStrategies,0,0,0,0,0,0,0,0
sanity_quickml,quickml.supervised.tree.bagging,0,0,0,0,0,0,0,0
sanity_quickml,quickml.supervised.tree.branchFinders,0,0,0,0,1,0,0,1
sanity_quickml,quickml.supervised.tree.branchFinders.branchFinderBuilders,0,0,0,0,0,2,0,2
sanity_quickml,quickml.supervised.tree.branchingConditions,0,0,0,0,0,0,0,0
sanity_quickml,quickml.supervised.tree.decisionTree.attributeValueIgnoringStrategies,0,0,0,0,0,1,0,1
sanity_quickml,quickml.supervised.tree.decisionTree.branchFinders.branchFinderBuilders,0,0,0,0,0,1,0,1
sanity_quickml,quickml.supervised.tree.decisionTree.branchFinders,0,1,0,0,0,0,0,1
sanity_quickml,quickml.supervised.tree.decisionTree.branchingConditions,0,0,0,0,0,0,0,0
sanity_quickml,quickml.supervised.tree.decisionTree,6,1,0,0,1,2,0,10
sanity_quickml,quickml.supervised.tree.decisionTree.nodes,0,0,0,0,0,0,0,0
sanity_quickml,quickml.supervised.tree.decisionTree.reducers,0,0,0,0,1,0,0,1
sanity_quickml,quickml.supervised.tree.decisionTree.reducers.reducerFactories,0,0,0,0,0,0,0,0
sanity_quickml,quickml.supervised.tree.decisionTree.scorers,0,0,0,0,1,2,0,3
sanity_quickml,quickml.supervised.tree.decisionTree.treeBuildContexts,0,0,0,0,0,0,0,0
sanity_quickml,quickml.supervised.tree.decisionTree.valueCounters,0,0,0,0,0,2,0,2
sanity_quickml,quickml.supervised.tree.nodes,0,0,0,0,1,2,0,3
sanity_quickml,quickml.supervised.tree.reducers,0,0,0,0,0,1,0,1
sanity_quickml,quickml.supervised.tree.regressionTree.attributeValueIgnoringStrategies,0,0,0,0,0,1,0,1
sanity_quickml,quickml.supervised.tree.regressionTree.branchFinders.branchFinderBuilders,0,0,0,0,0,1,0,1
sanity_quickml,quickml.supervised.tree.regressionTree.branchFinders,0,0,0,0,0,0,0,0
sanity_quickml,quickml.supervised.tree.regressionTree.branchingConditions,0,0,0,0,0,0,0,0
sanity_quickml,quickml.supervised.tree.regressionTree.nodes,0,0,0,0,0,0,0,0
sanity_quickml,quickml.supervised.tree.regressionTree,0,1,0,0,0,1,0,2
sanity_quickml,quickml.supervised.tree.regressionTree.reducers.reducerFactories,0,0,0,0,0,0,0,0
sanity_quickml,quickml.supervised.tree.regressionTree.reducers,0,0,0,0,0,0,0,0
sanity_quickml,quickml.supervised.tree.regressionTree.scorers,0,0,0,0,0,0,0,0
sanity_quickml,quickml.supervised.tree.regressionTree.treeBuildContexts,0,0,0,0,0,0,0,0
sanity_quickml,quickml.supervised.tree.regressionTree.valueCounters,0,0,0,0,0,1,0,1
sanity_quickml,quickml.supervised.tree.scorers,0,0,0,0,1,3,0,4
sanity_quickml,quickml.supervised.tree.summaryStatistics,0,0,0,0,0,2,0,2
sanity_quickml,quickml.supervised.tree,0,0,0,0,0,0,0,0
sanity_quickml,quickml.supervised.tree.treeBuildContexts,0,0,0,0,0,0,0,0
sanity_quickml,quickml.unsupervised.clustering,0,0,0,0,0,0,0,0
sanity_quickml,quickml.utlities,3,0,0,0,1,1,0,5
sanity_quickml,quickml.utlities.selectors,1,1,0,0,0,0,0,2
sanity_quickml,quickml.supervised.classifier.logRegression,0,0,0,0,0,0,0,0
sanity_quickml,quickml.supervised.classifier.randomForest,0,0,0,0,0,0,0,0
sanity_quickml,quickml.supervised.downsampling,0,0,0,0,0,0,0,0
sanity_quickml,quickml.supervised.featureEngineering,0,0,0,0,1,0,0,1
sanity_quickml,quickml.supervised.tree.decisionTree.attributeIgnoringStrategies,0,0,0,0,0,0,0,0
sanjivsingh_stackoverflow-java-sdk,com.google.code.stackexchange.client.examples,0,0,0,0,1,0,0,1
sanjivsingh_stackoverflow-java-sdk,com.google.code.stackexchange.client,0,1,0,0,1,0,0,2
sanjivsingh_stackoverflow-java-sdk,com.google.code.stackexchange.client.constant,0,0,0,0,0,0,0,0
sanjivsingh_stackoverflow-java-sdk,com.google.code.stackexchange.client.example,0,0,0,0,0,0,0,0
sanjivsingh_stackoverflow-java-sdk,com.google.code.stackexchange.client.exception,0,0,0,0,0,0,0,0
sanjivsingh_stackoverflow-java-sdk,com.google.code.stackexchange.client.impl,0,0,0,0,0,0,0,0
sanjivsingh_stackoverflow-java-sdk,com.google.code.stackexchange.client.provider,0,0,0,0,0,0,0,0
sanjivsingh_stackoverflow-java-sdk,com.google.code.stackexchange.client.provider.url,0,0,0,0,0,0,0,0
sanjivsingh_stackoverflow-java-sdk,com.google.code.stackexchange.client.query,0,1,0,0,0,0,0,1
sanjivsingh_stackoverflow-java-sdk,com.google.code.stackexchange.client.query.impl,0,0,0,0,1,0,0,1
sanjivsingh_stackoverflow-java-sdk,com.google.code.stackexchange.common,0,0,0,0,0,0,0,0
sanjivsingh_stackoverflow-java-sdk,com.google.code.stackexchange.schema,0,0,0,0,1,0,0,1
schema-repo_schema-repo,org.schemarepo.api.converter,0,0,0,0,0,1,0,1
schema-repo_schema-repo,org.schemarepo.api,0,0,0,0,0,1,0,1
schema-repo_schema-repo,org.schemarepo.client,0,0,0,0,1,0,0,1
schema-repo_schema-repo,org.schemarepo,1,1,0,1,0,1,0,4
schema-repo_schema-repo,org.schemarepo.config,1,0,0,0,0,0,0,1
schema-repo_schema-repo,org.schemarepo.json,0,0,0,0,0,0,0,0
schema-repo_schema-repo,org.schemarepo.server,0,0,0,0,1,0,0,1
schema-repo_schema-repo,org.schemarepo.zookeeper,0,0,0,0,0,0,0,0
scoverage_scoverage-maven-plugin,org.scoverage.plugin,0,0,0,0,1,0,0,1
scratches_spring-boot-legacy,org.springframework.boot.legacy.context.web,0,0,0,0,1,0,0,1
scratches_spring-boot-legacy,org.springframework.boot.legacy.context.web.servlet.support,0,0,0,0,0,0,0,0
scratches_spring-boot-legacy,org.springframework.boot.web.servlet,0,0,0,0,0,0,0,0
scratches_spring-boot-legacy,demo,0,0,0,0,1,0,0,1
scratches_spring-boot-legacy,demo.hello,0,0,0,0,0,0,0,0
scriptella_scriptella-etl,scriptella.configuration,10,1,0,0,0,1,1,13
scriptella_scriptella-etl,scriptella.core,7,1,0,1,0,1,1,11
scriptella_scriptella-etl,scriptella.execution,2,0,0,0,0,2,1,5
scriptella_scriptella-etl,scriptella.expression,5,1,0,0,0,3,1,10
scriptella_scriptella-etl,scriptella.interactive,0,0,0,0,1,0,1,2
scriptella_scriptella-etl,scriptella.jdbc,2,0,0,1,0,1,1,5
scriptella_scriptella-etl,scriptella.spi,6,1,0,0,1,5,1,14
scriptella_scriptella-etl,scriptella.spi.support,0,0,0,0,0,0,1,1
scriptella_scriptella-etl,scriptella.text,3,0,0,0,0,0,1,4
scriptella_scriptella-etl,scriptella.util,0,0,0,0,1,0,1,2
scriptella_scriptella-etl,scriptella,0,0,0,0,0,1,1,2
scriptella_scriptella-etl,scriptella.driver.as400,0,0,0,0,0,0,1,1
scriptella_scriptella-etl,scriptella.driver.auto,0,0,0,0,0,0,1,1
scriptella_scriptella-etl,scriptella.driver.csv,0,0,0,0,1,1,1,3
scriptella_scriptella-etl,scriptella.driver.csv.opencsv,0,0,0,0,0,0,1,1
scriptella_scriptella-etl,scriptella.driver.cubrid,0,0,0,0,0,0,1,1
scriptella_scriptella-etl,scriptella.driver.db2,0,0,0,0,0,0,1,1
scriptella_scriptella-etl,scriptella.driver.derby,0,0,0,0,0,0,1,1
scriptella_scriptella-etl,scriptella.driver.h2,0,0,0,0,0,0,1,1
scriptella_scriptella-etl,scriptella.driver.hsqldb,0,0,0,0,0,0,1,1
scriptella_scriptella-etl,scriptella.driver.janino,0,0,0,0,1,0,1,2
scriptella_scriptella-etl,scriptella.driver.jexl,0,0,0,0,1,0,1,2
scriptella_scriptella-etl,scriptella.driver.jndi,0,0,0,0,0,0,1,1
scriptella_scriptella-etl,scriptella.driver.ldap,0,0,0,0,0,1,1,2
scriptella_scriptella-etl,scriptella.driver.ldap.ldif,0,0,0,0,1,0,1,2
scriptella_scriptella-etl,scriptella.driver.lucene,0,0,0,0,0,0,1,1
scriptella_scriptella-etl,scriptella.driver.mail,0,0,0,0,0,0,1,1
scriptella_scriptella-etl,scriptella.driver.mssql,0,0,0,0,0,0,1,1
scriptella_scriptella-etl,scriptella.driver.mysql,0,0,0,0,0,0,1,1
scriptella_scriptella-etl,scriptella.driver.odbc,0,0,0,0,0,0,1,1
scriptella_scriptella-etl,scriptella.driver.oracle,0,0,0,0,0,0,1,1
scriptella_scriptella-etl,scriptella.driver.postgresql,0,0,0,0,0,0,1,1
scriptella_scriptella-etl,scriptella.driver.script,0,0,0,0,0,0,1,1
scriptella_scriptella-etl,scriptella.driver.scriptella,0,0,0,0,0,0,1,1
scriptella_scriptella-etl,scriptella.driver.spring,0,0,0,0,0,0,1,1
scriptella_scriptella-etl,scriptella.driver.sybase,0,0,0,0,0,0,1,1
scriptella_scriptella-etl,scriptella.driver.text,0,0,0,0,1,1,1,3
scriptella_scriptella-etl,scriptella.driver.velocity,0,0,0,0,1,0,1,2
scriptella_scriptella-etl,scriptella.driver.xls,0,0,0,0,0,0,1,1
scriptella_scriptella-etl,scriptella.driver.xpath,0,0,0,0,1,1,1,3
scriptella_scriptella-etl,scriptella.driver.alljdbc,0,0,0,0,0,0,1,1
scriptella_scriptella-etl,scriptella.tools.ant,0,0,0,0,1,0,1,2
scriptella_scriptella-etl,scriptella.tools.launcher,0,0,0,0,0,0,1,1
scriptella_scriptella-etl,scriptella.tools.template,0,0,0,0,0,0,1,1
sd4324530_fastweixin,com.github.sd4324530.fastweixin.api,0,0,0,0,1,0,0,1
sd4324530_fastweixin,com.github.sd4324530.fastweixin.api.config,0,0,0,0,0,0,0,0
sd4324530_fastweixin,com.github.sd4324530.fastweixin.api.entity,0,0,0,1,1,1,0,3
sd4324530_fastweixin,com.github.sd4324530.fastweixin.api.request,0,0,0,0,0,0,0,0
sd4324530_fastweixin,com.github.sd4324530.fastweixin.api.response,1,0,0,1,0,3,0,5
sd4324530_fastweixin,com.github.sd4324530.fastweixin.company.api.config,0,0,0,0,0,0,0,0
sd4324530_fastweixin,com.github.sd4324530.fastweixin.company.api.entity,0,0,0,0,1,1,0,2
sd4324530_fastweixin,com.github.sd4324530.fastweixin.company.api.handle,0,0,0,0,0,0,0,0
sd4324530_fastweixin,com.github.sd4324530.fastweixin.company.api,0,0,0,0,1,5,0,6
sd4324530_fastweixin,com.github.sd4324530.fastweixin.company.api.response,0,0,0,0,1,3,0,4
sd4324530_fastweixin,com.github.sd4324530.fastweixin.company.handle,0,0,0,0,0,0,0,0
sd4324530_fastweixin,com.github.sd4324530.fastweixin.company.message,0,0,0,0,1,0,0,1
sd4324530_fastweixin,com.github.sd4324530.fastweixin.company.message.req,0,0,0,0,0,0,0,0
sd4324530_fastweixin,com.github.sd4324530.fastweixin.company.message.resp,0,0,0,0,0,0,0,0
sd4324530_fastweixin,com.github.sd4324530.fastweixin.exception,0,0,0,0,0,0,0,0
sd4324530_fastweixin,com.github.sd4324530.fastweixin.handle,0,0,0,0,0,0,0,0
sd4324530_fastweixin,com.github.sd4324530.fastweixin.message.aes,0,0,0,0,0,0,0,0
sd4324530_fastweixin,com.github.sd4324530.fastweixin.message,0,0,0,0,0,0,0,0
sd4324530_fastweixin,com.github.sd4324530.fastweixin.message.req,0,0,0,0,0,0,0,0
sd4324530_fastweixin,com.github.sd4324530.fastweixin.message.util,0,0,0,0,0,0,0,0
sd4324530_fastweixin,com.github.sd4324530.fastweixin.servlet,0,0,0,0,1,0,0,1
sd4324530_fastweixin,com.github.sd4324530.fastweixin.util,1,1,0,0,1,0,0,3
sd4324530_fastweixin,com.github.sd4324530.fastweixin,0,0,0,0,0,4,0,4
sdbg_sdbg,com.github.sdbg.core,3,1,0,0,0,0,1,5
sdbg_sdbg,com.github.sdbg.debug.core.breakpoints,2,0,0,0,0,0,1,3
sdbg_sdbg,com.github.sdbg.debug.core,23,1,0,0,1,0,1,26
sdbg_sdbg,com.github.sdbg.debug.core.configs,2,0,0,0,1,0,1,4
sdbg_sdbg,com.github.sdbg.debug.core.internal.android,3,0,0,0,0,0,1,4
sdbg_sdbg,com.github.sdbg.debug.core.internal.expr,2,0,0,0,0,0,1,3
sdbg_sdbg,com.github.sdbg.debug.core.internal.forwarder,0,0,0,0,0,0,1,1
sdbg_sdbg,com.github.sdbg.debug.core.internal.source,2,0,0,0,0,0,1,3
sdbg_sdbg,com.github.sdbg.debug.core.internal.sourcemaps,0,0,0,0,1,0,1,2
sdbg_sdbg,com.github.sdbg.debug.core.internal.util,12,1,0,0,1,0,1,15
sdbg_sdbg,com.github.sdbg.debug.core.internal.webkit.model,7,0,0,1,1,0,1,10
sdbg_sdbg,com.github.sdbg.debug.core.internal.webkit.protocol,3,0,0,1,1,0,1,6
sdbg_sdbg,com.github.sdbg.debug.core.model,0,0,0,0,1,0,1,2
sdbg_sdbg,com.github.sdbg.debug.core.util,9,1,0,0,1,0,1,12
sdbg_sdbg,com.github.sdbg.utilities,7,1,0,0,1,0,1,10
sdbg_sdbg,com.github.sdbg.utilities.instrumentation,0,0,0,0,0,0,1,1
sdbg_sdbg,com.github.sdbg.core.util.io,0,0,0,0,0,0,1,1
sdbg_sdbg,com.github.sdbg.debug.ui.internal.actions,0,0,0,0,0,0,1,1
sdbg_sdbg,com.github.sdbg.debug.ui.internal.androidreverseforwards,0,0,0,0,0,0,1,1
sdbg_sdbg,com.github.sdbg.debug.ui.internal.breakpoints,0,0,0,0,1,0,1,2
sdbg_sdbg,com.github.sdbg.debug.ui.internal.browser,3,0,0,0,0,0,1,4
sdbg_sdbg,com.github.sdbg.debug.ui.internal.chrome,3,0,0,0,0,0,1,4
sdbg_sdbg,com.github.sdbg.debug.ui.internal.chromeapp,4,0,0,0,0,0,1,5
sdbg_sdbg,com.github.sdbg.debug.ui.internal.chromeconn,0,0,0,0,0,0,1,1
sdbg_sdbg,com.github.sdbg.debug.ui.internal.chromemobileconn,0,0,0,0,0,0,1,1
sdbg_sdbg,com.github.sdbg.debug.ui.internal,10,1,0,0,1,0,1,13
sdbg_sdbg,com.github.sdbg.debug.ui.internal.editors,0,0,0,0,1,0,1,2
sdbg_sdbg,com.github.sdbg.debug.ui.internal.hover,0,0,0,0,0,0,1,1
sdbg_sdbg,com.github.sdbg.debug.ui.internal.launch,0,0,0,0,1,0,1,2
sdbg_sdbg,com.github.sdbg.debug.ui.internal.objectinspector,4,0,0,0,1,0,1,6
sdbg_sdbg,com.github.sdbg.debug.ui.internal.preferences,0,0,0,0,0,0,1,1
sdbg_sdbg,com.github.sdbg.debug.ui.internal.presentation,1,0,0,0,1,0,1,3
sdbg_sdbg,com.github.sdbg.debug.ui.internal.pubserve,0,0,0,0,0,0,1,1
sdbg_sdbg,com.github.sdbg.debug.ui.internal.util,11,1,0,0,1,0,1,14
sdbg_sdbg,com.github.sdbg.debug.ui.internal.view,0,0,0,0,1,0,1,2
sdbg_sdbg,com.github.sdbg.ui.actions,0,0,0,0,0,0,1,1
sdbg_sdbg,com.github.sdbg.ui.instrumentation,0,0,0,0,0,0,1,1
sdbg_sdbg,com.github.sdbg.ui.internal.util,0,0,0,0,0,0,1,1
sdbg_sdbg,com.github.sdbg.integration.jdt,0,0,0,0,1,0,1,2
sdbg_sdbg,com.github.sdbg.integration.jdt.gwt.build,0,0,0,0,1,0,1,2
sdbg_sdbg,com.github.sdbg.integration.jdt.gwt.build.ui,0,0,0,0,0,0,1,1
sdbg_sdbg,com.github.sdbg.integration.jdt.gwt,0,0,0,0,1,0,1,2
sdbg_sdbg,com.github.sdbg.integration.jdt.ui,0,0,0,0,0,0,1,1
sdbg_sdbg,com.github.sdbg.maven,0,0,0,0,0,0,1,1
sdstoehr_har-reader,de.sstoehr.harreader,0,0,0,0,0,0,0,0
sdstoehr_har-reader,de.sstoehr.harreader.jackson,0,0,0,0,0,0,0,0
sdstoehr_har-reader,de.sstoehr.harreader.model,0,0,0,1,1,0,0,2
seagate_kinetic-java,com.seagate.kinetic.admin.cli,0,0,0,0,1,0,0,1
seagate_kinetic-java,com.seagate.kinetic.admin.impl,0,0,0,0,1,0,0,1
seagate_kinetic-java,com.seagate.kinetic.client.internal.async,0,0,0,0,1,1,0,2
seagate_kinetic-java,com.seagate.kinetic.client.internal,0,0,0,0,1,1,0,2
seagate_kinetic-java,com.seagate.kinetic.client.internal.p2p,0,0,0,0,0,0,0,0
seagate_kinetic-java,com.seagate.kinetic.client.internal.util.bigobject,0,0,0,0,1,1,0,2
seagate_kinetic-java,com.seagate.kinetic.client.internal.util.bigobject.example,0,0,0,0,1,0,0,1
seagate_kinetic-java,com.seagate.kinetic.client.io,0,0,0,0,0,0,0,0
seagate_kinetic-java,com.seagate.kinetic.client.io.provider.nio.http,0,0,0,0,1,0,0,1
seagate_kinetic-java,com.seagate.kinetic.client.io.provider.nio,0,0,0,0,0,0,0,0
seagate_kinetic-java,com.seagate.kinetic.client.io.provider.nio.ssl,0,0,0,0,1,1,0,2
seagate_kinetic-java,com.seagate.kinetic.client.io.provider.nio.tcp,0,1,0,0,1,1,0,3
seagate_kinetic-java,com.seagate.kinetic.client.io.provider.nio.udt,0,0,0,0,1,1,0,2
seagate_kinetic-java,com.seagate.kinetic.client.io.provider.spi,0,0,0,0,0,3,0,3
seagate_kinetic-java,com.seagate.kinetic.client.io.provider.tcp,0,0,0,0,0,0,0,0
seagate_kinetic-java,com.seagate.kinetic.client.lib,0,0,0,0,0,0,0,0
seagate_kinetic-java,com.seagate.kinetic.common.lib,0,0,0,0,1,0,0,1
seagate_kinetic-java,com.seagate.kinetic.common.protocol.codec,0,0,0,0,0,0,0,0
seagate_kinetic-java,com.seagate.kinetic.heartbeat,0,0,0,0,0,1,0,1
seagate_kinetic-java,com.seagate.kinetic.heartbeat.message,0,0,0,0,1,0,0,1
seagate_kinetic-java,com.seagate.kinetic.monitor,0,0,0,0,1,0,0,1
seagate_kinetic-java,com.seagate.kinetic.monitor.internal.service,0,0,0,0,1,1,0,2
seagate_kinetic-java,com.seagate.kinetic.monitor.internal.servlet,0,0,0,0,0,0,0,0
seagate_kinetic-java,com.seagate.kinetic.proto,0,0,0,2,0,0,0,2
seagate_kinetic-java,com.seagate.kinetic.simulator.heartbeat,0,0,0,0,0,0,0,0
seagate_kinetic-java,com.seagate.kinetic.simulator.heartbeat.provider,0,0,0,0,0,1,0,1
seagate_kinetic-java,com.seagate.kinetic.simulator.internal,5,0,0,1,1,2,0,9
seagate_kinetic-java,com.seagate.kinetic.simulator.internal.handler,0,0,0,0,1,0,0,1
seagate_kinetic-java,com.seagate.kinetic.simulator.internal.p2p,0,0,0,0,0,0,0,0
seagate_kinetic-java,com.seagate.kinetic.simulator.io.provider.nio,2,1,0,0,1,1,0,5
seagate_kinetic-java,com.seagate.kinetic.simulator.io.provider.nio.http,0,0,0,0,1,1,0,2
seagate_kinetic-java,com.seagate.kinetic.simulator.io.provider.nio.ssl,0,0,0,0,1,0,0,1
seagate_kinetic-java,com.seagate.kinetic.simulator.io.provider.nio.tcp,0,0,0,0,1,0,0,1
seagate_kinetic-java,com.seagate.kinetic.simulator.io.provider.nio.udt,0,0,0,0,1,1,0,2
seagate_kinetic-java,com.seagate.kinetic.simulator.io.provider.spi,0,0,0,0,0,4,0,4
seagate_kinetic-java,com.seagate.kinetic.simulator.io.provider.tcp,0,0,0,0,1,2,0,3
seagate_kinetic-java,com.seagate.kinetic.simulator.lib,0,0,0,0,1,0,0,1
seagate_kinetic-java,com.seagate.kinetic.simulator.persist,1,1,0,0,1,0,0,3
seagate_kinetic-java,com.seagate.kinetic.simulator.persist.bdb,0,0,0,0,1,0,0,1
seagate_kinetic-java,com.seagate.kinetic.simulator.persist.kyoto,0,0,0,0,0,0,0,0
seagate_kinetic-java,com.seagate.kinetic.simulator.persist.leveldb,0,0,0,0,1,0,0,1
seagate_kinetic-java,com.seagate.kinetic.simulator.persist.memory,0,0,0,0,0,0,0,0
seagate_kinetic-java,com.seagate.kinetic.simulator.utility,1,0,0,0,1,0,0,2
seagate_kinetic-java,kinetic.admin,0,1,0,0,1,4,0,6
seagate_kinetic-java,kinetic.client.advanced,0,0,0,0,0,4,0,4
seagate_kinetic-java,kinetic.client,0,1,0,1,1,17,0,20
seagate_kinetic-java,kinetic.client.p2p,0,0,0,0,1,0,0,1
seagate_kinetic-java,kinetic.simulator,3,1,0,0,0,7,0,11
seagate_kinetic-java,com.google.cloud,0,0,0,0,0,0,0,0
seagate_kinetic-java,com.seagate.kinetic,0,0,0,0,1,11,0,12
seagate_kinetic-java,com.seagate.kinetic.adminAPI,0,0,0,0,0,0,0,0
seagate_kinetic-java,com.seagate.kinetic.advancedAPI,0,0,0,0,0,1,0,1
seagate_kinetic-java,com.seagate.kinetic.asyncAPI,0,0,0,0,0,1,0,1
seagate_kinetic-java,com.seagate.kinetic.basicAPI,0,0,0,0,0,1,0,1
seagate_kinetic-java,com.seagate.kinetic.batchOp,0,0,0,0,1,0,0,1
seagate_kinetic-java,com.seagate.kinetic.boundary,0,0,0,0,0,1,0,1
seagate_kinetic-java,com.seagate.kinetic.concurrent,0,0,0,0,0,1,0,1
seagate_kinetic-java,com.seagate.kinetic.duriablity,0,0,0,0,0,0,0,0
seagate_kinetic-java,com.seagate.kinetic.example.admin,0,0,0,0,0,1,0,1
seagate_kinetic-java,com.seagate.kinetic.example.advanced,0,0,0,0,0,0,0,0
seagate_kinetic-java,com.seagate.kinetic.example.batchop,0,0,0,0,0,0,0,0
seagate_kinetic-java,com.seagate.kinetic.example.client.async,0,0,0,0,0,0,0,0
seagate_kinetic-java,com.seagate.kinetic.example.client,0,0,0,0,0,0,0,0
seagate_kinetic-java,com.seagate.kinetic.example.heartbeat.rest,0,0,0,0,0,0,0,0
seagate_kinetic-java,com.seagate.kinetic.example.heartbeat,0,0,0,0,0,0,0,0
seagate_kinetic-java,com.seagate.kinetic.example,0,0,0,0,0,0,0,0
seagate_kinetic-java,com.seagate.kinetic.example.monitor,0,0,0,0,0,0,0,0
seagate_kinetic-java,com.seagate.kinetic.example.openstorage,0,0,0,0,0,0,0,0
seagate_kinetic-java,com.seagate.kinetic.example.showprotocol,0,0,0,0,0,0,0,0
seagate_kinetic-java,com.seagate.kinetic.example.simulator,0,0,0,0,0,0,0,0
seagate_kinetic-java,com.seagate.kinetic.performance,0,0,0,0,0,2,0,2
seagate_kinetic-java,com.seagate.kinetic.sanityAPI,0,0,0,0,0,1,0,1
seagate_kinetic-java,com.seagate.kinetic.simulator.client.admin,0,0,0,0,0,1,0,1
seagate_kinetic-java,com.seagate.kinetic.simulator.client.admin.impl,0,0,0,0,0,1,0,1
seagate_kinetic-java,com.seagate.kinetic.simulator.client.async,0,0,0,0,1,0,0,1
seagate_kinetic-java,com.seagate.kinetic.simulator.client.internal,0,0,0,0,0,0,0,0
seagate_kinetic-java,com.seagate.kinetic.simulator.client.p2p,0,0,0,0,0,0,0,0
seagate_kinetic-java,com.seagate.kinetic.simulator.client.sanity,0,0,0,0,0,1,0,1
seagate_kinetic-java,com.seagate.kinetic.simulator.common.lib,0,0,0,0,0,0,0,0
seagate_kinetic-java,com.seagate.kinetic.simulator.console.multi,0,0,0,0,0,1,0,1
seagate_kinetic-java,com.seagate.kinetic.simulator.console.one,0,0,0,0,0,0,0,0
seagate_kinetic-java,com.seagate.kinetic.simulator.performance,0,0,0,0,1,0,0,1
seagate_kinetic-java,com.seagate.kinetic.socketlog,0,0,0,0,0,0,0,0
seagate_kinetic-java,com.seagate.kinetic.stress,0,0,0,0,0,0,0,0
seagate_kinetic-java,com.seagate.kinetic.usage.async,0,0,0,0,0,0,0,0
seagate_kinetic-java,com.seagate.kinetic.usage.p2p,0,0,0,0,0,1,0,1
searchisko_elasticsearch-river-jira,org.jboss.elasticsearch.river.jira,5,1,0,0,0,0,0,6
searchisko_elasticsearch-river-jira,org.jboss.elasticsearch.river.jira.mgm.fullupdate,1,0,0,0,1,0,0,2
searchisko_elasticsearch-river-jira,org.jboss.elasticsearch.river.jira.mgm.incrementalupdate,1,0,0,0,1,0,0,2
searchisko_elasticsearch-river-jira,org.jboss.elasticsearch.river.jira.mgm,0,0,0,0,1,0,0,1
searchisko_elasticsearch-river-jira,org.jboss.elasticsearch.river.jira.mgm.lifecycle,1,1,0,0,1,0,0,3
searchisko_elasticsearch-river-jira,org.jboss.elasticsearch.river.jira.mgm.riverslist,1,0,0,0,1,0,0,2
searchisko_elasticsearch-river-jira,org.jboss.elasticsearch.river.jira.mgm.state,1,1,0,0,1,0,0,3
searchisko_elasticsearch-river-remote,org.jboss.elasticsearch.river.remote,6,1,0,1,1,0,0,9
searchisko_elasticsearch-river-remote,org.jboss.elasticsearch.river.remote.content,0,0,0,0,0,0,0,0
searchisko_elasticsearch-river-remote,org.jboss.elasticsearch.river.remote.exception,0,0,0,0,0,0,0,0
searchisko_elasticsearch-river-remote,org.jboss.elasticsearch.river.remote.mgm.fullupdate,1,0,0,0,1,0,0,2
searchisko_elasticsearch-river-remote,org.jboss.elasticsearch.river.remote.mgm.incrementalupdate,1,0,0,0,1,0,0,2
searchisko_elasticsearch-river-remote,org.jboss.elasticsearch.river.remote.mgm,0,0,0,0,1,0,0,1
searchisko_elasticsearch-river-remote,org.jboss.elasticsearch.river.remote.mgm.lifecycle,1,1,0,0,1,0,0,3
searchisko_elasticsearch-river-remote,org.jboss.elasticsearch.river.remote.mgm.riverslist,1,0,0,0,1,0,0,2
searchisko_elasticsearch-river-remote,org.jboss.elasticsearch.river.remote.mgm.state,1,1,0,0,1,0,0,3
searchisko_elasticsearch-river-remote,org.jboss.elasticsearch.river.remote.sitemap,1,1,0,0,1,0,0,3
searchisko_elasticsearch-river-sysinfo,org.jboss.elasticsearch.river.sysinfo.esclient,1,1,0,0,1,0,0,3
searchisko_elasticsearch-river-sysinfo,org.jboss.elasticsearch.river.sysinfo,6,1,0,0,0,0,0,7
searchisko_elasticsearch-river-sysinfo,org.jboss.elasticsearch.river.sysinfo.mgm,2,0,0,0,1,0,0,3
searchisko_elasticsearch-river-sysinfo,org.jboss.elasticsearch.river.sysinfo.mgm.lifecycle,2,1,0,0,1,0,0,4
searchisko_elasticsearch-river-sysinfo,org.jboss.elasticsearch.river.sysinfo.mgm.period,1,0,0,0,1,0,0,2
searchisko_elasticsearch-river-sysinfo,org.jboss.elasticsearch.river.sysinfo.mgm.riverslist,3,0,0,0,1,0,0,4
sebastiangraf_perfidix,org.perfidix,2,0,0,0,0,2,0,4
sebastiangraf_perfidix,org.perfidix.element,3,1,0,1,0,2,0,7
sebastiangraf_perfidix,org.perfidix.example,0,0,0,0,0,0,0,0
sebastiangraf_perfidix,org.perfidix.example.list,0,0,0,0,0,0,0,0
sebastiangraf_perfidix,org.perfidix.example.stack,0,0,0,0,0,1,0,1
sebastiangraf_perfidix,org.perfidix.exceptions,0,0,0,0,0,0,0,0
sebastiangraf_perfidix,org.perfidix.meter,0,0,0,0,0,2,0,2
sebastiangraf_perfidix,org.perfidix.ouput,0,0,0,0,0,3,0,3
sebastiangraf_perfidix,org.perfidix.ouput.asciitable,0,0,0,0,0,0,0,0
sebastiangraf_perfidix,org.perfidix.result,2,1,0,0,1,3,0,7
sebastiangraf_perfidix,org.perfidix.socketadapter,0,0,0,0,1,0,0,1
sebastiangraf_perfidix,org.perfidix.output.asciitable,0,0,0,0,0,0,0,0
sebastiangraf_perfidix,org.perfidix.output,0,0,0,0,0,2,0,2
seleniumQuery_seleniumQuery,io.github.seleniumquery.browser,0,0,0,0,0,0,0,0
seleniumQuery_seleniumQuery,io.github.seleniumquery.browser.driver.builders,0,0,0,0,1,0,0,1
seleniumQuery_seleniumQuery,io.github.seleniumquery.browser.driver,0,0,0,0,0,0,0,0
seleniumQuery_seleniumQuery,io.github.seleniumquery.by.common,0,0,0,0,0,0,0,0
seleniumQuery_seleniumQuery,io.github.seleniumquery.by.common.elementfilter,0,0,0,0,0,1,0,1
seleniumQuery_seleniumQuery,io.github.seleniumquery.by.common.preparser,0,0,0,0,1,0,0,1
seleniumQuery_seleniumQuery,io.github.seleniumquery.by.common.preparser.w3cwithmap,0,0,0,0,0,0,0,0
seleniumQuery_seleniumQuery,io.github.seleniumquery.by,0,0,0,0,0,0,0,0
seleniumQuery_seleniumQuery,io.github.seleniumquery.by.firstgen.css.attributes,0,0,0,0,1,0,0,1
seleniumQuery_seleniumQuery,io.github.seleniumquery.by.firstgen.css.combinators,0,0,0,0,1,0,0,1
seleniumQuery_seleniumQuery,io.github.seleniumquery.by.firstgen.css.conditionals,0,0,0,0,0,0,0,0
seleniumQuery_seleniumQuery,io.github.seleniumquery.by.firstgen.css,0,1,0,0,0,0,0,1
seleniumQuery_seleniumQuery,io.github.seleniumquery.by.firstgen.css.pseudoclasses,0,0,0,1,1,0,0,2
seleniumQuery_seleniumQuery,io.github.seleniumquery.by.firstgen.css.tagname,0,0,0,0,0,0,0,0
seleniumQuery_seleniumQuery,io.github.seleniumquery.by.firstgen,0,0,0,0,0,0,0,0
seleniumQuery_seleniumQuery,io.github.seleniumquery.by.firstgen.xpath.component,0,0,0,0,0,0,0,0
seleniumQuery_seleniumQuery,io.github.seleniumquery.by.firstgen.xpath.component.special,0,0,0,0,0,0,0,0
seleniumQuery_seleniumQuery,io.github.seleniumquery.by.firstgen.xpath,0,0,0,0,0,0,0,0
seleniumQuery_seleniumQuery,io.github.seleniumquery.by.secondgen.csstree.condition.attribute,0,0,0,0,0,1,0,1
seleniumQuery_seleniumQuery,io.github.seleniumquery.by.secondgen.csstree.condition,0,0,0,0,1,0,0,1
seleniumQuery_seleniumQuery,io.github.seleniumquery.by.secondgen.csstree.condition.pseudoclass.basicfilter,1,1,0,0,1,0,0,3
seleniumQuery_seleniumQuery,io.github.seleniumquery.by.secondgen.csstree.condition.pseudoclass.childfilter,0,0,0,0,1,0,0,1
seleniumQuery_seleniumQuery,io.github.seleniumquery.by.secondgen.csstree.condition.pseudoclass.contentfilter,0,0,0,0,1,0,0,1
seleniumQuery_seleniumQuery,io.github.seleniumquery.by.secondgen.csstree.condition.pseudoclass,1,0,0,0,1,0,0,2
seleniumQuery_seleniumQuery,io.github.seleniumquery.by.secondgen.csstree.condition.pseudoclass.finderfactorystrategy,0,0,0,0,0,0,0,0
seleniumQuery_seleniumQuery,io.github.seleniumquery.by.secondgen.csstree.condition.pseudoclass.form,0,0,0,1,1,0,0,2
seleniumQuery_seleniumQuery,io.github.seleniumquery.by.secondgen.csstree.condition.pseudoclass.jqueryui,0,0,0,0,0,0,0,0
seleniumQuery_seleniumQuery,io.github.seleniumquery.by.secondgen.csstree.condition.pseudoclass.seleniumquery,0,0,0,0,1,0,0,1
seleniumQuery_seleniumQuery,io.github.seleniumquery.by.secondgen.csstree.condition.pseudoclass.visibility,0,0,0,0,0,0,0,0
seleniumQuery_seleniumQuery,io.github.seleniumquery.by.secondgen.csstree,0,0,0,0,0,1,0,1
seleniumQuery_seleniumQuery,io.github.seleniumquery.by.secondgen.csstree.selector.combinator,0,0,0,0,1,1,0,2
seleniumQuery_seleniumQuery,io.github.seleniumquery.by.secondgen.csstree.selector,0,1,0,0,1,1,0,3
seleniumQuery_seleniumQuery,io.github.seleniumquery.by.secondgen.finder,0,1,0,0,1,1,0,3
seleniumQuery_seleniumQuery,io.github.seleniumquery.by.secondgen,0,0,0,0,0,0,0,0
seleniumQuery_seleniumQuery,io.github.seleniumquery.by.secondgen.parser.ast.condition,0,0,0,0,0,0,0,0
seleniumQuery_seleniumQuery,io.github.seleniumquery.by.secondgen.parser.ast.condition.attribute,0,0,0,0,0,0,0,0
seleniumQuery_seleniumQuery,io.github.seleniumquery.by.secondgen.parser.ast.condition.pseudoclass,0,0,0,0,0,0,0,0
seleniumQuery_seleniumQuery,io.github.seleniumquery.by.secondgen.parser.ast.condition.pseudoclass.basicfilter,0,0,0,0,1,0,0,1
seleniumQuery_seleniumQuery,io.github.seleniumquery.by.secondgen.parser.ast.condition.pseudoclass.childfilter,0,0,0,0,1,0,0,1
seleniumQuery_seleniumQuery,io.github.seleniumquery.by.secondgen.parser.ast.condition.pseudoclass.contentfilter,0,0,0,0,0,0,0,0
seleniumQuery_seleniumQuery,io.github.seleniumquery.by.secondgen.parser.ast.condition.pseudoclass.form,0,0,0,0,1,0,0,1
seleniumQuery_seleniumQuery,io.github.seleniumquery.by.secondgen.parser.ast.condition.pseudoclass.jqueryui,0,0,0,0,0,0,0,0
seleniumQuery_seleniumQuery,io.github.seleniumquery.by.secondgen.parser.ast.condition.pseudoclass.seleniumquery,0,0,0,0,0,0,0,0
seleniumQuery_seleniumQuery,io.github.seleniumquery.by.secondgen.parser.ast.condition.pseudoclass.visibility,0,0,0,0,0,0,0,0
seleniumQuery_seleniumQuery,io.github.seleniumquery.by.secondgen.parser.ast.selector,0,0,0,0,0,0,0,0
seleniumQuery_seleniumQuery,io.github.seleniumquery.by.secondgen.parser,0,0,0,0,0,1,0,1
seleniumQuery_seleniumQuery,io.github.seleniumquery.by.secondgen.parser.translator.condition,0,0,0,0,0,0,0,0
seleniumQuery_seleniumQuery,io.github.seleniumquery.by.secondgen.parser.translator,0,0,0,0,0,0,0,0
seleniumQuery_seleniumQuery,io.github.seleniumquery.fluentfunctions.assertthat,0,0,0,0,0,0,0,0
seleniumQuery_seleniumQuery,io.github.seleniumquery.fluentfunctions.waituntil,0,0,0,0,0,0,0,0
seleniumQuery_seleniumQuery,io.github.seleniumquery.functions.as,0,0,0,0,0,0,0,0
seleniumQuery_seleniumQuery,io.github.seleniumquery.functions.jquery.attributes,0,0,0,0,0,0,0,0
seleniumQuery_seleniumQuery,io.github.seleniumquery.functions.jquery.events,0,0,0,0,1,0,0,1
seleniumQuery_seleniumQuery,io.github.seleniumquery.functions.jquery.forms,0,0,0,0,0,0,0,0
seleniumQuery_seleniumQuery,io.github.seleniumquery.functions.jquery.manipulation,0,0,0,0,0,0,0,0
seleniumQuery_seleniumQuery,io.github.seleniumquery.functions.jquery.miscellaneous,0,0,0,0,0,0,0,0
seleniumQuery_seleniumQuery,io.github.seleniumquery.functions.jquery.traversing.filtering,0,0,0,0,1,0,0,1
seleniumQuery_seleniumQuery,io.github.seleniumquery.functions.jquery.traversing.filtering.filterfunction,0,0,0,0,0,0,0,0
seleniumQuery_seleniumQuery,io.github.seleniumquery.functions.jquery.traversing,0,0,0,0,0,0,0,0
seleniumQuery_seleniumQuery,io.github.seleniumquery.functions.jquery.traversing.treetraversal,0,0,0,0,0,0,0,0
seleniumQuery_seleniumQuery,io.github.seleniumquery.functions,0,0,0,0,0,0,0,0
seleniumQuery_seleniumQuery,io.github.seleniumquery.functions.sq,0,0,0,0,0,0,0,0
seleniumQuery_seleniumQuery,io.github.seleniumquery.internal.browser.browserfunctions,0,0,0,0,0,0,0,0
seleniumQuery_seleniumQuery,io.github.seleniumquery.internal.browser,0,0,0,0,0,0,0,0
seleniumQuery_seleniumQuery,io.github.seleniumquery.internal.fluentfunctions,0,0,0,0,0,0,0,0
seleniumQuery_seleniumQuery,io.github.seleniumquery.internal.fluentfunctions.assertthat,0,0,0,0,0,0,0,0
seleniumQuery_seleniumQuery,io.github.seleniumquery.internal.fluentfunctions.evaluators.comparison,0,0,0,0,0,0,0,0
seleniumQuery_seleniumQuery,io.github.seleniumquery.internal.fluentfunctions.evaluators,0,0,0,0,0,1,0,1
seleniumQuery_seleniumQuery,io.github.seleniumquery.internal.fluentfunctions.evaluators.is,0,0,0,0,1,0,0,1
seleniumQuery_seleniumQuery,io.github.seleniumquery.internal.fluentfunctions.evaluators.matches,0,0,0,0,1,1,0,2
seleniumQuery_seleniumQuery,io.github.seleniumquery.internal.fluentfunctions.getters,0,0,0,0,1,1,0,2
seleniumQuery_seleniumQuery,io.github.seleniumquery.internal.fluentfunctions.waituntil,0,0,0,0,0,0,0,0
seleniumQuery_seleniumQuery,io.github.seleniumquery.internal.functions.seleniumquery,0,0,0,0,0,0,0,0
seleniumQuery_seleniumQuery,io.github.seleniumquery.internal,2,0,0,0,0,0,0,2
seleniumQuery_seleniumQuery,io.github.seleniumquery,2,1,0,0,1,0,0,4
seleniumQuery_seleniumQuery,io.github.seleniumquery.utils,0,0,0,0,1,0,0,1
seleniumQuery_seleniumQuery,io.github.seleniumquery.wait,0,0,0,0,0,0,0,0
seleniumQuery_seleniumQuery,endtoend.basic,0,0,0,0,0,0,0,0
seleniumQuery_seleniumQuery,endtoend.browser.browserfunctions,0,0,0,0,0,0,0,0
seleniumQuery_seleniumQuery,endtoend.browser.driver.builders,0,0,0,0,1,0,0,1
seleniumQuery_seleniumQuery,endtoend.browser.driver,0,0,0,0,0,0,0,0
seleniumQuery_seleniumQuery,endtoend.browser,0,0,0,0,0,0,0,0
seleniumQuery_seleniumQuery,endtoend.browser.util,0,0,0,0,0,0,0,0
seleniumQuery_seleniumQuery,endtoend.by.firstgen.css.pseudoclasses,0,0,0,0,0,0,0,0
seleniumQuery_seleniumQuery,endtoend.crossdriver.driverbugs,0,0,0,0,0,0,0,0
seleniumQuery_seleniumQuery,endtoend.fluentfunctions.assertthat,0,0,0,0,0,0,0,0
seleniumQuery_seleniumQuery,endtoend.fluentfunctions.evaluators.comparison,0,0,0,0,0,0,0,0
seleniumQuery_seleniumQuery,endtoend.fluentfunctions.evaluators,0,0,0,0,0,0,0,0
seleniumQuery_seleniumQuery,endtoend.fluentfunctions.evaluators.is,0,0,0,0,1,0,0,1
seleniumQuery_seleniumQuery,endtoend.fluentfunctions.evaluators.matches,0,0,0,0,0,0,0,0
seleniumQuery_seleniumQuery,endtoend.fluentfunctions.getters,0,0,0,0,0,0,0,0
seleniumQuery_seleniumQuery,endtoend.fluentfunctions.waituntil,0,0,0,0,1,0,0,1
seleniumQuery_seleniumQuery,endtoend.functions.as,0,0,0,0,0,0,0,0
seleniumQuery_seleniumQuery,endtoend.functions.jquery.attributes,0,0,0,0,0,0,0,0
seleniumQuery_seleniumQuery,endtoend.functions.jquery.events,0,0,0,0,0,0,0,0
seleniumQuery_seleniumQuery,endtoend.functions.jquery.forms,0,0,0,0,0,0,0,0
seleniumQuery_seleniumQuery,endtoend.functions.jquery.forms.val,0,0,0,0,0,0,0,0
seleniumQuery_seleniumQuery,endtoend.functions.jquery.manipulation,0,0,0,0,0,0,0,0
seleniumQuery_seleniumQuery,endtoend.functions.jquery.traversing,0,0,0,0,1,0,0,1
seleniumQuery_seleniumQuery,endtoend.functions.jquery.traversing.filtering,0,0,0,0,0,0,0,0
seleniumQuery_seleniumQuery,endtoend.functions.seleniumquery,0,0,0,0,0,0,0,0
seleniumQuery_seleniumQuery,endtoend.functions,0,0,0,0,0,0,0,0
seleniumQuery_seleniumQuery,endtoend.selectors.attributes,0,0,0,0,0,0,0,0
seleniumQuery_seleniumQuery,endtoend.selectors.combinators,0,0,0,0,0,0,0,0
seleniumQuery_seleniumQuery,endtoend.selectors,0,0,0,0,0,0,0,0
seleniumQuery_seleniumQuery,endtoend.selectors.mixed,0,0,0,0,0,0,0,0
seleniumQuery_seleniumQuery,endtoend.selectors.pseudoclasses.childfilter,0,0,0,0,0,0,0,0
seleniumQuery_seleniumQuery,endtoend.selectors.pseudoclasses.content,0,0,0,0,0,0,0,0
seleniumQuery_seleniumQuery,endtoend.selectors.pseudoclasses.form,0,0,0,0,1,0,0,1
seleniumQuery_seleniumQuery,endtoend.selectors.pseudoclasses,0,0,0,0,0,0,0,0
seleniumQuery_seleniumQuery,endtoend.selectors.pseudoclasses.positional,0,0,0,0,1,0,0,1
seleniumQuery_seleniumQuery,endtoend.selectors.pseudoclasses.visibility,0,0,0,0,0,0,0,0
seleniumQuery_seleniumQuery,endtoend.showcase,0,0,0,0,0,0,0,0
seleniumQuery_seleniumQuery,endtoend.sizzle,0,0,0,0,1,0,0,1
seleniumQuery_seleniumQuery,endtoend.utils,0,0,0,0,0,0,0,0
seleniumQuery_seleniumQuery,integration.io.github.seleniumquery.by,0,0,0,0,0,0,0,0
seleniumQuery_seleniumQuery,integration.io.github.seleniumquery.internal.browser,0,0,0,0,0,0,0,0
seleniumQuery_seleniumQuery,io.github.seleniumquery.by.secondgen.parser.translator.condition.attribute,0,0,0,0,0,0,0,0
seleniumQuery_seleniumQuery,io.github.seleniumquery.by.secondgen.parser.translator.selector.combinator,0,0,0,0,0,1,0,1
seleniumQuery_seleniumQuery,io.github.seleniumquery.by.secondgen.parser.translator.selector,0,0,0,0,0,0,0,0
semanticvectors_semanticvectors,pitt.search.examples,0,0,0,0,0,1,0,1
semanticvectors_semanticvectors,(default package),0,0,0,0,0,0,0,0
semanticvectors_semanticvectors,ch.akuhn.edu.mit.tedlab,0,0,0,0,1,0,0,1
semanticvectors_semanticvectors,pitt.search.lucene,0,0,0,0,1,0,0,1
semanticvectors_semanticvectors,pitt.search.semanticvectors,8,1,0,1,0,9,0,19
semanticvectors_semanticvectors,pitt.search.semanticvectors.experiments,0,0,0,0,1,1,0,2
semanticvectors_semanticvectors,pitt.search.semanticvectors.orthography,2,0,0,0,1,2,0,5
semanticvectors_semanticvectors,pitt.search.semanticvectors.tables,0,0,0,0,1,3,0,4
semanticvectors_semanticvectors,pitt.search.semanticvectors.utils,6,1,0,0,1,5,0,13
semanticvectors_semanticvectors,pitt.search.semanticvectors.vectors,5,1,0,0,0,8,0,14
semanticvectors_semanticvectors,pitt.search.semanticvectors.viz,3,0,0,0,0,0,0,3
semanticvectors_semanticvectors,purposefulchoice,0,0,0,0,0,0,0,0
semanticvectors_semanticvectors,qut.beagle,0,0,0,0,0,0,0,0
senbox-org_s1tbx,org.jlinda.core,1,1,0,0,1,0,0,3
senbox-org_s1tbx,org.jlinda.core.coregistration,0,0,0,0,0,0,0,0
senbox-org_s1tbx,org.jlinda.core.coregistration.cross,0,0,0,0,0,0,0,0
senbox-org_s1tbx,org.jlinda.core.coregistration.estimation,0,0,0,0,0,0,0,0
senbox-org_s1tbx,org.jlinda.core.coregistration.utils,0,0,0,0,0,0,0,0
senbox-org_s1tbx,org.jlinda.core.delaunay,0,0,0,0,1,0,0,1
senbox-org_s1tbx,org.jlinda.core.filtering,0,0,0,0,1,0,0,1
senbox-org_s1tbx,org.jlinda.core.geocode,0,0,0,0,0,0,0,0
senbox-org_s1tbx,org.jlinda.core.geom,0,0,0,0,1,0,0,1
senbox-org_s1tbx,org.jlinda.core.io,0,0,0,0,1,0,0,1
senbox-org_s1tbx,org.jlinda.core.simulation,1,0,0,0,0,0,0,1
senbox-org_s1tbx,org.jlinda.core.unwrapping.snaphu,0,0,0,0,0,0,0,0
senbox-org_s1tbx,org.jlinda.core.utils,2,1,0,0,1,0,0,4
senbox-org_s1tbx,org.jlinda.nest.dataio,0,0,0,0,1,0,0,1
senbox-org_s1tbx,org.jlinda.nest.gpf,0,0,0,0,1,0,0,1
senbox-org_s1tbx,org.jlinda.nest.gpf.ui,0,0,0,0,0,0,0,0
senbox-org_s1tbx,org.csa.rstb.io.radarsat1,0,0,0,0,1,0,0,1
senbox-org_s1tbx,org.csa.rstb.io.radarsat2,0,0,0,0,1,0,0,1
senbox-org_s1tbx,org.csa.rstb.io.rcm,0,0,0,0,1,0,0,1
senbox-org_s1tbx,org.csa.rstb.about,0,0,0,0,0,0,0,0
senbox-org_s1tbx,org.csa.rstb.calibration,0,0,0,0,0,0,0,0
senbox-org_s1tbx,org.csa.rstb.classification.gpf.classifiers,0,0,0,0,1,0,0,1
senbox-org_s1tbx,org.csa.rstb.classification.gpf,0,0,0,0,0,0,0,0
senbox-org_s1tbx,org.csa.rstb.classification.gpf.ui,0,1,0,0,0,0,0,1
senbox-org_s1tbx,org.csa.rstb.classification.rcp.actions,0,0,0,0,0,0,0,0
senbox-org_s1tbx,org.csa.rstb.classification.rcp.dialogs,0,0,0,0,0,0,0,0
senbox-org_s1tbx,org.csa.rstb.classification.rcp.wizards.PolarimetryWizard,0,0,0,0,0,0,0,0
senbox-org_s1tbx,org.csa.rstb.classification.rcp.wizards.TerrainFlattenedClassification,0,0,0,0,0,0,0,0
senbox-org_s1tbx,org.csa.rstb.polarimetric.gpf,0,0,0,1,1,0,0,2
senbox-org_s1tbx,org.csa.rstb.polarimetric.gpf.decompositions,0,0,0,0,1,0,0,1
senbox-org_s1tbx,org.csa.rstb.polarimetric.gpf.decompositions_cp,0,0,0,0,0,0,0,0
senbox-org_s1tbx,org.csa.rstb.polarimetric.gpf.specklefilters,0,0,0,0,1,0,0,1
senbox-org_s1tbx,org.csa.rstb.polarimetric.gpf.specklefilters.covariance,0,0,0,0,0,0,0,0
senbox-org_s1tbx,org.csa.rstb.polarimetric.gpf.support,0,0,0,0,1,0,0,1
senbox-org_s1tbx,org.csa.rstb.polarimetric.gpf.ui,0,0,0,0,0,0,0,0
senbox-org_s1tbx,org.csa.rstb.polarimetric,0,0,0,0,0,0,0,0
senbox-org_s1tbx,org.csa.rstb.polarimetric.rcp.actions,0,0,0,0,0,0,0,0
senbox-org_s1tbx,org.csa.rstb.polarimetric.rcp.toolviews,0,0,0,0,0,0,0,0
senbox-org_s1tbx,org.csa.rstb.soilmoisture.gpf,0,0,0,0,1,0,0,1
senbox-org_s1tbx,org.csa.rstb.soilmoisture.gpf.support,0,0,0,0,1,0,0,1
senbox-org_s1tbx,org.csa.rstb.soilmoisture.io.matlab,0,0,0,0,0,0,0,0
senbox-org_s1tbx,org.csa.rstb.soilmoisture,0,0,0,0,0,0,0,0
senbox-org_s1tbx,org.csa.rstb.soilmoisture.gpf.ui,0,0,0,0,1,0,0,1
senbox-org_s1tbx,org.esa.s1tbx.benchmark,0,0,0,0,1,0,0,1
senbox-org_s1tbx,array.rstb.utils,0,0,0,0,0,0,0,0
senbox-org_s1tbx,org.esa.s1tbx.commons,0,0,0,0,1,0,0,1
senbox-org_s1tbx,org.esa.s1tbx.commons.graphics,0,0,0,0,0,0,0,0
senbox-org_s1tbx,org.esa.s1tbx.commons.io,0,0,0,0,1,0,0,1
senbox-org_s1tbx,org.esa.s1tbx.commons.polsar,0,0,0,0,0,0,0,0
senbox-org_s1tbx,org.esa.s1tbx.commons.product,0,0,0,0,0,0,0,0
senbox-org_s1tbx,org.esa.s1tbx.commons.utils,0,0,0,0,0,0,0,0
senbox-org_s1tbx,org.esa.s1tbx.io.binary,0,0,0,0,1,0,0,1
senbox-org_s1tbx,org.esa.s1tbx.io.capella,0,0,0,0,1,0,0,1
senbox-org_s1tbx,org.esa.s1tbx.io.ceos.alos,0,0,0,0,1,0,0,1
senbox-org_s1tbx,org.esa.s1tbx.io.ceos.alos2,0,0,0,0,1,0,0,1
senbox-org_s1tbx,org.esa.s1tbx.io.ceos.basic,0,0,0,0,1,0,0,1
senbox-org_s1tbx,org.esa.s1tbx.io.ceos,0,0,0,0,1,0,0,1
senbox-org_s1tbx,org.esa.s1tbx.io.ceos.ers,0,0,0,0,1,0,0,1
senbox-org_s1tbx,org.esa.s1tbx.io.ceos.jers,0,0,0,0,1,0,0,1
senbox-org_s1tbx,org.esa.s1tbx.io.ceos.risat,0,0,0,0,1,0,0,1
senbox-org_s1tbx,org.esa.s1tbx.io.cosmo,0,0,0,0,0,0,0,0
senbox-org_s1tbx,org.esa.s1tbx.io.gamma,0,0,0,0,0,0,0,0
senbox-org_s1tbx,org.esa.s1tbx.io.gamma.header,0,0,0,0,1,0,0,1
senbox-org_s1tbx,org.esa.s1tbx.io.gamma.pyrate,0,0,0,0,0,0,0,0
senbox-org_s1tbx,org.esa.s1tbx.io.gamma.pyrate.pyrateheader,0,0,0,0,0,0,0,0
senbox-org_s1tbx,org.esa.s1tbx.io.generic,0,0,0,0,1,0,0,1
senbox-org_s1tbx,org.esa.s1tbx.io.geotiffxml,0,0,0,0,0,0,0,0
senbox-org_s1tbx,org.esa.s1tbx.io.gtopo30,0,0,0,0,0,0,0,0
senbox-org_s1tbx,org.esa.s1tbx.io.imageio,0,0,0,0,1,0,0,1
senbox-org_s1tbx,org.esa.s1tbx.io.kml,0,0,0,0,0,0,0,0
senbox-org_s1tbx,org.esa.s1tbx.io.kompsat5,0,0,0,0,1,0,0,1
senbox-org_s1tbx,org.esa.s1tbx.io.netcdf,0,0,0,0,1,0,0,1
senbox-org_s1tbx,org.esa.s1tbx.io.paz,0,0,0,0,1,0,0,1
senbox-org_s1tbx,org.esa.s1tbx.io.pcidsk,0,0,0,0,0,0,0,0
senbox-org_s1tbx,org.esa.s1tbx.io.polsarpro,0,0,0,0,0,0,0,0
senbox-org_s1tbx,org.esa.s1tbx.io.risat1,0,0,0,0,1,0,0,1
senbox-org_s1tbx,org.esa.s1tbx.io.saocom,0,0,0,0,1,0,0,1
senbox-org_s1tbx,org.esa.s1tbx.io.seasat,0,0,0,0,0,0,0,0
senbox-org_s1tbx,org.esa.s1tbx.io.sentinel1,0,0,0,0,1,0,0,1
senbox-org_s1tbx,org.esa.s1tbx.io.snaphu,0,0,0,0,0,0,0,0
senbox-org_s1tbx,org.esa.s1tbx.io.sunraster,0,0,0,0,0,0,0,0
senbox-org_s1tbx,org.esa.s1tbx.io.TAXI,0,0,0,0,0,0,0,0
senbox-org_s1tbx,org.esa.s1tbx.io.terrasarx,0,0,0,0,1,0,0,1
senbox-org_s1tbx,org.esa.s1tbx.io.uavsar,0,0,0,0,0,0,0,0
senbox-org_s1tbx,org.esa.s1tbx.io.ceos.records,0,0,0,0,0,0,0,0
senbox-org_s1tbx,org.esa.s1tbx.io.orbits,0,0,0,0,0,0,0,0
senbox-org_s1tbx,org.esa.s1tbx.io.orbits.delft,0,0,0,0,0,0,0,0
senbox-org_s1tbx,org.esa.s1tbx.io.orbits.doris,0,0,0,0,0,0,0,0
senbox-org_s1tbx,org.esa.s1tbx.io.orbits.k5,0,0,0,0,0,0,0,0
senbox-org_s1tbx,org.esa.s1tbx.io.orbits.prare,0,0,0,0,0,0,0,0
senbox-org_s1tbx,org.esa.s1tbx.io.orbits.sentinel1,0,0,0,0,1,0,0,1
senbox-org_s1tbx,org.esa.s1tbx.io.orbits.envisat,0,0,0,0,0,0,0,0
senbox-org_s1tbx,org.esa.s1tbx.about,0,0,0,0,0,0,0,0
senbox-org_s1tbx,org.esa.s1tbx.analysis.rcp.toolviews.timeseries,0,0,0,0,1,0,0,1
senbox-org_s1tbx,org.esa.s1tbx.analysis.rcp.toolviews.timeseries.graphs,0,0,0,0,0,0,0,0
senbox-org_s1tbx,org.esa.s1tbx.calibration.gpf,1,1,0,0,1,0,0,3
senbox-org_s1tbx,org.esa.s1tbx.calibration.gpf.calibrators,1,0,0,0,1,0,0,2
senbox-org_s1tbx,org.esa.s1tbx.calibration.gpf.support,0,0,0,0,1,0,0,1
senbox-org_s1tbx,org.esa.s1tbx.calibration.gpf.ui,0,0,0,0,0,0,0,0
senbox-org_s1tbx,org.esa.s1tbx.calibration.rcp,0,0,0,0,0,0,0,0
senbox-org_s1tbx,org.esa.s1tbx.fex.gpf,0,0,0,0,0,0,0,0
senbox-org_s1tbx,org.esa.s1tbx.fex.gpf.decisiontree,0,0,0,0,1,0,0,1
senbox-org_s1tbx,org.esa.s1tbx.fex.gpf.flood,0,0,0,0,0,0,0,0
senbox-org_s1tbx,org.esa.s1tbx.fex.gpf.forest,0,0,0,0,0,0,0,0
senbox-org_s1tbx,org.esa.s1tbx.fex.gpf.oceantools,0,0,0,0,1,0,0,1
senbox-org_s1tbx,org.esa.s1tbx.fex.gpf.texture,0,0,0,0,0,0,0,0
senbox-org_s1tbx,org.esa.s1tbx.fex.gpf.urban,0,0,0,0,0,0,0,0
senbox-org_s1tbx,org.esa.s1tbx.fex.gpf.ui.decisiontree,0,0,0,0,1,0,0,1
senbox-org_s1tbx,org.esa.s1tbx.fex.rcp.layersrc,0,0,0,0,1,0,0,1
senbox-org_s1tbx,org.esa.s1tbx.fex,0,0,0,0,0,0,0,0
senbox-org_s1tbx,org.esa.s1tbx.insar.gpf,1,1,0,1,1,0,0,4
senbox-org_s1tbx,org.esa.s1tbx.insar.gpf.coregistration,1,0,0,0,1,0,0,2
senbox-org_s1tbx,org.esa.s1tbx.insar.gpf.support,0,0,0,0,0,0,0,0
senbox-org_s1tbx,org.esa.s1tbx.insar.gpf.ui,0,0,0,0,1,0,0,1
senbox-org_s1tbx,org.esa.s1tbx.insar.gpf.ui.coregistration,0,0,0,0,0,0,0,0
senbox-org_s1tbx,org.esa.s1tbx.insar.rcp.actions,0,0,0,0,0,0,0,0
senbox-org_s1tbx,org.esa.s1tbx.insar.rcp.dialogs,0,0,0,0,0,0,0,0
senbox-org_s1tbx,org.esa.s1tbx.insar.rcp.layersrc,0,0,0,0,0,0,0,0
senbox-org_s1tbx,org.esa.s1tbx.insar.rcp.toolviews,0,0,0,0,0,0,0,0
senbox-org_s1tbx,org.esa.s1tbx.insar.rcp.toolviews.insar_statistics,0,0,0,0,1,0,0,1
senbox-org_s1tbx,org.esa.s1tbx.insar,0,0,0,0,0,0,0,0
senbox-org_s1tbx,org.esa.s1tbx.ocean.toolviews.polarview,1,0,0,0,1,0,0,2
senbox-org_s1tbx,org.esa.s1tbx.ocean.toolviews.polarview.polarplot,1,1,0,0,1,0,0,3
senbox-org_s1tbx,org.esa.s1tbx.ocean.worldwind.layers,0,0,0,0,0,0,0,0
senbox-org_s1tbx,org.esa.s1tbx.sar.gpf,0,0,0,0,1,0,0,1
senbox-org_s1tbx,org.esa.s1tbx.sar.gpf.filtering,0,0,0,0,1,0,0,1
senbox-org_s1tbx,org.esa.s1tbx.sar.gpf.filtering.SpeckleFilters,0,0,0,0,1,0,0,1
senbox-org_s1tbx,org.esa.s1tbx.sar.gpf.geometric,0,0,0,1,1,0,0,2
senbox-org_s1tbx,org.esa.s1tbx.sar.gpf.orbits,0,0,0,0,0,0,0,0
senbox-org_s1tbx,org.esa.s1tbx.sar.gpf.ui.filtering,0,0,0,0,0,0,0,0
senbox-org_s1tbx,org.esa.s1tbx.sar.gpf.ui.geometric,0,0,0,0,1,0,0,1
senbox-org_s1tbx,org.esa.s1tbx.sar.gpf.ui,0,0,0,0,0,0,0,0
senbox-org_s1tbx,org.esa.s1tbx.sar.gpf.ui.orbits,0,0,0,0,0,0,0,0
senbox-org_s1tbx,org.esa.s1tbx.sar.rcp.wizards.CoregisterWizard,0,0,0,0,0,0,0,0
senbox-org_s1tbx,org.esa.s1tbx.sar.rcp.wizards.MosaicWizard,0,0,0,0,0,0,0,0
senbox-org_s1tbx,org.esa.s1tbx.sar,0,0,0,0,0,0,0,0
senbox-org_s1tbx,org.esa.s1tbx.sentinel1.gpf,0,0,0,1,1,0,0,2
senbox-org_s1tbx,org.esa.s1tbx.sentinel1.gpf.experimental,0,0,0,0,0,0,0,0
senbox-org_s1tbx,org.esa.s1tbx.sentinel1.gpf.ui,0,0,0,0,0,0,0,0
senbox-org_s1tbx,org.esa.s1tbx.sentinel1.rcp.layers.topsbursts,0,0,0,0,0,0,0,0
senbox-org_s1tbx,org.esa.s1tbx.sentinel1.rcp,0,0,0,0,0,0,0,0
senbox-org_s1tbx,org.esa.s1tbx.sentinel1,0,0,0,0,0,0,0,0
senbox-org_s1tbx,org.esa.s1tbx.utilities.gpf,0,0,0,0,1,0,0,1
senbox-org_s1tbx,org.esa.s1tbx.utilities.gpf.ui,0,0,0,0,0,0,0,0
senbox-org_s1tbx,org.esa.s1tbx.dat.actions,0,0,0,0,0,0,0,0
senbox-org_s1tbx,org.esa.s1tbx.dat.dialogs,0,0,0,0,1,0,0,1
senbox-org_s1tbx,org.esa.s1tbx.dat.graphics,0,0,0,0,0,0,0,0
senbox-org_s1tbx,org.esa.s1tbx.dat.layers,0,0,0,0,1,0,0,1
senbox-org_s1tbx,org.esa.s1tbx.dat.layers.maptools.components,0,0,0,0,1,0,0,1
senbox-org_s1tbx,org.esa.s1tbx.dat.layers.maptools,0,0,0,0,1,0,0,1
senbox-org_s1tbx,org.esa.s1tbx.dat.preferences,0,0,0,0,0,0,0,0
senbox-org_s1tbx,org.esa.s1tbx.dat,0,0,0,0,0,0,0,0
senbox-org_s1tbx,org.esa.s1tbx.dat.toolviews.Projects.actions,0,0,0,0,1,0,0,1
senbox-org_s1tbx,org.esa.s1tbx.dat.toolviews.Projects,0,0,0,0,1,0,0,1
senbox-org_s1tbx,com.iceye.esa.snap.dataio,0,0,0,0,0,0,0,0
senbox-org_s1tbx,com.iceye.esa.snap.dataio.util,0,0,0,0,0,0,0,0
senbox-org_s1tbx,org.jlinda.core,1,1,0,0,1,0,0,3
senbox-org_s1tbx,org.jlinda.core.coregistration,0,0,0,0,0,0,0,0
senbox-org_s1tbx,org.jlinda.core.coregistration.cross,0,0,0,0,0,0,0,0
senbox-org_s1tbx,org.jlinda.core.coregistration.estimation,0,0,0,0,0,0,0,0
senbox-org_s1tbx,org.jlinda.core.coregistration.utils,0,0,0,0,0,0,0,0
senbox-org_s1tbx,org.jlinda.core.delaunay,0,0,0,0,1,0,0,1
senbox-org_s1tbx,org.jlinda.core.filtering,0,0,0,0,1,0,0,1
senbox-org_s1tbx,org.jlinda.core.geocode,0,0,0,0,0,0,0,0
senbox-org_s1tbx,org.jlinda.core.geom,0,0,0,0,1,0,0,1
senbox-org_s1tbx,org.jlinda.core.io,0,0,0,0,1,0,0,1
senbox-org_s1tbx,org.jlinda.core.simulation,1,0,0,0,0,0,0,1
senbox-org_s1tbx,org.jlinda.core.unwrapping.snaphu,0,0,0,0,0,0,0,0
senbox-org_s1tbx,org.jlinda.core.utils,2,1,0,0,1,0,0,4
senbox-org_s1tbx,org.jlinda.nest.dataio,0,0,0,0,1,0,0,1
senbox-org_s1tbx,org.jlinda.nest.gpf,0,0,0,0,1,0,0,1
senbox-org_s1tbx,org.jlinda.nest.gpf.ui,0,0,0,0,0,0,0,0
senbox-org_s1tbx,org.csa.rstb.io.radarsat1,0,0,0,0,1,0,0,1
senbox-org_s1tbx,org.csa.rstb.io.radarsat2,0,0,0,0,1,0,0,1
senbox-org_s1tbx,org.csa.rstb.io.rcm,0,0,0,0,1,0,0,1
senbox-org_s1tbx,org.csa.rstb.about,0,0,0,0,0,0,0,0
senbox-org_s1tbx,org.csa.rstb.calibration,0,0,0,0,0,0,0,0
senbox-org_s1tbx,org.csa.rstb.classification.gpf.classifiers,0,0,0,0,1,0,0,1
senbox-org_s1tbx,org.csa.rstb.classification.gpf,0,0,0,0,0,0,0,0
senbox-org_s1tbx,org.csa.rstb.classification.gpf.ui,0,1,0,0,0,0,0,1
senbox-org_s1tbx,org.csa.rstb.classification.rcp.actions,0,0,0,0,0,0,0,0
senbox-org_s1tbx,org.csa.rstb.classification.rcp.dialogs,0,0,0,0,0,0,0,0
senbox-org_s1tbx,org.csa.rstb.classification.rcp.wizards.PolarimetryWizard,0,0,0,0,0,0,0,0
senbox-org_s1tbx,org.csa.rstb.classification.rcp.wizards.TerrainFlattenedClassification,0,0,0,0,0,0,0,0
senbox-org_s1tbx,org.csa.rstb.polarimetric.gpf,0,0,0,1,1,0,0,2
senbox-org_s1tbx,org.csa.rstb.polarimetric.gpf.decompositions,0,0,0,0,1,0,0,1
senbox-org_s1tbx,org.csa.rstb.polarimetric.gpf.decompositions_cp,0,0,0,0,0,0,0,0
senbox-org_s1tbx,org.csa.rstb.polarimetric.gpf.specklefilters,0,0,0,0,1,0,0,1
senbox-org_s1tbx,org.csa.rstb.polarimetric.gpf.specklefilters.covariance,0,0,0,0,0,0,0,0
senbox-org_s1tbx,org.csa.rstb.polarimetric.gpf.support,0,0,0,0,1,0,0,1
senbox-org_s1tbx,org.csa.rstb.polarimetric.gpf.ui,0,0,0,0,0,0,0,0
senbox-org_s1tbx,org.csa.rstb.polarimetric,0,0,0,0,0,0,0,0
senbox-org_s1tbx,org.csa.rstb.polarimetric.rcp.actions,0,0,0,0,0,0,0,0
senbox-org_s1tbx,org.csa.rstb.polarimetric.rcp.toolviews,0,0,0,0,0,0,0,0
senbox-org_s1tbx,org.csa.rstb.soilmoisture.gpf,0,0,0,0,1,0,0,1
senbox-org_s1tbx,org.csa.rstb.soilmoisture.gpf.support,0,0,0,0,1,0,0,1
senbox-org_s1tbx,org.csa.rstb.soilmoisture.io.matlab,0,0,0,0,0,0,0,0
senbox-org_s1tbx,org.csa.rstb.soilmoisture,0,0,0,0,0,0,0,0
senbox-org_s1tbx,org.csa.rstb.soilmoisture.gpf.ui,0,0,0,0,1,0,0,1
senbox-org_s1tbx,org.esa.s1tbx.benchmark,0,0,0,0,1,0,0,1
senbox-org_s1tbx,array.rstb.utils,0,0,0,0,0,0,0,0
senbox-org_s1tbx,org.esa.s1tbx.commons,0,0,0,0,1,0,0,1
senbox-org_s1tbx,org.esa.s1tbx.commons.graphics,0,0,0,0,0,0,0,0
senbox-org_s1tbx,org.esa.s1tbx.commons.io,0,0,0,0,1,0,0,1
senbox-org_s1tbx,org.esa.s1tbx.commons.polsar,0,0,0,0,0,0,0,0
senbox-org_s1tbx,org.esa.s1tbx.commons.product,0,0,0,0,0,0,0,0
senbox-org_s1tbx,org.esa.s1tbx.commons.utils,0,0,0,0,0,0,0,0
senbox-org_s1tbx,org.esa.s1tbx.io.binary,0,0,0,0,1,0,0,1
senbox-org_s1tbx,org.esa.s1tbx.io.capella,0,0,0,0,1,0,0,1
senbox-org_s1tbx,org.esa.s1tbx.io.ceos.alos,0,0,0,0,1,0,0,1
senbox-org_s1tbx,org.esa.s1tbx.io.ceos.alos2,0,0,0,0,1,0,0,1
senbox-org_s1tbx,org.esa.s1tbx.io.ceos.basic,0,0,0,0,1,0,0,1
senbox-org_s1tbx,org.esa.s1tbx.io.ceos,0,0,0,0,1,0,0,1
senbox-org_s1tbx,org.esa.s1tbx.io.ceos.ers,0,0,0,0,1,0,0,1
senbox-org_s1tbx,org.esa.s1tbx.io.ceos.jers,0,0,0,0,1,0,0,1
senbox-org_s1tbx,org.esa.s1tbx.io.ceos.risat,0,0,0,0,1,0,0,1
senbox-org_s1tbx,org.esa.s1tbx.io.cosmo,0,0,0,0,0,0,0,0
senbox-org_s1tbx,org.esa.s1tbx.io.gamma,0,0,0,0,0,0,0,0
senbox-org_s1tbx,org.esa.s1tbx.io.gamma.header,0,0,0,0,1,0,0,1
senbox-org_s1tbx,org.esa.s1tbx.io.gamma.pyrate,0,0,0,0,0,0,0,0
senbox-org_s1tbx,org.esa.s1tbx.io.gamma.pyrate.pyrateheader,0,0,0,0,0,0,0,0
senbox-org_s1tbx,org.esa.s1tbx.io.generic,0,0,0,0,1,0,0,1
senbox-org_s1tbx,org.esa.s1tbx.io.geotiffxml,0,0,0,0,0,0,0,0
senbox-org_s1tbx,org.esa.s1tbx.io.gtopo30,0,0,0,0,0,0,0,0
senbox-org_s1tbx,org.esa.s1tbx.io.imageio,0,0,0,0,1,0,0,1
senbox-org_s1tbx,org.esa.s1tbx.io.kml,0,0,0,0,0,0,0,0
senbox-org_s1tbx,org.esa.s1tbx.io.kompsat5,0,0,0,0,1,0,0,1
senbox-org_s1tbx,org.esa.s1tbx.io.netcdf,0,0,0,0,1,0,0,1
senbox-org_s1tbx,org.esa.s1tbx.io.paz,0,0,0,0,1,0,0,1
senbox-org_s1tbx,org.esa.s1tbx.io.pcidsk,0,0,0,0,0,0,0,0
senbox-org_s1tbx,org.esa.s1tbx.io.polsarpro,0,0,0,0,0,0,0,0
senbox-org_s1tbx,org.esa.s1tbx.io.risat1,0,0,0,0,1,0,0,1
senbox-org_s1tbx,org.esa.s1tbx.io.saocom,0,0,0,0,1,0,0,1
senbox-org_s1tbx,org.esa.s1tbx.io.seasat,0,0,0,0,0,0,0,0
senbox-org_s1tbx,org.esa.s1tbx.io.sentinel1,0,0,0,0,1,0,0,1
senbox-org_s1tbx,org.esa.s1tbx.io.snaphu,0,0,0,0,0,0,0,0
senbox-org_s1tbx,org.esa.s1tbx.io.sunraster,0,0,0,0,0,0,0,0
senbox-org_s1tbx,org.esa.s1tbx.io.TAXI,0,0,0,0,0,0,0,0
senbox-org_s1tbx,org.esa.s1tbx.io.terrasarx,0,0,0,0,1,0,0,1
senbox-org_s1tbx,org.esa.s1tbx.io.uavsar,0,0,0,0,0,0,0,0
senbox-org_s1tbx,org.esa.s1tbx.io.ceos.records,0,0,0,0,0,0,0,0
senbox-org_s1tbx,org.esa.s1tbx.io.orbits,0,0,0,0,0,0,0,0
senbox-org_s1tbx,org.esa.s1tbx.io.orbits.delft,0,0,0,0,0,0,0,0
senbox-org_s1tbx,org.esa.s1tbx.io.orbits.doris,0,0,0,0,0,0,0,0
senbox-org_s1tbx,org.esa.s1tbx.io.orbits.k5,0,0,0,0,0,0,0,0
senbox-org_s1tbx,org.esa.s1tbx.io.orbits.prare,0,0,0,0,0,0,0,0
senbox-org_s1tbx,org.esa.s1tbx.io.orbits.sentinel1,0,0,0,0,1,0,0,1
senbox-org_s1tbx,org.esa.s1tbx.io.orbits.envisat,0,0,0,0,0,0,0,0
senbox-org_s1tbx,org.esa.s1tbx.about,0,0,0,0,0,0,0,0
senbox-org_s1tbx,org.esa.s1tbx.analysis.rcp.toolviews.timeseries,0,0,0,0,1,0,0,1
senbox-org_s1tbx,org.esa.s1tbx.analysis.rcp.toolviews.timeseries.graphs,0,0,0,0,0,0,0,0
senbox-org_s1tbx,org.esa.s1tbx.calibration.gpf,1,1,0,0,1,0,0,3
senbox-org_s1tbx,org.esa.s1tbx.calibration.gpf.calibrators,1,0,0,0,1,0,0,2
senbox-org_s1tbx,org.esa.s1tbx.calibration.gpf.support,0,0,0,0,1,0,0,1
senbox-org_s1tbx,org.esa.s1tbx.calibration.gpf.ui,0,0,0,0,0,0,0,0
senbox-org_s1tbx,org.esa.s1tbx.calibration.rcp,0,0,0,0,0,0,0,0
senbox-org_s1tbx,org.esa.s1tbx.fex.gpf,0,0,0,0,0,0,0,0
senbox-org_s1tbx,org.esa.s1tbx.fex.gpf.decisiontree,0,0,0,0,1,0,0,1
senbox-org_s1tbx,org.esa.s1tbx.fex.gpf.flood,0,0,0,0,0,0,0,0
senbox-org_s1tbx,org.esa.s1tbx.fex.gpf.forest,0,0,0,0,0,0,0,0
senbox-org_s1tbx,org.esa.s1tbx.fex.gpf.oceantools,0,0,0,0,1,0,0,1
senbox-org_s1tbx,org.esa.s1tbx.fex.gpf.texture,0,0,0,0,0,0,0,0
senbox-org_s1tbx,org.esa.s1tbx.fex.gpf.urban,0,0,0,0,0,0,0,0
senbox-org_s1tbx,org.esa.s1tbx.fex.gpf.ui.decisiontree,0,0,0,0,1,0,0,1
senbox-org_s1tbx,org.esa.s1tbx.fex.rcp.layersrc,0,0,0,0,1,0,0,1
senbox-org_s1tbx,org.esa.s1tbx.fex,0,0,0,0,0,0,0,0
senbox-org_s1tbx,org.esa.s1tbx.insar.gpf,1,1,0,1,1,0,0,4
senbox-org_s1tbx,org.esa.s1tbx.insar.gpf.coregistration,1,0,0,0,1,0,0,2
senbox-org_s1tbx,org.esa.s1tbx.insar.gpf.support,0,0,0,0,0,0,0,0
senbox-org_s1tbx,org.esa.s1tbx.insar.gpf.ui,0,0,0,0,1,0,0,1
senbox-org_s1tbx,org.esa.s1tbx.insar.gpf.ui.coregistration,0,0,0,0,0,0,0,0
senbox-org_s1tbx,org.esa.s1tbx.insar.rcp.actions,0,0,0,0,0,0,0,0
senbox-org_s1tbx,org.esa.s1tbx.insar.rcp.dialogs,0,0,0,0,0,0,0,0
senbox-org_s1tbx,org.esa.s1tbx.insar.rcp.layersrc,0,0,0,0,0,0,0,0
senbox-org_s1tbx,org.esa.s1tbx.insar.rcp.toolviews,0,0,0,0,0,0,0,0
senbox-org_s1tbx,org.esa.s1tbx.insar.rcp.toolviews.insar_statistics,0,0,0,0,1,0,0,1
senbox-org_s1tbx,org.esa.s1tbx.insar,0,0,0,0,0,0,0,0
senbox-org_s1tbx,org.esa.s1tbx.ocean.toolviews.polarview,1,0,0,0,1,0,0,2
senbox-org_s1tbx,org.esa.s1tbx.ocean.toolviews.polarview.polarplot,1,1,0,0,1,0,0,3
senbox-org_s1tbx,org.esa.s1tbx.ocean.worldwind.layers,0,0,0,0,0,0,0,0
senbox-org_s1tbx,org.esa.s1tbx.sar.gpf,0,0,0,0,1,0,0,1
senbox-org_s1tbx,org.esa.s1tbx.sar.gpf.filtering,0,0,0,0,1,0,0,1
senbox-org_s1tbx,org.esa.s1tbx.sar.gpf.filtering.SpeckleFilters,0,0,0,0,1,0,0,1
senbox-org_s1tbx,org.esa.s1tbx.sar.gpf.geometric,0,0,0,1,1,0,0,2
senbox-org_s1tbx,org.esa.s1tbx.sar.gpf.orbits,0,0,0,0,0,0,0,0
senbox-org_s1tbx,org.esa.s1tbx.sar.gpf.ui.filtering,0,0,0,0,0,0,0,0
senbox-org_s1tbx,org.esa.s1tbx.sar.gpf.ui.geometric,0,0,0,0,1,0,0,1
senbox-org_s1tbx,org.esa.s1tbx.sar.gpf.ui,0,0,0,0,0,0,0,0
senbox-org_s1tbx,org.esa.s1tbx.sar.gpf.ui.orbits,0,0,0,0,0,0,0,0
senbox-org_s1tbx,org.esa.s1tbx.sar.rcp.wizards.CoregisterWizard,0,0,0,0,0,0,0,0
senbox-org_s1tbx,org.esa.s1tbx.sar.rcp.wizards.MosaicWizard,0,0,0,0,0,0,0,0
senbox-org_s1tbx,org.esa.s1tbx.sar,0,0,0,0,0,0,0,0
senbox-org_s1tbx,org.esa.s1tbx.sentinel1.gpf,0,0,0,1,1,0,0,2
senbox-org_s1tbx,org.esa.s1tbx.sentinel1.gpf.experimental,0,0,0,0,0,0,0,0
senbox-org_s1tbx,org.esa.s1tbx.sentinel1.gpf.ui,0,0,0,0,0,0,0,0
senbox-org_s1tbx,org.esa.s1tbx.sentinel1.rcp.layers.topsbursts,0,0,0,0,0,0,0,0
senbox-org_s1tbx,org.esa.s1tbx.sentinel1.rcp,0,0,0,0,0,0,0,0
senbox-org_s1tbx,org.esa.s1tbx.sentinel1,0,0,0,0,0,0,0,0
senbox-org_s1tbx,org.esa.s1tbx.utilities.gpf,0,0,0,0,1,0,0,1
senbox-org_s1tbx,org.esa.s1tbx.utilities.gpf.ui,0,0,0,0,0,0,0,0
senbox-org_s1tbx,org.esa.s1tbx.dat.actions,0,0,0,0,0,0,0,0
senbox-org_s1tbx,org.esa.s1tbx.dat.dialogs,0,0,0,0,1,0,0,1
senbox-org_s1tbx,org.esa.s1tbx.dat.graphics,0,0,0,0,0,0,0,0
senbox-org_s1tbx,org.esa.s1tbx.dat.layers,0,0,0,0,1,0,0,1
senbox-org_s1tbx,org.esa.s1tbx.dat.layers.maptools.components,0,0,0,0,1,0,0,1
senbox-org_s1tbx,org.esa.s1tbx.dat.layers.maptools,0,0,0,0,1,0,0,1
senbox-org_s1tbx,org.esa.s1tbx.dat.preferences,0,0,0,0,0,0,0,0
senbox-org_s1tbx,org.esa.s1tbx.dat,0,0,0,0,0,0,0,0
senbox-org_s1tbx,org.esa.s1tbx.dat.toolviews.Projects.actions,0,0,0,0,1,0,0,1
senbox-org_s1tbx,org.esa.s1tbx.dat.toolviews.Projects,0,0,0,0,1,0,0,1
senbox-org_s1tbx,com.iceye.esa.snap.dataio,0,0,0,0,0,0,0,0
senbox-org_s1tbx,com.iceye.esa.snap.dataio.util,0,0,0,0,0,0,0,0
serenity-bdd_serenity-cucumber,cucumber.runtime.formatter,1,1,0,0,0,0,0,2
serenity-bdd_serenity-cucumber,cucumber.runtime,0,0,0,0,0,0,0,0
serenity-bdd_serenity-cucumber,net.serenitybdd.cucumber.actors,0,0,0,0,0,0,0,0
serenity-bdd_serenity-cucumber,net.serenitybdd.cucumber.cli,0,0,0,0,0,0,0,0
serenity-bdd_serenity-cucumber,net.serenitybdd.cucumber,3,0,0,0,0,0,0,3
serenity-bdd_serenity-cucumber,net.serenitybdd.cucumber.formatting,0,0,0,0,0,0,0,0
serenity-bdd_serenity-cucumber,net.serenitybdd.cucumber.integration.intellij,0,0,0,0,0,0,0,0
serenity-bdd_serenity-cucumber,net.serenitybdd.cucumber.model,0,0,0,0,0,0,0,0
serenity-bdd_serenity-cucumber,net.serenitybdd.cucumber.service,0,0,0,0,0,0,0,0
serenity-bdd_serenity-cucumber,net.serenitybdd.cucumber.suiteslicing,1,0,0,0,0,0,0,1
serenity-bdd_serenity-cucumber,net.serenitybdd.cucumber.util,2,1,0,0,1,0,0,4
serenity-bdd_serenity-cucumber,net.serenitybdd.cucumber.integration,0,0,0,1,1,0,0,2
serenity-bdd_serenity-cucumber,net.serenitybdd.cucumber.integration.steps,0,0,0,0,1,0,0,1
serenity-bdd_serenity-cucumber,net.serenitybdd.cucumber.integration.steps.thucydides,0,0,0,0,1,0,0,1
SharedKnowledge_SharkFW,net.sharkfw.asip,26,1,0,0,1,7,1,36
SharedKnowledge_SharkFW,net.sharkfw.asip.engine,8,1,0,0,1,3,1,14
SharedKnowledge_SharkFW,net.sharkfw.asip.engine.serializer,7,0,0,0,1,1,1,10
SharedKnowledge_SharkFW,net.sharkfw.asip.serialization,3,0,0,0,0,0,1,4
SharedKnowledge_SharkFW,net.sharkfw.knowledgeBase,17,1,0,1,0,18,1,38
SharedKnowledge_SharkFW,net.sharkfw.knowledgeBase.broadcast,4,0,0,0,1,2,1,8
SharedKnowledge_SharkFW,net.sharkfw.knowledgeBase.geom.inmemory,4,0,0,0,0,2,1,7
SharedKnowledge_SharkFW,net.sharkfw.knowledgeBase.geom,2,0,0,0,0,1,1,4
SharedKnowledge_SharkFW,net.sharkfw.knowledgeBase.inmemory,15,1,0,0,0,9,1,26
SharedKnowledge_SharkFW,net.sharkfw.knowledgeBase.persistent.dump,0,0,0,0,0,0,1,1
SharedKnowledge_SharkFW,net.sharkfw.knowledgeBase.persistent.sql,0,0,0,0,0,2,1,3
SharedKnowledge_SharkFW,net.sharkfw.knowledgeBase.spatial,1,0,0,0,1,0,1,3
SharedKnowledge_SharkFW,net.sharkfw.knowledgeBase.sync.manager.port,3,1,0,0,1,0,1,6
SharedKnowledge_SharkFW,net.sharkfw.knowledgeBase.sync.manager,7,1,0,0,0,6,1,15
SharedKnowledge_SharkFW,net.sharkfw.knowledgeBase.sync,5,0,0,0,0,3,1,9
SharedKnowledge_SharkFW,net.sharkfw.peer,32,1,0,0,1,7,1,42
SharedKnowledge_SharkFW,net.sharkfw.ports,0,0,0,0,1,0,1,2
SharedKnowledge_SharkFW,net.sharkfw.protocols,3,1,0,0,1,1,1,7
SharedKnowledge_SharkFW,net.sharkfw.protocols.http,1,0,0,0,0,0,1,2
SharedKnowledge_SharkFW,net.sharkfw.protocols.mail,2,0,0,0,0,0,1,3
SharedKnowledge_SharkFW,net.sharkfw.protocols.message2stream,0,0,0,0,0,0,1,1
SharedKnowledge_SharkFW,net.sharkfw.protocols.tcp,4,0,0,0,0,1,1,6
SharedKnowledge_SharkFW,net.sharkfw.routing,2,1,0,0,0,0,1,4
SharedKnowledge_SharkFW,net.sharkfw.security,5,0,0,0,1,2,1,9
SharedKnowledge_SharkFW,net.sharkfw.security.utilities,1,0,0,0,0,0,1,2
SharedKnowledge_SharkFW,net.sharkfw.system,27,1,0,0,1,13,1,43
sharneng_gm4java,org.gm4java.engine,0,0,0,0,0,0,0,0
sharneng_gm4java,org.gm4java.engine.support,0,0,0,0,1,0,0,1
sharneng_gm4java,org.gm4java.im4java,0,0,0,0,0,0,0,0
shazam_fork,com.shazam.chimprunner,0,0,0,0,0,0,0,0
shazam_fork,com.shazam.chimprunner.injector,0,0,0,0,0,0,0,0
shazam_fork,com.shazam.chimprunner.injector.device,0,0,0,0,0,0,0,0
shazam_fork,com.shazam.chimprunner.injector.io,0,0,0,0,0,0,0,0
shazam_fork,com.shazam.chimprunner.injector.suite,0,0,0,0,0,0,0,0
shazam_fork,com.shazam.chimprunner.injector.system,0,0,0,0,0,0,0,0
shazam_fork,com.shazam.fork,5,1,0,0,1,0,0,7
shazam_fork,com.shazam.fork.device,0,0,0,0,1,0,0,1
shazam_fork,com.shazam.fork.io,0,0,0,0,1,0,0,1
shazam_fork,com.shazam.fork.model,0,0,0,0,0,0,0,0
shazam_fork,com.shazam.fork.suite,0,0,0,0,0,0,0,0
shazam_fork,com.shazam.fork.summary,2,0,0,0,0,0,0,2
shazam_fork,com.shazam.fork.system.adb,0,0,0,0,0,0,0,0
shazam_fork,com.shazam.fork.system.axmlparser,0,0,0,0,0,0,0,0
shazam_fork,com.shazam.fork.utils,0,0,0,0,0,0,0,0
shazam_fork,com.shazam.fork.reporter,0,0,0,0,0,0,0,0
shazam_fork,com.shazam.fork.reporter.html,0,0,0,0,0,0,0,0
shazam_fork,com.shazam.fork.reporter.injector,0,0,0,0,1,0,0,1
shazam_fork,com.shazam.fork.reporter.model,0,1,0,0,0,0,0,1
shazam_fork,com.shazam.fork.reporter.gradle,0,0,0,0,0,0,0,0
shazam_fork,com.shazam.fork.aggregator,2,1,0,0,0,0,0,3
shazam_fork,com.shazam.fork.injector.accumulator,0,0,0,0,0,0,0,0
shazam_fork,com.shazam.fork.injector.aggregator,0,0,0,0,0,0,0,0
shazam_fork,com.shazam.fork.injector,0,0,0,0,0,0,0,0
shazam_fork,com.shazam.fork.injector.device,0,0,0,0,0,0,0,0
shazam_fork,com.shazam.fork.injector.io,0,0,0,0,0,0,0,0
shazam_fork,com.shazam.fork.injector.listeners,0,0,0,0,0,0,0,0
shazam_fork,com.shazam.fork.injector.pooling,0,0,0,0,0,0,0,0
shazam_fork,com.shazam.fork.injector.runner,0,0,0,0,0,0,0,0
shazam_fork,com.shazam.fork.injector.suite,0,0,0,0,0,0,0,0
shazam_fork,com.shazam.fork.injector.summary,0,0,0,0,1,0,0,1
shazam_fork,com.shazam.fork.injector.system,0,0,0,0,0,0,0,0
shazam_fork,com.shazam.fork.pooling,1,0,0,0,0,0,0,1
shazam_fork,com.shazam.fork.pooling.geometry,0,0,0,0,0,0,0,0
shazam_fork,com.shazam.fork.runner,4,1,0,0,0,0,0,5
shazam_fork,com.shazam.fork.runner.listeners,2,0,0,0,0,0,0,2
shazam_fork,com.shazam.fork.system.io,0,0,0,0,0,0,0,0
shazam_fork,com.shazam.fork.system,1,0,0,0,0,0,0,1
shazam_fork,com.shazam.fork.matcher,0,0,0,0,0,0,0,0
shazam_fork,com.shazam.fork.util,0,0,0,0,0,0,0,0
ShifuML_guagua,ml.shifu.guagua.client,0,0,0,0,0,0,0,0
ShifuML_guagua,ml.shifu.guagua,8,1,0,0,1,0,0,10
ShifuML_guagua,ml.shifu.guagua.coordinator.zk,0,0,0,0,1,0,0,1
ShifuML_guagua,ml.shifu.guagua.io,3,0,0,0,1,0,0,4
ShifuML_guagua,ml.shifu.guagua.master,4,0,0,0,1,0,0,5
ShifuML_guagua,ml.shifu.guagua.unit,0,0,0,0,0,0,0,0
ShifuML_guagua,ml.shifu.guagua.util,5,1,0,0,1,0,0,7
ShifuML_guagua,ml.shifu.guagua.worker,2,0,0,0,1,0,0,3
ShifuML_guagua,ml.shifu.guagua.example.kmeans,0,0,0,0,1,0,0,1
ShifuML_guagua,ml.shifu.guagua.example.lnr,0,0,0,0,1,0,0,1
ShifuML_guagua,ml.shifu.guagua.example.lr,0,0,0,0,1,0,0,1
ShifuML_guagua,ml.shifu.guagua.example.nn,0,0,0,0,1,0,0,1
ShifuML_guagua,ml.shifu.guagua.example.nn.meta,0,0,0,0,0,0,0,0
ShifuML_guagua,ml.shifu.guagua.example.sum,0,0,0,0,0,0,0,0
ShifuML_guagua,ml.shifu.guagua.mapreduce.example.lnr,0,0,0,0,0,0,0,0
ShifuML_guagua,ml.shifu.guagua.mapreduce.example.lr,0,0,0,0,0,0,0,0
ShifuML_guagua,ml.shifu.guagua.mapreduce.example.sum,0,0,0,0,0,0,0,0
ShifuML_guagua,ml.shifu.guagua.hadoop,0,1,0,0,1,0,0,2
ShifuML_guagua,ml.shifu.guagua.hadoop.io,0,0,0,0,1,0,0,1
ShifuML_guagua,ml.shifu.guagua.hadoop.util,0,0,0,0,0,0,0,0
ShifuML_guagua,ml.shifu.guagua.mapreduce,0,0,0,0,1,0,0,1
ShifuML_guagua,ml.shifu.guagua.yarn,1,0,0,0,1,0,0,2
ShifuML_guagua,ml.shifu.guagua.yarn.util,1,1,0,0,1,0,0,3
shilad_wikibrain,org.wikibrain.cookbook.concepts,0,0,0,0,0,0,1,1
shilad_wikibrain,org.wikibrain.cookbook.core,0,0,0,0,1,3,1,5
shilad_wikibrain,org.wikibrain.cookbook.pageview,0,0,0,0,0,0,1,1
shilad_wikibrain,org.wikibrain.cookbook.phrases,0,0,0,0,0,1,1,2
shilad_wikibrain,org.wikibrain.cookbook,0,0,0,0,0,0,1,1
shilad_wikibrain,org.wikibrain.cookbook.spatial,0,0,0,0,0,0,1,1
shilad_wikibrain,org.wikibrain.cookbook.sr,0,0,0,0,1,1,1,3
shilad_wikibrain,org.wikibrain.cookbook.wikidata,0,0,0,0,0,1,1,2
shilad_wikibrain,org.wikibrain.core.jooq,1,0,0,0,1,0,1,3
shilad_wikibrain,org.wikibrain.core.jooq.tables,1,1,0,0,1,0,1,4
shilad_wikibrain,org.wikibrain.core.cmd,1,0,0,0,0,5,1,7
shilad_wikibrain,org.wikibrain.core.dao,8,1,0,0,1,10,1,21
shilad_wikibrain,org.wikibrain.core.dao.live,0,0,0,0,1,0,1,2
shilad_wikibrain,org.wikibrain.core.dao.matrix,3,0,0,0,0,0,1,4
shilad_wikibrain,org.wikibrain.core.dao.sql,3,1,0,1,0,3,1,9
shilad_wikibrain,org.wikibrain.core.lang,8,1,0,0,1,9,1,20
shilad_wikibrain,org.wikibrain.core.model,4,0,0,0,1,7,1,13
shilad_wikibrain,org.wikibrain.core.nlp,0,0,0,0,1,1,1,3
shilad_wikibrain,org.wikibrain.core,0,0,0,0,0,0,1,1
shilad_wikibrain,org.wikibrain.download,0,0,0,0,0,0,1,1
shilad_wikibrain,org.wikibrain.integration,0,0,0,0,0,2,1,3
shilad_wikibrain,(default package),0,0,0,0,1,1,1,3
shilad_wikibrain,org.wikibrain,0,0,0,0,0,0,1,1
shilad_wikibrain,org.wikibrain.loader,0,0,0,0,1,1,1,3
shilad_wikibrain,org.wikibrain.loader.pipeline,0,0,0,0,1,0,1,2
shilad_wikibrain,org.wikibrain.lucene,1,1,0,0,1,1,1,5
shilad_wikibrain,org.wikibrain.lucene.tokenizers,1,0,0,1,1,0,1,4
shilad_wikibrain,org.wikibrain.mapper.algorithms.conceptualign3,0,0,0,0,1,0,1,2
shilad_wikibrain,org.wikibrain.mapper.algorithms,0,0,0,0,0,0,1,1
shilad_wikibrain,org.wikibrain.mapper,0,0,0,0,0,0,1,1
shilad_wikibrain,org.wikibrain.matrix,0,0,0,0,1,0,1,2
shilad_wikibrain,org.wikibrain.matrix.knn,0,0,0,0,1,0,1,2
shilad_wikibrain,org.wikibrain.pageview,0,0,0,0,1,0,1,2
shilad_wikibrain,org.wikibrain.parser,0,0,0,0,1,0,1,2
shilad_wikibrain,org.wikibrain.parser.sql,0,0,0,0,0,0,1,1
shilad_wikibrain,org.wikibrain.parser.wiki,0,0,0,0,1,1,1,3
shilad_wikibrain,org.wikibrain.parser.xml,0,0,0,0,0,0,1,1
shilad_wikibrain,org.wikibrain.phrases,0,1,0,1,1,1,1,5
shilad_wikibrain,ags.utils.dataStructures,0,0,0,0,1,0,1,2
shilad_wikibrain,ags.utils.dataStructures.trees.secondGenKD,0,0,0,0,0,0,1,1
shilad_wikibrain,ags.utils.dataStructures.trees.thirdGenKD,0,0,0,0,0,0,1,1
shilad_wikibrain,org.wikibrain.spatial.constants,0,0,0,0,0,0,1,1
shilad_wikibrain,org.wikibrain.spatial.cookbook,0,0,0,0,1,0,1,2
shilad_wikibrain,org.wikibrain.spatial.cookbook.tflevaluate,0,0,0,0,1,0,1,2
shilad_wikibrain,org.wikibrain.spatial.dao.postgis,0,0,0,0,1,0,1,2
shilad_wikibrain,org.wikibrain.spatial.dao,0,0,0,0,0,0,1,1
shilad_wikibrain,org.wikibrain.spatial.distance,0,0,0,0,1,0,1,2
shilad_wikibrain,org.wikibrain.spatial.loader,0,0,0,0,0,0,1,1
shilad_wikibrain,org.wikibrain.spatial.matcher,0,0,0,0,1,0,1,2
shilad_wikibrain,org.wikibrain.spatial,0,0,0,0,0,0,1,1
shilad_wikibrain,org.wikibrain.spatial.util,0,0,0,0,0,0,1,1
shilad_wikibrain,org.wikibrain.spatial.utils,0,0,0,0,0,0,1,1
shilad_wikibrain,org.wikibrain.sr,12,1,0,0,1,1,1,16
shilad_wikibrain,org.wikibrain.sr.category,0,0,0,0,0,0,1,1
shilad_wikibrain,org.wikibrain.sr.dataset,3,1,0,0,1,2,1,8
shilad_wikibrain,org.wikibrain.sr.disambig,3,1,0,0,1,0,1,6
shilad_wikibrain,org.wikibrain.sr.ensemble,2,0,0,0,1,0,1,4
shilad_wikibrain,org.wikibrain.sr.esa,0,0,0,0,0,0,1,1
shilad_wikibrain,org.wikibrain.sr.evaluation,0,0,0,0,1,1,1,3
shilad_wikibrain,org.wikibrain.sr.milnewitten,0,0,0,0,1,0,1,2
shilad_wikibrain,org.wikibrain.sr.normalize,1,0,0,0,1,0,1,3
shilad_wikibrain,org.wikibrain.sr.phrasesim,0,0,0,0,1,0,1,2
shilad_wikibrain,org.wikibrain.sr.synrank,0,0,0,0,0,0,1,1
shilad_wikibrain,org.wikibrain.sr.utils,3,1,0,0,1,0,1,6
shilad_wikibrain,org.wikibrain.sr.vector,2,0,0,0,1,0,1,4
shilad_wikibrain,org.wikibrain.sr.wikify,3,0,0,0,1,1,1,6
shilad_wikibrain,org.wikibrain.sr.word2vec,1,0,0,0,1,0,1,3
shilad_wikibrain,org.wikibrain.sr.word2vec.universal,0,0,0,0,0,0,1,1
shilad_wikibrain,jnt.scimark2,0,0,0,0,0,0,1,1
shilad_wikibrain,org.clapper.util.classutil,0,0,0,0,0,0,1,1
shilad_wikibrain,org.wikibrain.conf,0,0,0,0,1,0,1,2
shilad_wikibrain,org.wikibrain.utils,0,0,0,1,1,0,1,3
shilad_wikibrain,org.wikibrain.webapi,0,0,0,0,1,0,1,2
shilad_wikibrain,org.wikibrain.wikidata,0,0,0,0,1,1,1,3
siacs_Conversations,rocks.xmpp.addr,0,0,0,0,0,0,1,1
siacs_Conversations,rocks.xmpp.util.cache,0,0,0,0,0,0,1,1
siacs_Conversations,eu.siacs.conversations.ui.widget,4,1,0,0,1,0,1,7
siacs_Conversations,eu.siacs.conversations.utils,24,1,0,1,1,0,1,28
siacs_Conversations,eu.siacs.conversations.services,30,1,0,1,0,0,1,33
siacs_Conversations,eu.siacs.conversations.ui.adapter,13,1,0,1,1,0,1,17
siacs_Conversations,eu.siacs.conversations.ui,22,0,0,1,0,0,1,24
siacs_Conversations,eu.siacs.conversations.ui.service,4,1,0,0,1,0,1,7
siacs_Conversations,eu.siacs.conversations.android,3,0,0,0,0,0,1,4
siacs_Conversations,eu.siacs.conversations,0,0,0,0,0,0,1,1
siacs_Conversations,eu.siacs.conversations.crypto.axolotl,10,1,0,0,0,0,1,12
siacs_Conversations,eu.siacs.conversations.crypto,3,1,0,0,0,0,1,5
siacs_Conversations,eu.siacs.conversations.crypto.sasl,2,0,0,0,0,0,1,3
siacs_Conversations,eu.siacs.conversations.entities,22,1,0,1,0,0,1,25
siacs_Conversations,eu.siacs.conversations.generator,2,0,0,0,0,0,1,3
siacs_Conversations,eu.siacs.conversations.http,4,1,0,0,0,0,1,6
siacs_Conversations,eu.siacs.conversations.http.services,0,0,0,0,0,0,1,1
siacs_Conversations,eu.siacs.conversations.parser,3,0,0,0,0,0,1,4
siacs_Conversations,eu.siacs.conversations.persistance,4,1,0,0,1,0,1,7
siacs_Conversations,eu.siacs.conversations.ui.forms,0,0,0,0,0,0,1,1
siacs_Conversations,eu.siacs.conversations.ui.interfaces,2,0,0,0,1,0,1,4
siacs_Conversations,eu.siacs.conversations.ui.text,0,0,0,0,0,0,1,1
siacs_Conversations,eu.siacs.conversations.ui.util,7,1,0,1,1,0,1,11
siacs_Conversations,eu.siacs.conversations.xml,15,1,0,0,1,0,1,18
siacs_Conversations,eu.siacs.conversations.xmpp.forms,2,0,0,0,0,0,1,3
siacs_Conversations,eu.siacs.conversations.xmpp,18,1,0,0,1,0,1,21
siacs_Conversations,eu.siacs.conversations.xmpp.jingle,3,0,0,0,0,0,1,4
siacs_Conversations,eu.siacs.conversations.xmpp.jingle.stanzas,2,0,0,0,0,0,1,3
siacs_Conversations,eu.siacs.conversations.xmpp.mam,0,0,0,0,0,0,1,1
siacs_Conversations,eu.siacs.conversations.xmpp.pep,3,0,0,0,0,0,1,4
siacs_Conversations,eu.siacs.conversations.xmpp.stanzas,10,1,0,0,0,0,1,12
siacs_Conversations,eu.siacs.conversations.xmpp.stanzas.csi,0,0,0,0,0,0,1,1
siacs_Conversations,eu.siacs.conversations.xmpp.stanzas.streammgmt,0,0,0,0,0,0,1,1
siacs_Conversations,eu.siacs.conversations.ui.drawable,0,0,0,0,0,0,1,1
simpligility_android-maven-plugin,(default package),0,0,0,0,0,0,0,0
simpligility_android-maven-plugin,com.simpligility.maven.plugins.android,2,1,0,1,1,0,0,5
simpligility_android-maven-plugin,com.simpligility.maven.plugins.android.asm,0,0,0,0,0,0,0,0
simpligility_android-maven-plugin,com.simpligility.maven.plugins.android.common,3,1,0,0,1,0,0,5
simpligility_android-maven-plugin,com.simpligility.maven.plugins.android.compiler,0,0,0,0,0,0,0,0
simpligility_android-maven-plugin,com.simpligility.maven.plugins.android.config,0,0,0,0,0,0,0,0
simpligility_android-maven-plugin,com.simpligility.maven.plugins.android.configuration,0,0,0,1,1,0,0,2
simpligility_android-maven-plugin,com.simpligility.maven.plugins.android.phase01generatesources,0,0,0,0,1,0,0,1
simpligility_android-maven-plugin,com.simpligility.maven.plugins.android.phase04processclasses,0,0,0,0,0,0,0,0
simpligility_android-maven-plugin,com.simpligility.maven.plugins.android.phase08preparepackage,0,0,0,0,0,0,0,0
simpligility_android-maven-plugin,com.simpligility.maven.plugins.android.phase09package,2,0,0,0,0,0,0,2
simpligility_android-maven-plugin,com.simpligility.maven.plugins.android.phase_prebuild,0,0,0,0,0,0,0,0
simpligility_android-maven-plugin,com.simpligility.maven.plugins.android.resource,0,0,0,0,0,0,0,0
simpligility_android-maven-plugin,com.simpligility.maven.plugins.android.standalonemojos,0,0,0,1,1,0,0,2
simpligility_android-maven-plugin,org.apache.maven.surefire,0,0,0,0,0,0,0,0
simpligility_android-maven-plugin,com.simpligility.android.aar,0,0,0,0,0,0,0,0
simpligility_android-maven-plugin,org.jboss.aerogear.android.parent,0,0,0,0,0,0,0,0
simpligility_android-maven-plugin,com.example.android.apis.accessibility,0,0,0,0,1,0,0,1
simpligility_android-maven-plugin,com.example.android.apis.animation,0,0,0,0,1,0,0,1
simpligility_android-maven-plugin,com.example.android.apis,0,0,0,0,1,0,0,1
simpligility_android-maven-plugin,com.example.android.apis.app,0,0,0,1,1,0,0,2
simpligility_android-maven-plugin,com.example.android.apis.appwidget,0,0,0,0,0,0,0,0
simpligility_android-maven-plugin,com.example.android.apis.content,0,0,0,0,1,0,0,1
simpligility_android-maven-plugin,com.example.android.apis.graphics,0,0,0,1,1,0,0,2
simpligility_android-maven-plugin,com.example.android.apis.graphics.kube,0,0,0,0,0,0,0,0
simpligility_android-maven-plugin,com.example.android.apis.graphics.spritetext,0,0,0,0,0,0,0,0
simpligility_android-maven-plugin,com.example.android.apis.media,0,0,0,0,1,0,0,1
simpligility_android-maven-plugin,com.example.android.apis.nfc,0,0,0,0,0,0,0,0
simpligility_android-maven-plugin,com.example.android.apis.os,0,0,0,0,1,0,0,1
simpligility_android-maven-plugin,com.example.android.apis.preference,0,0,0,0,1,0,0,1
simpligility_android-maven-plugin,com.example.android.apis.text,0,0,0,0,0,0,0,0
simpligility_android-maven-plugin,com.example.android.apis.view,0,0,0,1,1,0,0,2
simpligility_android-maven-plugin,com.simpligility.android.helloflashlightinjection,0,0,0,0,0,0,0,0
simpligility_android-maven-plugin,com.example.android.duplicates,0,0,0,0,0,0,0,0
simpligility_android-maven-plugin,com.simpligility.android.helloflashlight,0,0,0,0,0,0,0,0
simpligility_android-maven-plugin,org.apache.maven.plugin,0,0,0,0,0,0,0,0
simpligility_android-maven-plugin,org.apache.maven.plugin.compiler,0,0,0,0,1,0,0,1
simpligility_android-maven-plugin,org.apache.maven.plugins.shade,0,0,0,0,1,0,0,1
simpligility_android-maven-plugin,org.apache.maven.plugins.shade.filter,0,0,0,0,0,0,0,0
simpligility_android-maven-plugin,org.apache.maven.plugins.shade.mojo,0,0,0,0,1,0,0,1
simpligility_android-maven-plugin,org.apache.maven.plugins.shade.pom,0,0,0,0,0,0,0,0
simpligility_android-maven-plugin,org.apache.maven.plugins.shade.relocation,0,0,0,0,0,0,0,0
simpligility_android-maven-plugin,org.apache.maven.plugins.shade.resource,0,0,0,0,0,0,0,0
simpligility_android-ndk-maven-plugin,com.simpligility.maven.plugins.androidndk,2,1,0,0,1,0,0,4
simpligility_android-ndk-maven-plugin,com.simpligility.maven.plugins.androidndk.common,1,0,0,0,1,0,0,2
simpligility_android-ndk-maven-plugin,com.simpligility.maven.plugins.androidndk.configuration,0,0,0,0,0,0,0,0
simpligility_android-ndk-maven-plugin,com.simpligility.maven.plugins.androidndk.phase00clean,0,0,0,0,0,0,0,0
simpligility_android-ndk-maven-plugin,com.simpligility.maven.plugins.androidndk.phase05compile,2,0,0,0,1,0,0,3
simpligility_android-ndk-maven-plugin,com.simpligility.maven.plugins.androidndk.projects,0,0,0,0,0,0,0,0
simpligility_android-ndk-maven-plugin,com.simpligility.maven.plugins.androidndk.standalonemojos,0,0,0,0,0,0,0,0
simpligility_android-ndk-maven-plugin,com.acme.hellojni,0,0,0,0,0,0,0,0
sindicetech_siren,com.sindicetech.siren.analysis,2,0,0,1,1,0,0,4
sindicetech_siren,com.sindicetech.siren.analysis.attributes,1,0,0,0,1,0,0,2
sindicetech_siren,com.sindicetech.siren.analysis.filter,0,0,0,0,1,0,0,1
sindicetech_siren,com.sindicetech.siren.index.codecs.block,0,0,0,1,0,0,0,1
sindicetech_siren,com.sindicetech.siren.index.codecs.siren10,2,0,0,0,1,0,0,3
sindicetech_siren,com.sindicetech.siren.index,2,1,0,0,1,0,0,4
sindicetech_siren,com.sindicetech.siren.search.node,2,0,0,1,1,0,0,4
sindicetech_siren,com.sindicetech.siren.search.spans,0,0,0,1,1,0,0,2
sindicetech_siren,com.sindicetech.siren.similarity,0,0,0,0,0,0,0,0
sindicetech_siren,com.sindicetech.siren.util,7,1,0,0,1,0,0,9
sindicetech_siren,com.sindicetech.siren.index.codecs,3,1,0,0,0,0,0,4
sindicetech_siren,com.sindicetech.siren.search,0,0,0,0,1,0,0,1
sindicetech_siren,com.sindicetech.siren.elasticsearch.analysis,0,1,0,0,0,0,0,1
sindicetech_siren,com.sindicetech.siren.elasticsearch.index,0,1,0,0,1,0,0,2
sindicetech_siren,com.sindicetech.siren.elasticsearch.plugin,0,0,0,0,0,0,0,0
sindicetech_siren,com.sindicetech.siren.elasticsearch.query,0,0,0,0,1,0,0,1
sindicetech_siren,com.sindicetech.siren.elasticsearch,0,0,0,0,0,0,0,0
sindicetech_siren,com.sindicetech.siren.demo.bnb,0,0,0,0,0,0,0,0
sindicetech_siren,com.sindicetech.siren.demo.movie,0,0,0,0,0,0,0,0
sindicetech_siren,com.sindicetech.siren.demo,0,0,0,0,0,0,0,0
sindicetech_siren,com.sindicetech.siren.qparser.keyword.builders,0,0,0,0,1,0,0,1
sindicetech_siren,com.sindicetech.siren.qparser.keyword.builders.concise,0,0,0,0,0,0,0,0
sindicetech_siren,com.sindicetech.siren.qparser.keyword,0,0,0,0,1,0,0,1
sindicetech_siren,com.sindicetech.siren.qparser.keyword.config,0,0,0,0,0,0,0,0
sindicetech_siren,com.sindicetech.siren.qparser.keyword.nodes,1,1,0,0,1,0,0,3
sindicetech_siren,com.sindicetech.siren.qparser.keyword.processors,1,0,0,0,1,0,0,2
sindicetech_siren,com.sindicetech.siren.qparser.tree.builders,0,0,0,0,1,0,0,1
sindicetech_siren,com.sindicetech.siren.qparser.tree.builders.concise,0,0,0,0,0,0,0,0
sindicetech_siren,com.sindicetech.siren.qparser.tree,0,0,0,0,1,0,0,1
sindicetech_siren,com.sindicetech.siren.qparser.tree.config,0,0,0,0,0,0,0,0
sindicetech_siren,com.sindicetech.siren.qparser.tree.dsl,0,0,0,0,1,0,0,1
sindicetech_siren,com.sindicetech.siren.qparser.tree.nodes,0,0,0,0,1,0,0,1
sindicetech_siren,com.sindicetech.siren.qparser.tree.parser,0,0,0,0,1,0,0,1
sindicetech_siren,com.sindicetech.siren.qparser.tree.processors,0,0,0,0,0,0,0,0
sindicetech_siren,com.sindicetech.siren.qparser.tree.storage,0,0,0,0,0,0,0,0
sindicetech_siren,com.sindicetech.siren.solr.analysis,0,0,0,0,1,0,0,1
sindicetech_siren,com.sindicetech.siren.solr.client.solrj.request,0,0,0,0,0,0,0,0
sindicetech_siren,com.sindicetech.siren.solr.handler,1,0,0,0,1,0,0,2
sindicetech_siren,com.sindicetech.siren.solr.handler.mapper,1,1,0,0,1,0,0,3
sindicetech_siren,com.sindicetech.siren.solr.qparser.keyword,0,0,0,0,0,0,0,0
sindicetech_siren,com.sindicetech.siren.solr.qparser,0,0,0,0,1,0,0,1
sindicetech_siren,com.sindicetech.siren.solr.qparser.tree,0,0,0,0,0,0,0,0
sindicetech_siren,com.sindicetech.siren.solr.response,0,0,0,0,0,0,0,0
sindicetech_siren,com.sindicetech.siren.solr.schema,0,1,0,0,1,0,0,2
sindicetech_siren,com.sindicetech.siren.solr,0,0,0,0,0,0,0,0
sindicetech_siren,com.sindicetech.siren.demo.loader,0,0,0,0,0,0,0,0
sindicetech_siren,com.sindicetech.siren.demo.ncpr,0,0,0,0,0,0,0,0
sindicetech_siren,com.sindicetech.siren.solr.facet,0,0,0,0,1,0,0,1
sitewhere_sitewhere,com.sitewhere.asset,0,0,0,0,0,0,0,0
sitewhere_sitewhere,com.sitewhere.asset.configuration,0,0,0,0,0,0,0,0
sitewhere_sitewhere,com.sitewhere.asset.grpc,0,0,0,0,0,0,0,0
sitewhere_sitewhere,com.sitewhere.asset.initializer,0,0,0,0,0,0,0,0
sitewhere_sitewhere,com.sitewhere.asset.microservice,0,0,0,0,0,0,0,0
sitewhere_sitewhere,com.sitewhere.asset.modules.wso2.ksoap2,0,0,0,0,0,0,0,0
sitewhere_sitewhere,com.sitewhere.asset.modules.wso2.scim,0,0,0,0,0,0,0,0
sitewhere_sitewhere,com.sitewhere.asset.modules.wso2.ws,0,0,0,1,0,0,0,1
sitewhere_sitewhere,com.sitewhere.asset.persistence,0,0,0,0,0,0,0,0
sitewhere_sitewhere,com.sitewhere.asset.persistence.mongodb,0,0,0,0,1,0,0,1
sitewhere_sitewhere,com.sitewhere.asset.spi.grpc,0,0,0,0,0,0,0,0
sitewhere_sitewhere,com.sitewhere.asset.spi,0,0,0,0,0,0,0,0
sitewhere_sitewhere,com.sitewhere.asset.spi.microservice,0,0,0,0,0,0,0,0
sitewhere_sitewhere,com.sitewhere.asset.spring,0,0,0,0,0,0,0,0
sitewhere_sitewhere,com.sitewhere.batch,0,0,0,0,1,0,0,1
sitewhere_sitewhere,com.sitewhere.batch.configuration,0,0,0,0,0,0,0,0
sitewhere_sitewhere,com.sitewhere.batch.handler,0,0,0,0,0,0,0,0
sitewhere_sitewhere,com.sitewhere.batch.microservice,0,0,0,0,0,0,0,0
sitewhere_sitewhere,com.sitewhere.batch.persistence,0,1,0,0,0,0,0,1
sitewhere_sitewhere,com.sitewhere.batch.persistence.mongodb,0,0,0,0,1,0,0,1
sitewhere_sitewhere,com.sitewhere.batch.spi.grpc,0,0,0,0,0,0,0,0
sitewhere_sitewhere,com.sitewhere.batch.spi,0,0,0,0,0,0,0,0
sitewhere_sitewhere,com.sitewhere.batch.spi.kafka,0,0,0,0,0,0,0,0
sitewhere_sitewhere,com.sitewhere.batch.spi.microservice,0,0,0,0,0,0,0,0
sitewhere_sitewhere,com.sitewhere.batch.spring,0,0,0,0,0,0,0,0
sitewhere_sitewhere,com.sitewhere.microservice.grpc,0,0,0,0,1,0,0,1
sitewhere_sitewhere,com.sitewhere.microservice.kafka,0,0,0,1,0,0,0,1
sitewhere_sitewhere,com.sitewhere.commands,0,0,0,0,1,0,0,1
sitewhere_sitewhere,com.sitewhere.commands.configuration,0,0,0,0,0,0,0,0
sitewhere_sitewhere,com.sitewhere.commands.destination.coap,0,0,0,0,0,0,0,0
sitewhere_sitewhere,com.sitewhere.commands.destination,0,0,0,0,0,0,0,0
sitewhere_sitewhere,com.sitewhere.commands.destination.mqtt,0,0,0,0,0,0,0,0
sitewhere_sitewhere,com.sitewhere.commands.destination.sms,0,0,0,0,0,0,0,0
sitewhere_sitewhere,com.sitewhere.commands.encoding,0,0,0,0,0,0,0,0
sitewhere_sitewhere,com.sitewhere.commands.encoding.json,0,0,0,0,0,0,0,0
sitewhere_sitewhere,com.sitewhere.commands.encoding.protobuf,0,0,0,0,0,0,0,0
sitewhere_sitewhere,com.sitewhere.commands.encoding.string,0,0,0,0,0,0,0,0
sitewhere_sitewhere,com.sitewhere.commands.groovy,0,0,0,0,0,0,0,0
sitewhere_sitewhere,com.sitewhere.commands.microservice,0,0,0,0,0,0,0,0
sitewhere_sitewhere,com.sitewhere.commands.routing,0,0,0,0,0,0,0,0
sitewhere_sitewhere,com.sitewhere.commands.spi,0,0,0,0,1,0,0,1
sitewhere_sitewhere,com.sitewhere.commands.spi.kafka,0,0,0,0,0,0,0,0
sitewhere_sitewhere,com.sitewhere.commands.spi.microservice,0,0,0,0,0,0,0,0
sitewhere_sitewhere,com.sitewhere.commands.spring,0,0,0,0,0,0,0,0
sitewhere_sitewhere,com.sitewhere.commands.twilio,0,0,0,0,0,0,0,0
sitewhere_sitewhere,com.sitewhere.device.configuration,0,0,0,0,0,0,0,0
sitewhere_sitewhere,com.sitewhere.device,0,0,0,0,0,0,0,0
sitewhere_sitewhere,com.sitewhere.device.initializer,0,0,0,0,0,0,0,0
sitewhere_sitewhere,com.sitewhere.device.microservice,0,0,0,0,0,0,0,0
sitewhere_sitewhere,com.sitewhere.device.persistence,0,0,0,0,0,0,0,0
sitewhere_sitewhere,com.sitewhere.device.persistence.mongodb,0,0,0,0,0,0,0,0
sitewhere_sitewhere,com.sitewhere.device.spi.grpc,0,0,0,0,0,0,0,0
sitewhere_sitewhere,com.sitewhere.device.spi.initializer,0,0,0,0,0,0,0,0
sitewhere_sitewhere,com.sitewhere.device.spi.kafka,0,0,0,0,0,0,0,0
sitewhere_sitewhere,com.sitewhere.device.spi.microservice,0,0,0,0,0,0,0,0
sitewhere_sitewhere,com.sitewhere.device.spring,0,0,0,0,0,0,0,0
sitewhere_sitewhere,com.sitewhere.registration.configuration,0,0,0,0,0,0,0,0
sitewhere_sitewhere,com.sitewhere.registration,0,0,0,0,0,0,0,0
sitewhere_sitewhere,com.sitewhere.registration.microservice,0,0,0,0,0,0,0,0
sitewhere_sitewhere,com.sitewhere.registration.spi,0,0,0,0,0,0,0,0
sitewhere_sitewhere,com.sitewhere.registration.spi.kafka,0,0,0,0,0,0,0,0
sitewhere_sitewhere,com.sitewhere.registration.spi.microservice,0,0,0,0,0,0,0,0
sitewhere_sitewhere,com.sitewhere.registration.spring,0,0,0,0,0,0,0,0
sitewhere_sitewhere,com.sitewhere.devicestate.configuration,0,0,0,0,0,0,0,0
sitewhere_sitewhere,com.sitewhere.devicestate,0,0,0,0,0,0,0,0
sitewhere_sitewhere,com.sitewhere.devicestate.microservice,0,0,0,0,0,0,0,0
sitewhere_sitewhere,com.sitewhere.devicestate.persistence,0,0,0,0,0,0,0,0
sitewhere_sitewhere,com.sitewhere.devicestate.persistence.mongodb,0,0,0,0,0,0,0,0
sitewhere_sitewhere,com.sitewhere.devicestate.presence,0,0,0,0,0,0,0,0
sitewhere_sitewhere,com.sitewhere.devicestate.processing,0,0,0,0,0,0,0,0
sitewhere_sitewhere,com.sitewhere.devicestate.spi.grpc,0,0,0,0,0,0,0,0
sitewhere_sitewhere,com.sitewhere.devicestate.spi,0,0,0,0,0,0,0,0
sitewhere_sitewhere,com.sitewhere.devicestate.spi.kafka,0,0,0,0,0,0,0,0
sitewhere_sitewhere,com.sitewhere.devicestate.spi.microservice,0,0,0,0,0,0,0,0
sitewhere_sitewhere,com.sitewhere.devicestate.spi.processing,0,0,0,0,0,0,0,0
sitewhere_sitewhere,com.sitewhere.devicestate.spring,0,0,0,0,0,0,0,0
sitewhere_sitewhere,com.sitewhere.event.configuration,0,0,0,0,0,0,0,0
sitewhere_sitewhere,com.sitewhere.event,0,0,0,0,0,0,0,0
sitewhere_sitewhere,com.sitewhere.event.initializer,0,0,0,0,0,0,0,0
sitewhere_sitewhere,com.sitewhere.event.microservice,0,0,0,0,0,0,0,0
sitewhere_sitewhere,com.sitewhere.event.persistence.cassandra,0,0,0,0,0,0,0,0
sitewhere_sitewhere,com.sitewhere.event.persistence,0,0,0,0,0,0,0,0
sitewhere_sitewhere,com.sitewhere.event.persistence.influxdb,0,0,0,0,0,0,0,0
sitewhere_sitewhere,com.sitewhere.event.persistence.mongodb,0,0,0,0,0,0,0,0
sitewhere_sitewhere,com.sitewhere.event.processing,0,0,0,0,0,0,0,0
sitewhere_sitewhere,com.sitewhere.event.spi.grpc,0,0,0,0,0,0,0,0
sitewhere_sitewhere,com.sitewhere.event.spi.initializer,0,0,0,0,0,0,0,0
sitewhere_sitewhere,com.sitewhere.event.spi.kafka,0,0,0,0,0,0,0,0
sitewhere_sitewhere,com.sitewhere.event.spi.microservice,0,0,0,0,0,0,0,0
sitewhere_sitewhere,com.sitewhere.event.spring,0,0,0,0,0,0,0,0
sitewhere_sitewhere,com.sitewhere.search.configuration,0,0,0,0,0,0,0,0
sitewhere_sitewhere,com.sitewhere.search,0,0,0,0,0,0,0,0
sitewhere_sitewhere,com.sitewhere.search.microservice,0,0,0,0,0,0,0,0
sitewhere_sitewhere,com.sitewhere.search.solr,0,0,0,0,0,0,0,0
sitewhere_sitewhere,com.sitewhere.search.spi,0,0,0,0,0,0,0,0
sitewhere_sitewhere,com.sitewhere.search.spi.microservice,0,0,0,0,0,0,0,0
sitewhere_sitewhere,com.sitewhere.search.spring,0,0,0,0,0,0,0,0
sitewhere_sitewhere,com.sitewhere.sources.activemq,0,0,0,0,1,0,0,1
sitewhere_sitewhere,com.sitewhere.sources.azure,0,0,0,0,0,0,0,0
sitewhere_sitewhere,com.sitewhere.sources,0,1,0,0,1,0,0,2
sitewhere_sitewhere,com.sitewhere.sources.coap,0,0,0,0,0,0,0,0
sitewhere_sitewhere,com.sitewhere.sources.configuration,0,0,0,0,0,0,0,0
sitewhere_sitewhere,com.sitewhere.sources.decoder.coap,0,1,0,0,0,0,0,1
sitewhere_sitewhere,com.sitewhere.sources.decoder.composite,0,0,0,0,1,0,0,1
sitewhere_sitewhere,com.sitewhere.sources.decoder.debug,0,0,0,0,0,0,0,0
sitewhere_sitewhere,com.sitewhere.sources.decoder,0,0,0,0,0,0,0,0
sitewhere_sitewhere,com.sitewhere.sources.decoder.json,0,1,0,0,0,0,0,1
sitewhere_sitewhere,com.sitewhere.sources.decoder.protobuf,0,0,0,0,0,0,0,0
sitewhere_sitewhere,com.sitewhere.sources.deduplicator,0,0,0,0,0,0,0,0
sitewhere_sitewhere,com.sitewhere.sources.microservice,0,0,0,0,0,0,0,0
sitewhere_sitewhere,com.sitewhere.sources.mqtt,0,0,0,0,1,0,0,1
sitewhere_sitewhere,com.sitewhere.sources.rabbitmq,0,0,0,0,0,0,0,0
sitewhere_sitewhere,com.sitewhere.sources.rest,0,0,0,0,0,0,0,0
sitewhere_sitewhere,com.sitewhere.sources.socket,0,0,0,0,1,0,0,1
sitewhere_sitewhere,com.sitewhere.sources.spi,0,0,0,0,1,0,0,1
sitewhere_sitewhere,com.sitewhere.sources.spi.microservice,0,0,0,0,0,0,0,0
sitewhere_sitewhere,com.sitewhere.sources.spi.socket,0,0,0,0,0,0,0,0
sitewhere_sitewhere,com.sitewhere.sources.spring,0,0,0,0,0,0,0,0
sitewhere_sitewhere,com.sitewhere.sources.websocket,0,0,0,0,1,0,0,1
sitewhere_sitewhere,com.sitewhere.inbound.configuration,0,0,0,0,0,0,0,0
sitewhere_sitewhere,com.sitewhere.inbound,0,0,0,0,0,0,0,0
sitewhere_sitewhere,com.sitewhere.inbound.microservice,0,0,0,0,0,0,0,0
sitewhere_sitewhere,com.sitewhere.inbound.processing,0,0,0,0,0,0,0,0
sitewhere_sitewhere,com.sitewhere.inbound.spi,0,0,0,0,0,0,0,0
sitewhere_sitewhere,com.sitewhere.inbound.spi.kafka,0,0,0,0,0,0,0,0
sitewhere_sitewhere,com.sitewhere.inbound.spi.microservice,0,0,0,0,0,0,0,0
sitewhere_sitewhere,com.sitewhere.inbound.spi.processing,0,0,0,0,0,0,0,0
sitewhere_sitewhere,com.sitewhere.inbound.spring,0,0,0,0,0,0,0,0
sitewhere_sitewhere,com.sitewhere.instance.configuration,0,0,0,0,0,0,0,0
sitewhere_sitewhere,com.sitewhere.instance.initializer,0,0,0,0,0,0,0,0
sitewhere_sitewhere,com.sitewhere.instance,0,0,0,0,0,0,0,0
sitewhere_sitewhere,com.sitewhere.instance.microservice,0,0,0,0,0,0,0,0
sitewhere_sitewhere,com.sitewhere.instance.spi.initializer,0,0,0,0,0,0,0,0
sitewhere_sitewhere,com.sitewhere.instance.spi.instance.grpc,0,0,0,0,0,0,0,0
sitewhere_sitewhere,com.sitewhere.instance.spi.microservice,0,0,0,0,0,0,0,0
sitewhere_sitewhere,com.sitewhere.instance.spi.templates,0,0,0,0,0,0,0,0
sitewhere_sitewhere,com.sitewhere.instance.spi.tenant.grpc,0,0,0,0,0,0,0,0
sitewhere_sitewhere,com.sitewhere.instance.spi.tenant.kafka,0,0,0,0,0,0,0,0
sitewhere_sitewhere,com.sitewhere.instance.spi.tenant.templates,0,0,0,0,0,0,0,0
sitewhere_sitewhere,com.sitewhere.instance.spi.user.grpc,0,0,0,0,0,0,0,0
sitewhere_sitewhere,com.sitewhere.instance.templates,0,0,0,0,0,0,0,0
sitewhere_sitewhere,com.sitewhere.instance.tenant.templates,0,0,0,0,0,0,0,0
sitewhere_sitewhere,com.sitewhere.instance.user.persistence,0,0,0,0,0,0,0,0
sitewhere_sitewhere,com.sitewhere.microservice.grpc.instance,0,0,0,0,0,0,0,0
sitewhere_sitewhere,com.sitewhere.microservice.grpc.tenant,0,0,0,0,0,0,0,0
sitewhere_sitewhere,com.sitewhere.microservice.grpc.user,0,0,0,0,0,0,0,0
sitewhere_sitewhere,com.sitewhere.microservice.kafka.tenant,0,0,0,0,0,0,0,0
sitewhere_sitewhere,com.sitewhere.microservice.kafka.user,0,0,0,0,0,0,0,0
sitewhere_sitewhere,com.sitewhere.labels.configuration,0,0,0,0,0,0,0,0
sitewhere_sitewhere,com.sitewhere.labels,0,0,0,0,0,0,0,0
sitewhere_sitewhere,com.sitewhere.labels.microservice,0,0,0,0,0,0,0,0
sitewhere_sitewhere,com.sitewhere.labels.spi.grpc,0,0,0,0,0,0,0,0
sitewhere_sitewhere,com.sitewhere.labels.spi.microservice,0,0,0,0,0,0,0,0
sitewhere_sitewhere,com.sitewhere.labels.spring,0,0,0,0,0,0,0,0
sitewhere_sitewhere,com.sitewhere.labels.symbology,0,0,0,0,0,0,0,0
sitewhere_sitewhere,com.sitewhere.connectors.aws.sqs,0,0,0,0,0,0,0,0
sitewhere_sitewhere,com.sitewhere.connectors.azure,0,0,0,0,0,0,0,0
sitewhere_sitewhere,com.sitewhere.connectors.configuration,0,0,0,0,0,0,0,0
sitewhere_sitewhere,com.sitewhere.connectors.dweetio,0,0,0,0,0,0,0,0
sitewhere_sitewhere,com.sitewhere.connectors.filter,0,0,0,0,0,0,0,0
sitewhere_sitewhere,com.sitewhere.connectors,0,1,0,0,0,0,0,1
sitewhere_sitewhere,com.sitewhere.connectors.groovy.common,0,0,0,0,0,0,0,0
sitewhere_sitewhere,com.sitewhere.connectors.groovy.filter,0,0,0,0,0,0,0,0
sitewhere_sitewhere,com.sitewhere.connectors.groovy,0,0,0,0,0,0,0,0
sitewhere_sitewhere,com.sitewhere.connectors.groovy.multicast,0,0,0,0,0,0,0,0
sitewhere_sitewhere,com.sitewhere.connectors.groovy.routing,0,0,0,0,0,0,0,0
sitewhere_sitewhere,com.sitewhere.connectors.http,0,0,0,0,0,0,0,0
sitewhere_sitewhere,com.sitewhere.connectors.initialstate,0,0,0,0,0,0,0,0
sitewhere_sitewhere,com.sitewhere.connectors.microservice,0,0,0,0,0,0,0,0
sitewhere_sitewhere,com.sitewhere.connectors.mqtt,0,0,0,0,0,0,0,0
sitewhere_sitewhere,com.sitewhere.connectors.rabbitmq,0,0,0,0,0,0,0,0
sitewhere_sitewhere,com.sitewhere.connectors.solr,0,0,0,0,0,0,0,0
sitewhere_sitewhere,com.sitewhere.connectors.spi.common,0,0,0,0,0,0,0,0
sitewhere_sitewhere,com.sitewhere.connectors.spi,0,0,0,0,1,0,0,1
sitewhere_sitewhere,com.sitewhere.connectors.spi.microservice,0,0,0,0,0,0,0,0
sitewhere_sitewhere,com.sitewhere.connectors.spi.multicast,0,0,0,0,0,0,0,0
sitewhere_sitewhere,com.sitewhere.connectors.spi.routing,0,0,0,0,0,0,0,0
sitewhere_sitewhere,com.sitewhere.connectors.spring,0,0,0,0,0,0,0,0
sitewhere_sitewhere,com.sitewhere.rules.configuration,0,0,0,0,0,0,0,0
sitewhere_sitewhere,com.sitewhere.rules.microservice,0,0,0,0,0,0,0,0
sitewhere_sitewhere,com.sitewhere.rules.processors.geospatial,0,0,0,0,0,0,0,0
sitewhere_sitewhere,com.sitewhere.rules,0,1,0,0,0,0,0,1
sitewhere_sitewhere,com.sitewhere.rules.spi,0,0,0,0,0,0,0,0
sitewhere_sitewhere,com.sitewhere.rules.spi.microservice,0,0,0,0,0,0,0,0
sitewhere_sitewhere,com.sitewhere.rules.spring,0,0,0,0,0,0,0,0
sitewhere_sitewhere,com.sitewhere.schedule.configuration,0,0,0,0,0,0,0,0
sitewhere_sitewhere,com.sitewhere.schedule,1,1,0,0,1,0,0,3
sitewhere_sitewhere,com.sitewhere.schedule.initializer,0,0,0,0,0,0,0,0
sitewhere_sitewhere,com.sitewhere.schedule.jobs,1,0,0,0,0,0,0,1
sitewhere_sitewhere,com.sitewhere.schedule.microservice,0,0,0,0,0,0,0,0
sitewhere_sitewhere,com.sitewhere.schedule.persistence.mongodb,0,0,0,0,1,0,0,1
sitewhere_sitewhere,com.sitewhere.schedule.persistence,0,0,0,0,0,0,0,0
sitewhere_sitewhere,com.sitewhere.schedule.spi.grpc,0,0,0,0,0,0,0,0
sitewhere_sitewhere,com.sitewhere.schedule.spi.initializer,0,0,0,0,0,0,0,0
sitewhere_sitewhere,com.sitewhere.schedule.spi,0,0,0,0,0,0,0,0
sitewhere_sitewhere,com.sitewhere.schedule.spi.microservice,0,0,0,0,0,0,0,0
sitewhere_sitewhere,com.sitewhere.schedule.spring,0,0,0,0,0,0,0,0
sitewhere_sitewhere,com.sitewhere.media.configuration,0,0,0,0,0,0,0,0
sitewhere_sitewhere,com.sitewhere.media,0,0,0,0,0,0,0,0
sitewhere_sitewhere,com.sitewhere.media.microservice,0,0,0,0,0,0,0,0
sitewhere_sitewhere,com.sitewhere.media.persistence.cassandra,0,0,0,0,0,0,0,0
sitewhere_sitewhere,com.sitewhere.media.persistence,0,0,0,0,0,0,0,0
sitewhere_sitewhere,com.sitewhere.media.persistence.influxdb,0,0,0,0,0,0,0,0
sitewhere_sitewhere,com.sitewhere.media.persistence.mongodb,0,0,0,0,1,0,0,1
sitewhere_sitewhere,com.sitewhere.media.spi.microservice,0,0,0,0,0,0,0,0
sitewhere_sitewhere,com.sitewhere.media.spring,0,0,0,0,0,0,0,0
sitewhere_sitewhere,com.sitewhere.web.auth.controllers,0,0,0,0,0,0,0,0
sitewhere_sitewhere,com.sitewhere.web.auth,0,0,0,0,0,0,0,0
sitewhere_sitewhere,com.sitewhere.web.configuration,0,0,0,0,0,0,0,0
sitewhere_sitewhere,com.sitewhere.web.filters,0,0,0,0,1,0,0,1
sitewhere_sitewhere,com.sitewhere.web.microservice,0,0,0,0,0,0,0,0
sitewhere_sitewhere,com.sitewhere.web,0,0,0,0,0,0,0,0
sitewhere_sitewhere,com.sitewhere.web.rest.controllers,0,0,0,0,1,0,0,1
sitewhere_sitewhere,com.sitewhere.web.rest.marshaling,0,0,0,0,0,0,0,0
sitewhere_sitewhere,com.sitewhere.web.rest.model,0,0,0,0,0,0,0,0
sitewhere_sitewhere,com.sitewhere.web.rest,0,0,0,0,0,0,0,0
sitewhere_sitewhere,com.sitewhere.web.rest.view,0,0,0,0,0,0,0,0
sitewhere_sitewhere,com.sitewhere.web.security,0,0,0,0,1,0,0,1
sitewhere_sitewhere,com.sitewhere.web.security.basic,0,0,0,0,0,0,0,0
sitewhere_sitewhere,com.sitewhere.web.security.jwt,0,0,0,0,0,0,0,0
sitewhere_sitewhere,com.sitewhere.web.spi.microservice,0,0,0,0,0,0,0,0
sitewhere_sitewhere,com.sitewhere.web.spring,0,0,0,0,0,0,0,0
sitewhere_sitewhere,com.sitewhere.web.ws.components.topology,0,0,0,0,0,0,0,0
sitewhere_sitewhere,com.sitewhere.web.ws.components,0,0,0,0,0,0,0,0
sitewhere_sitewhere,com.sitewhere.web.ws,0,0,0,0,0,0,0,0
sitewhere_sitewhere,com.sitewhere.cassandra,0,0,0,0,0,0,0,0
sitewhere_sitewhere,com.sitewhere.communication.mqtt,0,0,0,0,0,0,0,0
sitewhere_sitewhere,com.sitewhere.communication.protobuf,0,0,0,0,0,0,0,0
sitewhere_sitewhere,com.sitewhere.configuration,0,0,0,0,0,0,0,0
sitewhere_sitewhere,com.sitewhere.configuration.content,0,0,0,0,0,0,0,0
sitewhere_sitewhere,com.sitewhere.configuration.datastore,0,0,0,0,0,0,0,0
sitewhere_sitewhere,com.sitewhere.configuration.instance.cassandra,0,0,0,0,0,0,0,0
sitewhere_sitewhere,com.sitewhere.configuration.instance.influxdb,0,0,0,0,0,0,0,0
sitewhere_sitewhere,com.sitewhere.configuration.instance.mongodb,0,0,0,0,0,0,0,0
sitewhere_sitewhere,com.sitewhere.configuration.instance.solr,0,0,0,0,0,0,0,0
sitewhere_sitewhere,com.sitewhere.configuration.model,0,0,0,0,0,0,0,0
sitewhere_sitewhere,com.sitewhere.configuration.old,0,0,0,0,0,0,0,0
sitewhere_sitewhere,com.sitewhere.configuration.parser,0,0,0,0,1,0,0,1
sitewhere_sitewhere,com.sitewhere.asset.marshaling,0,0,0,0,0,0,0,0
sitewhere_sitewhere,com.sitewhere.batch.marshaling,0,0,0,0,0,0,0,0
sitewhere_sitewhere,com.sitewhere.core,0,0,0,0,0,0,0,0
sitewhere_sitewhere,com.sitewhere.device.charting,0,0,0,0,0,0,0,0
sitewhere_sitewhere,com.sitewhere.device.group,0,0,0,0,0,0,0,0
sitewhere_sitewhere,com.sitewhere.device.marshaling,0,0,0,0,0,0,0,0
sitewhere_sitewhere,com.sitewhere.device.marshaling.invalid,0,0,0,0,0,0,0,0
sitewhere_sitewhere,com.sitewhere.geospatial,0,0,0,0,0,0,0,0
sitewhere_sitewhere,com.sitewhere.groovy,0,0,0,0,0,0,0,0
sitewhere_sitewhere,com.sitewhere.persistence,0,0,0,0,0,0,0,0
sitewhere_sitewhere,com.sitewhere.security,0,0,0,0,0,0,0,0
sitewhere_sitewhere,com.sitewhere.server,0,0,0,0,0,0,0,0
sitewhere_sitewhere,com.sitewhere.tenant,0,0,0,0,0,0,0,0
sitewhere_sitewhere,com.sitewhere.user,0,0,0,0,0,0,0,0
sitewhere_sitewhere,com.sitewhere,0,0,0,0,0,0,0,0
sitewhere_sitewhere,com.sitewhere.common,0,0,0,0,0,0,0,0
sitewhere_sitewhere,com.sitewhere.rest.model.asset.request.scripting,0,0,0,0,0,0,0,0
sitewhere_sitewhere,com.sitewhere.rest.model.configuration,0,0,0,0,1,0,0,1
sitewhere_sitewhere,com.sitewhere.rest.model.device.asset,0,0,0,0,0,0,0,0
sitewhere_sitewhere,com.sitewhere.rest.model.device.event.request.scripting,0,0,0,0,0,0,0,0
sitewhere_sitewhere,com.sitewhere.rest.model.device.request.scripting,0,0,0,0,0,0,0,0
sitewhere_sitewhere,com.sitewhere.rest.model.microservice.scripting,0,0,0,0,0,0,0,0
sitewhere_sitewhere,com.sitewhere.rest.model.microservice.state,0,0,0,0,1,0,0,1
sitewhere_sitewhere,com.sitewhere.rest.model.monitoring,0,0,0,0,0,0,0,0
sitewhere_sitewhere,com.sitewhere.rest.model.resource,0,0,0,0,0,0,0,0
sitewhere_sitewhere,com.sitewhere.rest.model.resource.request,0,0,0,0,0,0,0,0
sitewhere_sitewhere,com.sitewhere.rest.model.scheduling.request.scripting,0,0,0,0,0,0,0,0
sitewhere_sitewhere,com.sitewhere.rest.model.search.external,0,0,0,0,0,0,0,0
sitewhere_sitewhere,com.sitewhere.rest.model,0,0,0,0,0,0,0,0
sitewhere_sitewhere,com.sitewhere.rest.model.tenant,0,0,0,0,0,0,0,0
sitewhere_sitewhere,com.sitewhere.rest.model.tenant.request.scripting,0,0,0,0,0,0,0,0
sitewhere_sitewhere,com.sitewhere.rest.model.user.request,0,0,0,0,0,0,0,0
sitewhere_sitewhere,com.sitewhere.spi.asset,0,0,0,0,0,0,0,0
sitewhere_sitewhere,com.sitewhere.spi.batch,0,0,0,0,0,0,0,0
sitewhere_sitewhere,com.sitewhere.spi.configuration,0,0,0,0,0,0,0,0
sitewhere_sitewhere,com.sitewhere.spi.device.communication,0,0,0,0,0,0,0,0
sitewhere_sitewhere,com.sitewhere.spi.device.event,0,0,0,0,0,0,0,0
sitewhere_sitewhere,com.sitewhere.spi.device,0,0,0,0,0,0,0,0
sitewhere_sitewhere,com.sitewhere.spi.device.state,0,0,0,0,0,0,0,0
sitewhere_sitewhere,com.sitewhere.spi.device.streaming,0,0,0,0,0,0,0,0
sitewhere_sitewhere,com.sitewhere.spi.instance,0,0,0,0,0,0,0,0
sitewhere_sitewhere,com.sitewhere.spi,0,0,0,0,0,0,0,0
sitewhere_sitewhere,com.sitewhere.spi.label,0,0,0,0,0,0,0,0
sitewhere_sitewhere,com.sitewhere.spi.microservice.configuration,1,0,0,0,0,0,0,1
sitewhere_sitewhere,com.sitewhere.spi.microservice.configuration.model,0,0,0,0,1,0,0,1
sitewhere_sitewhere,com.sitewhere.spi.microservice.groovy,0,0,0,0,0,0,0,0
sitewhere_sitewhere,com.sitewhere.spi.microservice.grpc,0,0,0,0,0,0,0,0
sitewhere_sitewhere,com.sitewhere.spi.microservice,0,0,0,0,1,0,0,1
sitewhere_sitewhere,com.sitewhere.spi.microservice.instance,0,0,0,0,0,0,0,0
sitewhere_sitewhere,com.sitewhere.spi.microservice.kafka,0,0,0,0,0,0,0,0
sitewhere_sitewhere,com.sitewhere.spi.microservice.kafka.tenant,0,0,0,0,0,0,0,0
sitewhere_sitewhere,com.sitewhere.spi.microservice.metrics,0,0,0,0,0,0,0,0
sitewhere_sitewhere,com.sitewhere.spi.microservice.multitenant,2,1,0,0,1,0,0,4
sitewhere_sitewhere,com.sitewhere.spi.microservice.scripting,0,0,0,0,1,0,0,1
sitewhere_sitewhere,com.sitewhere.spi.microservice.security,0,0,0,0,0,0,0,0
sitewhere_sitewhere,com.sitewhere.spi.microservice.spring,0,0,0,0,1,0,0,1
sitewhere_sitewhere,com.sitewhere.spi.microservice.state,0,0,0,0,1,0,0,1
sitewhere_sitewhere,com.sitewhere.spi.monitoring,0,0,0,0,0,0,0,0
sitewhere_sitewhere,com.sitewhere.spi.resource,0,0,0,0,0,0,0,0
sitewhere_sitewhere,com.sitewhere.spi.resource.request,0,0,0,0,0,0,0,0
sitewhere_sitewhere,com.sitewhere.spi.scheduling,0,0,0,0,0,0,0,0
sitewhere_sitewhere,com.sitewhere.spi.search,0,0,0,0,0,0,0,0
sitewhere_sitewhere,com.sitewhere.spi.security,0,0,0,0,0,0,0,0
sitewhere_sitewhere,com.sitewhere.spi.server,0,0,0,0,0,0,0,0
sitewhere_sitewhere,com.sitewhere.spi.server.lifecycle,2,1,0,0,1,0,0,4
sitewhere_sitewhere,com.sitewhere.spi.tenant,0,0,0,0,0,0,0,0
sitewhere_sitewhere,com.sitewhere.spi.user,0,0,0,0,0,0,0,0
sitewhere_sitewhere,com.sitewhere.server.lifecycle,0,0,0,0,1,0,0,1
sitewhere_sitewhere,com.sitewhere.server.lifecycle.parameters,0,0,0,0,0,0,0,0
sitewhere_sitewhere,com.sitewhere.grpc.client,0,1,0,0,1,0,0,2
sitewhere_sitewhere,com.sitewhere.grpc.client.asset,0,0,0,0,0,0,0,0
sitewhere_sitewhere,com.sitewhere.grpc.client.batch,0,0,0,0,0,0,0,0
sitewhere_sitewhere,com.sitewhere.grpc.client.cache,0,0,0,0,1,0,0,1
sitewhere_sitewhere,com.sitewhere.grpc.client.common.converter,0,0,0,0,0,0,0,0
sitewhere_sitewhere,com.sitewhere.grpc.client.common.marshaler,0,0,0,0,0,0,0,0
sitewhere_sitewhere,com.sitewhere.grpc.client.common.security,0,0,0,0,0,0,0,0
sitewhere_sitewhere,com.sitewhere.grpc.client.common.tracing,0,0,0,0,0,0,0,0
sitewhere_sitewhere,com.sitewhere.grpc.client.device,0,0,0,0,1,0,0,1
sitewhere_sitewhere,com.sitewhere.grpc.client.devicestate,0,0,0,0,0,0,0,0
sitewhere_sitewhere,com.sitewhere.grpc.client.event,0,1,0,0,1,0,0,2
sitewhere_sitewhere,com.sitewhere.grpc.client.instance,0,0,0,0,0,0,0,0
sitewhere_sitewhere,com.sitewhere.grpc.client.label,0,0,0,0,0,0,0,0
sitewhere_sitewhere,com.sitewhere.grpc.client.microservice,0,0,0,0,0,0,0,0
sitewhere_sitewhere,com.sitewhere.grpc.client.schedule,0,0,0,0,0,0,0,0
sitewhere_sitewhere,com.sitewhere.grpc.client.spi.cache,0,0,0,0,0,0,0,0
sitewhere_sitewhere,com.sitewhere.grpc.client.spi.client,0,0,0,0,1,0,0,1
sitewhere_sitewhere,com.sitewhere.grpc.client.spi,0,0,0,0,0,0,0,0
sitewhere_sitewhere,com.sitewhere.grpc.client.spi.multitenant,0,0,0,0,0,0,0,0
sitewhere_sitewhere,com.sitewhere.grpc.client.spi.server,0,0,0,0,0,0,0,0
sitewhere_sitewhere,com.sitewhere.grpc.client.stream,0,0,0,0,0,0,0,0
sitewhere_sitewhere,com.sitewhere.grpc.client.tenant,0,0,0,0,1,0,0,1
sitewhere_sitewhere,com.sitewhere.grpc.client.user,0,0,0,0,1,0,0,1
sitewhere_sitewhere,com.sitewhere.influxdb,0,0,0,0,0,0,0,0
sitewhere_sitewhere,com.sitewhere.microservice.configuration,0,0,0,0,1,0,0,1
sitewhere_sitewhere,com.sitewhere.microservice,0,0,0,0,1,0,0,1
sitewhere_sitewhere,com.sitewhere.microservice.groovy,0,0,0,0,0,0,0,0
sitewhere_sitewhere,com.sitewhere.microservice.health,0,0,0,0,0,0,0,0
sitewhere_sitewhere,com.sitewhere.microservice.instance,0,0,0,0,0,0,0,0
sitewhere_sitewhere,com.sitewhere.microservice.management,0,0,0,0,0,0,0,0
sitewhere_sitewhere,com.sitewhere.microservice.metrics,0,0,0,0,0,0,0,0
sitewhere_sitewhere,com.sitewhere.microservice.multitenant,0,0,0,0,1,0,0,1
sitewhere_sitewhere,com.sitewhere.microservice.scripting,0,0,0,0,1,0,0,1
sitewhere_sitewhere,com.sitewhere.microservice.security,0,0,0,0,1,0,0,1
sitewhere_sitewhere,com.sitewhere.microservice.spring,0,0,0,0,0,0,0,0
sitewhere_sitewhere,com.sitewhere.microservice.state,0,0,0,0,1,0,0,1
sitewhere_sitewhere,com.sitewhere.microservice.tenant.persistence,0,0,0,0,0,0,0,0
sitewhere_sitewhere,com.sitewhere.microservice.zookeeper,0,0,0,0,0,0,0,0
sitewhere_sitewhere,com.sitewhere.mongodb.common,0,0,0,0,0,0,0,0
sitewhere_sitewhere,com.sitewhere.mongodb,0,1,0,0,1,0,0,2
sitewhere_sitewhere,com.sitewhere.solr,0,0,0,0,0,0,0,0
sjamesr_jfreesane,au.com.southsky.jfreesane,0,0,0,1,0,0,0,1
skroutz_elasticsearch-analysis-turkishstemmer,org.elasticsearch.index.analysis.stemmer.turkish.states,0,0,0,0,0,0,0,0
skroutz_elasticsearch-analysis-turkishstemmer,org.elasticsearch.index.analysis.stemmer.turkish.suffixes,0,0,0,0,0,0,0,0
skroutz_elasticsearch-analysis-turkishstemmer,org.elasticsearch.index.analysis.stemmer.turkish.transitions,0,0,0,0,0,0,0,0
skroutz_elasticsearch-analysis-turkishstemmer,org.elasticsearch.index.analysis,0,0,0,0,1,0,0,1
skroutz_elasticsearch-analysis-turkishstemmer,org.elasticsearch.plugin.analysis.turkishstemmer,0,0,0,0,0,0,0,0
smola_galimatias,io.mola.galimatias.canonicalize,0,0,0,0,0,0,0,0
smola_galimatias,io.mola.galimatias.cli,0,0,0,0,0,0,0,0
smola_galimatias,io.mola.galimatias,0,0,0,1,0,0,0,1
smola_galimatias,io.mola.galimatias.theories,0,0,0,0,0,0,0,0
snazy_ohc,org.caffinitas.ohc.benchmark,0,0,0,0,1,0,0,1
snazy_ohc,org.caffinitas.ohc.benchmark.distribution,0,0,0,0,1,0,0,1
snazy_ohc,org.caffinitas.ohc.alloc,0,0,0,0,0,0,0,0
snazy_ohc,org.caffinitas.ohc,2,1,0,0,1,1,0,5
snazy_ohc,org.caffinitas.ohc.chunked,1,0,0,1,0,1,0,3
snazy_ohc,org.caffinitas.ohc.histo,0,0,0,0,0,1,0,1
snazy_ohc,org.caffinitas.ohc.linked,1,0,0,1,0,0,0,2
snazy_ohc,org.caffinitas.ohc.jmh,0,0,0,0,1,0,0,1
snazy_ohc,org.caffinitas.ohc.jmh.generated,0,0,0,1,0,0,0,1
sockeqwe_fragmentargs,com.hannesdorfmann.fragmentargs.bundler,0,0,0,0,0,0,0,0
sockeqwe_fragmentargs,com.hannesdorfmann.fragmentargs,0,0,0,0,0,0,0,0
sockeqwe_fragmentargs,com.hannesdorfmann.fragmentargs.processor,0,0,0,0,1,0,0,1
sockeqwe_fragmentargs,com.hannesdorfmann.fragmentargs.repacked.com.squareup.javawriter,0,0,0,0,0,0,0,0
socketIo4Netty_socketIo4j,io.scalecube.socketio,0,0,0,0,1,0,0,1
socketIo4Netty_socketIo4j,io.scalecube.socketio.packets,0,0,0,0,1,0,0,1
socketIo4Netty_socketIo4j,io.scalecube.socketio.pipeline,0,0,0,0,1,0,0,1
socketIo4Netty_socketIo4j,io.scalecube.socketio.serialization,0,0,0,0,0,0,0,0
socketIo4Netty_socketIo4j,io.scalecube.socketio.session,0,0,0,0,1,0,0,1
softlayer_softlayer-java,com.softlayer.api.example,0,0,0,0,0,2,1,3
softlayer_softlayer-java,com.softlayer.api.gen,0,0,0,0,0,0,1,1
softlayer_softlayer-java,com.softlayer.api,2,1,0,0,1,2,1,7
softlayer_softlayer-java,com.softlayer.api.http,1,1,0,0,0,2,1,5
softlayer_softlayer-java,com.softlayer.api.json,1,0,0,0,1,1,1,4
softlayer_softlayer-java,com.softlayer.api.service.abuse.lockdown,0,0,0,0,0,0,1,1
softlayer_softlayer-java,com.softlayer.api.service.account,88,1,0,1,1,0,1,92
softlayer_softlayer-java,com.softlayer.api.service.account.address,2,0,0,0,0,0,1,3
softlayer_softlayer-java,com.softlayer.api.service.account.agreement,2,0,0,0,0,0,1,3
softlayer_softlayer-java,com.softlayer.api.service.account.attachment.employee,1,0,0,0,0,0,1,2
softlayer_softlayer-java,com.softlayer.api.service.account.attachment,3,0,0,0,0,0,1,4
softlayer_softlayer-java,com.softlayer.api.service.account.attribute,2,0,0,0,0,0,1,3
softlayer_softlayer-java,com.softlayer.api.service.account.authentication.attribute,1,0,0,0,0,0,1,2
softlayer_softlayer-java,com.softlayer.api.service.account.authentication,2,0,0,0,0,0,1,3
softlayer_softlayer-java,com.softlayer.api.service.account.authentication.openidconnect,0,0,0,0,0,0,1,1
softlayer_softlayer-java,com.softlayer.api.service.account.business,2,0,0,0,0,0,1,3
softlayer_softlayer-java,com.softlayer.api.service.account.classification.group,0,0,0,0,0,0,1,1
softlayer_softlayer-java,com.softlayer.api.service.account.contact,2,0,0,0,0,0,1,3
softlayer_softlayer-java,com.softlayer.api.service.account.external,2,0,0,0,0,0,1,3
softlayer_softlayer-java,com.softlayer.api.service.account.historical,0,0,0,0,0,0,1,1
softlayer_softlayer-java,com.softlayer.api.service.account.internal,0,0,0,0,0,0,1,1
softlayer_softlayer-java,com.softlayer.api.service.account.link,3,0,0,0,1,0,1,5
softlayer_softlayer-java,com.softlayer.api.service.account.link.openstack,0,0,0,0,1,0,1,2
softlayer_softlayer-java,com.softlayer.api.service.account.lockdown,0,0,0,0,0,0,1,1
softlayer_softlayer-java,com.softlayer.api.service.account.media.data.transfer.request,2,0,0,0,0,0,1,3
softlayer_softlayer-java,com.softlayer.api.service.account.media.data.transfer,4,0,0,0,0,0,1,5
softlayer_softlayer-java,com.softlayer.api.service.account.media,2,0,0,0,0,0,1,3
softlayer_softlayer-java,com.softlayer.api.service.account.network.vlan,1,0,0,0,0,0,1,2
softlayer_softlayer-java,com.softlayer.api.service.account.note,3,0,0,0,0,0,1,4
softlayer_softlayer-java,com.softlayer.api.service.account.partner.referral,0,0,0,0,0,0,1,1
softlayer_softlayer-java,com.softlayer.api.service.account.password,2,0,0,0,0,0,1,3
softlayer_softlayer-java,com.softlayer.api.service.account.personaldata,0,0,0,0,0,0,1,1
softlayer_softlayer-java,com.softlayer.api.service.account.proofofconcept.approver,1,1,0,0,1,0,1,4
softlayer_softlayer-java,com.softlayer.api.service.account.proofofconcept,1,0,0,0,0,0,1,2
softlayer_softlayer-java,com.softlayer.api.service.account.proofofconcept.funding,0,0,0,0,0,0,1,1
softlayer_softlayer-java,com.softlayer.api.service.account.regional.registry.detail.property,2,0,0,0,0,0,1,3
softlayer_softlayer-java,com.softlayer.api.service.account.regional.registry.detail,5,0,0,0,1,0,1,7
softlayer_softlayer-java,com.softlayer.api.service.account.regional.registry.detail.version4.person,0,0,0,0,0,0,1,1
softlayer_softlayer-java,com.softlayer.api.service.account.regional.registry,8,1,0,0,0,0,1,10
softlayer_softlayer-java,com.softlayer.api.service.account.reports,0,0,0,0,0,0,1,1
softlayer_softlayer-java,com.softlayer.api.service.account.rwhois,2,0,0,0,0,0,1,3
softlayer_softlayer-java,com.softlayer.api.service.account.shipment.item,2,0,0,0,0,0,1,3
softlayer_softlayer-java,com.softlayer.api.service.account.shipment,5,0,0,0,1,0,1,7
softlayer_softlayer-java,com.softlayer.api.service.account.shipment.resource,0,0,0,0,0,0,1,1
softlayer_softlayer-java,com.softlayer.api.service.account.shipment.tracking,3,0,0,0,0,0,1,4
softlayer_softlayer-java,com.softlayer.api.service,579,1,0,2,0,1,1,584
softlayer_softlayer-java,com.softlayer.api.service.auxiliary.marketing,0,0,0,0,0,0,1,1
softlayer_softlayer-java,com.softlayer.api.service.auxiliary.network,0,0,0,0,0,0,1,1
softlayer_softlayer-java,com.softlayer.api.service.auxiliary.notification.emergency,0,0,0,0,0,0,1,1
softlayer_softlayer-java,com.softlayer.api.service.auxiliary.notification,0,0,0,0,0,0,1,1
softlayer_softlayer-java,com.softlayer.api.service.auxiliary.press.release.about.press,1,0,0,0,0,0,1,2
softlayer_softlayer-java,com.softlayer.api.service.auxiliary.press.release,0,0,0,0,1,0,1,2
softlayer_softlayer-java,com.softlayer.api.service.auxiliary.press.release.contact.press,1,0,0,0,0,0,1,2
softlayer_softlayer-java,com.softlayer.api.service.auxiliary.press.release.media.partner.press,1,0,0,0,0,0,1,2
softlayer_softlayer-java,com.softlayer.api.service.auxiliary.press.release.media,0,0,0,0,0,0,1,1
softlayer_softlayer-java,com.softlayer.api.service.auxiliary.press,3,1,0,0,0,0,1,5
softlayer_softlayer-java,com.softlayer.api.service.auxiliary.shipping.courier,0,0,0,0,0,0,1,1
softlayer_softlayer-java,com.softlayer.api.service.auxiliary.shipping,2,0,0,0,0,0,1,3
softlayer_softlayer-java,com.softlayer.api.service.billing.currency,3,0,0,0,1,0,1,5
softlayer_softlayer-java,com.softlayer.api.service.billing,86,1,0,0,0,0,1,88
softlayer_softlayer-java,com.softlayer.api.service.billing.info,2,0,0,0,0,0,1,3
softlayer_softlayer-java,com.softlayer.api.service.billing.invoice.item,0,0,0,0,0,0,1,1
softlayer_softlayer-java,com.softlayer.api.service.billing.invoice.item.tax,4,0,0,0,0,0,1,5
softlayer_softlayer-java,com.softlayer.api.service.billing.invoice,2,0,0,0,1,0,1,4
softlayer_softlayer-java,com.softlayer.api.service.billing.invoice.receivable,3,0,0,0,0,0,1,4
softlayer_softlayer-java,com.softlayer.api.service.billing.invoice.tax,7,1,0,0,1,0,1,10
softlayer_softlayer-java,com.softlayer.api.service.billing.item.account.media.data.transfer,0,0,0,0,0,0,1,1
softlayer_softlayer-java,com.softlayer.api.service.billing.item.association,3,0,0,0,0,0,1,4
softlayer_softlayer-java,com.softlayer.api.service.billing.item.cancellation.reason,3,0,0,0,0,0,1,4
softlayer_softlayer-java,com.softlayer.api.service.billing.item.cancellation,5,1,0,0,1,0,1,8
softlayer_softlayer-java,com.softlayer.api.service.billing.item.cancellation.request,3,1,0,0,0,0,1,5
softlayer_softlayer-java,com.softlayer.api.service.billing.item.ctc,0,0,0,0,0,0,1,1
softlayer_softlayer-java,com.softlayer.api.service.billing.item.gateway.appliance,0,0,0,0,0,0,1,1
softlayer_softlayer-java,com.softlayer.api.service.billing.item.hardware,0,0,0,0,1,0,1,2
softlayer_softlayer-java,com.softlayer.api.service.billing.item.hardware.security,0,0,0,0,0,0,1,1
softlayer_softlayer-java,com.softlayer.api.service.billing.item,2,1,0,0,1,0,1,5
softlayer_softlayer-java,com.softlayer.api.service.billing.item.link,0,0,0,0,0,0,1,1
softlayer_softlayer-java,com.softlayer.api.service.billing.item.network.application.delivery.controller.loadbalancer,0,0,0,0,0,0,1,1
softlayer_softlayer-java,com.softlayer.api.service.billing.item.network.application.delivery,3,0,0,0,0,0,1,4
softlayer_softlayer-java,com.softlayer.api.service.billing.item.network,8,1,0,0,1,0,1,11
softlayer_softlayer-java,com.softlayer.api.service.billing.item.network.firewall.module,0,0,0,0,0,0,1,1
softlayer_softlayer-java,com.softlayer.api.service.billing.item.network.loadbalancer,0,0,0,0,0,0,1,1
softlayer_softlayer-java,com.softlayer.api.service.billing.item.network.message,0,0,0,0,0,0,1,1
softlayer_softlayer-java,com.softlayer.api.service.billing.item.network.performancestorage,0,0,0,0,0,0,1,1
softlayer_softlayer-java,com.softlayer.api.service.billing.item.network.storage.hub,0,0,0,0,0,0,1,1
softlayer_softlayer-java,com.softlayer.api.service.billing.item.network.storage,0,0,0,0,0,0,1,1
softlayer_softlayer-java,com.softlayer.api.service.billing.item.network.subnet.ipaddress,2,0,0,0,0,0,1,3
softlayer_softlayer-java,com.softlayer.api.service.billing.item.priv,0,0,0,0,0,0,1,1
softlayer_softlayer-java,com.softlayer.api.service.billing.item.software.component.analytics,0,0,0,0,0,0,1,1
softlayer_softlayer-java,com.softlayer.api.service.billing.item.software.component.controlpanel.parallels.plesk,0,0,0,0,0,0,1,1
softlayer_softlayer-java,com.softlayer.api.service.billing.item.software.component,0,0,0,0,0,0,1,1
softlayer_softlayer-java,com.softlayer.api.service.billing.item.software.component.operatingsystem.addon.citrix,0,0,0,0,0,0,1,1
softlayer_softlayer-java,com.softlayer.api.service.billing.item.software.component.operatingsystem,0,0,0,0,0,0,1,1
softlayer_softlayer-java,com.softlayer.api.service.billing.item.software.component.virtual.operatingsystem,0,0,0,0,0,0,1,1
softlayer_softlayer-java,com.softlayer.api.service.billing.item.software.component.virtual,0,0,0,0,0,0,1,1
softlayer_softlayer-java,com.softlayer.api.service.billing.item.software,0,0,0,0,0,0,1,1
softlayer_softlayer-java,com.softlayer.api.service.billing.item.user.customer.external,0,0,0,0,0,0,1,1
softlayer_softlayer-java,com.softlayer.api.service.billing.item.virtual.dedicated,0,0,0,0,0,0,1,1
softlayer_softlayer-java,com.softlayer.api.service.billing.item.virtual,2,0,0,0,1,0,1,4
softlayer_softlayer-java,com.softlayer.api.service.billing.item.virtual.disk,3,0,0,0,0,0,1,4
softlayer_softlayer-java,com.softlayer.api.service.billing.item.virtual.host,0,0,0,0,0,0,1,1
softlayer_softlayer-java,com.softlayer.api.service.billing.order,15,1,0,0,1,0,1,18
softlayer_softlayer-java,com.softlayer.api.service.billing.order.item.category,3,0,0,0,0,0,1,4
softlayer_softlayer-java,com.softlayer.api.service.billing.payment.card,10,0,0,0,1,0,1,12
softlayer_softlayer-java,com.softlayer.api.service.billing.payment.paypal,4,0,0,0,0,0,1,5
softlayer_softlayer-java,com.softlayer.api.service.billing.payment.processor,3,0,0,0,0,0,1,4
softlayer_softlayer-java,com.softlayer.api.service.billing.payment,10,1,0,0,1,0,1,13
softlayer_softlayer-java,com.softlayer.api.service.bluepages.container,0,0,0,0,0,0,1,1
softlayer_softlayer-java,com.softlayer.api.service.bluepages,0,0,0,0,0,0,1,1
softlayer_softlayer-java,com.softlayer.api.service.brand,2,0,0,0,0,0,1,3
softlayer_softlayer-java,com.softlayer.api.service.brand.business,2,0,0,0,0,0,1,3
softlayer_softlayer-java,com.softlayer.api.service.brand.contact,1,0,0,0,0,0,1,2
softlayer_softlayer-java,com.softlayer.api.service.brand.payment,3,0,0,0,0,0,1,4
softlayer_softlayer-java,com.softlayer.api.service.brand.restriction.location,2,0,0,0,0,0,1,3
softlayer_softlayer-java,com.softlayer.api.service.business.partner,2,0,0,0,1,0,1,4
softlayer_softlayer-java,com.softlayer.api.service.catalyst,2,0,0,0,0,0,1,3
softlayer_softlayer-java,com.softlayer.api.service.catalyst.company,1,0,0,0,0,0,1,2
softlayer_softlayer-java,com.softlayer.api.service.catalyst.enrollment.request.container,0,0,0,0,0,0,1,1
softlayer_softlayer-java,com.softlayer.api.service.catalyst.enrollment,0,0,0,0,0,0,1,1
softlayer_softlayer-java,com.softlayer.api.service.compliance.report,0,0,0,0,0,0,1,1
softlayer_softlayer-java,com.softlayer.api.service.configuration.storage.filesystem,2,0,0,0,0,0,1,3
softlayer_softlayer-java,com.softlayer.api.service.configuration.storage.group.array,3,1,0,0,0,0,1,5
softlayer_softlayer-java,com.softlayer.api.service.configuration.storage.group,4,0,0,0,0,0,1,5
softlayer_softlayer-java,com.softlayer.api.service.configuration.storage.group.template,2,0,0,0,0,0,1,3
softlayer_softlayer-java,com.softlayer.api.service.configuration.template,5,1,0,0,1,0,1,8
softlayer_softlayer-java,com.softlayer.api.service.configuration.template.section,6,1,0,0,1,0,1,9
softlayer_softlayer-java,com.softlayer.api.service.configuration.template.section.definition.attribute,1,0,0,0,0,0,1,2
softlayer_softlayer-java,com.softlayer.api.service.configuration.template.section.definition,5,0,0,0,1,0,1,7
softlayer_softlayer-java,com.softlayer.api.service.configuration,15,1,0,0,0,0,1,17
softlayer_softlayer-java,com.softlayer.api.service.container.account.authentication.openidconnect,0,0,0,0,0,0,1,1
softlayer_softlayer-java,com.softlayer.api.service.container.account.discount.program,0,0,0,0,0,0,1,1
softlayer_softlayer-java,com.softlayer.api.service.container.account.discount,0,0,0,0,0,0,1,1
softlayer_softlayer-java,com.softlayer.api.service.container.account.external.setup.provisioningholdlifted,0,0,0,0,0,0,1,1
softlayer_softlayer-java,com.softlayer.api.service.container.account.external.setup,0,0,0,0,0,0,1,1
softlayer_softlayer-java,com.softlayer.api.service.container.account.graph,0,0,0,0,0,0,1,1
softlayer_softlayer-java,com.softlayer.api.service.container.account.historical.summary.detail,0,0,0,0,0,0,1,1
softlayer_softlayer-java,com.softlayer.api.service.container.account.historical.summary,1,1,0,0,0,0,1,3
softlayer_softlayer-java,com.softlayer.api.service.container.account.historical,1,0,0,0,0,0,1,2
softlayer_softlayer-java,com.softlayer.api.service.container.account.internal.ibm,0,0,0,0,0,0,1,1
softlayer_softlayer-java,com.softlayer.api.service.container.account.payment.method,0,0,0,0,0,0,1,1
softlayer_softlayer-java,com.softlayer.api.service.container.account,0,0,0,0,0,0,1,1
softlayer_softlayer-java,com.softlayer.api.service.container.account.proofofconcept.contact,0,0,0,0,0,0,1,1
softlayer_softlayer-java,com.softlayer.api.service.container.account.proofofconcept.contact.ibmer,0,0,0,0,0,0,1,1
softlayer_softlayer-java,com.softlayer.api.service.container.account.proofofconcept.request,0,0,0,0,1,0,1,2
softlayer_softlayer-java,com.softlayer.api.service.container.account.proofofconcept.review,0,0,0,0,1,0,1,2
softlayer_softlayer-java,com.softlayer.api.service.container.account.proofofconcept,0,0,0,0,0,0,1,1
softlayer_softlayer-java,com.softlayer.api.service.container.account.update,0,0,0,0,0,0,1,1
softlayer_softlayer-java,com.softlayer.api.service.container.authentication.request,0,0,0,0,1,0,1,2
softlayer_softlayer-java,com.softlayer.api.service.container.authentication.request.nat.external,0,0,0,0,0,0,1,1
softlayer_softlayer-java,com.softlayer.api.service.container.authentication.request.nat,0,0,0,0,0,0,1,1
softlayer_softlayer-java,com.softlayer.api.service.container.authentication.request.openidconnect.external,0,0,0,0,0,0,1,1
softlayer_softlayer-java,com.softlayer.api.service.container.authentication.request.openidconnect,0,0,0,0,0,0,1,1
softlayer_softlayer-java,com.softlayer.api.service.container.authentication.response,0,0,0,0,0,0,1,1
softlayer_softlayer-java,com.softlayer.api.service.container.auxiliary.network.status,0,0,0,0,0,0,1,1
softlayer_softlayer-java,com.softlayer.api.service.container.bandwidth,0,0,0,0,1,0,1,2
softlayer_softlayer-java,com.softlayer.api.service.container.billing.currency,0,0,0,0,0,0,1,1
softlayer_softlayer-java,com.softlayer.api.service.container.billing.info,0,0,0,0,0,0,1,1
softlayer_softlayer-java,com.softlayer.api.service.container.billing.invoice,0,0,0,0,0,0,1,1
softlayer_softlayer-java,com.softlayer.api.service.container.billing.order,0,0,0,0,0,0,1,1
softlayer_softlayer-java,com.softlayer.api.service.container.catalyst,0,0,0,0,0,0,1,1
softlayer_softlayer-java,com.softlayer.api.service.container.collection.locale,0,0,0,0,1,0,1,2
softlayer_softlayer-java,com.softlayer.api.service.container.disk.image.capture.template.volume,0,0,0,0,0,0,1,1
softlayer_softlayer-java,com.softlayer.api.service.container.disk.image.capture.template,0,0,0,0,0,0,1,1
softlayer_softlayer-java,com.softlayer.api.service.container.disk.image.capture,0,0,0,0,0,0,1,1
softlayer_softlayer-java,com.softlayer.api.service.container.dns.domain.registration,0,0,0,0,1,0,1,2
softlayer_softlayer-java,com.softlayer.api.service.container.dns.domain.registration.extendedattribute,0,0,0,0,0,0,1,1
softlayer_softlayer-java,com.softlayer.api.service.container.dns.domain.registration.extendedattribute.option,0,0,0,0,0,0,1,1
softlayer_softlayer-java,com.softlayer.api.service.container.dns.domain.registration.lookup,0,0,0,0,0,0,1,1
softlayer_softlayer-java,com.softlayer.api.service.container.dns.domain.registration.nameserver,0,0,0,0,0,0,1,1
softlayer_softlayer-java,com.softlayer.api.service.container.dns.domain.registration.registrant.verification,0,0,0,0,0,0,1,1
softlayer_softlayer-java,com.softlayer.api.service.container.dns.domain.registration.transfer,0,0,0,0,0,0,1,1
softlayer_softlayer-java,com.softlayer.api.service.container,0,0,0,0,1,0,1,2
softlayer_softlayer-java,com.softlayer.api.service.container.graph,0,0,0,0,0,0,1,1
softlayer_softlayer-java,com.softlayer.api.service.container.graph.plot,0,0,0,0,0,0,1,1
softlayer_softlayer-java,com.softlayer.api.service.container.hardware.configuration,0,0,0,0,0,0,1,1
softlayer_softlayer-java,com.softlayer.api.service.container.hardware,0,0,0,0,0,0,1,1
softlayer_softlayer-java,com.softlayer.api.service.container.hardware.pool.details,0,0,0,0,0,0,1,1
softlayer_softlayer-java,com.softlayer.api.service.container.hardware.pool,0,0,0,0,0,0,1,1
softlayer_softlayer-java,com.softlayer.api.service.container.hardware.server,0,0,0,0,1,0,1,2
softlayer_softlayer-java,com.softlayer.api.service.container.knowledgelayer,0,0,0,0,0,0,1,1
softlayer_softlayer-java,com.softlayer.api.service.container.metric.data,2,0,0,0,0,0,1,3
softlayer_softlayer-java,com.softlayer.api.service.container.metric.tracking.object,0,0,0,0,0,0,1,1
softlayer_softlayer-java,com.softlayer.api.service.container.metric.tracking.object.virtual.host,0,0,0,0,0,0,1,1
softlayer_softlayer-java,com.softlayer.api.service.container.monitoring.alarm,0,0,0,0,0,0,1,1
softlayer_softlayer-java,com.softlayer.api.service.container.monitoring.graph,0,0,0,0,0,0,1,1
softlayer_softlayer-java,com.softlayer.api.service.container.network.authentication,0,0,0,0,0,0,1,1
softlayer_softlayer-java,com.softlayer.api.service.container.network.bandwidth.data,0,0,0,0,0,0,1,1
softlayer_softlayer-java,com.softlayer.api.service.container.network.bandwidth.version1,0,0,0,0,0,0,1,1
softlayer_softlayer-java,com.softlayer.api.service.container.network.cdnmarketplace.configuration.cache,0,0,0,0,0,0,1,1
softlayer_softlayer-java,com.softlayer.api.service.container.network.cdnmarketplace.configuration,0,0,0,0,0,0,1,1
softlayer_softlayer-java,com.softlayer.api.service.container.network.cdnmarketplace.configuration.mapping,0,0,0,0,0,0,1,1
softlayer_softlayer-java,com.softlayer.api.service.container.network.cdnmarketplace.configuration.performance,0,0,0,0,0,0,1,1
softlayer_softlayer-java,com.softlayer.api.service.container.network.cdnmarketplace,0,0,0,0,0,0,1,1
softlayer_softlayer-java,com.softlayer.api.service.container.network.directory,0,0,0,0,0,0,1,1
softlayer_softlayer-java,com.softlayer.api.service.container.network.loadbalancer,0,0,0,0,0,0,1,1
softlayer_softlayer-java,com.softlayer.api.service.container.network.media,0,0,0,0,0,0,1,1
softlayer_softlayer-java,com.softlayer.api.service.container.network.media.transcode.job.watermark,1,0,0,0,0,0,1,2
softlayer_softlayer-java,com.softlayer.api.service.container.network.media.transcode.job,2,0,0,0,0,0,1,3
softlayer_softlayer-java,com.softlayer.api.service.container.network.media.transcode.preset.element,0,0,0,0,0,0,1,1
softlayer_softlayer-java,com.softlayer.api.service.container.network.media.transcode.preset,0,0,0,0,0,0,1,1
softlayer_softlayer-java,com.softlayer.api.service.container.network.media.transcode,0,0,0,0,0,0,1,1
softlayer_softlayer-java,com.softlayer.api.service.container.network.message.delivery.email.sendgrid.account,0,0,0,0,0,0,1,1
softlayer_softlayer-java,com.softlayer.api.service.container.network.message.delivery.email.sendgrid.customer,0,0,0,0,0,0,1,1
softlayer_softlayer-java,com.softlayer.api.service.container.network.message.delivery.email.sendgrid.list,0,0,0,0,0,0,1,1
softlayer_softlayer-java,com.softlayer.api.service.container.network.message.delivery.email.sendgrid.statistics,0,0,0,0,0,0,1,1
softlayer_softlayer-java,com.softlayer.api.service.container.network.message.delivery.email.sendgrid,0,0,0,0,0,0,1,1
softlayer_softlayer-java,com.softlayer.api.service.container.network.message.delivery,0,0,0,0,0,0,1,1
softlayer_softlayer-java,com.softlayer.api.service.container.network.port,0,0,0,0,0,0,1,1
softlayer_softlayer-java,com.softlayer.api.service.container.network.securitygroup,0,0,0,0,0,0,1,1
softlayer_softlayer-java,com.softlayer.api.service.container.network.service.resource.objectstorage,0,0,0,0,0,0,1,1
softlayer_softlayer-java,com.softlayer.api.service.container.network.storage.backup.evault.webcc.authentication,0,0,0,0,0,0,1,1
softlayer_softlayer-java,com.softlayer.api.service.container.network.storage.evault.vault,0,0,0,0,0,0,1,1
softlayer_softlayer-java,com.softlayer.api.service.container.network.storage.evault.webcc,0,0,0,0,1,0,1,2
softlayer_softlayer-java,com.softlayer.api.service.container.network.storage,0,0,0,0,1,0,1,2
softlayer_softlayer-java,com.softlayer.api.service.container.network.storage.hub.objectstorage,0,0,0,0,1,0,1,2
softlayer_softlayer-java,com.softlayer.api.service.container.network.storage.massdatamigration.request,0,0,0,0,0,0,1,1
softlayer_softlayer-java,com.softlayer.api.service.container.network.subnet,0,0,0,0,0,0,1,1
softlayer_softlayer-java,com.softlayer.api.service.container.network.subnet.registration,0,0,0,0,0,0,1,1
softlayer_softlayer-java,com.softlayer.api.service.container.notification.mass.filter,0,0,0,0,0,0,1,1
softlayer_softlayer-java,com.softlayer.api.service.container.policy,0,0,0,0,0,0,1,1
softlayer_softlayer-java,com.softlayer.api.service.container.product.item.category.question,0,0,0,0,0,0,1,1
softlayer_softlayer-java,com.softlayer.api.service.container.product.item.category.zerofee,0,0,0,0,0,0,1,1
softlayer_softlayer-java,com.softlayer.api.service.container.product.item,0,0,0,0,0,0,1,1
softlayer_softlayer-java,com.softlayer.api.service.container.product.item.discount,0,0,0,0,0,0,1,1
softlayer_softlayer-java,com.softlayer.api.service.container.product.order.account.media.data.transfer,0,0,0,0,0,0,1,1
softlayer_softlayer-java,com.softlayer.api.service.container.product.order.attribute,0,0,0,0,1,0,1,2
softlayer_softlayer-java,com.softlayer.api.service.container.product.order.billing,0,0,0,0,0,0,1,1
softlayer_softlayer-java,com.softlayer.api.service.container.product.order.dns.domain,0,0,0,0,0,0,1,1
softlayer_softlayer-java,com.softlayer.api.service.container.product.order.gateway.appliance,0,0,0,0,0,0,1,1
softlayer_softlayer-java,com.softlayer.api.service.container.product.order.hardware.security,0,0,0,0,0,0,1,1
softlayer_softlayer-java,com.softlayer.api.service.container.product.order.hardware.server,0,0,0,0,1,0,1,2
softlayer_softlayer-java,com.softlayer.api.service.container.product.order.hardware.server.gateway,0,0,0,0,0,0,1,1
softlayer_softlayer-java,com.softlayer.api.service.container.product.order.hardware,0,1,0,0,0,0,1,2
softlayer_softlayer-java,com.softlayer.api.service.container.product.order.monitoring,0,0,0,0,0,0,1,1
softlayer_softlayer-java,com.softlayer.api.service.container.product.order.multiconfiguration,0,0,0,0,0,0,1,1
softlayer_softlayer-java,com.softlayer.api.service.container.product.order,1,0,0,0,1,0,1,3
softlayer_softlayer-java,com.softlayer.api.service.container.product.order.network.application.delivery,0,0,0,0,0,0,1,1
softlayer_softlayer-java,com.softlayer.api.service.container.product.order.network.interconnect,0,0,0,0,0,0,1,1
softlayer_softlayer-java,com.softlayer.api.service.container.product.order.network,0,0,0,0,1,0,1,2
softlayer_softlayer-java,com.softlayer.api.service.container.product.order.network.loadbalancer,0,0,0,0,0,0,1,1
softlayer_softlayer-java,com.softlayer.api.service.container.product.order.network.message,0,0,0,0,0,0,1,1
softlayer_softlayer-java,com.softlayer.api.service.container.product.order.network.performancestorage,0,0,0,0,0,0,1,1
softlayer_softlayer-java,com.softlayer.api.service.container.product.order.network.protection.firewall.dedicated,0,0,0,0,0,0,1,1
softlayer_softlayer-java,com.softlayer.api.service.container.product.order.network.protection.firewall,0,0,0,0,0,0,1,1
softlayer_softlayer-java,com.softlayer.api.service.container.product.order.network.protection,0,0,0,0,0,0,1,1
softlayer_softlayer-java,com.softlayer.api.service.container.product.order.network.storage.asaservice,0,0,0,0,0,0,1,1
softlayer_softlayer-java,com.softlayer.api.service.container.product.order.network.storage,0,0,0,0,1,0,1,2
softlayer_softlayer-java,com.softlayer.api.service.container.product.order.network.storage.backup.evault,0,0,0,0,0,0,1,1
softlayer_softlayer-java,com.softlayer.api.service.container.product.order.network.storage.enterprise.snapshotspace,0,0,0,0,0,0,1,1
softlayer_softlayer-java,com.softlayer.api.service.container.product.order.network.storage.enterprise,0,0,0,0,0,0,1,1
softlayer_softlayer-java,com.softlayer.api.service.container.product.order.network.storage.hub,0,0,0,0,0,0,1,1
softlayer_softlayer-java,com.softlayer.api.service.container.product.order.network.storage.iscsi,0,0,0,0,0,0,1,1
softlayer_softlayer-java,com.softlayer.api.service.container.product.order.network.storage.massdatamigration,0,0,0,0,0,0,1,1
softlayer_softlayer-java,com.softlayer.api.service.container.product.order.network.storage.objectstorage,0,0,0,0,0,0,1,1
softlayer_softlayer-java,com.softlayer.api.service.container.product.order.network.tunnel,0,0,0,0,0,0,1,1
softlayer_softlayer-java,com.softlayer.api.service.container.product.order.priv,0,0,0,0,0,0,1,1
softlayer_softlayer-java,com.softlayer.api.service.container.product.order.security,0,0,0,0,0,0,1,1
softlayer_softlayer-java,com.softlayer.api.service.container.product.order.service,0,0,0,0,0,0,1,1
softlayer_softlayer-java,com.softlayer.api.service.container.product.order.software.component,0,0,0,0,0,0,1,1
softlayer_softlayer-java,com.softlayer.api.service.container.product.order.software,0,0,0,0,0,0,1,1
softlayer_softlayer-java,com.softlayer.api.service.container.product.order.storage.group,0,0,0,0,0,0,1,1
softlayer_softlayer-java,com.softlayer.api.service.container.product.order.storage,0,0,0,0,0,0,1,1
softlayer_softlayer-java,com.softlayer.api.service.container.product.order.user.customer.external,0,0,0,0,0,0,1,1
softlayer_softlayer-java,com.softlayer.api.service.container.product.order.virtual,0,0,0,0,1,0,1,2
softlayer_softlayer-java,com.softlayer.api.service.container.product.order.virtual.disk,0,0,0,0,0,0,1,1
softlayer_softlayer-java,com.softlayer.api.service.container.product.order.virtual.guest,1,0,0,0,0,0,1,2
softlayer_softlayer-java,com.softlayer.api.service.container.product.order.virtual.guest.vpc,1,1,0,0,1,0,1,4
softlayer_softlayer-java,com.softlayer.api.service.container.product.order.vpc,0,0,0,0,0,0,1,1
softlayer_softlayer-java,com.softlayer.api.service.container.product,1,1,0,0,0,0,1,3
softlayer_softlayer-java,com.softlayer.api.service.container.product.promotion,0,0,0,0,0,0,1,1
softlayer_softlayer-java,com.softlayer.api.service.container.provisioning.maintenance,0,0,0,0,0,0,1,1
softlayer_softlayer-java,com.softlayer.api.service.container.referral.partner,0,0,0,0,0,0,1,1
softlayer_softlayer-java,com.softlayer.api.service.container.referral.partner.payment,0,0,0,0,0,0,1,1
softlayer_softlayer-java,com.softlayer.api.service.container.remotemanagement.graphs,0,0,0,0,0,0,1,1
softlayer_softlayer-java,com.softlayer.api.service.container.remotemanagement,0,0,0,0,1,0,1,2
softlayer_softlayer-java,com.softlayer.api.service.container.resource.metadata,0,0,0,0,0,0,1,1
softlayer_softlayer-java,com.softlayer.api.service.container.search.objecttype,0,0,0,0,0,0,1,1
softlayer_softlayer-java,com.softlayer.api.service.container.search,0,0,0,0,0,0,1,1
softlayer_softlayer-java,com.softlayer.api.service.container.software.component.hostips,0,0,0,0,0,0,1,1
softlayer_softlayer-java,com.softlayer.api.service.container.tax.cache,1,0,0,0,0,0,1,2
softlayer_softlayer-java,com.softlayer.api.service.container.tax,1,0,0,0,0,0,1,2
softlayer_softlayer-java,com.softlayer.api.service.container.ticket,0,0,0,0,1,0,1,2
softlayer_softlayer-java,com.softlayer.api.service.container.ticket.survey,0,0,0,0,0,0,1,1
softlayer_softlayer-java,com.softlayer.api.service.container.user.authentication,3,0,0,0,0,0,1,4
softlayer_softlayer-java,com.softlayer.api.service.container.user.customer.external.binding.phone,0,0,0,0,0,0,1,1
softlayer_softlayer-java,com.softlayer.api.service.container.user.customer.external.binding,0,0,0,0,1,0,1,2
softlayer_softlayer-java,com.softlayer.api.service.container.user.customer.external,0,0,0,0,0,0,1,1
softlayer_softlayer-java,com.softlayer.api.service.container.user.customer.openidconnect,0,0,0,0,0,0,1,1
softlayer_softlayer-java,com.softlayer.api.service.container.user.customer,0,0,0,0,0,0,1,1
softlayer_softlayer-java,com.softlayer.api.service.container.user.customer.portal,0,0,0,0,0,0,1,1
softlayer_softlayer-java,com.softlayer.api.service.container.user.customer.profile.event.hyperwarp.profilechange,0,0,0,0,0,0,1,1
softlayer_softlayer-java,com.softlayer.api.service.container.user.customer.profile.event.hyperwarp,0,0,0,0,0,0,1,1
softlayer_softlayer-java,com.softlayer.api.service.container.user.data,0,0,0,0,0,0,1,1
softlayer_softlayer-java,com.softlayer.api.service.container.user.employee.external.binding,0,0,0,0,0,0,1,1
softlayer_softlayer-java,com.softlayer.api.service.container.utility.file,0,0,0,0,0,0,1,1
softlayer_softlayer-java,com.softlayer.api.service.container.utility,0,0,0,0,0,0,1,1
softlayer_softlayer-java,com.softlayer.api.service.container.utility.microsoft.windows.updateservices,0,0,0,0,0,0,1,1
softlayer_softlayer-java,com.softlayer.api.service.container.utility.network.firewall.rule,0,0,0,0,0,0,1,1
softlayer_softlayer-java,com.softlayer.api.service.container.utility.network.subnet.mask.generic,0,0,0,0,0,0,1,1
softlayer_softlayer-java,com.softlayer.api.service.container.virtual.dedicatedhost,2,0,0,0,0,0,1,3
softlayer_softlayer-java,com.softlayer.api.service.container.virtual.dedicatedhost.pci.device,2,0,0,0,0,0,1,3
softlayer_softlayer-java,com.softlayer.api.service.container.virtual.guest.block.device.template,0,0,0,0,0,0,1,1
softlayer_softlayer-java,com.softlayer.api.service.container.virtual.guest.configuration,0,0,0,0,0,0,1,1
softlayer_softlayer-java,com.softlayer.api.service.container.virtual.guest,0,0,0,0,0,0,1,1
softlayer_softlayer-java,com.softlayer.api.service.dns.domain,8,1,0,0,1,0,1,11
softlayer_softlayer-java,com.softlayer.api.service.dns.domain.registration.registrant.verification,2,0,0,0,0,0,1,3
softlayer_softlayer-java,com.softlayer.api.service.dns.domain.registration,2,0,0,0,0,0,1,3
softlayer_softlayer-java,com.softlayer.api.service.dns.domain.resourcerecord,2,0,0,0,1,0,1,4
softlayer_softlayer-java,com.softlayer.api.service.dns.domain.reverse,0,0,0,0,0,0,1,1
softlayer_softlayer-java,com.softlayer.api.service.dns,8,1,0,0,0,0,1,10
softlayer_softlayer-java,com.softlayer.api.service.email.subscription,0,0,0,0,0,0,1,1
softlayer_softlayer-java,com.softlayer.api.service.email.subscription.suppression,0,0,0,0,0,0,1,1
softlayer_softlayer-java,com.softlayer.api.service.email,0,0,0,0,0,0,1,1
softlayer_softlayer-java,com.softlayer.api.service.event,0,0,0,0,0,0,1,1
softlayer_softlayer-java,com.softlayer.api.service.exception.brand,0,0,0,0,0,0,1,1
softlayer_softlayer-java,com.softlayer.api.service.exception.hardware.component.locator,0,0,0,0,0,0,1,1
softlayer_softlayer-java,com.softlayer.api.service.flexiblecredit,2,0,0,0,1,0,1,4
softlayer_softlayer-java,com.softlayer.api.service.flexiblecredit.company,1,0,0,0,0,0,1,2
softlayer_softlayer-java,com.softlayer.api.service.hardware.attribute,3,0,0,0,0,0,1,4
softlayer_softlayer-java,com.softlayer.api.service.hardware,11,1,0,1,1,0,1,15
softlayer_softlayer-java,com.softlayer.api.service.hardware.benchmark,1,0,0,0,0,0,1,2
softlayer_softlayer-java,com.softlayer.api.service.hardware.component.attribute,2,0,0,0,0,0,1,3
softlayer_softlayer-java,com.softlayer.api.service.hardware.component,17,1,0,1,1,0,1,21
softlayer_softlayer-java,com.softlayer.api.service.hardware.component.firmware.attribute,2,0,0,0,0,0,1,3
softlayer_softlayer-java,com.softlayer.api.service.hardware.component.firmware,5,0,0,0,0,0,1,6
softlayer_softlayer-java,com.softlayer.api.service.hardware.component.locator,0,0,0,0,0,0,1,1
softlayer_softlayer-java,com.softlayer.api.service.hardware.component.model.architecture,2,0,0,0,0,0,1,3
softlayer_softlayer-java,com.softlayer.api.service.hardware.component.model.attribute,3,1,0,0,0,0,1,5
softlayer_softlayer-java,com.softlayer.api.service.hardware.component.model,12,1,0,0,0,0,1,14
softlayer_softlayer-java,com.softlayer.api.service.hardware.component.model.generic,3,0,0,0,0,0,1,4
softlayer_softlayer-java,com.softlayer.api.service.hardware.component.motherboard.reboot,3,0,0,0,0,0,1,4
softlayer_softlayer-java,com.softlayer.api.service.hardware.component.partition,5,1,0,0,0,0,1,7
softlayer_softlayer-java,com.softlayer.api.service.hardware.component.partition.template,3,0,0,0,0,0,1,4
softlayer_softlayer-java,com.softlayer.api.service.hardware.component.remotemanagement.command,2,0,0,0,0,0,1,3
softlayer_softlayer-java,com.softlayer.api.service.hardware.component.remotemanagement,2,1,0,0,0,0,1,4
softlayer_softlayer-java,com.softlayer.api.service.hardware.component.securitydevice,0,0,0,0,0,0,1,1
softlayer_softlayer-java,com.softlayer.api.service.hardware.note,2,0,0,0,0,0,1,3
softlayer_softlayer-java,com.softlayer.api.service.hardware.power,1,0,0,0,0,0,1,2
softlayer_softlayer-java,com.softlayer.api.service.hardware.resource.configuration.property,2,0,0,0,0,0,1,3
softlayer_softlayer-java,com.softlayer.api.service.hardware.resource.configuration,4,1,0,0,0,0,1,6
softlayer_softlayer-java,com.softlayer.api.service.hardware.resource,4,0,0,0,0,0,1,5
softlayer_softlayer-java,com.softlayer.api.service.hardware.router,3,1,0,0,0,0,1,5
softlayer_softlayer-java,com.softlayer.api.service.integratedofferingteam.container.region,0,0,0,0,0,0,1,1
softlayer_softlayer-java,com.softlayer.api.service.integratedofferingteam.container,0,0,0,0,0,0,1,1
softlayer_softlayer-java,com.softlayer.api.service.integratedofferingteam,0,0,0,0,0,0,1,1
softlayer_softlayer-java,com.softlayer.api.service.layout.container,2,0,0,0,0,0,1,3
softlayer_softlayer-java,com.softlayer.api.service.layout,12,1,0,0,0,0,1,14
softlayer_softlayer-java,com.softlayer.api.service.layout.item,2,0,0,0,0,0,1,3
softlayer_softlayer-java,com.softlayer.api.service.layout.preference,2,0,0,0,0,0,1,3
softlayer_softlayer-java,com.softlayer.api.service.layout.profile,4,0,0,0,1,0,1,6
softlayer_softlayer-java,com.softlayer.api.service.legal.regulatedworkload,1,0,0,0,0,0,1,2
softlayer_softlayer-java,com.softlayer.api.service.legal,2,0,0,0,0,0,1,3
softlayer_softlayer-java,com.softlayer.api.service.locale,2,0,0,0,1,0,1,4
softlayer_softlayer-java,com.softlayer.api.service.location,12,1,0,0,1,0,1,15
softlayer_softlayer-java,com.softlayer.api.service.location.group.location,2,0,0,0,0,0,1,3
softlayer_softlayer-java,com.softlayer.api.service.location.group,4,1,0,0,1,0,1,7
softlayer_softlayer-java,com.softlayer.api.service.location.inventory,0,0,0,0,0,0,1,1
softlayer_softlayer-java,com.softlayer.api.service.location.network.operations,0,0,0,0,0,0,1,1
softlayer_softlayer-java,com.softlayer.api.service.location.region,3,0,0,0,0,0,1,4
softlayer_softlayer-java,com.softlayer.api.service.location.reservation.rack,3,1,0,0,0,0,1,5
softlayer_softlayer-java,com.softlayer.api.service.location.reservation,4,0,0,0,0,0,1,5
softlayer_softlayer-java,com.softlayer.api.service.location.server,0,0,0,0,0,0,1,1
softlayer_softlayer-java,com.softlayer.api.service.location.storage,0,0,0,0,0,0,1,1
softlayer_softlayer-java,com.softlayer.api.service.marketplace,0,0,0,0,1,0,1,2
softlayer_softlayer-java,com.softlayer.api.service.marketplace.partner.attachment,0,0,0,0,0,0,1,1
softlayer_softlayer-java,com.softlayer.api.service.marketplace.partner,0,0,0,0,0,0,1,1
softlayer_softlayer-java,com.softlayer.api.service.marketplace.partner.file,0,0,0,0,0,0,1,1
softlayer_softlayer-java,com.softlayer.api.service.mcafee.epolicy.orchestrator.version36.agent,0,0,0,0,0,0,1,1
softlayer_softlayer-java,com.softlayer.api.service.mcafee.epolicy.orchestrator.version36.agent.parent,0,0,0,0,0,0,1,1
softlayer_softlayer-java,com.softlayer.api.service.mcafee.epolicy.orchestrator.version36.antivirus.event,0,0,0,0,0,0,1,1
softlayer_softlayer-java,com.softlayer.api.service.mcafee.epolicy.orchestrator.version36.antivirus.event.filter,0,0,0,0,0,0,1,1
softlayer_softlayer-java,com.softlayer.api.service.mcafee.epolicy.orchestrator.version36.antivirus,0,0,0,0,0,0,1,1
softlayer_softlayer-java,com.softlayer.api.service.mcafee.epolicy.orchestrator.version36.hips.version6,0,0,0,0,0,0,1,1
softlayer_softlayer-java,com.softlayer.api.service.mcafee.epolicy.orchestrator.version36.hips.version6.event,0,0,0,0,0,0,1,1
softlayer_softlayer-java,com.softlayer.api.service.mcafee.epolicy.orchestrator.version36.hips.version7,0,0,0,0,0,0,1,1
softlayer_softlayer-java,com.softlayer.api.service.mcafee.epolicy.orchestrator.version36.hips.version7.event,0,0,0,0,0,0,1,1
softlayer_softlayer-java,com.softlayer.api.service.mcafee.epolicy.orchestrator.version36.policy,0,0,0,0,0,0,1,1
softlayer_softlayer-java,com.softlayer.api.service.mcafee.epolicy.orchestrator.version36.product,0,0,0,0,0,0,1,1
softlayer_softlayer-java,com.softlayer.api.service.mcafee.epolicy.orchestrator.version45.agent,0,0,0,0,0,0,1,1
softlayer_softlayer-java,com.softlayer.api.service.mcafee.epolicy.orchestrator.version45.agent.parent,0,0,0,0,0,0,1,1
softlayer_softlayer-java,com.softlayer.api.service.mcafee.epolicy.orchestrator.version45.event.filter,0,0,0,0,0,0,1,1
softlayer_softlayer-java,com.softlayer.api.service.mcafee.epolicy.orchestrator.version45.event,0,0,0,0,0,0,1,1
softlayer_softlayer-java,com.softlayer.api.service.mcafee.epolicy.orchestrator.version45,0,0,0,0,0,0,1,1
softlayer_softlayer-java,com.softlayer.api.service.mcafee.epolicy.orchestrator.version45.hips.event.signature,0,0,0,0,0,0,1,1
softlayer_softlayer-java,com.softlayer.api.service.mcafee.epolicy.orchestrator.version45.policy,0,0,0,0,0,0,1,1
softlayer_softlayer-java,com.softlayer.api.service.mcafee.epolicy.orchestrator.version45.product,0,0,0,0,0,0,1,1
softlayer_softlayer-java,com.softlayer.api.service.metric.tracking.object,5,1,0,0,1,0,1,8
softlayer_softlayer-java,com.softlayer.api.service.metric.tracking.object.bandwidth,2,0,0,0,0,0,1,3
softlayer_softlayer-java,com.softlayer.api.service.metric.tracking.object.virtual.storage,3,0,0,0,0,0,1,4
softlayer_softlayer-java,com.softlayer.api.service.metric.tracking,6,1,0,0,0,0,1,8
softlayer_softlayer-java,com.softlayer.api.service.monitoring.agent.configuration.template.group,6,1,0,0,0,0,1,8
softlayer_softlayer-java,com.softlayer.api.service.monitoring.agent.configuration.template,3,0,0,0,0,0,1,4
softlayer_softlayer-java,com.softlayer.api.service.monitoring.agent.configuration,5,1,0,0,0,0,1,7
softlayer_softlayer-java,com.softlayer.api.service.monitoring.agent,2,0,0,0,0,0,1,3
softlayer_softlayer-java,com.softlayer.api.service.monitoring,13,0,0,0,0,0,1,14
softlayer_softlayer-java,com.softlayer.api.service.monitoring.robot,2,0,0,0,0,0,1,3
softlayer_softlayer-java,com.softlayer.api.service.network.application.delivery.controller.configuration,3,0,0,0,0,0,1,4
softlayer_softlayer-java,com.softlayer.api.service.network.application.delivery.controller.loadbalancer.health.attribute,2,0,0,0,0,0,1,3
softlayer_softlayer-java,com.softlayer.api.service.network.application.delivery.controller.loadbalancer.health,7,0,0,0,0,0,1,8
softlayer_softlayer-java,com.softlayer.api.service.network.application.delivery.controller.loadbalancer.health.check,2,0,0,0,0,0,1,3
softlayer_softlayer-java,com.softlayer.api.service.network.application.delivery.controller.loadbalancer,39,1,0,0,0,0,1,41
softlayer_softlayer-java,com.softlayer.api.service.network.application.delivery.controller.loadbalancer.routing,2,0,0,0,1,0,1,4
softlayer_softlayer-java,com.softlayer.api.service.network.application.delivery.controller.loadbalancer.service.group,5,1,0,0,0,0,1,7
softlayer_softlayer-java,com.softlayer.api.service.network.application.delivery.controller.loadbalancer.service,5,0,0,0,0,0,1,6
softlayer_softlayer-java,com.softlayer.api.service.network.application.delivery.controller.loadbalancer.virtualipaddress,3,0,0,0,0,0,1,4
softlayer_softlayer-java,com.softlayer.api.service.network.application.delivery.controller,2,0,0,0,0,0,1,3
softlayer_softlayer-java,com.softlayer.api.service.network.application.delivery,18,1,0,0,0,0,1,20
softlayer_softlayer-java,com.softlayer.api.service.network.backbone.location,1,0,0,0,0,0,1,2
softlayer_softlayer-java,com.softlayer.api.service.network,73,1,0,1,0,0,1,76
softlayer_softlayer-java,com.softlayer.api.service.network.bandwidth.usage,0,0,0,0,0,0,1,1
softlayer_softlayer-java,com.softlayer.api.service.network.bandwidth,4,1,0,0,0,0,1,6
softlayer_softlayer-java,com.softlayer.api.service.network.bandwidth.version1,11,1,0,0,1,0,1,14
softlayer_softlayer-java,com.softlayer.api.service.network.bandwidth.version1.allotment,2,1,0,0,0,0,1,4
softlayer_softlayer-java,com.softlayer.api.service.network.bandwidth.version1.usage.detail,2,0,0,0,0,0,1,3
softlayer_softlayer-java,com.softlayer.api.service.network.bandwidth.version1.usage,3,0,0,0,0,0,1,4
softlayer_softlayer-java,com.softlayer.api.service.network.cdnmarketplace,0,0,0,0,1,0,1,2
softlayer_softlayer-java,com.softlayer.api.service.network.cdnmarketplace.configuration.behavior.geoblocking,0,0,0,0,0,0,1,1
softlayer_softlayer-java,com.softlayer.api.service.network.cdnmarketplace.configuration.behavior,0,0,0,0,1,0,1,2
softlayer_softlayer-java,com.softlayer.api.service.network.cdnmarketplace.configuration.cache,0,0,0,0,1,0,1,2
softlayer_softlayer-java,com.softlayer.api.service.network.cdnmarketplace.configuration.mapping,0,0,0,0,0,0,1,1
softlayer_softlayer-java,com.softlayer.api.service.network.cdnmarketplace.configuration,0,0,0,0,0,0,1,1
softlayer_softlayer-java,com.softlayer.api.service.network.cdnmarketplace.utils,0,0,0,0,0,0,1,1
softlayer_softlayer-java,com.softlayer.api.service.network.component.duplex,2,0,0,0,0,0,1,3
softlayer_softlayer-java,com.softlayer.api.service.network.component.firewall,3,0,0,0,0,0,1,4
softlayer_softlayer-java,com.softlayer.api.service.network.component,8,1,0,0,1,0,1,11
softlayer_softlayer-java,com.softlayer.api.service.network.component.network.vlan,3,0,0,0,0,0,1,4
softlayer_softlayer-java,com.softlayer.api.service.network.component.uplink,2,0,0,0,0,0,1,3
softlayer_softlayer-java,com.softlayer.api.service.network.customer.subnet,4,0,0,0,0,0,1,5
softlayer_softlayer-java,com.softlayer.api.service.network.customer,3,1,0,0,0,0,1,5
softlayer_softlayer-java,com.softlayer.api.service.network.directlink,1,0,0,0,1,0,1,3
softlayer_softlayer-java,com.softlayer.api.service.network.firewall,6,0,0,0,1,0,1,8
softlayer_softlayer-java,com.softlayer.api.service.network.firewall.module.context,7,1,0,0,0,0,1,9
softlayer_softlayer-java,com.softlayer.api.service.network.firewall.template,2,1,0,0,0,0,1,4
softlayer_softlayer-java,com.softlayer.api.service.network.firewall.update.request,1,0,0,0,1,0,1,3
softlayer_softlayer-java,com.softlayer.api.service.network.firewall.update.request.rule,0,0,0,0,0,0,1,1
softlayer_softlayer-java,com.softlayer.api.service.network.firewall.update,4,1,0,0,0,0,1,6
softlayer_softlayer-java,com.softlayer.api.service.network.gateway.member,3,0,0,0,0,0,1,4
softlayer_softlayer-java,com.softlayer.api.service.network.gateway,5,1,0,0,1,0,1,8
softlayer_softlayer-java,com.softlayer.api.service.network.interconnect,4,0,0,0,0,0,1,5
softlayer_softlayer-java,com.softlayer.api.service.network.lbaas,0,0,0,1,1,0,1,3
softlayer_softlayer-java,com.softlayer.api.service.network.loadbalancer.global,2,0,0,0,1,0,1,4
softlayer_softlayer-java,com.softlayer.api.service.network.loadbalancer,2,0,0,0,0,0,1,3
softlayer_softlayer-java,com.softlayer.api.service.network.logging,2,0,0,0,0,0,1,3
softlayer_softlayer-java,com.softlayer.api.service.network.media.transcode,4,0,0,0,0,0,1,5
softlayer_softlayer-java,com.softlayer.api.service.network.media.transcode.job,1,0,0,0,1,0,1,3
softlayer_softlayer-java,com.softlayer.api.service.network.message.delivery,2,0,0,0,1,0,1,4
softlayer_softlayer-java,com.softlayer.api.service.network.message.delivery.email,0,0,0,0,0,0,1,1
softlayer_softlayer-java,com.softlayer.api.service.network.message,4,1,0,0,0,0,1,6
softlayer_softlayer-java,com.softlayer.api.service.network.monitor.version1,2,0,0,0,0,0,1,3
softlayer_softlayer-java,com.softlayer.api.service.network.monitor.version1.query.host,2,0,0,0,0,0,1,3
softlayer_softlayer-java,com.softlayer.api.service.network.monitor.version1.query,2,0,0,0,1,0,1,4
softlayer_softlayer-java,com.softlayer.api.service.network.protection,3,0,0,0,0,0,1,4
softlayer_softlayer-java,com.softlayer.api.service.network.regional.internet,2,0,0,0,0,0,1,3
softlayer_softlayer-java,com.softlayer.api.service.network.security.scanner.request,2,0,0,0,0,0,1,3
softlayer_softlayer-java,com.softlayer.api.service.network.security.scanner,4,0,0,0,0,0,1,5
softlayer_softlayer-java,com.softlayer.api.service.network.securitygroup,3,0,0,0,1,0,1,5
softlayer_softlayer-java,com.softlayer.api.service.network.service.health,2,0,0,0,0,0,1,3
softlayer_softlayer-java,com.softlayer.api.service.network.service,8,1,0,0,0,0,1,10
softlayer_softlayer-java,com.softlayer.api.service.network.service.resource.attribute,1,0,0,0,0,0,1,2
softlayer_softlayer-java,com.softlayer.api.service.network.service.resource,4,0,0,0,1,0,1,6
softlayer_softlayer-java,com.softlayer.api.service.network.service.resource.hub,0,0,0,0,0,0,1,1
softlayer_softlayer-java,com.softlayer.api.service.network.service.vpn,3,0,0,0,0,0,1,4
softlayer_softlayer-java,com.softlayer.api.service.network.storage.allowed.host,0,0,0,0,1,0,1,2
softlayer_softlayer-java,com.softlayer.api.service.network.storage.allowed,2,1,0,0,0,0,1,4
softlayer_softlayer-java,com.softlayer.api.service.network.storage.backup.evault,0,0,0,0,0,0,1,1
softlayer_softlayer-java,com.softlayer.api.service.network.storage.backup,0,0,0,0,0,0,1,1
softlayer_softlayer-java,com.softlayer.api.service.network.storage,19,1,0,1,1,0,1,23
softlayer_softlayer-java,com.softlayer.api.service.network.storage.credential,2,0,0,0,0,0,1,3
softlayer_softlayer-java,com.softlayer.api.service.network.storage.daily,2,0,0,0,0,0,1,3
softlayer_softlayer-java,com.softlayer.api.service.network.storage.event,2,0,0,0,0,0,1,3
softlayer_softlayer-java,com.softlayer.api.service.network.storage.group,2,0,0,0,1,0,1,4
softlayer_softlayer-java,com.softlayer.api.service.network.storage.hub.cleversafe,0,0,0,0,0,0,1,1
softlayer_softlayer-java,com.softlayer.api.service.network.storage.hub.swift,0,0,0,0,1,0,1,2
softlayer_softlayer-java,com.softlayer.api.service.network.storage.hub,0,1,0,0,0,0,1,2
softlayer_softlayer-java,com.softlayer.api.service.network.storage.iscsi.equallogic.version3,0,0,0,0,0,0,1,1
softlayer_softlayer-java,com.softlayer.api.service.network.storage.iscsi.equallogic,0,1,0,0,0,0,1,2
softlayer_softlayer-java,com.softlayer.api.service.network.storage.iscsi.os,2,0,0,0,0,0,1,3
softlayer_softlayer-java,com.softlayer.api.service.network.storage.massdatamigration.crossregion.country,0,0,0,0,0,0,1,1
softlayer_softlayer-java,com.softlayer.api.service.network.storage.massdatamigration.request,1,1,0,0,1,0,1,4
softlayer_softlayer-java,com.softlayer.api.service.network.storage.massdatamigration,1,1,0,0,0,0,1,3
softlayer_softlayer-java,com.softlayer.api.service.network.storage.openstack,0,0,0,0,0,0,1,1
softlayer_softlayer-java,com.softlayer.api.service.network.storage.partnership,2,0,0,0,0,0,1,3
softlayer_softlayer-java,com.softlayer.api.service.network.storage.property,2,0,0,0,0,0,1,3
softlayer_softlayer-java,com.softlayer.api.service.network.storage.schedule.property,2,0,0,0,0,0,1,3
softlayer_softlayer-java,com.softlayer.api.service.network.storage.schedule,5,0,0,0,0,0,1,6
softlayer_softlayer-java,com.softlayer.api.service.network.subnet.ipaddress,4,0,0,0,1,0,1,6
softlayer_softlayer-java,com.softlayer.api.service.network.subnet,17,1,0,0,1,0,1,20
softlayer_softlayer-java,com.softlayer.api.service.network.subnet.registration,4,0,0,0,1,0,1,6
softlayer_softlayer-java,com.softlayer.api.service.network.subnet.registration.event,2,0,0,0,0,0,1,3
softlayer_softlayer-java,com.softlayer.api.service.network.subnet.rwhois,1,0,0,0,0,0,1,2
softlayer_softlayer-java,com.softlayer.api.service.network.subnet.swip,3,0,0,0,0,0,1,4
softlayer_softlayer-java,com.softlayer.api.service.network.tunnel.module.context.address,5,1,0,0,0,0,1,7
softlayer_softlayer-java,com.softlayer.api.service.network.tunnel.module,4,0,0,0,0,0,1,5
softlayer_softlayer-java,com.softlayer.api.service.network.vlan.firewall,2,1,0,0,0,0,1,4
softlayer_softlayer-java,com.softlayer.api.service.network.vlan,3,0,0,0,1,0,1,5
softlayer_softlayer-java,com.softlayer.api.service.notification.delivery,2,0,0,0,0,0,1,3
softlayer_softlayer-java,com.softlayer.api.service.notification,6,1,0,0,1,0,1,9
softlayer_softlayer-java,com.softlayer.api.service.notification.occurrence,7,1,0,0,0,0,1,9
softlayer_softlayer-java,com.softlayer.api.service.notification.occurrence.event,3,0,0,0,0,0,1,4
softlayer_softlayer-java,com.softlayer.api.service.notification.occurrence.resource,0,0,0,0,0,0,1,1
softlayer_softlayer-java,com.softlayer.api.service.notification.occurrence.resource.network.application.delivery.controller.loadbalancer,0,0,0,0,0,0,1,1
softlayer_softlayer-java,com.softlayer.api.service.notification.occurrence.resource.network.application.delivery,0,0,0,0,0,0,1,1
softlayer_softlayer-java,com.softlayer.api.service.notification.occurrence.resource.network.storage.iscsi,0,0,0,0,0,0,1,1
softlayer_softlayer-java,com.softlayer.api.service.notification.occurrence.resource.network.storage,0,0,0,0,0,0,1,1
softlayer_softlayer-java,com.softlayer.api.service.notification.occurrence.resource.network.storage.netapp.volume.replicant,0,0,0,0,0,0,1,1
softlayer_softlayer-java,com.softlayer.api.service.notification.occurrence.resource.network.storage.netapp,0,0,0,0,0,0,1,1
softlayer_softlayer-java,com.softlayer.api.service.notification.occurrence.status,2,0,0,0,0,0,1,3
softlayer_softlayer-java,com.softlayer.api.service.notification.subscriber,0,0,0,0,0,0,1,1
softlayer_softlayer-java,com.softlayer.api.service.notification.subscriber.delivery,4,0,0,0,0,0,1,5
softlayer_softlayer-java,com.softlayer.api.service.notification.user.subscriber,1,0,0,0,1,0,1,3
softlayer_softlayer-java,com.softlayer.api.service.notification.user.subscriber.delivery,0,0,0,0,0,0,1,1
softlayer_softlayer-java,com.softlayer.api.service.notification.user,4,1,0,0,0,0,1,6
softlayer_softlayer-java,com.softlayer.api.service.policy.document.acceptance,0,0,0,0,0,0,1,1
softlayer_softlayer-java,com.softlayer.api.service.product.catalog.item,0,0,0,0,0,0,1,1
softlayer_softlayer-java,com.softlayer.api.service.product,34,1,0,0,1,1,1,38
softlayer_softlayer-java,com.softlayer.api.service.product.item.attribute,2,0,0,0,0,0,1,3
softlayer_softlayer-java,com.softlayer.api.service.product.item,33,1,0,0,1,0,1,36
softlayer_softlayer-java,com.softlayer.api.service.product.item.billing,0,0,0,0,0,0,1,1
softlayer_softlayer-java,com.softlayer.api.service.product.item.category,5,1,0,0,1,0,1,8
softlayer_softlayer-java,com.softlayer.api.service.product.item.category.order.option,2,0,0,0,0,0,1,3
softlayer_softlayer-java,com.softlayer.api.service.product.item.category.question.field,1,0,0,0,0,0,1,2
softlayer_softlayer-java,com.softlayer.api.service.product.item.category.question,5,0,0,0,0,0,1,6
softlayer_softlayer-java,com.softlayer.api.service.product.item.link,0,0,0,0,0,0,1,1
softlayer_softlayer-java,com.softlayer.api.service.product.item.overage,0,0,0,0,0,0,1,1
softlayer_softlayer-java,com.softlayer.api.service.product.item.policy,3,0,0,0,0,0,1,4
softlayer_softlayer-java,com.softlayer.api.service.product.item.price.account,2,0,0,0,0,0,1,3
softlayer_softlayer-java,com.softlayer.api.service.product.item.price.attribute,2,0,0,0,0,0,1,3
softlayer_softlayer-java,com.softlayer.api.service.product.item.price,5,0,0,0,1,0,1,7
softlayer_softlayer-java,com.softlayer.api.service.product.item.resource.conflict.item,0,0,0,0,0,0,1,1
softlayer_softlayer-java,com.softlayer.api.service.product.item.resource.conflict,0,0,0,0,0,0,1,1
softlayer_softlayer-java,com.softlayer.api.service.product.item.resource,3,1,0,0,0,0,1,5
softlayer_softlayer-java,com.softlayer.api.service.product.item.rule.resource.item,3,0,0,0,0,0,1,4
softlayer_softlayer-java,com.softlayer.api.service.product.item.rule.resource,3,0,0,0,1,0,1,5
softlayer_softlayer-java,com.softlayer.api.service.product.item.rule,7,1,0,0,0,0,1,9
softlayer_softlayer-java,com.softlayer.api.service.product.item.server,2,0,0,0,0,0,1,3
softlayer_softlayer-java,com.softlayer.api.service.product.item.tax,3,0,0,0,0,0,1,4
softlayer_softlayer-java,com.softlayer.api.service.product.pkg.attribute,2,0,0,0,0,0,1,3
softlayer_softlayer-java,com.softlayer.api.service.product.pkg,12,1,0,0,1,0,1,15
softlayer_softlayer-java,com.softlayer.api.service.product.pkg.item.category,4,0,0,0,0,0,1,5
softlayer_softlayer-java,com.softlayer.api.service.product.pkg.item,3,0,0,0,0,0,1,4
softlayer_softlayer-java,com.softlayer.api.service.product.pkg.order,6,1,0,0,0,0,1,8
softlayer_softlayer-java,com.softlayer.api.service.product.pkg.order.step,3,0,0,0,0,0,1,4
softlayer_softlayer-java,com.softlayer.api.service.product.pkg.preset.attribute,2,0,0,0,0,0,1,3
softlayer_softlayer-java,com.softlayer.api.service.product.pkg.preset,5,0,0,0,0,0,1,6
softlayer_softlayer-java,com.softlayer.api.service.product.pkg.server,0,0,0,0,0,0,1,1
softlayer_softlayer-java,com.softlayer.api.service.product.upgrade.request,2,0,0,0,0,0,1,3
softlayer_softlayer-java,com.softlayer.api.service.product.upgrade,4,0,0,0,0,0,1,5
softlayer_softlayer-java,com.softlayer.api.service.provisioning.hook,1,0,0,0,0,0,1,2
softlayer_softlayer-java,com.softlayer.api.service.provisioning,2,0,0,0,0,0,1,3
softlayer_softlayer-java,com.softlayer.api.service.provisioning.maintenance.classification.item,1,0,0,0,0,0,1,2
softlayer_softlayer-java,com.softlayer.api.service.provisioning.maintenance,1,1,0,0,0,0,1,3
softlayer_softlayer-java,com.softlayer.api.service.provisioning.version1.transaction,3,0,0,0,1,0,1,5
softlayer_softlayer-java,com.softlayer.api.service.provisioning.version1,3,1,0,0,0,0,1,5
softlayer_softlayer-java,com.softlayer.api.service.resource,8,1,0,0,0,0,1,10
softlayer_softlayer-java,com.softlayer.api.service.resource.group.attribute,2,0,0,0,0,0,1,3
softlayer_softlayer-java,com.softlayer.api.service.resource.group,15,1,0,0,1,0,1,18
softlayer_softlayer-java,com.softlayer.api.service.resource.group.descendant,0,0,0,0,0,0,1,1
softlayer_softlayer-java,com.softlayer.api.service.resource.group.member.attribute,2,0,0,0,0,0,1,3
softlayer_softlayer-java,com.softlayer.api.service.resource.group.member,5,0,0,0,1,0,1,7
softlayer_softlayer-java,com.softlayer.api.service.resource.group.member.cloudstack.version3,0,0,0,0,1,0,1,2
softlayer_softlayer-java,com.softlayer.api.service.resource.group.member.network,0,0,0,0,1,0,1,2
softlayer_softlayer-java,com.softlayer.api.service.resource.group.member.resource,0,0,0,0,0,0,1,1
softlayer_softlayer-java,com.softlayer.api.service.resource.group.member.role,2,0,0,0,0,0,1,3
softlayer_softlayer-java,com.softlayer.api.service.resource.group.member.software.component,0,0,0,0,0,0,1,1
softlayer_softlayer-java,com.softlayer.api.service.resource.group.member.virtual.host,0,0,0,0,0,0,1,1
softlayer_softlayer-java,com.softlayer.api.service.resource.group.template,3,0,0,0,0,0,1,4
softlayer_softlayer-java,com.softlayer.api.service.sales.presale,2,0,0,0,0,0,1,3
softlayer_softlayer-java,com.softlayer.api.service.scale.asset,0,0,0,0,0,0,1,1
softlayer_softlayer-java,com.softlayer.api.service.scale.asset.virtual,2,0,0,0,0,0,1,3
softlayer_softlayer-java,com.softlayer.api.service.scale,28,1,0,0,0,0,1,30
softlayer_softlayer-java,com.softlayer.api.service.scale.group,3,0,0,0,1,0,1,5
softlayer_softlayer-java,com.softlayer.api.service.scale.member.virtual,4,1,0,0,0,0,1,6
softlayer_softlayer-java,com.softlayer.api.service.scale.network,3,0,0,0,0,0,1,4
softlayer_softlayer-java,com.softlayer.api.service.scale.policy.action,4,0,0,0,1,0,1,6
softlayer_softlayer-java,com.softlayer.api.service.scale.policy,11,1,0,0,1,0,1,14
softlayer_softlayer-java,com.softlayer.api.service.scale.policy.trigger,7,1,0,0,1,0,1,10
softlayer_softlayer-java,com.softlayer.api.service.scale.policy.trigger.resourceuse,3,0,0,0,0,0,1,4
softlayer_softlayer-java,com.softlayer.api.service.scale.termination,2,0,0,0,0,0,1,3
softlayer_softlayer-java,com.softlayer.api.service.security.certificate,4,0,0,0,1,0,1,6
softlayer_softlayer-java,com.softlayer.api.service.security.certificate.request,2,0,0,0,1,0,1,4
softlayer_softlayer-java,com.softlayer.api.service.security,2,1,0,0,1,0,1,5
softlayer_softlayer-java,com.softlayer.api.service.security.directory.service.host.xref,0,0,0,0,0,0,1,1
softlayer_softlayer-java,com.softlayer.api.service.security.ssh,2,1,0,0,0,0,1,4
softlayer_softlayer-java,com.softlayer.api.service.service.external,0,0,0,0,0,0,1,1
softlayer_softlayer-java,com.softlayer.api.service.service,2,1,0,0,0,0,1,4
softlayer_softlayer-java,com.softlayer.api.service.software,61,1,0,0,0,1,1,64
softlayer_softlayer-java,com.softlayer.api.service.software.component.analytics,0,0,0,0,0,0,1,1
softlayer_softlayer-java,com.softlayer.api.service.software.component,7,1,0,0,1,0,1,10
softlayer_softlayer-java,com.softlayer.api.service.software.component.antivirusspyware.mcafee.epo,0,0,0,0,0,0,1,1
softlayer_softlayer-java,com.softlayer.api.service.software.component.antivirusspyware,0,0,0,0,0,0,1,1
softlayer_softlayer-java,com.softlayer.api.service.software.component.controlpanel,0,1,0,0,1,0,1,3
softlayer_softlayer-java,com.softlayer.api.service.software.component.controlpanel.idera,0,0,0,0,0,0,1,1
softlayer_softlayer-java,com.softlayer.api.service.software.component.controlpanel.microsoft,0,0,0,0,0,0,1,1
softlayer_softlayer-java,com.softlayer.api.service.software.component.controlpanel.parallels,0,0,0,0,0,0,1,1
softlayer_softlayer-java,com.softlayer.api.service.software.component.controlpanel.r1soft,0,0,0,0,0,0,1,1
softlayer_softlayer-java,com.softlayer.api.service.software.component.hostips.mcafee.epo.version36.hips,0,0,0,0,0,0,1,1
softlayer_softlayer-java,com.softlayer.api.service.software.component.hostips.mcafee.epo.version36,0,0,0,0,0,0,1,1
softlayer_softlayer-java,com.softlayer.api.service.software.component.hostips.mcafee.epo.version45.hips,0,0,0,0,0,0,1,1
softlayer_softlayer-java,com.softlayer.api.service.software.component.hostips.mcafee.epo.version45,0,0,0,0,0,0,1,1
softlayer_softlayer-java,com.softlayer.api.service.software.component.hostips,0,0,0,0,0,0,1,1
softlayer_softlayer-java,com.softlayer.api.service.software.component.password,3,0,0,0,0,0,1,4
softlayer_softlayer-java,com.softlayer.api.service.software.component.pkg.management,0,0,0,0,0,0,1,1
softlayer_softlayer-java,com.softlayer.api.service.software.component.pkg,0,0,0,0,0,0,1,1
softlayer_softlayer-java,com.softlayer.api.service.software.component.security,0,0,0,0,0,0,1,1
softlayer_softlayer-java,com.softlayer.api.service.software.description.attribute,2,0,0,0,0,0,1,3
softlayer_softlayer-java,com.softlayer.api.service.software.description,5,0,0,0,1,0,1,7
softlayer_softlayer-java,com.softlayer.api.service.survey,1,0,0,0,1,0,1,3
softlayer_softlayer-java,com.softlayer.api.service.tag.reference,0,0,0,0,0,0,1,1
softlayer_softlayer-java,com.softlayer.api.service.tag.reference.network.application.delivery,0,0,0,0,0,0,1,1
softlayer_softlayer-java,com.softlayer.api.service.tag.reference.network.vlan,0,0,0,0,0,0,1,1
softlayer_softlayer-java,com.softlayer.api.service.tag.reference.network,0,0,0,0,0,0,1,1
softlayer_softlayer-java,com.softlayer.api.service.tag.reference.resource,0,0,0,0,0,0,1,1
softlayer_softlayer-java,com.softlayer.api.service.tag.reference.virtual,0,0,0,0,0,0,1,1
softlayer_softlayer-java,com.softlayer.api.service.tag.reference.virtual.guest.block.device.template,0,0,0,0,0,0,1,1
softlayer_softlayer-java,com.softlayer.api.service.tag,2,1,0,0,0,0,1,4
softlayer_softlayer-java,com.softlayer.api.service.ticket,15,1,0,0,1,0,1,18
softlayer_softlayer-java,com.softlayer.api.service.ticket.attachment.assigned,0,0,0,0,0,0,1,1
softlayer_softlayer-java,com.softlayer.api.service.ticket.attachment,2,0,0,0,1,0,1,4
softlayer_softlayer-java,com.softlayer.api.service.ticket.attachment.dedicated,0,0,0,0,0,0,1,1
softlayer_softlayer-java,com.softlayer.api.service.ticket.attachment.file,0,0,0,0,0,0,1,1
softlayer_softlayer-java,com.softlayer.api.service.ticket.attachment.manual,0,0,0,0,0,0,1,1
softlayer_softlayer-java,com.softlayer.api.service.ticket.attachment.network.storage.mass.data,0,0,0,0,0,0,1,1
softlayer_softlayer-java,com.softlayer.api.service.ticket.attachment.scheduled,0,0,0,0,0,0,1,1
softlayer_softlayer-java,com.softlayer.api.service.ticket.attachment.virtual,0,0,0,0,0,0,1,1
softlayer_softlayer-java,com.softlayer.api.service.ticket.chat,2,0,0,0,0,0,1,3
softlayer_softlayer-java,com.softlayer.api.service.ticket.chat.transcriptline,0,0,0,0,0,0,1,1
softlayer_softlayer-java,com.softlayer.api.service.ticket.group,2,0,0,0,0,0,1,3
softlayer_softlayer-java,com.softlayer.api.service.ticket.state,2,0,0,0,0,0,1,3
softlayer_softlayer-java,com.softlayer.api.service.ticket.subject,3,0,0,0,0,0,1,4
softlayer_softlayer-java,com.softlayer.api.service.ticket.update,2,0,0,0,1,0,1,4
softlayer_softlayer-java,com.softlayer.api.service.user.access.facility.log,1,0,0,0,0,0,1,2
softlayer_softlayer-java,com.softlayer.api.service.user.access.facility,3,0,0,0,0,0,1,4
softlayer_softlayer-java,com.softlayer.api.service.user.access.facility.visitor,1,0,0,0,0,0,1,2
softlayer_softlayer-java,com.softlayer.api.service.user.customer.access,3,0,0,0,0,0,1,4
softlayer_softlayer-java,com.softlayer.api.service.user.customer,6,0,0,0,1,0,1,8
softlayer_softlayer-java,com.softlayer.api.service.user.customer.customerpermission,2,0,0,0,0,0,1,3
softlayer_softlayer-java,com.softlayer.api.service.user.customer.external.binding,0,0,0,0,1,0,1,2
softlayer_softlayer-java,com.softlayer.api.service.user.customer.external,0,1,0,0,0,0,1,2
softlayer_softlayer-java,com.softlayer.api.service.user.customer.link,0,0,0,0,0,0,1,1
softlayer_softlayer-java,com.softlayer.api.service.user.customer.mobiledevice,2,0,0,0,1,0,1,4
softlayer_softlayer-java,com.softlayer.api.service.user.customer.notification,3,0,0,0,0,0,1,4
softlayer_softlayer-java,com.softlayer.api.service.user.customer.notification.virtual,3,0,0,0,0,0,1,4
softlayer_softlayer-java,com.softlayer.api.service.user.customer.profile.event,0,0,0,0,0,0,1,1
softlayer_softlayer-java,com.softlayer.api.service.user.customer.prospect.serviceprovider,0,0,0,0,0,0,1,1
softlayer_softlayer-java,com.softlayer.api.service.user.customer.prospect,2,0,0,0,0,0,1,3
softlayer_softlayer-java,com.softlayer.api.service.user.customer.security,5,0,0,0,0,0,1,6
softlayer_softlayer-java,com.softlayer.api.service.user,55,1,0,0,1,0,1,58
softlayer_softlayer-java,com.softlayer.api.service.user.employee,2,0,0,0,0,0,1,3
softlayer_softlayer-java,com.softlayer.api.service.user.external.binding,3,1,0,0,1,0,1,6
softlayer_softlayer-java,com.softlayer.api.service.user.external,5,0,0,0,0,0,1,6
softlayer_softlayer-java,com.softlayer.api.service.user.permission,7,1,0,0,0,0,1,9
softlayer_softlayer-java,com.softlayer.api.service.user.permission.group,4,0,0,0,0,0,1,5
softlayer_softlayer-java,com.softlayer.api.service.user.preference,2,0,0,0,0,0,1,3
softlayer_softlayer-java,com.softlayer.api.service.user.security,2,0,0,0,0,0,1,3
softlayer_softlayer-java,com.softlayer.api.service.utility,0,0,0,0,1,0,1,2
softlayer_softlayer-java,com.softlayer.api.service.utility.objectfilter.operation,0,0,0,0,0,0,1,1
softlayer_softlayer-java,com.softlayer.api.service.utility.objectfilter,0,0,0,0,0,0,1,1
softlayer_softlayer-java,com.softlayer.api.service.virtual,68,1,0,0,0,1,1,71
softlayer_softlayer-java,com.softlayer.api.service.virtual.disk.image.software,3,0,0,0,0,0,1,4
softlayer_softlayer-java,com.softlayer.api.service.virtual.disk.image,6,1,0,0,0,0,1,8
softlayer_softlayer-java,com.softlayer.api.service.virtual.disk,9,1,0,0,0,0,1,11
softlayer_softlayer-java,com.softlayer.api.service.virtual.guest.attribute,3,0,0,0,0,0,1,4
softlayer_softlayer-java,com.softlayer.api.service.virtual.guest,6,1,0,0,1,0,1,9
softlayer_softlayer-java,com.softlayer.api.service.virtual.guest.block.device,3,1,0,0,0,0,1,5
softlayer_softlayer-java,com.softlayer.api.service.virtual.guest.block.device.template.group,3,0,0,0,0,0,1,4
softlayer_softlayer-java,com.softlayer.api.service.virtual.guest.block.device.template,14,1,0,0,0,0,1,16
softlayer_softlayer-java,com.softlayer.api.service.virtual.guest.block,3,0,0,0,0,0,1,4
softlayer_softlayer-java,com.softlayer.api.service.virtual.guest.boot.parameter,2,0,0,0,0,0,1,3
softlayer_softlayer-java,com.softlayer.api.service.virtual.guest.boot,5,0,0,0,0,0,1,6
softlayer_softlayer-java,com.softlayer.api.service.virtual.guest.network.component,3,1,0,0,0,0,1,5
softlayer_softlayer-java,com.softlayer.api.service.virtual.guest.network,5,1,0,0,0,0,1,7
softlayer_softlayer-java,com.softlayer.api.service.virtual.guest.power,2,0,0,0,0,0,1,3
softlayer_softlayer-java,com.softlayer.api.service.virtual.guest.vpc,0,0,0,0,0,0,1,1
softlayer_softlayer-java,com.softlayer.api.service.virtual.host,3,0,0,0,0,0,1,4
softlayer_softlayer-java,com.softlayer.api.service.virtual.network.securitygroup,3,0,0,0,0,0,1,4
softlayer_softlayer-java,com.softlayer.api.service.virtual.placementgroup,2,0,0,0,0,0,1,3
softlayer_softlayer-java,com.softlayer.api.service.virtual.reservedcapacitygroup,4,0,0,0,0,0,1,5
softlayer_softlayer-java,com.softlayer.api.service.virtual.storage.repository,3,1,0,0,0,0,1,5
softlayer_softlayer-java,com.softlayer.api.service.virtual.storage,9,1,0,0,0,0,1,11
SomMeri_matasano-cryptopals-solutions,jexxus.client,0,0,0,0,0,0,0,0
SomMeri_matasano-cryptopals-solutions,jexxus.common,0,0,0,0,0,0,0,0
SomMeri_matasano-cryptopals-solutions,jexxus.server,0,0,0,0,0,0,0,0
SomMeri_matasano-cryptopals-solutions,org.meri.matasano,0,0,0,0,1,9,0,10
SomMeri_matasano-cryptopals-solutions,org.meri.matasano.utils,0,0,0,0,1,5,0,6
SomMeri_matasano-cryptopals-solutions,org.meri.matasano.utils.cryptoanalysis,0,0,0,0,1,7,0,8
SomMeri_matasano-cryptopals-solutions,org.meri.matasano.utils.encryption,0,0,0,1,1,5,0,7
SomMeri_matasano-cryptopals-solutions,org.meri.matasano.utils.networking,0,0,0,0,0,0,0,0
SomMeri_matasano-cryptopals-solutions,org.meri.matasano.utils.oracle,0,0,0,0,1,6,0,7
SomMeri_matasano-cryptopals-solutions,org.meri.matasano.utils.protocols,0,0,0,0,0,0,0,0
SomMeri_matasano-cryptopals-solutions,org.meri.matasano.utils.randomanalysis,0,0,0,0,0,0,0,0
SomMeri_matasano-cryptopals-solutions,org.meri.matasano.utils.webtools,0,1,0,0,1,2,0,4
SomMeri_matasano-cryptopals-solutions,org.meri.matasano.utils.webtools.servlets,0,0,0,0,0,0,0,0
SomMeri_matasano-cryptopals-solutions,org.meri.matasano.playground,0,0,0,0,0,0,0,0
SomMeri_matasano-cryptopals-solutions,org.meri.matasano.set1,0,1,0,0,0,0,0,1
SomMeri_matasano-cryptopals-solutions,org.meri.matasano.set2,0,0,0,0,0,0,0,0
SomMeri_matasano-cryptopals-solutions,org.meri.matasano.set3.competitors,0,0,0,0,0,0,0,0
SomMeri_matasano-cryptopals-solutions,org.meri.matasano.set3,0,0,0,0,0,1,0,1
SomMeri_matasano-cryptopals-solutions,org.meri.matasano.set4,0,0,0,0,0,2,0,2
SomMeri_matasano-cryptopals-solutions,org.meri.matasano.set5,0,0,0,0,0,0,0,0
SomMeri_matasano-cryptopals-solutions,org.meri.matasano.set6,0,0,0,0,0,1,0,1
SomMeri_matasano-cryptopals-solutions,org.meri.matasano.util,0,0,0,0,0,0,0,0
SonarSource_sonarqube,org.sonar.xoo.checks,0,0,0,0,0,0,0,0
SonarSource_sonarqube,org.sonar.xoo.coverage,1,1,0,0,0,0,0,2
SonarSource_sonarqube,org.sonar.xoo.extensions,0,0,0,0,0,0,0,0
SonarSource_sonarqube,org.sonar.xoo.global,0,0,0,0,0,0,0,0
SonarSource_sonarqube,org.sonar.xoo.lang,1,0,0,0,1,0,0,2
SonarSource_sonarqube,org.sonar.xoo,4,1,0,0,0,0,0,5
SonarSource_sonarqube,org.sonar.xoo.rule,1,0,0,1,0,0,0,2
SonarSource_sonarqube,org.sonar.xoo.scm,1,1,0,0,0,0,0,2
SonarSource_sonarqube,org.sonar.auth.gitlab,0,0,0,0,0,0,0,0
SonarSource_sonarqube,org.sonar.ce.app,0,0,0,0,0,0,0,0
SonarSource_sonarqube,org.sonar.ce.async,0,0,0,0,0,0,0,0
SonarSource_sonarqube,org.sonar.ce,7,1,0,0,1,0,0,9
SonarSource_sonarqube,org.sonar.ce.cleaning,4,1,0,0,0,0,0,5
SonarSource_sonarqube,org.sonar.ce.configuration,0,0,0,0,1,0,0,1
SonarSource_sonarqube,org.sonar.ce.container,4,0,0,0,1,0,0,5
SonarSource_sonarqube,org.sonar.ce.db,0,0,0,0,0,0,0,0
SonarSource_sonarqube,org.sonar.ce.httpd,0,0,0,0,1,0,0,1
SonarSource_sonarqube,org.sonar.ce.logging,0,0,0,0,0,0,0,0
SonarSource_sonarqube,org.sonar.ce.monitoring,3,1,0,0,1,0,0,5
SonarSource_sonarqube,org.sonar.ce.notification,1,0,0,0,0,0,0,1
SonarSource_sonarqube,org.sonar.ce.platform,0,0,0,0,1,0,0,1
SonarSource_sonarqube,org.sonar.ce.queue,11,1,0,0,0,0,0,12
SonarSource_sonarqube,org.sonar.ce.systeminfo,0,0,0,0,0,0,0,0
SonarSource_sonarqube,org.sonar.ce.taskprocessor,8,1,0,1,0,0,0,10
SonarSource_sonarqube,(default package),0,0,0,0,0,0,0,0
SonarSource_sonarqube,org.sonar.ce.task,0,0,0,0,1,0,0,1
SonarSource_sonarqube,org.sonar.ce.task.container,0,0,0,0,0,0,0,0
SonarSource_sonarqube,org.sonar.ce.task.log,0,0,0,0,1,0,0,1
SonarSource_sonarqube,org.sonar.ce.task.setting,0,0,0,0,0,0,0,0
SonarSource_sonarqube,org.sonar.ce.task.step,0,0,0,0,0,0,0,0
SonarSource_sonarqube,org.sonar.ce.task.taskprocessor,0,0,0,0,0,0,0,0
SonarSource_sonarqube,org.sonar.ce.task.util,0,0,0,0,0,0,0,0
SonarSource_sonarqube,org.sonar.ce.task.projectanalysis.analysis,0,0,0,0,1,0,0,1
SonarSource_sonarqube,org.sonar.ce.task.projectanalysis.api.measurecomputer,0,0,0,0,1,0,0,1
SonarSource_sonarqube,org.sonar.ce.task.projectanalysis.api.posttask,0,0,0,0,1,0,0,1
SonarSource_sonarqube,org.sonar.ce.task.projectanalysis.batch,0,0,0,0,0,0,0,0
SonarSource_sonarqube,org.sonar.ce.task.projectanalysis.component,0,0,0,1,1,0,0,2
sonyxperiadev_gerrit-events,com.sonymobile.tools.gerrit.gerritevents,2,1,0,0,1,0,0,4
sonyxperiadev_gerrit-events,com.sonymobile.tools.gerrit.gerritevents.dto.attr,1,0,0,0,1,0,0,2
sonyxperiadev_gerrit-events,com.sonymobile.tools.gerrit.gerritevents.dto.events,0,0,0,0,1,0,0,1
sonyxperiadev_gerrit-events,com.sonymobile.tools.gerrit.gerritevents.dto,0,0,1,0,1,0,0,2
sonyxperiadev_gerrit-events,com.sonymobile.tools.gerrit.gerritevents.dto.rest,0,0,0,0,1,0,0,1
sonyxperiadev_gerrit-events,com.sonymobile.tools.gerrit.gerritevents.helpers,0,0,0,0,0,0,0,0
sonyxperiadev_gerrit-events,com.sonymobile.tools.gerrit.gerritevents.rest,0,0,0,0,0,1,0,1
sonyxperiadev_gerrit-events,com.sonymobile.tools.gerrit.gerritevents.ssh,1,1,0,0,1,1,0,4
sonyxperiadev_gerrit-events,com.sonymobile.tools.gerrit.gerritevents.watchdog,0,0,0,0,1,0,0,1
sonyxperiadev_gerrit-events,com.sonymobile.tools.gerrit.gerritevents.workers,0,0,0,0,1,0,0,1
sonyxperiadev_gerrit-events,com.sonymobile.tools.gerrit.gerritevents.workers.cmd,0,0,0,0,1,1,0,2
sonyxperiadev_gerrit-events,com.sonymobile.tools.gerrit.gerritevents.workers.rest,0,0,0,0,1,0,0,1
sonyxperiadev_gerrit-events,com.sonymobile.tools.gerrit.gerritevents.mock,0,0,0,0,0,0,0,0
SpongePowered_Artemis,com.artemis,0,0,0,0,0,0,0,0
SpongePowered_Artemis,com.artemis.managers,0,0,0,0,0,0,0,0
SpongePowered_Artemis,com.artemis.systems,0,0,0,0,0,0,0,0
SpongePowered_Artemis,com.artemis.utils,0,0,0,0,1,0,0,1
SpongePowered_Mixin,org.spongepowered.tools.agent,0,0,0,0,0,0,1,1
SpongePowered_Mixin,org.spongepowered.tools.obfuscation,6,0,0,1,0,0,1,8
SpongePowered_Mixin,org.spongepowered.tools.obfuscation.fg3,0,0,0,0,0,0,1,1
SpongePowered_Mixin,org.spongepowered.tools.obfuscation.interfaces,3,1,0,0,1,0,1,6
SpongePowered_Mixin,org.spongepowered.tools.obfuscation.mapping.common,0,0,0,0,0,0,1,1
SpongePowered_Mixin,org.spongepowered.tools.obfuscation.mapping.fg3,0,0,0,0,0,0,1,1
SpongePowered_Mixin,org.spongepowered.tools.obfuscation.mapping,1,1,0,0,0,0,1,3
SpongePowered_Mixin,org.spongepowered.tools.obfuscation.mapping.mcp,0,0,0,0,0,0,1,1
SpongePowered_Mixin,org.spongepowered.tools.obfuscation.mcp,2,1,0,0,0,0,1,4
SpongePowered_Mixin,org.spongepowered.tools.obfuscation.mirror,0,1,0,0,0,0,1,2
SpongePowered_Mixin,org.spongepowered.tools.obfuscation.mirror.mapping,0,0,0,0,0,0,1,1
SpongePowered_Mixin,org.spongepowered.tools.obfuscation.service,2,1,0,0,0,0,1,4
SpongePowered_Mixin,org.spongepowered.tools.obfuscation.struct,0,0,0,0,0,0,1,1
SpongePowered_Mixin,org.spongepowered.tools.obfuscation.validation,0,0,0,0,0,0,1,1
SpongePowered_Mixin,org.spongepowered.asm.bridge,0,0,0,0,0,0,1,1
SpongePowered_Mixin,org.spongepowered.tools.obfuscation.json,0,0,0,0,0,0,1,1
SpongePowered_Mixin,org.spongepowered.asm.mixin.transformer.debug,0,0,0,0,0,0,1,1
SpongePowered_Mixin,org.spongepowered.asm.launch,11,1,0,0,0,0,1,13
SpongePowered_Mixin,org.spongepowered.asm.launch.platform,14,1,0,0,0,0,1,16
SpongePowered_Mixin,org.spongepowered.asm.mixin,16,1,0,0,0,0,1,18
SpongePowered_Mixin,org.spongepowered.asm.mixin.transformer,40,1,0,1,0,0,1,43
SpongePowered_Mixin,org.spongepowered.asm.service.mojang,3,0,0,0,1,0,1,5
SpongePowered_Mixin,org.spongepowered.asm.lib,0,0,0,0,1,0,1,2
SpongePowered_Mixin,org.spongepowered.asm.lib.tree,0,0,0,0,0,0,1,1
SpongePowered_Mixin,org.spongepowered.asm.mixin.throwables,1,1,0,0,1,0,1,4
SpongePowered_Mixin,org.spongepowered.asm.launch.platform.container,1,1,0,0,0,0,1,3
SpongePowered_Mixin,org.spongepowered.asm.mixin.connect,0,0,0,0,0,0,1,1
SpongePowered_Mixin,org.spongepowered.asm.mixin.extensibility,7,1,0,0,1,0,1,10
SpongePowered_Mixin,org.spongepowered.asm.mixin.gen,4,0,0,0,0,0,1,5
SpongePowered_Mixin,org.spongepowered.asm.mixin.gen.throwables,0,0,0,0,0,0,1,1
SpongePowered_Mixin,org.spongepowered.asm.mixin.injection,4,0,0,0,0,0,1,5
SpongePowered_Mixin,org.spongepowered.asm.mixin.injection.callback,4,0,0,0,0,0,1,5
SpongePowered_Mixin,org.spongepowered.asm.mixin.injection.code,2,0,0,0,0,0,1,3
SpongePowered_Mixin,org.spongepowered.asm.mixin.injection.invoke.arg,0,0,0,0,0,0,1,1
SpongePowered_Mixin,org.spongepowered.asm.mixin.injection.invoke,0,0,0,0,0,0,1,1
SpongePowered_Mixin,org.spongepowered.asm.mixin.injection.invoke.util,0,0,0,0,0,0,1,1
SpongePowered_Mixin,org.spongepowered.asm.mixin.injection.modify,2,0,0,0,0,0,1,3
SpongePowered_Mixin,org.spongepowered.asm.mixin.injection.points,0,0,0,0,1,0,1,2
SpongePowered_Mixin,org.spongepowered.asm.mixin.injection.selectors,6,1,0,0,1,0,1,9
SpongePowered_Mixin,org.spongepowered.asm.mixin.injection.struct,14,1,0,0,0,0,1,16
SpongePowered_Mixin,org.spongepowered.asm.mixin.injection.throwables,0,0,0,0,0,0,1,1
SpongePowered_Mixin,org.spongepowered.asm.mixin.refmap,7,1,0,0,0,0,1,9
SpongePowered_Mixin,org.spongepowered.asm.mixin.struct,3,1,0,0,1,0,1,6
SpongePowered_Mixin,org.spongepowered.asm.mixin.transformer.ext.extensions,5,0,0,0,0,0,1,6
SpongePowered_Mixin,org.spongepowered.asm.mixin.transformer.ext,3,1,0,0,1,0,1,6
SpongePowered_Mixin,org.spongepowered.asm.mixin.transformer.throwables,3,0,0,0,1,0,1,5
SpongePowered_Mixin,org.spongepowered.asm.obfuscation.mapping.common,2,0,0,0,0,0,1,3
SpongePowered_Mixin,org.spongepowered.asm.obfuscation.mapping,0,0,0,0,0,0,1,1
SpongePowered_Mixin,org.spongepowered.asm.obfuscation.mapping.mcp,0,0,0,0,0,0,1,1
SpongePowered_Mixin,org.spongepowered.asm.obfuscation,2,0,0,0,0,0,1,3
SpongePowered_Mixin,org.spongepowered.asm.service,16,1,0,0,1,0,1,19
SpongePowered_Mixin,org.spongepowered.asm.transformers,1,1,0,0,0,0,1,3
SpongePowered_Mixin,org.spongepowered.asm.util,28,1,0,1,1,0,1,32
SpongePowered_Mixin,org.spongepowered.asm.util.asm,3,1,0,0,0,0,1,5
SpongePowered_Mixin,org.spongepowered.asm.util.perf,4,0,0,0,0,0,1,5
SpongePowered_Mixin,org.spongepowered.asm.util.throwables,0,0,0,0,0,0,1,1
SpongePowered_Mixin,org.spongepowered.asm.service.modlauncher,4,0,0,0,1,0,1,6
SpongePowered_Mixin,org.spongepowered.asm.service.modlauncher.ext,0,0,0,0,0,0,1,1
spotify_crtauth-java,com.spotify.crtauth,2,0,0,0,0,2,0,4
spotify_crtauth-java,com.spotify.crtauth.exceptions,0,0,0,0,0,0,0,0
spotify_crtauth-java,com.spotify.crtauth.keyprovider,0,0,0,0,0,1,0,1
spotify_crtauth-java,com.spotify.crtauth.protocol,1,1,0,0,0,1,0,3
spotify_crtauth-java,com.spotify.crtauth.signer,1,1,0,0,1,0,0,3
spotify_crtauth-java,com.spotify.crtauth.utils,0,0,0,0,1,2,0,3
spotify_docker-client,com.spotify.docker.client,3,0,0,1,1,1,0,6
spotify_docker-client,com.spotify.docker.client.auth,1,0,0,0,1,1,0,3
spotify_docker-client,com.spotify.docker.client.auth.gcr,0,0,0,0,0,0,0,0
spotify_docker-client,com.spotify.docker.client.exceptions,0,0,0,0,0,0,0,0
spotify_docker-client,com.spotify.docker.client.jackson,0,0,0,0,1,0,0,1
spotify_docker-client,com.spotify.docker.client.messages,3,1,0,1,1,1,0,7
spotify_docker-client,com.spotify.docker.client.messages.mount,0,0,0,0,1,0,0,1
spotify_docker-client,com.spotify.docker.client.messages.swarm,1,0,0,1,1,0,0,3
spotify_docker-client,com.spotify.docker.client.npipe,0,0,0,0,0,0,0,0
spotify_docker-client,com.spotify.docker,0,0,0,0,0,0,0,0
spotify_docker-client,com.spotify.docker.it,0,0,0,0,0,0,0,0
spotify_docker-maven-plugin,com.spotify.simple,0,0,0,0,1,0,0,1
spotify_docker-maven-plugin,com.spotify.manymodules,0,0,0,0,0,0,0,0
spotify_docker-maven-plugin,com.spotify.docker,0,0,0,0,1,0,0,1
spotify_helios,com.spotify.helios.client,0,0,0,0,1,0,1,2
spotify_helios,com.spotify.helios.common,1,0,0,0,1,1,1,4
spotify_helios,com.spotify.helios.common.descriptors,1,1,0,1,0,2,1,6
spotify_helios,com.spotify.helios.common.protocol,0,1,0,0,1,0,1,3
spotify_helios,com.spotify.helios,7,1,0,0,1,0,1,10
spotify_helios,com.spotify.helios.serviceregistration,0,0,0,0,1,0,1,2
spotify_helios,com.spotify.helios.agent,6,0,0,1,1,2,1,11
spotify_helios,com.spotify.helios.master,6,1,0,0,1,1,1,10
spotify_helios,com.spotify.helios.master.http,0,0,0,0,0,0,1,1
spotify_helios,com.spotify.helios.master.metrics,0,0,0,0,1,0,1,2
spotify_helios,com.spotify.helios.master.reaper,3,0,0,0,1,0,1,5
spotify_helios,com.spotify.helios.master.resources,0,0,0,0,1,1,1,3
spotify_helios,com.spotify.helios.rollingupdate,2,0,0,0,1,0,1,4
spotify_helios,com.spotify.helios.servicescommon,3,1,0,1,1,0,1,7
spotify_helios,com.spotify.helios.servicescommon.coordination,11,1,0,1,1,2,1,17
spotify_helios,com.spotify.helios.servicescommon.statistics,0,0,0,0,1,0,1,2
spotify_helios,com.spotify.helios.system,0,0,0,1,1,0,1,3
spotify_helios,com.spotify.helios.cli,0,1,0,0,1,0,1,3
spotify_helios,com.spotify.helios.cli.command,0,0,0,1,1,0,1,3
spotify_trickle,com.spotify.trickle.example,0,0,0,0,0,0,0,0
spotify_trickle,com.spotify.trickle,0,0,0,1,1,0,0,2
spring-cloud_spring-cloud-cli,org.springframework.cloud.cli.command,0,0,0,0,0,0,0,0
spring-cloud_spring-cloud-cli,org.springframework.cloud.cli.command.encrypt,0,0,0,0,1,0,0,1
spring-cloud_spring-cloud-cli,org.springframework.cloud.cli.command.url,0,0,0,0,1,0,0,1
spring-cloud_spring-cloud-cli,org.springframework.cloud.cli.compiler,0,0,0,0,1,0,0,1
spring-cloud_spring-cloud-cli,org.springframework.cloud.cli,0,0,0,0,0,0,0,0
spring-cloud_spring-cloud-cli,org.springframework.cloud.launcher.cli,0,0,0,0,0,0,0,0
spring-cloud_spring-cloud-cli,org.springframework.cloud.launcher.configserver,0,0,0,0,0,0,0,0
spring-cloud_spring-cloud-cli,org.springframework.cloud.launcher.dataflow,0,0,0,0,0,0,0,0
spring-cloud_spring-cloud-cli,org.springframework.cloud.launcher.deployer,0,0,0,0,1,0,0,1
spring-cloud_spring-cloud-cli,org.springframework.cloud.launcher.eureka,0,0,0,0,0,0,0,0
spring-cloud_spring-cloud-cli,org.springframework.cloud.launcher.h2,0,0,0,0,0,0,0,0
spring-cloud_spring-cloud-cli,org.springframework.cloud.launcher.hystrixdashboard,0,0,0,0,0,0,0,0
spring-cloud_spring-cloud-cli,org.springframework.cloud.launcher.kafka,0,0,0,0,0,0,0,0
spring-cloud_spring-cloud-cli,org.springframework.cloud.launcher.stubrunner,0,0,0,0,0,0,0,0
spring-cloud_spring-cloud-config,org.springframework.cloud.config.client,0,0,0,0,1,0,0,1
spring-cloud_spring-cloud-config,org.springframework.cloud.config.environment,0,0,0,0,0,0,0,0
spring-cloud_spring-cloud-config,org.springframework.cloud.config.monitor,0,0,0,0,1,0,0,1
spring-cloud_spring-cloud-config,org.springframework.cloud.config.server.bootstrap,0,0,0,0,0,0,0,0
spring-cloud_spring-cloud-config,org.springframework.cloud.config.server.composite,1,1,0,0,0,0,0,2
spring-cloud_spring-cloud-config,org.springframework.cloud.config.server.config,1,0,0,1,1,0,0,3
spring-cloud_spring-cloud-config,org.springframework.cloud.config.server,1,0,0,1,1,0,0,3
spring-cloud_spring-cloud-config,org.springframework.cloud.config.server.diagnostics,0,0,0,0,0,0,0,0
spring-cloud_spring-cloud-config,org.springframework.cloud.config.server.encryption,0,0,0,1,1,0,0,2
spring-cloud_spring-cloud-config,org.springframework.cloud.config.server.environment,1,1,0,1,1,1,0,5
spring-cloud_spring-cloud-config,org.springframework.cloud.config.server.environment.vault.authentication,0,0,0,0,1,0,0,1
spring-cloud_spring-cloud-config,org.springframework.cloud.config.server.environment.vault,0,0,0,0,1,0,0,1
spring-cloud_spring-cloud-config,org.springframework.cloud.config.server.proxy,0,0,0,0,0,0,0,0
spring-cloud_spring-cloud-config,org.springframework.cloud.config.server.resource,0,0,0,0,1,0,0,1
spring-cloud_spring-cloud-config,org.springframework.cloud.config.server.ssh,0,1,0,0,1,1,0,3
spring-cloud_spring-cloud-config,org.springframework.cloud.config.server.support,0,0,0,0,1,1,0,2
spring-cloud_spring-cloud-config,org.springframework.cloud.config.server.credentials,0,0,0,0,0,0,0,0
spring-cloud_spring-cloud-consul,(default package),0,0,0,0,0,0,0,0
spring-cloud_spring-cloud-consul,org.springframework.cloud.consul.binder.config,0,0,0,0,0,0,0,0
spring-cloud_spring-cloud-consul,org.springframework.cloud.consul.binder,0,0,0,0,1,0,0,1
spring-cloud_spring-cloud-consul,org.springframework.cloud.consul.config,0,0,0,0,1,0,0,1
spring-cloud_spring-cloud-consul,org.springframework.cloud.consul,0,0,0,0,1,0,0,1
spring-cloud_spring-cloud-consul,org.springframework.cloud.consul.discovery,0,0,0,1,1,0,0,2
spring-cloud_spring-cloud-consul,org.springframework.cloud.consul.discovery.configclient,0,0,0,0,1,0,0,1
spring-cloud_spring-cloud-consul,org.springframework.cloud.consul.discovery.filters,0,0,0,0,0,0,0,0
spring-cloud_spring-cloud-consul,org.springframework.cloud.consul.discovery.reactive,0,0,0,0,0,0,0,0
spring-cloud_spring-cloud-consul,org.springframework.cloud.consul.serviceregistry,0,0,0,1,1,0,0,2
spring-cloud_spring-cloud-consul,org.springframework.cloud.consul.support,0,0,0,0,0,0,0,0
spring-projects_spring-data-examples,example.springdata.cassandra.basic,0,0,0,0,0,0,0,0
spring-projects_spring-data-examples,example.springdata.cassandra.convert,0,0,0,0,0,0,0,0
spring-projects_spring-data-examples,example.springdata.cassandra.events,0,0,0,0,0,0,0,0
spring-projects_spring-data-examples,example.springdata.cassandra.projection,0,0,0,0,1,0,0,1
spring-projects_spring-data-examples,example.springdata.cassandra.udt,0,0,0,0,0,0,0,0
spring-projects_spring-data-examples,example.springdata.cassandra.java8,0,0,0,0,1,0,0,1
spring-projects_spring-data-examples,example.springdata.cassandra.people,0,0,0,0,1,0,0,1
spring-projects_spring-data-examples,example.springdata.cassandra.util,0,0,0,0,0,0,0,0
spring-projects_spring-data-examples,example.springdata.couchbase.model,0,0,0,0,0,0,0,0
spring-projects_spring-data-examples,example.springdata.couchbase.repository,0,0,0,0,1,0,0,1
spring-projects_spring-data-examples,example.springdata.couchbase,0,0,0,0,0,0,0,0
spring-projects_spring-data-examples,example.springdata.couchbase.template,0,0,0,0,0,0,0,0
spring-projects_spring-data-examples,example.springdata.couchbase.util,0,0,0,0,0,0,0,0
spring-projects_spring-data-examples,example.springdata.elasticsearch.conference,0,0,0,0,1,0,0,1
spring-projects_spring-data-examples,example.springdata.elasticsearch.util,0,0,0,0,0,0,0,0
spring-projects_spring-data-examples,example.springdata.jdbc.basics.aggregate,0,0,0,0,1,0,0,1
spring-projects_spring-data-examples,example.springdata.jdbc.basics.simpleentity,0,0,0,0,1,0,0,1
spring-projects_spring-data-examples,example.springdata.jdbc.basics,0,0,0,0,0,0,0,0
spring-projects_spring-data-examples,example.springdata.jdbc.jooq,0,0,0,0,1,0,0,1
spring-projects_spring-data-examples,example.springdata.jdbc.basics.simpleentity.domain,1,0,0,0,1,0,0,2
spring-projects_spring-data-examples,example.springdata.jdbc.basics.simpleentity.domain.tables,1,1,0,0,0,0,0,2
spring-projects_spring-data-examples,example.springdata.jdbc.basics.simpleentity.domain.tables.records,0,0,0,0,0,0,0,0
spring-projects_spring-data-examples,example.springdata.jdbc.mybatis,0,0,0,0,1,0,0,1
spring-projects_spring-data-examples,example,0,0,0,0,1,0,0,1
spring-projects_spring-data-examples,example.model,0,0,0,2,1,0,0,3
spring-projects_spring-data-examples,example.repo,0,0,0,1,1,0,0,2
spring-projects_spring-data-examples,example.service,0,0,0,1,1,0,0,2
spring-projects_spring-data-examples,example.springdata.jpa.eclipselink,0,0,0,0,0,0,0,0
spring-projects_spring-data-examples,example.springdata.jpa.auditing,0,0,0,0,0,0,0,0
spring-projects_spring-data-examples,example.springdata.jpa.caching,0,0,0,0,0,0,0,0
spring-projects_spring-data-examples,example.springdata.jpa.compositions,0,0,0,0,1,0,0,1
spring-projects_spring-data-examples,example.springdata.jpa.custom,0,0,0,0,1,0,0,1
spring-projects_spring-data-examples,example.springdata.jpa.customall,0,0,0,0,1,0,0,1
spring-projects_spring-data-examples,example.springdata.jpa.projections,0,0,0,0,1,0,0,1
spring-projects_spring-data-examples,example.springdata.jpa.simple,0,0,0,0,0,0,0,0
spring-projects_spring-data-examples,example.springdata.jpa.basics,0,0,0,0,0,0,0,0
spring-projects_spring-data-examples,example.springdata.jpa.interceptors,0,0,0,0,0,0,0,0
spring-projects_spring-data-examples,example.springdata.jpa.java8,0,0,0,0,0,0,0,0
spring-projects_spring-data-examples,example.springdata.jpa.resultsetmappings,0,0,0,0,1,0,0,1
spring-projects_spring-data-examples,example.springdata.jpa.storedprocedures,0,0,0,0,0,0,0,0
spring-projects_spring-data-examples,example.springdata.jpa.multipleds,0,0,0,0,0,0,0,0
spring-projects_spring-data-examples,example.springdata.jpa.multipleds.customer,0,0,0,0,0,0,0,0
spring-projects_spring-data-examples,example.springdata.jpa.multipleds.order,0,0,0,0,0,0,0,0
spring-projects_spring-data-examples,example.springdata.jpa.querybyexample,0,0,0,0,1,0,0,1
spring-projects_spring-data-examples,example.springdata.jpa.security,0,0,0,0,1,0,0,1
spring-projects_spring-data-examples,example.springdata.jpa.showcase.after,0,0,0,0,0,0,0,0
spring-projects_spring-data-examples,example.springdata.jpa.showcase.before,0,0,0,0,1,0,0,1
spring-projects_spring-data-examples,example.springdata.jpa.showcase.core,0,0,0,0,0,0,0,0
spring-projects_spring-data-examples,example.springdata.jpa.showcase.snippets,0,0,0,0,1,0,0,1
spring-projects_spring-data-examples,example.springdata.jpa.showcase,0,0,0,0,0,0,0,0
spring-projects_spring-data-examples,example.springdata.ldap,0,0,0,0,0,0,0,0
spring-projects_spring-data-examples,example.springdata.map,0,0,0,0,0,0,0,0
spring-projects_spring-data-examples,example.springdata.mongodb.aggregation,0,0,0,0,1,0,0,1
spring-projects_spring-data-examples,example.springdata.mongodb,0,0,0,0,1,0,0,1
spring-projects_spring-data-examples,example.springdata.mongodb.advanced,0,0,0,0,0,0,0,0
spring-projects_spring-data-examples,example.springdata.mongodb.customer,0,0,0,0,1,0,0,1
spring-projects_spring-data-examples,example.springdata.mongodb.projections,0,0,0,0,1,0,0,1
spring-projects_spring-data-examples,org.bson.types,0,0,0,0,0,0,0,0
spring-projects_spring-data-examples,example.springdata.mongodb.fluent,0,0,0,0,1,0,0,1
spring-projects_spring-data-examples,example.springdata.mongodb.geojson,0,0,0,0,0,0,0,0
spring-projects_spring-data-examples,example.springdata.mongodb.gridfs,0,0,0,0,0,0,0,0
spring-projects_spring-data-examples,example.springdata.mongodb.people,0,0,0,0,1,0,0,1
spring-projects_spring-data-examples,example.springdata.mongodb.querybyexample,0,0,0,0,1,0,0,1
spring-projects_spring-data-examples,example.springdata.mongodb.imperative,0,0,0,0,1,0,0,1
spring-projects_spring-data-examples,example.springdata.mongodb.reactive,0,0,0,0,1,0,0,1
spring-projects_spring-data-examples,example.springdata.mongodb.schema,0,0,0,0,0,0,0,0
spring-projects_spring-data-examples,example.springdata.mongodb.security,0,0,0,0,0,0,0,0
spring-projects_spring-data-examples,example.springdata.mongodb.textsearch,0,0,0,0,0,0,0,0
spring-projects_spring-data-examples,example.springdata.mongodb.util,0,0,0,0,1,0,0,1
spring-projects_spring-data-examples,example.springdata.multistore,0,0,0,0,0,0,0,0
spring-projects_spring-data-examples,example.springdata.multistore.customer,0,0,0,0,0,0,0,0
spring-projects_spring-data-examples,example.springdata.multistore.shop,0,0,0,0,0,0,0,0
spring-projects_spring-data-examples,example.springdata.neo4j,0,0,0,0,1,0,0,1
spring-projects_spring-data-examples,example.springdata.r2dbc.basics,0,0,0,0,1,0,0,1
spring-projects_spring-data-examples,example.springdata.redis.cluster,0,0,0,0,0,0,0,0
spring-projects_spring-data-examples,example.springdata.redis.commands,0,0,0,0,0,0,0,0
spring-projects_spring-data-examples,example.springdata.redis,0,0,0,0,0,0,0,0
spring-projects_spring-data-examples,example.springdata.redis.operations,0,0,0,0,0,0,0,0
spring-projects_spring-data-examples,example.springdata.redis.repositories,0,0,0,0,0,0,0,0
spring-projects_spring-data-examples,example.springdata.redis.sentinel,0,0,0,0,0,0,0,0
spring-projects_spring-data-examples,example.springdata.rest.headers,0,0,0,0,1,0,0,1
spring-projects_spring-data-examples,example.springdata.multistore.person,0,0,0,0,0,0,0,0
spring-projects_spring-data-examples,example.springdata.multistore.treasure,0,0,0,0,0,0,0,0
spring-projects_spring-data-examples,example.springdata.rest.projections,0,0,0,0,1,0,0,1
spring-projects_spring-data-examples,example.springdata.rest.security,0,0,0,0,1,0,0,1
spring-projects_spring-data-examples,example.springdata.rest.stores,0,0,0,0,1,0,0,1
spring-projects_spring-data-examples,example.springdata.rest.stores.web,0,0,0,0,0,0,0,0
spring-projects_spring-data-examples,example.springdata.rest.uris,0,0,0,0,1,0,0,1
spring-projects_spring-data-examples,example.springdata.solr.product,0,0,0,0,1,0,0,1
spring-projects_spring-data-examples,example.springdata.solr,0,0,0,0,1,0,0,1
spring-projects_spring-data-examples,example.users,0,0,0,0,1,0,0,1
spring-projects_spring-data-examples,example.users.web,0,0,0,0,0,0,0,0
spring-projects_spring-data-keyvalue,org.springframework.data.keyvalue.core,0,0,0,1,1,0,0,2
spring-projects_spring-data-keyvalue,org.springframework.data.keyvalue.core.event,0,0,0,0,1,0,0,1
spring-projects_spring-data-keyvalue,org.springframework.data.keyvalue.core.mapping,0,0,0,0,1,0,0,1
spring-projects_spring-data-keyvalue,org.springframework.data.keyvalue.core.mapping.context,0,0,0,0,0,0,0,0
spring-projects_spring-data-keyvalue,org.springframework.data.keyvalue.core.query,0,0,0,0,0,0,0,0
spring-projects_spring-data-keyvalue,org.springframework.data.keyvalue.repository.config,0,0,0,0,0,0,0,0
spring-projects_spring-data-keyvalue,org.springframework.data.keyvalue.repository,0,0,0,0,0,0,0,0
spring-projects_spring-data-keyvalue,org.springframework.data.keyvalue.repository.query,0,0,0,0,1,0,0,1
spring-projects_spring-data-keyvalue,org.springframework.data.keyvalue.repository.support,0,0,0,0,1,0,0,1
spring-projects_spring-data-keyvalue,org.springframework.data.map,0,0,0,0,1,0,0,1
spring-projects_spring-data-keyvalue,org.springframework.data.map.repository.config,0,0,0,0,1,0,0,1
spring-projects_spring-data-keyvalue,org.springframework.data.keyvalue,0,0,0,0,1,0,0,1
spring-projects_spring-integration-java-dsl,org.springframework.integration.dsl,0,1,0,1,0,0,0,2
spring-projects_spring-integration-java-dsl,org.springframework.integration.dsl.amqp,0,0,0,0,0,0,0,0
spring-projects_spring-integration-java-dsl,org.springframework.integration.dsl.channel,0,0,0,0,0,0,0,0
spring-projects_spring-integration-java-dsl,org.springframework.integration.dsl.config,0,0,0,0,0,0,0,0
spring-projects_spring-integration-java-dsl,org.springframework.integration.dsl.context,0,0,0,0,0,0,0,0
spring-projects_spring-integration-java-dsl,org.springframework.integration.dsl.core,0,0,0,0,0,0,0,0
spring-projects_spring-integration-java-dsl,org.springframework.integration.dsl.feed,0,0,0,0,0,0,0,0
spring-projects_spring-integration-java-dsl,org.springframework.integration.dsl.file,0,0,0,0,1,0,0,1
spring-projects_spring-integration-java-dsl,org.springframework.integration.dsl.ftp,0,0,0,0,0,0,0,0
spring-projects_spring-integration-java-dsl,org.springframework.integration.dsl.http,0,0,0,0,0,0,0,0
spring-projects_spring-integration-java-dsl,org.springframework.integration.dsl.jms,0,0,0,0,0,0,0,0
spring-projects_spring-integration-java-dsl,org.springframework.integration.dsl.jpa,0,0,0,0,0,0,0,0
spring-projects_spring-integration-java-dsl,org.springframework.integration.dsl.kafka,0,0,0,0,0,0,0,0
spring-projects_spring-integration-java-dsl,org.springframework.integration.dsl.mail,0,0,0,0,0,0,0,0
spring-projects_spring-integration-java-dsl,org.springframework.integration.dsl.scripting,0,0,0,0,0,0,0,0
spring-projects_spring-integration-java-dsl,org.springframework.integration.dsl.sftp,0,0,0,0,0,0,0,0
spring-projects_spring-integration-java-dsl,org.springframework.integration.dsl.support,0,0,0,0,1,0,0,1
spring-projects_spring-integration-java-dsl,org.springframework.integration.dsl.support.tuple,0,0,0,0,0,0,0,0
spring-projects_spring-integration-java-dsl,org.springframework.integration.dsl.transaction,0,0,0,0,0,0,0,0
spring-projects_spring-integration-kafka,org.springframework.integration.kafka.config.xml,0,0,0,0,1,0,0,1
spring-projects_spring-integration-kafka,org.springframework.integration.kafka.dsl,2,0,0,0,0,0,0,2
spring-projects_spring-integration-kafka,org.springframework.integration.kafka.inbound,2,1,0,0,1,0,0,4
spring-projects_spring-integration-kafka,org.springframework.integration.kafka.outbound,1,0,0,0,0,0,0,1
spring-projects_spring-integration-kafka,org.springframework.integration.kafka.support,0,0,0,0,0,0,0,0
spring-projects_spring-restdocs,com.example,0,0,0,0,0,0,1,1
spring-projects_spring-restdocs,com.example.mockmvc,0,0,0,0,1,0,1,2
spring-projects_spring-restdocs,com.example.restassured,0,0,0,0,1,0,1,2
spring-projects_spring-restdocs,com.example.junit5,0,0,0,0,0,0,1,1
spring-projects_spring-restdocs,com.example.notes,0,0,0,1,1,0,1,3
spring-projects_spring-restdocs,org.springframework.restdocs.asciidoctor,0,0,0,0,0,0,1,1
spring-projects_spring-restdocs,org.springframework.restdocs.cli,0,0,0,0,0,0,1,1
spring-projects_spring-restdocs,org.springframework.restdocs.config,0,0,0,0,0,0,1,1
spring-projects_spring-restdocs,org.springframework.restdocs.constraints,0,0,0,0,0,0,1,1
spring-projects_spring-restdocs,org.springframework.restdocs.generate,3,1,0,0,0,0,1,5
spring-projects_spring-restdocs,org.springframework.restdocs.headers,0,0,0,0,0,0,1,1
spring-projects_spring-restdocs,org.springframework.restdocs.http,0,0,0,0,0,0,1,1
spring-projects_spring-restdocs,org.springframework.restdocs.hypermedia,3,0,0,0,0,0,1,4
spring-projects_spring-restdocs,org.springframework.restdocs,9,1,0,0,1,0,1,12
spring-projects_spring-restdocs,org.springframework.restdocs.operation,0,0,0,0,1,0,1,2
spring-projects_spring-restdocs,org.springframework.restdocs.operation.preprocess,5,1,0,1,0,0,1,8
spring-projects_spring-restdocs,org.springframework.restdocs.payload,0,0,0,1,0,0,1,2
spring-projects_spring-restdocs,org.springframework.restdocs.request,0,0,0,0,0,0,1,1
spring-projects_spring-restdocs,org.springframework.restdocs.snippet,4,0,0,0,1,0,1,6
spring-projects_spring-restdocs,org.springframework.restdocs.templates.mustache,0,0,0,0,0,0,1,1
spring-projects_spring-restdocs,org.springframework.restdocs.templates,0,0,0,0,1,0,1,2
spring-projects_spring-restdocs,org.springframework.restdocs.mockmvc,0,0,0,0,0,0,1,1
spring-projects_spring-restdocs,org.springframework.restdocs.restassured3.operation.preprocess,0,0,0,0,0,0,1,1
spring-projects_spring-restdocs,org.springframework.restdocs.restassured3,0,0,0,0,0,0,1,1
spring-projects_spring-session,org.springframework.session.config.annotation.web.http,0,0,0,0,1,0,0,1
spring-projects_spring-session,org.springframework.session.config.annotation.web.server,0,0,1,0,0,0,0,1
spring-projects_spring-session,org.springframework.session.config,0,0,0,0,0,0,0,0
spring-projects_spring-session,org.springframework.session,0,0,0,0,0,0,0,0
spring-projects_spring-session,org.springframework.session.events,0,0,0,0,0,0,0,0
spring-projects_spring-session,org.springframework.session.security,0,0,0,0,0,0,0,0
spring-projects_spring-session,org.springframework.session.security.web.authentication,0,0,0,0,0,0,0,0
spring-projects_spring-session,org.springframework.session.web.context,0,0,0,0,0,0,0,0
spring-projects_spring-session,org.springframework.session.web.http,0,0,0,0,0,0,0,0
spring-projects_spring-session,org.springframework.session.web.server.session,0,0,0,0,0,0,0,0
spring-projects_spring-session,org.springframework.session.web.socket.config.annotation,0,0,0,0,0,0,0,0
spring-projects_spring-session,org.springframework.session.web.socket.events,0,0,0,0,0,0,0,0
spring-projects_spring-session,org.springframework.session.web.socket.handler,0,0,0,0,0,0,0,0
spring-projects_spring-session,org.springframework.session.web.socket.server,0,0,0,0,0,0,0,0
spring-projects_spring-session,org.springframework.session.data.redis,0,0,0,0,0,0,0,0
spring-projects_spring-session,org.springframework.session.data.redis.config.annotation.web.http,0,0,0,1,1,0,0,2
spring-projects_spring-session,org.springframework.session.data.redis.flushimmediately,0,0,0,0,0,0,0,0
spring-projects_spring-session,org.springframework.session.data.redis.taskexecutor,0,0,0,0,0,0,0,0
spring-projects_spring-session,org.springframework.session.data,0,0,0,0,0,0,0,0
spring-projects_spring-session,org.springframework.session.data.redis.config.annotation.web.server,0,0,0,0,1,0,0,1
spring-projects_spring-session,org.springframework.session.data.redis.config,0,0,0,0,0,0,0,0
spring-projects_spring-session,org.springframework.session.data.redis.config.annotation.web.http.gh109,0,0,0,0,0,0,0,0
spring-projects_spring-session,docs,0,0,0,0,1,0,0,1
spring-projects_spring-session,docs.http,0,0,0,0,1,0,0,1
spring-projects_spring-session,docs.security,0,0,0,0,0,0,0,0
spring-projects_spring-session,docs.websocket,0,0,0,0,0,0,0,0
spring-projects_spring-session,org.springframework.session.hazelcast,0,0,0,0,0,0,0,0
spring-projects_spring-session,org.springframework.session.hazelcast.config.annotation.web.http,0,0,0,0,0,0,0,0
spring-projects_spring-session,org.springframework.session.jdbc,0,0,0,1,0,0,0,1
spring-projects_spring-session,org.springframework.session.jdbc.config.annotation.web.http,0,0,0,0,1,0,0,1
spring-projects_spring-session,rest,0,0,0,0,0,0,0,0
SpringData_spring-data-cassandra,org.springdata.cassandra.config,0,1,0,0,0,0,0,1
SpringData_spring-data-cassandra,org.springdata.cassandra.config.java,0,0,0,0,0,0,0,0
SpringData_spring-data-cassandra,org.springdata.cassandra.config.xml,0,0,0,0,0,0,0,0
SpringData_spring-data-cassandra,org.springdata.cassandra.convert,0,0,0,0,1,0,0,1
SpringData_spring-data-cassandra,org.springdata.cassandra.core,0,0,0,0,1,0,0,1
SpringData_spring-data-cassandra,org.springdata.cassandra.mapping,0,0,0,0,1,0,0,1
SpringData_spring-data-cassandra,org.springdata.cassandra.mapping.support,0,0,0,0,0,0,0,0
SpringData_spring-data-cassandra,org.springdata.cassandra.repository,0,0,0,0,0,0,0,0
SpringData_spring-data-cassandra,org.springdata.cassandra.repository.config,0,0,0,0,0,0,0,0
SpringData_spring-data-cassandra,org.springdata.cassandra.repository.query,0,0,0,0,0,0,0,0
SpringData_spring-data-cassandra,org.springdata.cassandra.repository.support,0,0,0,0,0,0,0,0
SpringData_spring-data-cassandra,org.springdata.cql.builder,0,0,0,0,1,0,0,1
SpringData_spring-data-cassandra,org.springdata.cql.config,0,0,0,0,1,0,0,1
SpringData_spring-data-cassandra,org.springdata.cql.config.java,0,0,0,0,0,0,0,0
SpringData_spring-data-cassandra,org.springdata.cql.config.xml,0,0,0,0,0,0,0,0
SpringData_spring-data-cassandra,org.springdata.cql.core,0,0,0,1,1,0,0,2
SpringData_spring-data-cassandra,org.springdata.cql.generator,0,0,0,0,0,0,0,0
SpringData_spring-data-cassandra,org.springdata.cql.option,0,0,0,0,1,0,0,1
SpringData_spring-data-cassandra,org.springdata.cql.spec,0,0,0,0,1,0,0,1
SpringData_spring-data-cassandra,org.springdata.cql.support,0,0,0,0,0,0,0,0
SpringData_spring-data-cassandra,org.springdata.cql.support.exception,0,0,0,0,1,0,0,1
SpringData_spring-data-cassandra,org.springdata.cql.util,0,0,0,0,0,0,0,0
springdox_springdox,springfox.bean.validators.configuration,0,0,0,0,0,0,1,1
springdox_springdox,springfox.bean.validators.plugins.parameter,0,0,0,0,1,0,1,2
springdox_springdox,springfox.bean.validators.plugins,0,0,0,0,0,0,1,1
springdox_springdox,springfox.bean.validators.plugins.schema,0,0,0,0,1,0,1,2
springdox_springdox,springfox.bean.validators.plugins.models,0,0,0,0,1,0,1,2
springdox_springdox,springfox.documentation.builders,6,0,0,0,1,0,1,8
springdox_springdox,springfox.documentation.common,0,0,0,0,0,0,1,1
springdox_springdox,springfox.documentation,0,0,0,0,0,0,1,1
springdox_springdox,springfox.documentation.schema,20,1,0,1,1,0,1,24
springdox_springdox,springfox.documentation.service,12,1,0,1,1,0,1,16
springdox_springdox,springfox.documentation.spring.wrapper,0,0,0,0,0,0,1,1
springdox_springdox,springfox.documentation.spring.data.rest,0,0,0,0,0,0,1,1
springdox_springdox,springfox.documentation.spring.data.rest.configuration,0,0,0,0,0,0,1,1
springdox_springdox,springfox.documentation.spring.data.rest.schema,0,0,0,0,0,0,1,1
springdox_springdox,springfox.documentation.oas.mappers,0,0,0,0,0,0,1,1
springdox_springdox,springfox.documentation.oas.configuration,0,0,0,0,0,0,1,1
springdox_springdox,springfox.documentation.oas.web,0,0,0,0,0,0,1,1
springdox_springdox,springfox.petstore.controller,0,0,0,0,0,0,1,1
springdox_springdox,springfox.petstore.model,0,0,0,0,1,0,1,2
springdox_springdox,springfox.petstore,0,0,0,0,0,0,1,1
springdox_springdox,springfox.petstore.repository,0,0,0,0,0,0,1,1
springdox_springdox,springfox.petstore.webflux.controller,0,0,0,0,0,0,1,1
springdox_springdox,springfox.petstore.webflux.model,0,0,0,0,0,0,1,1
springdox_springdox,springfox.petstore.webflux,0,0,0,0,0,0,1,1
springdox_springdox,springfox.petstore.webflux.repository,0,0,0,0,0,0,1,1
springdox_springdox,springfox.documentation.schema.configuration,0,0,0,0,0,0,1,1
springdox_springdox,springfox.documentation.schema.plugins,4,0,0,0,0,0,1,5
springdox_springdox,springfox.documentation.schema.property,9,0,0,0,1,0,1,11
springdox_springdox,springfox.documentation.schema.property.bean,2,0,0,0,0,0,1,3
springdox_springdox,springfox.documentation.schema.property.field,2,0,0,0,0,0,1,3
springdox_springdox,springfox.documentation.spi,0,0,0,0,0,0,1,1
springdox_springdox,springfox.documentation.spi.schema,10,1,0,0,1,0,1,13
springdox_springdox,springfox.documentation.spi.schema.contexts,7,1,0,0,0,0,1,9
springdox_springdox,springfox.documentation.spi.service,1,0,0,0,1,0,1,3
springdox_springdox,springfox.documentation.spi.service.contexts,5,1,0,0,1,0,1,8
springdox_springdox,springfox.springconfig,0,0,0,0,0,0,1,1
springdox_springdox,springfox.documentation.spring.web,3,1,0,0,1,0,1,6
springdox_springdox,springfox.documentation.spring.web.plugins,8,1,0,0,1,0,1,11
springdox_springdox,springfox.documentation.spring.web.json,0,0,0,0,0,0,1,1
springdox_springdox,springfox.documentation.spring.web.paths,0,0,0,0,1,0,1,2
springdox_springdox,springfox.documentation.spring.web.readers.operation,6,1,0,0,1,0,1,9
springdox_springdox,springfox.documentation.spring.web.readers.parameter,3,0,0,0,1,0,1,5
springdox_springdox,springfox.documentation.spring.web.scanners,3,0,0,0,1,0,1,5
springdox_springdox,springfox.documentation.spring.web.configuration,0,0,0,0,0,0,1,1
springdox_springdox,springfox.documentation.spring.web.dummy,0,0,0,1,1,0,1,3
springdox_springdox,springfox.documentation.spring.web.dummy.controllers,0,0,0,1,1,0,1,3
springdox_springdox,springfox.documentation.spring.web.dummy.models,0,0,0,1,1,0,1,3
springdox_springdox,springfox.documentation.spring.web.dummy.models.same,0,0,0,0,0,0,1,1
springdox_springdox,springfox.documentation.swagger.annotations,0,0,0,0,0,0,1,1
springdox_springdox,springfox.documentation.swagger.common,0,0,0,0,0,0,1,1
springdox_springdox,springfox.documentation.swagger.configuration,0,0,0,0,0,0,1,1
springdox_springdox,springfox.documentation.swagger.readers.operation,0,0,0,0,1,0,1,2
springdox_springdox,springfox.documentation.swagger.readers.parameter,0,0,0,0,0,0,1,1
springdox_springdox,springfox.documentation.swagger.schema,0,0,0,0,0,0,1,1
springdox_springdox,springfox.documentation.swagger.web,0,0,0,0,1,0,1,2
springdox_springdox,springfox.documentation.swagger1.mappers,0,0,0,0,1,0,1,2
springdox_springdox,springfox.documentation.swagger1.configuration,0,0,0,0,1,0,1,2
springdox_springdox,springfox.documentation.swagger1.dto,0,0,0,1,1,0,1,3
springdox_springdox,springfox.documentation.swagger1.readers.parameter,0,0,0,0,0,0,1,1
springdox_springdox,springfox.documentation.swagger1.web,0,0,0,0,0,0,1,1
springdox_springdox,springfox.documentation.swagger1.models,0,0,0,0,0,0,1,1
springdox_springdox,springfox.documentation.swagger2.mappers,0,0,0,0,0,0,1,1
springdox_springdox,springfox.documentation.swagger2.configuration,0,0,0,0,1,0,1,2
springdox_springdox,springfox.documentation.swagger2.web,0,0,0,0,0,0,1,1
springer-opensource_omelet,pageobjects,0,0,0,0,1,0,0,1
springer-opensource_omelet,omelet.browserstack.support,0,0,0,0,0,0,0,0
springer-opensource_omelet,omelet.common,0,0,0,0,0,0,0,0
springer-opensource_omelet,omelet.configuration,4,1,0,0,0,0,0,5
springer-opensource_omelet,omelet.data,12,1,0,0,1,0,0,14
springer-opensource_omelet,omelet.data.driverconf,5,1,0,0,1,1,0,8
springer-opensource_omelet,omelet.data.googlesheet,1,0,0,0,0,0,0,1
springer-opensource_omelet,omelet.data.xml,2,0,0,0,0,0,0,2
springer-opensource_omelet,omelet.driver,6,1,0,0,1,1,0,9
springer-opensource_omelet,omelet.exception,0,0,0,0,0,0,0,0
springer-opensource_omelet,omelet.mail,0,0,0,0,0,0,0,0
springer-opensource_omelet,omelet.support.saucelabs,0,0,0,0,0,1,0,1
springfox_springfox,springfox.bean.validators.configuration,0,0,0,0,0,0,1,1
springfox_springfox,springfox.bean.validators.plugins.parameter,0,0,0,0,1,0,1,2
springfox_springfox,springfox.bean.validators.plugins,0,0,0,0,0,0,1,1
springfox_springfox,springfox.bean.validators.plugins.schema,0,0,0,0,1,0,1,2
springfox_springfox,springfox.bean.validators.plugins.models,0,0,0,0,1,0,1,2
springfox_springfox,springfox.documentation.builders,6,0,0,0,1,0,1,8
springfox_springfox,springfox.documentation.common,0,0,0,0,0,0,1,1
springfox_springfox,springfox.documentation,0,0,0,0,0,0,1,1
springfox_springfox,springfox.documentation.schema,20,1,0,1,1,0,1,24
springfox_springfox,springfox.documentation.service,12,1,0,1,1,0,1,16
springfox_springfox,springfox.documentation.spring.wrapper,0,0,0,0,0,0,1,1
springfox_springfox,springfox.documentation.spring.data.rest,0,0,0,0,0,0,1,1
springfox_springfox,springfox.documentation.spring.data.rest.configuration,0,0,0,0,0,0,1,1
springfox_springfox,springfox.documentation.spring.data.rest.schema,0,0,0,0,0,0,1,1
springfox_springfox,springfox.documentation.oas.mappers,0,0,0,0,0,0,1,1
springfox_springfox,springfox.documentation.oas.configuration,0,0,0,0,0,0,1,1
springfox_springfox,springfox.documentation.oas.web,0,0,0,0,0,0,1,1
springfox_springfox,springfox.petstore.controller,0,0,0,0,0,0,1,1
springfox_springfox,springfox.petstore.model,0,0,0,0,1,0,1,2
springfox_springfox,springfox.petstore,0,0,0,0,0,0,1,1
springfox_springfox,springfox.petstore.repository,0,0,0,0,0,0,1,1
springfox_springfox,springfox.petstore.webflux.controller,0,0,0,0,0,0,1,1
springfox_springfox,springfox.petstore.webflux.model,0,0,0,0,0,0,1,1
springfox_springfox,springfox.petstore.webflux,0,0,0,0,0,0,1,1
springfox_springfox,springfox.petstore.webflux.repository,0,0,0,0,0,0,1,1
springfox_springfox,springfox.documentation.schema.configuration,0,0,0,0,0,0,1,1
springfox_springfox,springfox.documentation.schema.plugins,4,0,0,0,0,0,1,5
springfox_springfox,springfox.documentation.schema.property,9,0,0,0,1,0,1,11
springfox_springfox,springfox.documentation.schema.property.bean,2,0,0,0,0,0,1,3
springfox_springfox,springfox.documentation.schema.property.field,2,0,0,0,0,0,1,3
springfox_springfox,springfox.documentation.spi,0,0,0,0,0,0,1,1
springfox_springfox,springfox.documentation.spi.schema,10,1,0,0,1,0,1,13
springfox_springfox,springfox.documentation.spi.schema.contexts,7,1,0,0,0,0,1,9
springfox_springfox,springfox.documentation.spi.service,1,0,0,0,1,0,1,3
springfox_springfox,springfox.documentation.spi.service.contexts,5,1,0,0,1,0,1,8
springfox_springfox,springfox.springconfig,0,0,0,0,0,0,1,1
springfox_springfox,springfox.documentation.spring.web,3,1,0,0,1,0,1,6
springfox_springfox,springfox.documentation.spring.web.plugins,8,1,0,0,1,0,1,11
springfox_springfox,springfox.documentation.spring.web.json,0,0,0,0,0,0,1,1
springfox_springfox,springfox.documentation.spring.web.paths,0,0,0,0,1,0,1,2
springfox_springfox,springfox.documentation.spring.web.readers.operation,6,1,0,0,1,0,1,9
springfox_springfox,springfox.documentation.spring.web.readers.parameter,3,0,0,0,1,0,1,5
springfox_springfox,springfox.documentation.spring.web.scanners,3,0,0,0,1,0,1,5
springfox_springfox,springfox.documentation.spring.web.configuration,0,0,0,0,0,0,1,1
springfox_springfox,springfox.documentation.spring.web.dummy,0,0,0,1,1,0,1,3
springfox_springfox,springfox.documentation.spring.web.dummy.controllers,0,0,0,1,1,0,1,3
springfox_springfox,springfox.documentation.spring.web.dummy.models,0,0,0,1,1,0,1,3
springfox_springfox,springfox.documentation.spring.web.dummy.models.same,0,0,0,0,0,0,1,1
springfox_springfox,springfox.documentation.swagger.annotations,0,0,0,0,0,0,1,1
springfox_springfox,springfox.documentation.swagger.common,0,0,0,0,0,0,1,1
springfox_springfox,springfox.documentation.swagger.configuration,0,0,0,0,0,0,1,1
springfox_springfox,springfox.documentation.swagger.readers.operation,0,0,0,0,1,0,1,2
springfox_springfox,springfox.documentation.swagger.readers.parameter,0,0,0,0,0,0,1,1
springfox_springfox,springfox.documentation.swagger.schema,0,0,0,0,0,0,1,1
springfox_springfox,springfox.documentation.swagger.web,0,0,0,0,1,0,1,2
springfox_springfox,springfox.documentation.swagger1.mappers,0,0,0,0,1,0,1,2
springfox_springfox,springfox.documentation.swagger1.configuration,0,0,0,0,1,0,1,2
springfox_springfox,springfox.documentation.swagger1.dto,0,0,0,1,1,0,1,3
springfox_springfox,springfox.documentation.swagger1.readers.parameter,0,0,0,0,0,0,1,1
springfox_springfox,springfox.documentation.swagger1.web,0,0,0,0,0,0,1,1
springfox_springfox,springfox.documentation.swagger1.models,0,0,0,0,0,0,1,1
springfox_springfox,springfox.documentation.swagger2.mappers,0,0,0,0,0,0,1,1
springfox_springfox,springfox.documentation.swagger2.configuration,0,0,0,0,1,0,1,2
springfox_springfox,springfox.documentation.swagger2.web,0,0,0,0,0,0,1,1
square_burst,com.squareup.burst,0,0,0,1,1,0,0,2
square_javapoet,com.squareup.javapoet,0,0,0,1,1,0,0,2
square_javapoet,(default package),0,0,0,0,0,0,0,0
square_moshi,com.squareup.moshi.adapters,0,0,0,0,1,0,0,1
square_moshi,com.squareup.moshi,1,1,0,1,1,0,0,4
square_moshi,com.squareup.moshi.recipes,0,0,0,1,1,0,0,2
square_moshi,com.squareup.moshi.recipes.models,0,0,0,0,0,0,0,0
square_moshi,com.squareup.moshi.kotlin.codegen,0,0,0,1,1,0,0,2
square_moshi,com.squareup.moshi.kotlin.codegen.api,0,0,0,0,1,0,0,1
square_moshi,error,0,0,0,0,0,0,0,0
square_moshi,com.squareup.moshi.kotlin.codegen.LooksLikeAClass,0,0,0,0,0,0,0,0
square_moshi,com.squareup.moshi.kotlin,0,0,0,1,1,0,0,2
square_moshi,com.squareup.moshi.kotlin.reflect,0,0,0,1,1,0,0,2
square_moshi,com.squareup.moshi.internal,1,0,0,0,1,0,0,2
square_moshi,android.util,0,0,0,0,0,0,0,0
square_okio,com.squareup.okio.benchmarks,0,0,0,0,1,0,0,1
square_okio,okio,0,0,0,1,1,0,0,2
srikalyc_Sql4D,com.yahoo.sql4d.indexeragent.actors,0,0,0,0,0,0,0,0
srikalyc_Sql4D,com.yahoo.sql4d.indexeragent,0,0,0,0,0,0,0,0
srikalyc_Sql4D,com.yahoo.sql4d.indexeragent.meta.beans,0,0,0,0,0,0,0,0
srikalyc_Sql4D,com.yahoo.sql4d.indexeragent.meta,0,0,0,0,0,0,0,0
srikalyc_Sql4D,com.yahoo.sql4d.indexeragent.sql,0,0,0,0,0,0,0,0
srikalyc_Sql4D,com.yahoo.sql4d.indexeragent.util,0,0,0,0,0,0,0,0
srikalyc_Sql4D,com.yahoo.sql4dclient,0,0,0,0,0,0,0,0
srikalyc_Sql4D,com.yahoo.sql4d,0,0,0,0,1,0,0,1
srikalyc_Sql4D,com.yahoo.sql4d.beans,0,0,0,0,0,0,0,0
srikalyc_Sql4D,com.yahoo.sql4d.converter,0,0,0,0,1,0,0,1
srikalyc_Sql4D,com.yahoo.sql4d.delete,0,0,0,0,0,0,0,0
srikalyc_Sql4D,com.yahoo.sql4d.drop,0,0,0,0,0,0,0,0
srikalyc_Sql4D,com.yahoo.sql4d.insert,0,0,0,0,0,0,0,0
srikalyc_Sql4D,com.yahoo.sql4d.insert.nodes,0,0,0,0,0,0,0,0
srikalyc_Sql4D,com.yahoo.sql4d.query,0,0,0,0,0,0,0,0
srikalyc_Sql4D,com.yahoo.sql4d.query.groupby,0,0,0,0,0,0,0,0
srikalyc_Sql4D,com.yahoo.sql4d.query.nodes,0,0,0,0,0,0,0,0
srikalyc_Sql4D,com.yahoo.sql4d.query.search,0,0,0,0,0,0,0,0
srikalyc_Sql4D,com.yahoo.sql4d.query.select,0,0,0,0,0,0,0,0
srikalyc_Sql4D,com.yahoo.sql4d.query.timeboundary,0,0,0,0,0,0,0,0
srikalyc_Sql4D,com.yahoo.sql4d.query.timeseries,0,0,0,0,0,0,0,0
srikalyc_Sql4D,com.yahoo.sql4d.query.topn,0,0,0,0,0,0,0,0
srikalyc_Sql4D,com.yahoo.sql4d.utils,0,0,0,0,0,0,0,0
srikalyc_Sql4D,com.yahoo.sql4d.sql4ddriver,1,1,0,0,1,0,0,3
srikalyc_Sql4D,com.yahoo.sql4d.sql4ddriver.rowmapper,1,0,0,0,0,0,0,1
srikalyc_Sql4D,com.yahoo.sql4d.sql4ddriver.sql,0,0,0,0,0,0,0,0
stagemonitor_stagemonitor,org.stagemonitor.alerting.alerter,2,0,0,0,0,0,1,3
stagemonitor_stagemonitor,org.stagemonitor.alerting,5,1,0,0,1,0,1,8
stagemonitor_stagemonitor,org.stagemonitor.alerting.annotation,2,0,0,0,0,0,1,3
stagemonitor_stagemonitor,org.stagemonitor.alerting.check,0,1,0,0,0,0,1,2
stagemonitor_stagemonitor,org.stagemonitor.alerting.incident,3,1,0,0,0,0,1,5
stagemonitor_stagemonitor,org.stagemonitor.benchmark.profiler,0,0,0,0,1,0,1,2
stagemonitor_stagemonitor,org.stagemonitor,0,0,0,0,1,0,1,2
stagemonitor_stagemonitor,org.stagemonitor.configuration,8,1,0,0,0,0,1,10
stagemonitor_stagemonitor,org.stagemonitor.configuration.converter,0,0,0,1,0,0,1,2
stagemonitor_stagemonitor,org.stagemonitor.configuration.source,8,1,0,0,1,0,1,11
stagemonitor_stagemonitor,org.stagemonitor.util,0,0,0,0,0,0,1,1
stagemonitor_stagemonitor,org.stagemonitor.configuration.example,0,0,0,0,0,0,1,1
stagemonitor_stagemonitor,org.stagemonitor.core.configuration,3,0,0,0,1,0,1,5
stagemonitor_stagemonitor,org.stagemonitor.core,22,1,0,0,0,0,1,24
stagemonitor_stagemonitor,org.stagemonitor.core.elasticsearch,9,1,0,0,0,0,1,11
stagemonitor_stagemonitor,org.stagemonitor.core.grafana,2,0,0,0,0,0,1,3
stagemonitor_stagemonitor,org.stagemonitor.core.instrument,4,0,0,0,1,0,1,6
stagemonitor_stagemonitor,org.stagemonitor.core.metrics,2,0,0,0,1,0,1,4
stagemonitor_stagemonitor,org.stagemonitor.core.metrics.annotations,0,0,0,0,1,0,1,2
stagemonitor_stagemonitor,org.stagemonitor.core.metrics.aspects,2,0,0,0,0,0,1,3
stagemonitor_stagemonitor,org.stagemonitor.core.metrics.health,0,0,0,0,0,0,1,1
stagemonitor_stagemonitor,org.stagemonitor.core.metrics.metrics2,8,1,0,1,0,0,1,11
stagemonitor_stagemonitor,org.stagemonitor.core.metrics.prometheus,0,0,0,0,0,0,1,1
stagemonitor_stagemonitor,org.stagemonitor.core.pool,2,0,0,0,0,0,1,3
stagemonitor_stagemonitor,org.stagemonitor.core.util,14,1,0,1,1,0,1,18
stagemonitor_stagemonitor,org.stagemonitor.core.util.http,3,0,0,0,0,0,1,4
stagemonitor_stagemonitor,org.stagemonitor.dispatcher,0,0,0,0,0,0,1,1
stagemonitor_stagemonitor,org.stagemonitor.junit,0,0,0,0,0,0,1,1
stagemonitor_stagemonitor,__redirected.org.stagemonitor.dispatcher,0,0,0,0,0,0,1,1
stagemonitor_stagemonitor,org.stagemonitor.ehcache,0,0,0,0,0,0,1,1
stagemonitor_stagemonitor,org.stagemonitor.eum,0,0,0,0,0,0,1,1
stagemonitor_stagemonitor,org.stagemonitor.jdbc,0,0,0,0,0,0,1,1
stagemonitor_stagemonitor,org.stagemonitor.jvm,0,0,0,0,0,0,1,1
stagemonitor_stagemonitor,org.stagemonitor.logging,0,0,0,0,0,0,1,1
stagemonitor_stagemonitor,org.stagemonitor.os.metrics,0,0,0,0,0,0,1,1
stagemonitor_stagemonitor,org.stagemonitor.os,0,0,0,0,0,0,1,1
stagemonitor_stagemonitor,org.stagemonitor.tracing,6,1,0,1,0,0,1,9
stagemonitor_stagemonitor,org.stagemonitor.tracing.anonymization,0,0,0,0,0,0,1,1
stagemonitor_stagemonitor,org.stagemonitor.tracing.ejb,0,0,0,0,1,0,1,2
stagemonitor_stagemonitor,org.stagemonitor.tracing.freemarker,0,0,0,0,0,0,1,1
stagemonitor_stagemonitor,org.stagemonitor.tracing.impl,0,0,0,0,0,0,1,1
stagemonitor_stagemonitor,org.stagemonitor.tracing.mdc,0,0,0,0,0,0,1,1
stagemonitor_stagemonitor,org.stagemonitor.tracing.metrics,2,0,0,0,0,0,1,3
stagemonitor_stagemonitor,org.stagemonitor.tracing.profiler,3,1,0,0,0,0,1,5
stagemonitor_stagemonitor,org.stagemonitor.tracing.profiler.elasticsearch,0,0,0,0,0,0,1,1
stagemonitor_stagemonitor,org.stagemonitor.tracing.profiler.formatter,1,0,0,0,0,0,1,2
stagemonitor_stagemonitor,org.stagemonitor.tracing.reporter,2,1,0,0,1,0,1,5
stagemonitor_stagemonitor,org.stagemonitor.tracing.sampling,3,0,0,0,0,0,1,4
stagemonitor_stagemonitor,org.stagemonitor.tracing.soap,0,0,0,0,1,0,1,2
stagemonitor_stagemonitor,org.stagemonitor.tracing.tagexclude,0,0,0,0,0,0,1,1
stagemonitor_stagemonitor,org.stagemonitor.tracing.utils,0,1,0,0,0,0,1,2
stagemonitor_stagemonitor,org.stagemonitor.tracing.wrapper,0,0,0,0,0,0,1,1
stagemonitor_stagemonitor,org.stagemonitor.tracing.prof.elasticsearch,0,0,0,0,0,0,1,1
stagemonitor_stagemonitor,org.stagemonitor.tracing.prof,0,0,0,0,0,0,1,1
stagemonitor_stagemonitor,org.stagemonitor.tracing.tracing,0,0,0,0,0,0,1,1
stagemonitor_stagemonitor,org.stagemonitor.tracing.elasticsearch,0,0,0,0,0,0,1,1
stagemonitor_stagemonitor,org.stagemonitor.tracing.elasticsearch.impl,0,0,0,0,0,0,1,1
stagemonitor_stagemonitor,org.stagemonitor.zipkin,0,0,0,0,0,0,1,1
stagemonitor_stagemonitor,org.stagemonitor.web.servlet.configuration,1,0,0,0,0,0,1,2
stagemonitor_stagemonitor,org.stagemonitor.web.servlet,6,1,0,0,1,0,1,9
stagemonitor_stagemonitor,org.stagemonitor.web.servlet.eum,2,0,0,0,0,0,1,3
stagemonitor_stagemonitor,org.stagemonitor.web.servlet.filter,3,1,0,0,0,0,1,5
stagemonitor_stagemonitor,org.stagemonitor.web.servlet.health,0,0,0,0,0,0,1,1
stagemonitor_stagemonitor,org.stagemonitor.web.servlet.initializer,0,1,0,0,0,0,1,2
stagemonitor_stagemonitor,org.stagemonitor.web.servlet.jaxrs,0,0,0,0,0,0,1,1
stagemonitor_stagemonitor,org.stagemonitor.web.servlet.session,0,0,0,0,0,0,1,1
stagemonitor_stagemonitor,org.stagemonitor.web.servlet.spring,0,0,0,0,1,0,1,2
stagemonitor_stagemonitor,org.stagemonitor.web.servlet.tracing,0,0,0,0,0,0,1,1
stagemonitor_stagemonitor,org.stagemonitor.web.servlet.useragent,0,0,0,0,0,0,1,1
stagemonitor_stagemonitor,org.stagemonitor.web.servlet.util,0,0,0,0,0,0,1,1
stagemonitor_stagemonitor,org.stagemonitor.web.servlet.widget,2,0,0,0,1,0,1,4
stagemonitor_stagemonitor,org.stagemonitor.tracing.tracing.jaeger,0,0,0,0,0,0,1,1
stagemonitor_stagemonitor,org.stagemonitor.web,0,0,0,0,0,0,1,1
statefulj_statefulj,org.statefulj.common.utils,0,0,0,0,1,0,0,1
statefulj_statefulj,org.statefulj.framework.binders.camel,0,0,0,0,0,0,0,0
statefulj_statefulj,org.statefulj.framework.binders.common,0,0,0,0,0,0,0,0
statefulj_statefulj,org.statefulj.framework.binders.common.utils,0,0,0,0,0,0,0,0
statefulj_statefulj,org.statefulj.framework.binders.jersey,0,0,0,0,0,0,0,0
statefulj_statefulj,org.statefulj.framework.binders.springmvc,0,0,0,0,0,0,0,0
statefulj_statefulj,org.statefulj.framework.core.actions,0,0,0,0,0,0,0,0
statefulj_statefulj,org.statefulj.framework.core.fsm,0,0,0,0,0,0,0,0
statefulj_statefulj,org.statefulj.framework.core.model,0,0,0,0,1,0,0,1
statefulj_statefulj,org.statefulj.framework.core.model.impl,0,1,0,0,1,0,0,2
statefulj_statefulj,org.statefulj.framework.core,0,0,0,0,0,0,0,0
statefulj_statefulj,org.alternative,0,0,0,0,1,0,0,1
statefulj_statefulj,org.statefulj.framework.core.controllers,0,0,0,0,0,0,0,0
statefulj_statefulj,org.statefulj.framework.core.dao,0,0,0,0,0,0,0,0
statefulj_statefulj,org.statefulj.framework.core.mocks,0,0,0,0,0,0,0,0
statefulj_statefulj,org.statefulj.framework.persistence.jpa,0,0,0,0,0,0,0,0
statefulj_statefulj,org.statefulj.framework.persistence.mongo,0,0,0,0,0,0,0,0
statefulj_statefulj,org.statefulj.fsm,2,0,0,0,0,0,0,2
statefulj_statefulj,org.statefulj.fsm.model,0,0,0,0,0,0,0,0
statefulj_statefulj,org.statefulj.fsm.model.impl,1,1,0,0,0,0,0,2
statefulj_statefulj,org.statefulj.persistence.memory,1,1,0,0,0,0,0,2
statefulj_statefulj,org.statefulj.persistence,0,0,0,0,0,0,0,0
statefulj_statefulj,org.statefulj.fsm.persistence,0,0,0,0,1,0,0,1
statefulj_statefulj,org.statefulj.persistence.common,0,0,0,0,0,0,0,0
statefulj_statefulj,org.statefulj.persistence.jpa,0,0,0,0,0,0,0,0
statefulj_statefulj,org.statefulj.persistence.jpa.model,0,0,0,0,0,0,0,0
statefulj_statefulj,org.statefulj.persistence.jpa.embedded,0,0,0,0,0,0,0,0
statefulj_statefulj,org.statefulj.persistence.jpa.lazy,0,0,0,0,0,0,0,0
statefulj_statefulj,org.statefulj.persistence.jpa.utils,0,0,0,0,0,0,0,0
statefulj_statefulj,org.statefulj.persistence.mongo.model,0,0,0,0,0,0,0,0
statefulj_statefulj,org.statefulj.persistence.mongo,0,0,0,0,1,0,0,1
stephanenicolas_mimic,com.github.stephanenicolas.mimic,0,0,0,0,1,0,0,1
Steveice10_MCProtocolLib,com.github.steveice10.mc.protocol,3,0,0,0,1,0,0,4
Steveice10_MCProtocolLib,com.github.steveice10.mc.protocol.data.game.advancement,0,0,0,0,0,0,0,0
Steveice10_MCProtocolLib,com.github.steveice10.mc.protocol.data.game,0,0,0,0,0,0,0,0
Steveice10_MCProtocolLib,com.github.steveice10.mc.protocol.data.game.chunk,0,0,0,0,0,0,0,0
Steveice10_MCProtocolLib,com.github.steveice10.mc.protocol.data.game.command,0,0,0,0,0,0,0,0
Steveice10_MCProtocolLib,com.github.steveice10.mc.protocol.data.game.command.properties,0,0,0,0,0,0,0,0
Steveice10_MCProtocolLib,com.github.steveice10.mc.protocol.data.game.entity.attribute,0,0,0,0,0,0,0,0
Steveice10_MCProtocolLib,com.github.steveice10.mc.protocol.data.game.entity.metadata,1,1,0,0,0,0,0,2
Steveice10_MCProtocolLib,com.github.steveice10.mc.protocol.data.game.entity.type.object,0,0,0,0,0,0,0,0
Steveice10_MCProtocolLib,com.github.steveice10.mc.protocol.data.game.recipe.data,0,0,0,0,0,0,0,0
Steveice10_MCProtocolLib,com.github.steveice10.mc.protocol.data.game.recipe,0,0,0,0,0,0,0,0
Steveice10_MCProtocolLib,com.github.steveice10.mc.protocol.data.game.statistic,0,0,1,0,0,0,0,1
Steveice10_MCProtocolLib,com.github.steveice10.mc.protocol.data.game.window,0,0,0,0,0,0,0,0
Steveice10_MCProtocolLib,com.github.steveice10.mc.protocol.data.game.window.property,0,0,0,0,0,0,0,0
Steveice10_MCProtocolLib,com.github.steveice10.mc.protocol.data.game.world.block,0,0,0,0,0,0,0,0
Steveice10_MCProtocolLib,com.github.steveice10.mc.protocol.data.game.world.block.value,0,0,1,0,1,0,0,2
Steveice10_MCProtocolLib,com.github.steveice10.mc.protocol.data.game.world.effect,0,0,0,0,1,0,0,1
Steveice10_MCProtocolLib,com.github.steveice10.mc.protocol.data.game.world.map,0,0,0,0,0,0,0,0
Steveice10_MCProtocolLib,com.github.steveice10.mc.protocol.data.game.world.notify,0,0,0,0,0,0,0,0
Steveice10_MCProtocolLib,com.github.steveice10.mc.protocol.data.game.world.particle,1,0,0,0,1,0,0,2
Steveice10_MCProtocolLib,com.github.steveice10.mc.protocol.data.game.world.sound,0,0,0,0,0,0,0,0
Steveice10_MCProtocolLib,com.github.steveice10.mc.protocol.data,0,0,0,0,0,0,0,0
Steveice10_MCProtocolLib,com.github.steveice10.mc.protocol.data.message,0,0,0,0,0,0,0,0
Steveice10_MCProtocolLib,com.github.steveice10.mc.protocol.data.status.handler,0,0,0,0,0,0,0,0
Steveice10_MCProtocolLib,com.github.steveice10.mc.protocol.data.status,2,1,0,0,0,0,0,3
Steveice10_MCProtocolLib,com.github.steveice10.mc.protocol.packet.handshake.client,1,1,0,0,0,0,0,2
Steveice10_MCProtocolLib,com.github.steveice10.mc.protocol.packet.ingame.client,0,0,0,0,1,0,0,1
Steveice10_MCProtocolLib,com.github.steveice10.mc.protocol.packet.ingame.client.player,0,0,0,0,1,0,0,1
Steveice10_MCProtocolLib,com.github.steveice10.mc.protocol.packet.ingame.client.window,0,0,0,0,1,0,0,1
Steveice10_MCProtocolLib,com.github.steveice10.mc.protocol.packet.ingame.client.world,0,0,0,0,1,0,0,1
Steveice10_MCProtocolLib,com.github.steveice10.mc.protocol.packet.ingame.server.entity.player,0,0,0,0,1,0,0,1
Steveice10_MCProtocolLib,com.github.steveice10.mc.protocol.packet.ingame.server.entity,0,0,0,0,1,0,0,1
Steveice10_MCProtocolLib,com.github.steveice10.mc.protocol.packet.ingame.server.entity.spawn,0,0,0,0,1,0,0,1
Steveice10_MCProtocolLib,com.github.steveice10.mc.protocol.packet.ingame.server.scoreboard,0,0,0,0,0,0,0,0
Steveice10_MCProtocolLib,com.github.steveice10.mc.protocol.packet.ingame.server,0,0,0,0,1,0,0,1
Steveice10_MCProtocolLib,com.github.steveice10.mc.protocol.packet.ingame.server.window,0,0,0,0,1,0,0,1
Steveice10_MCProtocolLib,com.github.steveice10.mc.protocol.packet.ingame.server.world,0,0,0,0,1,0,0,1
Steveice10_MCProtocolLib,com.github.steveice10.mc.protocol.packet.login.client,0,0,0,0,1,0,0,1
Steveice10_MCProtocolLib,com.github.steveice10.mc.protocol.packet.login.server,0,0,0,0,1,0,0,1
Steveice10_MCProtocolLib,com.github.steveice10.mc.protocol.packet.status.client,0,0,0,0,0,0,0,0
Steveice10_MCProtocolLib,com.github.steveice10.mc.protocol.packet.status.server,1,0,0,0,0,0,0,1
Steveice10_MCProtocolLib,com.github.steveice10.mc.protocol.packet,0,0,0,0,0,0,0,0
stickfigure_objectify-insight,com.googlecode.objectify.insight,0,0,0,0,1,0,0,1
stickfigure_objectify-insight,com.googlecode.objectify.insight.puller,0,0,0,0,1,0,0,1
stickfigure_objectify-insight,com.googlecode.objectify.insight.servlet,0,0,0,0,0,0,0,0
stickfigure_objectify-insight,com.googlecode.objectify.insight.util,0,0,0,0,0,0,0,0
Stratehm_stratum-proxy,strat.mining.stratum.proxy.callback,0,0,0,0,0,0,0,0
Stratehm_stratum-proxy,strat.mining.stratum.proxy.cli,0,0,0,0,0,0,0,0
Stratehm_stratum-proxy,strat.mining.stratum.proxy.configuration,14,1,0,0,0,1,0,16
Stratehm_stratum-proxy,strat.mining.stratum.proxy.configuration.model,0,0,0,0,0,0,0,0
Stratehm_stratum-proxy,strat.mining.stratum.proxy.constant,0,0,0,0,0,0,0,0
Stratehm_stratum-proxy,strat.mining.stratum.proxy.database,3,1,0,0,0,1,0,5
Stratehm_stratum-proxy,strat.mining.stratum.proxy.database.model,0,0,0,0,0,0,0,0
Stratehm_stratum-proxy,strat.mining.stratum.proxy.exception,0,0,0,0,1,0,0,1
Stratehm_stratum-proxy,strat.mining.stratum.proxy.grizzly,0,0,0,0,0,0,0,0
Stratehm_stratum-proxy,strat.mining.stratum.proxy.json,0,0,0,0,1,4,0,5
Stratehm_stratum-proxy,strat.mining.stratum.proxy,14,0,0,0,0,1,0,15
Stratehm_stratum-proxy,strat.mining.stratum.proxy.manager,11,1,0,0,0,10,0,22
Stratehm_stratum-proxy,strat.mining.stratum.proxy.manager.strategy,0,0,0,0,1,3,0,4
Stratehm_stratum-proxy,strat.mining.stratum.proxy.model,2,0,0,0,0,0,0,2
Stratehm_stratum-proxy,strat.mining.stratum.proxy.network,0,0,0,0,0,4,0,4
Stratehm_stratum-proxy,strat.mining.stratum.proxy.pool,2,0,0,0,0,8,0,10
Stratehm_stratum-proxy,strat.mining.stratum.proxy.rest.authentication,2,1,0,0,0,0,0,3
Stratehm_stratum-proxy,strat.mining.stratum.proxy.rest.dto,0,0,0,0,1,2,0,3
Stratehm_stratum-proxy,strat.mining.stratum.proxy.rest,2,1,0,0,0,0,0,3
Stratehm_stratum-proxy,strat.mining.stratum.proxy.rest.ssl,0,0,0,0,0,0,0,0
Stratehm_stratum-proxy,strat.mining.stratum.proxy.utils,0,0,0,0,1,1,0,2
Stratehm_stratum-proxy,strat.mining.stratum.proxy.utils.mining,5,1,0,0,0,0,0,6
Stratehm_stratum-proxy,strat.mining.stratum.proxy.worker,9,1,0,0,1,4,0,15
Stratio_crossdata,com.stratio.qa.specs,1,0,0,0,0,0,0,1
Stratio_crossdata,com.stratio.qa.utils,1,0,0,0,1,0,0,2
Stratio_flume-ingestion,com.stratio.ingestion.deserializer.xmlxpath,0,0,0,0,0,0,0,0
Stratio_flume-ingestion,com.stratio.ingestion.serialization.tracker,0,0,0,0,0,0,0,0
Stratio_flume-ingestion,com.stratio.ingestion.serializer.elasticsearch,0,0,0,0,0,0,0,0
Stratio_flume-ingestion,com.stratio.ingestion.sink.cassandra,0,0,0,0,1,0,0,1
Stratio_flume-ingestion,com.stratio.ingestion.sink.decision,0,0,0,0,1,0,0,1
Stratio_flume-ingestion,com.stratio.ingestion.sink.druid,0,0,0,0,0,0,0,0
Stratio_flume-ingestion,com.stratio.ingestion.sink.elasticsearch,1,1,0,0,0,0,0,2
Stratio_flume-ingestion,com.stratio.ingestion.sink.elasticsearch.client,1,0,0,0,0,0,0,1
Stratio_flume-ingestion,com.stratio.ingestion.elasticsearch.client,0,0,0,0,0,0,0,0
Stratio_flume-ingestion,com.stratio.ingestion.sink.jdbc,0,0,0,0,0,0,0,0
Stratio_flume-ingestion,com.stratio.ingestion.sink.kafka,0,0,0,0,0,0,0,0
Stratio_flume-ingestion,com.stratio.ingestion.sink.mongodb,0,0,0,0,0,0,0,0
Stratio_flume-ingestion,com.stratio.ingestion.source.irc,0,0,0,0,0,0,0,0
Stratio_flume-ingestion,com.stratio.ingestion.source.redis,0,0,0,0,0,0,0,0
Stratio_flume-ingestion,com.stratio.ingestion.source.rest.exception,0,0,0,0,0,0,0,0
Stratio_flume-ingestion,com.stratio.ingestion.source.rest.handler,0,0,0,0,1,0,0,1
Stratio_flume-ingestion,com.stratio.ingestion.source.rest,0,0,0,0,0,0,0,0
Stratio_flume-ingestion,com.stratio.ingestion.source.rest.url,0,0,0,0,0,0,0,0
Stratio_flume-ingestion,com.stratio.ingestion.source.rest.url.filter.exception,0,0,0,0,0,0,0,0
Stratio_flume-ingestion,com.stratio.ingestion.source.rest.url.filter,0,0,0,0,0,0,0,0
Stratio_flume-ingestion,com.stratio.ingestion.source.rest.url.filter.type,0,0,0,0,0,0,0,0
Stratio_flume-ingestion,com.stratio.ingestion.source.snmptraps,0,0,0,0,0,0,0,0
Stratio_stratio-ingestion,com.stratio.ingestion.deserializer.xmlxpath,0,0,0,0,0,0,0,0
Stratio_stratio-ingestion,com.stratio.ingestion.serialization.tracker,0,0,0,0,0,0,0,0
Stratio_stratio-ingestion,com.stratio.ingestion.serializer.elasticsearch,0,0,0,0,0,0,0,0
Stratio_stratio-ingestion,com.stratio.ingestion.sink.cassandra,0,0,0,0,1,0,0,1
Stratio_stratio-ingestion,com.stratio.ingestion.sink.decision,0,0,0,0,1,0,0,1
Stratio_stratio-ingestion,com.stratio.ingestion.sink.druid,0,0,0,0,0,0,0,0
Stratio_stratio-ingestion,com.stratio.ingestion.sink.elasticsearch,1,1,0,0,0,0,0,2
Stratio_stratio-ingestion,com.stratio.ingestion.sink.elasticsearch.client,1,0,0,0,0,0,0,1
Stratio_stratio-ingestion,com.stratio.ingestion.elasticsearch.client,0,0,0,0,0,0,0,0
Stratio_stratio-ingestion,com.stratio.ingestion.sink.jdbc,0,0,0,0,0,0,0,0
Stratio_stratio-ingestion,com.stratio.ingestion.sink.kafka,0,0,0,0,0,0,0,0
Stratio_stratio-ingestion,com.stratio.ingestion.sink.mongodb,0,0,0,0,0,0,0,0
Stratio_stratio-ingestion,com.stratio.ingestion.source.irc,0,0,0,0,0,0,0,0
Stratio_stratio-ingestion,com.stratio.ingestion.source.redis,0,0,0,0,0,0,0,0
Stratio_stratio-ingestion,com.stratio.ingestion.source.rest.exception,0,0,0,0,0,0,0,0
Stratio_stratio-ingestion,com.stratio.ingestion.source.rest.handler,0,0,0,0,1,0,0,1
Stratio_stratio-ingestion,com.stratio.ingestion.source.rest,0,0,0,0,0,0,0,0
Stratio_stratio-ingestion,com.stratio.ingestion.source.rest.url,0,0,0,0,0,0,0,0
Stratio_stratio-ingestion,com.stratio.ingestion.source.rest.url.filter.exception,0,0,0,0,0,0,0,0
Stratio_stratio-ingestion,com.stratio.ingestion.source.rest.url.filter,0,0,0,0,0,0,0,0
Stratio_stratio-ingestion,com.stratio.ingestion.source.rest.url.filter.type,0,0,0,0,0,0,0,0
Stratio_stratio-ingestion,com.stratio.ingestion.source.snmptraps,0,0,0,0,0,0,0,0
Stratio_stratio-meta,com.stratio.qa.specs,1,0,0,0,0,0,0,1
Stratio_stratio-meta,com.stratio.qa.utils,1,0,0,0,1,0,0,2
Stratio_stratio-streaming,com.stratio.decision.api.partitioner,0,0,0,0,0,0,0,0
Stratio_stratio-streaming,com.stratio.decision.commons.avro,0,0,0,0,0,0,0,0
Stratio_stratio-streaming,com.stratio.decision.commons.constants,0,0,0,0,1,0,0,1
Stratio_stratio-streaming,com.stratio.decision.commons.dto,0,0,0,0,0,0,0,0
Stratio_stratio-streaming,com.stratio.decision.commons.exceptions,0,0,0,0,0,0,0,0
Stratio_stratio-streaming,com.stratio.decision.commons.kafka.serializer,0,0,0,0,0,0,0,0
Stratio_stratio-streaming,com.stratio.decision.commons.kafka.service,0,0,0,0,0,0,0,0
Stratio_stratio-streaming,com.stratio.decision.commons.messages,0,0,0,0,0,0,0,0
Stratio_stratio-streaming,com.stratio.decision.commons.streams,0,0,0,0,0,0,0,0
Stratio_stratio-streaming,com.stratio.decision.commons.kafka,0,0,0,0,0,0,0,0
Stratio_stratio-streaming,com.stratio.decision.callbacks,2,0,0,0,0,0,0,2
Stratio_stratio-streaming,com.stratio.decision.clustering,3,1,0,0,0,0,0,4
Stratio_stratio-streaming,com.stratio.decision.configuration,27,1,0,0,0,0,0,28
Stratio_stratio-streaming,com.stratio.decision.dao,13,1,0,0,0,0,0,14
Stratio_stratio-streaming,com.stratio.decision.drools.configuration,0,0,0,0,0,0,0,0
Stratio_stratio-streaming,com.stratio.decision.drools,0,0,0,0,0,0,0,0
Stratio_stratio-streaming,com.stratio.decision.drools.sessions,0,0,0,0,0,0,0,0
Stratio_stratio-streaming,com.stratio.decision.exception,0,0,0,0,0,0,0,0
Stratio_stratio-streaming,com.stratio.decision.factory,0,0,0,0,0,0,0,0
Stratio_stratio-streaming,com.stratio.decision.functions,9,0,0,0,1,0,0,10
Stratio_stratio-streaming,com.stratio.decision.functions.dal,2,0,0,0,1,0,0,3
Stratio_stratio-streaming,com.stratio.decision.functions.ddl,2,0,0,0,0,0,0,2
Stratio_stratio-streaming,com.stratio.decision.functions.dml,4,0,0,0,0,0,0,4
Stratio_stratio-streaming,com.stratio.decision.functions.engine,2,0,0,0,0,0,0,2
Stratio_stratio-streaming,com.stratio.decision.functions.messages,0,0,0,0,0,0,0,0
Stratio_stratio-streaming,com.stratio.decision.functions.validator,4,1,0,0,0,0,0,5
Stratio_stratio-streaming,com.stratio.decision.highAvailability,0,0,0,0,0,0,0,0
Stratio_stratio-streaming,com.stratio.decision.metrics,3,1,0,0,0,0,0,4
Stratio_stratio-streaming,com.stratio.decision.model,2,0,0,0,0,0,0,2
Stratio_stratio-streaming,com.stratio.decision.serializer.gson.impl,0,0,0,0,0,0,0,0
Stratio_stratio-streaming,com.stratio.decision.serializer.impl,2,0,0,0,0,0,0,2
Stratio_stratio-streaming,com.stratio.decision.serializer,0,0,0,0,0,0,0,0
Stratio_stratio-streaming,com.stratio.decision.service,26,1,0,0,0,0,0,27
Stratio_stratio-streaming,com.stratio.decision,5,0,0,0,0,0,0,5
Stratio_stratio-streaming,com.stratio.decision.streams,0,0,0,0,0,0,0,0
Stratio_stratio-streaming,com.stratio.decision.task,3,1,0,0,0,0,0,4
Stratio_stratio-streaming,com.stratio.decision.utils,3,0,0,0,1,0,0,4
Stratio_stratio-streaming,com.stratio.decision.unit.engine.action,0,0,0,0,0,0,0,0
Stratio_stratio-streaming,com.stratio.decision.unit.engine.validator,0,0,0,0,0,0,0,0
Stratio_stratio-streaming,com.stratio.decision.executables,0,0,0,0,1,0,0,1
Stratio_stratio-streaming,com.stratio.decision.generator,0,0,0,0,0,0,0,0
Stratio_stratio-streaming,com.stratio.decision.shell.command,0,0,0,0,0,0,0,0
Stratio_stratio-streaming,com.stratio.decision.shell.configuration,0,0,0,0,0,0,0,0
Stratio_stratio-streaming,com.stratio.decision.shell.converter,0,0,0,0,0,0,0,0
Stratio_stratio-streaming,com.stratio.decision.shell.converter.wrapper,0,0,0,0,0,0,0,0
Stratio_stratio-streaming,com.stratio.decision.shell.dao,0,0,0,0,0,0,0,0
Stratio_stratio-streaming,com.stratio.decision.shell.dao.impl,0,0,0,0,0,0,0,0
Stratio_stratio-streaming,com.stratio.decision.shell.exception,0,0,0,0,0,0,0,0
Stratio_stratio-streaming,com.stratio.decision.shell,0,0,0,0,0,0,0,0
Stratio_stratio-streaming,com.stratio.decision.shell.provider,0,0,0,0,0,0,0,0
Stratio_stratio-streaming,com.stratio.decision.shell.renderer,0,0,0,0,0,0,0,0
Stratio_stratio-streaming,com.stratio.decision.shell.wrapper,0,0,0,0,0,0,0,0
Stratio_stratio-streaming,com.stratio.decision.shell.commands,0,0,0,0,0,0,0,0
Stratio_stratio-streaming,com.stratio.decision.siddhi.extension,0,0,0,0,0,0,0,0
Stratio_stratio-streaming,com.stratio.decision.unit.siddhi.extension.window,0,0,0,0,0,0,0,0
Stratio_stratio-streaming,com.stratio.decision.unit.siddhi.query,0,0,0,0,0,0,0,0
Stratio_streaming-cep-engine,com.stratio.decision.api.partitioner,0,0,0,0,0,0,0,0
Stratio_streaming-cep-engine,com.stratio.decision.commons.avro,0,0,0,0,0,0,0,0
Stratio_streaming-cep-engine,com.stratio.decision.commons.constants,0,0,0,0,1,0,0,1
Stratio_streaming-cep-engine,com.stratio.decision.commons.dto,0,0,0,0,0,0,0,0
Stratio_streaming-cep-engine,com.stratio.decision.commons.exceptions,0,0,0,0,0,0,0,0
Stratio_streaming-cep-engine,com.stratio.decision.commons.kafka.serializer,0,0,0,0,0,0,0,0
Stratio_streaming-cep-engine,com.stratio.decision.commons.kafka.service,0,0,0,0,0,0,0,0
Stratio_streaming-cep-engine,com.stratio.decision.commons.messages,0,0,0,0,0,0,0,0
Stratio_streaming-cep-engine,com.stratio.decision.commons.streams,0,0,0,0,0,0,0,0
Stratio_streaming-cep-engine,com.stratio.decision.commons.kafka,0,0,0,0,0,0,0,0
Stratio_streaming-cep-engine,com.stratio.decision.callbacks,2,0,0,0,0,0,0,2
Stratio_streaming-cep-engine,com.stratio.decision.clustering,3,1,0,0,0,0,0,4
Stratio_streaming-cep-engine,com.stratio.decision.configuration,27,1,0,0,0,0,0,28
Stratio_streaming-cep-engine,com.stratio.decision.dao,13,1,0,0,0,0,0,14
Stratio_streaming-cep-engine,com.stratio.decision.drools.configuration,0,0,0,0,0,0,0,0
Stratio_streaming-cep-engine,com.stratio.decision.drools,0,0,0,0,0,0,0,0
Stratio_streaming-cep-engine,com.stratio.decision.drools.sessions,0,0,0,0,0,0,0,0
Stratio_streaming-cep-engine,com.stratio.decision.exception,0,0,0,0,0,0,0,0
Stratio_streaming-cep-engine,com.stratio.decision.factory,0,0,0,0,0,0,0,0
Stratio_streaming-cep-engine,com.stratio.decision.functions,9,0,0,0,1,0,0,10
Stratio_streaming-cep-engine,com.stratio.decision.functions.dal,2,0,0,0,1,0,0,3
Stratio_streaming-cep-engine,com.stratio.decision.functions.ddl,2,0,0,0,0,0,0,2
Stratio_streaming-cep-engine,com.stratio.decision.functions.dml,4,0,0,0,0,0,0,4
Stratio_streaming-cep-engine,com.stratio.decision.functions.engine,2,0,0,0,0,0,0,2
Stratio_streaming-cep-engine,com.stratio.decision.functions.messages,0,0,0,0,0,0,0,0
Stratio_streaming-cep-engine,com.stratio.decision.functions.validator,4,1,0,0,0,0,0,5
Stratio_streaming-cep-engine,com.stratio.decision.highAvailability,0,0,0,0,0,0,0,0
Stratio_streaming-cep-engine,com.stratio.decision.metrics,3,1,0,0,0,0,0,4
Stratio_streaming-cep-engine,com.stratio.decision.model,2,0,0,0,0,0,0,2
Stratio_streaming-cep-engine,com.stratio.decision.serializer.gson.impl,0,0,0,0,0,0,0,0
Stratio_streaming-cep-engine,com.stratio.decision.serializer.impl,2,0,0,0,0,0,0,2
Stratio_streaming-cep-engine,com.stratio.decision.serializer,0,0,0,0,0,0,0,0
Stratio_streaming-cep-engine,com.stratio.decision.service,26,1,0,0,0,0,0,27
Stratio_streaming-cep-engine,com.stratio.decision,5,0,0,0,0,0,0,5
Stratio_streaming-cep-engine,com.stratio.decision.streams,0,0,0,0,0,0,0,0
Stratio_streaming-cep-engine,com.stratio.decision.task,3,1,0,0,0,0,0,4
Stratio_streaming-cep-engine,com.stratio.decision.utils,3,0,0,0,1,0,0,4
Stratio_streaming-cep-engine,com.stratio.decision.unit.engine.action,0,0,0,0,0,0,0,0
Stratio_streaming-cep-engine,com.stratio.decision.unit.engine.validator,0,0,0,0,0,0,0,0
Stratio_streaming-cep-engine,com.stratio.decision.executables,0,0,0,0,1,0,0,1
Stratio_streaming-cep-engine,com.stratio.decision.generator,0,0,0,0,0,0,0,0
Stratio_streaming-cep-engine,com.stratio.decision.shell.command,0,0,0,0,0,0,0,0
Stratio_streaming-cep-engine,com.stratio.decision.shell.configuration,0,0,0,0,0,0,0,0
Stratio_streaming-cep-engine,com.stratio.decision.shell.converter,0,0,0,0,0,0,0,0
Stratio_streaming-cep-engine,com.stratio.decision.shell.converter.wrapper,0,0,0,0,0,0,0,0
Stratio_streaming-cep-engine,com.stratio.decision.shell.dao,0,0,0,0,0,0,0,0
Stratio_streaming-cep-engine,com.stratio.decision.shell.dao.impl,0,0,0,0,0,0,0,0
Stratio_streaming-cep-engine,com.stratio.decision.shell.exception,0,0,0,0,0,0,0,0
Stratio_streaming-cep-engine,com.stratio.decision.shell,0,0,0,0,0,0,0,0
Stratio_streaming-cep-engine,com.stratio.decision.shell.provider,0,0,0,0,0,0,0,0
Stratio_streaming-cep-engine,com.stratio.decision.shell.renderer,0,0,0,0,0,0,0,0
Stratio_streaming-cep-engine,com.stratio.decision.shell.wrapper,0,0,0,0,0,0,0,0
Stratio_streaming-cep-engine,com.stratio.decision.shell.commands,0,0,0,0,0,0,0,0
Stratio_streaming-cep-engine,com.stratio.decision.siddhi.extension,0,0,0,0,0,0,0,0
Stratio_streaming-cep-engine,com.stratio.decision.unit.siddhi.extension.window,0,0,0,0,0,0,0,0
Stratio_streaming-cep-engine,com.stratio.decision.unit.siddhi.query,0,0,0,0,0,0,0,0
sttc_stateful,co.stateful.core,0,0,0,0,1,0,0,1
sttc_stateful,co.stateful,0,0,0,0,0,0,0,0
sttc_stateful,co.stateful.quota,0,0,0,0,1,0,0,1
sttc_stateful,co.stateful.rest,0,0,0,0,1,0,0,1
sttc_stateful,co.stateful.spi,0,0,0,0,0,0,0,0
stuartgunter_dropwizard-cassandra,systems.composable.dropwizard.cassandra.auth,0,0,0,0,0,0,0,0
stuartgunter_dropwizard-cassandra,systems.composable.dropwizard.cassandra,0,0,0,0,1,0,0,1
stuartgunter_dropwizard-cassandra,systems.composable.dropwizard.cassandra.loadbalancing,0,0,0,0,1,0,0,1
stuartgunter_dropwizard-cassandra,systems.composable.dropwizard.cassandra.network,0,0,0,0,0,0,0,0
stuartgunter_dropwizard-cassandra,systems.composable.dropwizard.cassandra.pooling,0,0,0,0,0,0,0,0
stuartgunter_dropwizard-cassandra,systems.composable.dropwizard.cassandra.reconnection,0,0,0,0,0,0,0,0
stuartgunter_dropwizard-cassandra,systems.composable.dropwizard.cassandra.retry,0,0,0,0,1,0,0,1
stuartgunter_dropwizard-cassandra,systems.composable.dropwizard.cassandra.speculativeexecution,0,0,0,0,0,0,0,0
stuartgunter_dropwizard-cassandra,systems.composable.dropwizard.cassandra.ssl,0,0,0,0,1,0,0,1
stuartgunter_dropwizard-cassandra,systems.composable.dropwizard.cassandra.multiCluster,0,0,0,0,0,0,0,0
stuartgunter_dropwizard-cassandra,systems.composable.dropwizard.cassandra.smoke,0,0,0,0,0,0,0,0
subchen_jetbrick-template-1x,jetbrick.template.compiler,0,0,0,0,1,0,0,1
subchen_jetbrick-template-1x,jetbrick.template,6,1,0,0,1,1,0,9
subchen_jetbrick-template-1x,jetbrick.template.parser.code,0,0,0,0,1,0,0,1
subchen_jetbrick-template-1x,jetbrick.template.parser,3,0,0,0,1,0,0,4
subchen_jetbrick-template-1x,jetbrick.template.parser.support,0,0,0,0,0,0,0,0
subchen_jetbrick-template-1x,jetbrick.template.resource,0,0,0,0,0,0,0,0
subchen_jetbrick-template-1x,jetbrick.template.resource.loader,2,0,0,0,0,0,0,2
subchen_jetbrick-template-1x,jetbrick.template.runtime,2,0,0,0,1,1,0,4
subchen_jetbrick-template-1x,jetbrick.template.utils,0,0,0,0,1,1,0,2
subchen_jetbrick-template-1x,jetbrick.template.utils.finder,2,1,0,0,0,0,0,3
subchen_jetbrick-template-1x,jetbrick.template.web,2,1,0,0,1,0,0,4
subchen_jetbrick-template-1x,jetbrick.template.web.jfinal,0,0,0,0,0,0,0,0
subchen_jetbrick-template-1x,jetbrick.template.web.jodd,0,0,0,0,0,0,0,0
subchen_jetbrick-template-1x,jetbrick.template.web.nutz,0,0,0,0,0,0,0,0
subchen_jetbrick-template-1x,jetbrick.template.web.servlet,0,0,0,0,0,0,0,0
subchen_jetbrick-template-1x,jetbrick.template.web.springmvc,0,0,0,0,0,0,0,0
subchen_jetbrick-template-1x,jetbrick.template.web.struts,0,0,0,0,0,0,0,0
subchen_jetbrick-template-1x,template,0,0,0,0,0,0,0,0
subchen_jetbrick-template-1x,jetbrick.template.parser.grammer,0,0,0,1,0,0,0,1
subchen_jetbrick-template-2x,jetbrick.template,3,1,0,0,1,2,0,7
subchen_jetbrick-template-2x,jetbrick.template.loader,1,0,0,0,0,0,0,1
subchen_jetbrick-template-2x,jetbrick.template.loader.resource,0,0,0,0,0,0,0,0
subchen_jetbrick-template-2x,jetbrick.template.parser.ast,0,0,0,1,0,2,0,3
subchen_jetbrick-template-2x,jetbrick.template.parser,1,0,0,0,1,0,0,2
subchen_jetbrick-template-2x,jetbrick.template.resolver.clazz,0,0,0,0,0,0,0,0
subchen_jetbrick-template-2x,jetbrick.template.resolver.function,0,0,0,0,0,0,0,0
subchen_jetbrick-template-2x,jetbrick.template.resolver,0,0,0,0,0,1,0,1
subchen_jetbrick-template-2x,jetbrick.template.resolver.macro,0,0,0,0,0,0,0,0
subchen_jetbrick-template-2x,jetbrick.template.resolver.method,0,0,0,0,0,1,0,1
subchen_jetbrick-template-2x,jetbrick.template.resolver.property,0,0,0,0,1,0,0,1
subchen_jetbrick-template-2x,jetbrick.template.resolver.tag,0,0,0,0,0,0,0,0
subchen_jetbrick-template-2x,jetbrick.template.runtime.buildin,0,0,0,0,0,0,0,0
subchen_jetbrick-template-2x,jetbrick.template.runtime,1,0,0,0,1,2,0,4
subchen_jetbrick-template-2x,jetbrick.template.runtime.writer,0,0,0,0,1,0,0,1
subchen_jetbrick-template-2x,jetbrick.template.exec,0,0,0,0,0,0,0,0
subchen_jetbrick-template-2x,jetbrick.template.exec.buildin,0,0,0,0,0,0,0,0
subchen_jetbrick-template-2x,jetbrick.template.exec.config,0,0,0,0,0,0,0,0
subchen_jetbrick-template-2x,jetbrick.template.exec.directive,0,0,0,0,1,0,0,1
subchen_jetbrick-template-2x,jetbrick.template.exec.invoker,0,0,0,0,1,0,0,1
subchen_jetbrick-template-2x,jetbrick.template.exec.issue,0,0,0,0,0,0,0,0
subchen_jetbrick-template-2x,jetbrick.template.exec.operator,0,0,0,0,0,0,0,0
subchen_jetbrick-template-2x,jetbrick.template.exec.option,0,0,0,0,1,0,0,1
subchen_jetbrick-template-2x,jetbrick.template.exec.value,0,0,0,0,0,0,0,0
subchen_jetbrick-template-2x,jetbrick.template.performance,0,0,0,0,0,0,0,0
subchen_jetbrick-template-2x,jetbrick.template.runtime.parser.grammer,0,0,0,1,0,0,0,1
subchen_jetbrick-template-2x,jetbrick.template.web.jetbrickmvc,0,0,0,0,0,0,0,0
subchen_jetbrick-template-2x,jetbrick.template.web.jfinal,0,0,0,0,1,0,0,1
subchen_jetbrick-template-2x,jetbrick.template.web.jodd,0,0,0,0,0,0,0,0
subchen_jetbrick-template-2x,jetbrick.template.web.nutz,0,0,0,0,0,0,0,0
subchen_jetbrick-template-2x,jetbrick.template.shiro.tags,0,0,0,0,0,0,0,0
subchen_jetbrick-template-2x,jetbrick.template.web.springboot,1,0,0,0,0,0,0,1
subchen_jetbrick-template-2x,jetbrick.template.web.springmvc,0,0,0,0,0,0,0,0
subchen_jetbrick-template-2x,jetbrick.template.web.tag,1,1,0,0,0,0,0,2
subchen_jetbrick-template-2x,jetbrick.template.web.struts,0,0,0,0,0,0,0,0
subchen_jetbrick-template-2x,jetbrick.template.web.buildin,0,0,0,0,0,0,0,0
subchen_jetbrick-template-2x,jetbrick.template.web,1,0,0,0,0,0,0,1
subchen_jetbrick-template-2x,jetbrick.template.web.servlet,0,0,0,0,0,0,0,0
subchen_jetbrick-webmvc,jetbrick.web.mvc.action,4,0,0,0,0,0,0,4
subchen_jetbrick-webmvc,jetbrick.web.mvc.action.annotation,0,0,0,1,1,0,0,2
subchen_jetbrick-webmvc,jetbrick.web.mvc,9,1,0,0,1,0,0,11
subchen_jetbrick-webmvc,jetbrick.web.mvc.interceptor,0,0,0,0,0,0,0,0
subchen_jetbrick-webmvc,jetbrick.web.mvc.multipart,3,1,0,0,1,0,0,5
subchen_jetbrick-webmvc,jetbrick.web.mvc.plugin,0,0,0,0,0,0,0,0
subchen_jetbrick-webmvc,jetbrick.web.mvc.result,2,0,0,0,1,0,0,3
subchen_jetbrick-webmvc,jetbrick.web.mvc.result.view,2,0,0,0,1,0,0,3
subchen_jetbrick-webmvc,jetbrick.web.mvc.router,3,0,0,0,1,0,0,4
subchen_jetbrick-webmvc,jetbrick.util.fastjson,0,0,0,0,0,0,0,0
subchen_jetbrick-webmvc,jetbrick.template.web.freemarker,0,0,0,0,0,0,0,0
super-csv_super-csv,org.supercsv.cellprocessor,0,0,0,1,0,4,0,5
super-csv_super-csv,org.supercsv.cellprocessor.constraint,0,0,0,0,1,1,0,2
super-csv_super-csv,org.supercsv.cellprocessor.ift,0,0,0,0,0,4,0,4
super-csv_super-csv,org.supercsv.comment,0,0,0,0,0,0,0,0
super-csv_super-csv,org.supercsv.encoder,1,0,0,0,0,0,0,1
super-csv_super-csv,org.supercsv.exception,1,1,0,0,0,0,0,2
super-csv_super-csv,org.supercsv.io,0,0,0,1,0,3,0,4
super-csv_super-csv,org.supercsv.prefs,2,1,0,0,0,1,0,4
super-csv_super-csv,org.supercsv.quote,1,0,0,0,0,0,0,1
super-csv_super-csv,org.supercsv.util,1,0,0,0,1,0,0,2
super-csv_super-csv,org.supercsv.example,0,0,0,0,0,0,0,0
super-csv_super-csv,org.supercsv.features,0,0,0,0,0,1,0,1
super-csv_super-csv,org.supercsv.io.reflection,0,0,0,0,0,0,0,0
super-csv_super-csv,org.supercsv.mock,1,1,0,0,1,0,0,3
super-csv_super-csv,org.supercsv,1,0,0,0,0,0,0,1
super-csv_super-csv,org.supercsv.util.reflection,0,0,0,0,0,0,0,0
super-csv_super-csv,org.supercsv.benchmark,0,0,0,0,0,1,0,1
super-csv_super-csv,org.supercsv.benchmark.cellprocessor,0,0,0,0,0,1,0,1
super-csv_super-csv,org.supercsv.benchmark.model,0,0,0,0,0,0,0,0
super-csv_super-csv,org.supercsv.datacreators,0,0,0,0,0,0,0,0
super-csv_super-csv,org.supercsv.io.dozer,0,0,0,0,1,2,0,3
super-csv_super-csv,org.supercsv.example.dozer,0,0,0,0,0,1,0,1
super-csv_super-csv,org.supercsv.mock.dozer,0,0,0,0,0,0,0,0
super-csv_super-csv,org.supercsv.cellprocessor.time,0,0,0,1,0,1,0,2
super-csv_super-csv,org.supercsv.cellprocessor.time.mock,0,0,0,0,0,0,0,0
super-csv_super-csv,org.supercsv.cellprocessor.joda,0,0,0,1,1,1,0,3
super-csv_super-csv,org.supercsv.cellprocessor.joda.mock,0,0,0,0,0,0,0,0
SurveyMan_SurveyMan,edu.umass.cs.surveyman.analyses,14,1,0,0,1,2,1,19
SurveyMan_SurveyMan,edu.umass.cs.surveyman.analyses.rules,6,0,0,0,1,0,1,8
SurveyMan_SurveyMan,edu.umass.cs.surveyman.input,2,0,0,0,0,0,1,3
SurveyMan_SurveyMan,edu.umass.cs.surveyman.input.csv,8,0,0,0,0,0,1,9
SurveyMan_SurveyMan,edu.umass.cs.surveyman.input.exceptions,0,0,0,0,1,0,1,2
SurveyMan_SurveyMan,edu.umass.cs.surveyman.input.json,3,0,0,0,0,0,1,4
SurveyMan_SurveyMan,edu.umass.cs.surveyman.output,4,0,0,0,1,1,1,7
SurveyMan_SurveyMan,edu.umass.cs.surveyman,12,1,0,0,0,0,1,14
SurveyMan_SurveyMan,edu.umass.cs.surveyman.qc,16,1,0,0,1,2,1,21
SurveyMan_SurveyMan,edu.umass.cs.surveyman.qc.classifiers,4,0,0,0,1,0,1,6
SurveyMan_SurveyMan,edu.umass.cs.surveyman.qc.exceptions,0,0,0,0,0,0,1,1
SurveyMan_SurveyMan,edu.umass.cs.surveyman.qc.random,0,0,0,0,0,0,1,1
SurveyMan_SurveyMan,edu.umass.cs.surveyman.qc.respondents,6,1,0,0,1,0,1,9
SurveyMan_SurveyMan,edu.umass.cs.surveyman.server,0,0,0,0,0,0,1,1
SurveyMan_SurveyMan,edu.umass.cs.surveyman.survey,17,1,0,0,1,1,1,21
SurveyMan_SurveyMan,edu.umass.cs.surveyman.survey.exceptions,0,0,0,0,0,0,1,1
SurveyMan_SurveyMan,edu.umass.cs.surveyman.utils,5,1,0,0,1,0,1,8
SurveyMan_SurveyMan,edu.umass.cs.surveyman.utils.jsonify,0,0,0,0,0,0,1,1
SVT_helios-consul,se.svt.helios.serviceregistration.consul,0,0,0,0,1,0,0,1
SVT_helios-consul,se.svt.helios.serviceregistration.consul.model,0,0,0,0,1,0,0,1
swagger-api_swagger-parser,io.swagger.parser,0,0,0,0,0,0,0,0
swagger-api_swagger-parser,io.swagger.v3.parser.core.extensions,0,0,0,0,0,0,0,0
swagger-api_swagger-parser,io.swagger.v3.parser.core.models,0,0,0,0,0,0,0,0
swagger-api_swagger-parser,io.swagger.v3.parser.converter,0,0,0,0,0,0,0,0
swagger-api_swagger-parser,io.swagger.v3.parser,1,0,0,0,0,0,0,1
swagger-api_swagger-parser,io.swagger.v3.parser.processors,2,1,0,0,1,0,0,4
swagger-api_swagger-parser,io.swagger.v3.parser.util,2,1,0,0,1,0,0,4
swookiee_com.swookiee.runtime,com.swookiee.runtime.authentication,0,0,0,0,0,0,0,0
swookiee_com.swookiee.runtime,com.swookiee.runtime.authentication.internal,0,0,0,0,0,0,0,0
swookiee_com.swookiee.runtime,com.swookiee.runtime.core.internal,0,0,0,0,0,0,0,0
swookiee_com.swookiee.runtime,com.swookiee.runtime.core.internal.logging,0,0,0,0,0,0,0,0
swookiee_com.swookiee.runtime,com.swookiee.core.internal.logging,0,0,0,0,0,0,0,0
swookiee_com.swookiee.runtime,com.swookiee.runtime.ewok.auth,0,0,0,0,0,0,0,0
swookiee_com.swookiee.runtime,com.swookiee.runtime.ewok.representation,0,0,0,0,1,0,0,1
swookiee_com.swookiee.runtime,com.swookiee.runtime.ewok,0,0,0,0,0,0,0,0
swookiee_com.swookiee.runtime,com.swookiee.runtime.ewok.servlet,0,0,0,0,1,0,0,1
swookiee_com.swookiee.runtime,com.swookiee.runtime.ewok.util,0,0,0,0,0,0,0,0
swookiee_com.swookiee.runtime,com.swookiee.runtime.metrics.prometheus,0,0,0,0,0,0,0,0
swookiee_com.swookiee.runtime,com.swookiee.runtime.metrics.prometheus.logcounter,0,0,0,0,0,0,0,0
swookiee_com.swookiee.runtime,com.swookiee.runtime.metrics.prometheus.servlet,0,0,0,0,0,0,0,0
swookiee_com.swookiee.runtime,com.swookiee.runtime.swaggerui,0,0,0,0,1,0,0,1
swookiee_com.swookiee.runtime,com.swookiee.runtime.util.configuration,0,0,0,0,0,0,0,0
swookiee_com.swookiee.runtime,com.swookiee.runtime.util,0,0,0,0,0,0,0,0
swookiee_com.swookiee.runtime,com.swookiee.runtime.core.configuration,0,0,0,0,0,0,0,0
tabulapdf_tabula-java,technology.tabula,2,1,0,1,1,1,0,6
tabulapdf_tabula-java,technology.tabula.debug,0,0,0,0,0,0,0,0
tabulapdf_tabula-java,technology.tabula.detectors,0,0,0,0,1,0,0,1
tabulapdf_tabula-java,technology.tabula.extractors,1,0,0,0,0,1,0,2
tabulapdf_tabula-java,technology.tabula.json,0,0,0,0,0,0,0,0
tabulapdf_tabula-java,technology.tabula.writers,1,0,0,0,0,1,0,2
takahi-i_likelike,org.unigram.likelike.common,0,0,0,0,1,0,0,1
takahi-i_likelike,org.unigram.likelike.feature,0,0,0,0,0,0,0,0
takahi-i_likelike,org.unigram.likelike.lsh.function,1,0,0,0,0,0,0,1
takahi-i_likelike,org.unigram.likelike.lsh,1,1,0,0,1,0,0,3
takahi-i_likelike,org.unigram.likelike.util.accessor,0,0,0,0,0,0,0,0
takahi-i_likelike,org.unigram.likelike.util,0,0,0,0,0,0,0,0
takahi-i_likelike,org.unigram.likelike.validate,0,0,0,0,1,0,0,1
takahi-i_likelike,org.unigram.likelike,0,0,0,0,0,0,0,0
takari_takari-lifecycle,io.takari.maven.plugins.compile,2,0,0,0,1,0,0,3
takari_takari-lifecycle,io.takari.maven.plugins.compile.javac,1,1,0,0,1,0,0,3
takari_takari-lifecycle,io.takari.maven.plugins.compile.jdt,2,1,0,0,1,0,0,4
takari_takari-lifecycle,io.takari.maven.plugins.compile.jdt.classpath,0,0,0,0,1,0,0,1
takari_takari-lifecycle,io.takari.maven.plugins.configurator,0,0,0,0,1,0,0,1
takari_takari-lifecycle,io.takari.maven.plugins,0,0,0,0,0,0,0,0
takari_takari-lifecycle,io.takari.maven.plugins.exportpackage,0,0,0,0,0,0,0,0
takari_takari-lifecycle,io.takari.maven.plugins.install_deploy,0,0,0,0,0,0,0,0
takari_takari-lifecycle,io.takari.maven.plugins.jar,0,0,0,0,1,0,0,1
takari_takari-lifecycle,io.takari.maven.plugins.plugin,0,0,0,0,1,0,0,1
takari_takari-lifecycle,io.takari.maven.plugins.resources,0,0,0,0,0,0,0,0
takari_takari-lifecycle,io.takari.maven.plugins.sisu,0,0,0,0,0,0,0,0
takari_takari-lifecycle,io.takari.maven.plugins.util,0,0,0,0,0,0,0,0
takari_takari-lifecycle,io.takari.resources.filtering,0,0,0,0,1,0,0,1
takari_takari-lifecycle,annotation,0,0,0,0,0,0,0,0
takari_takari-lifecycle,basic,0,0,0,0,1,0,0,1
takari_takari-lifecycle,annotated,0,0,0,0,0,0,0,0
takari_takari-lifecycle,project,0,0,0,0,0,0,0,0
takari_takari-lifecycle,classpath,0,0,0,0,0,0,0,0
takari_takari-lifecycle,encoding,0,0,0,0,0,0,0,0
takari_takari-lifecycle,implicit,0,0,0,0,0,0,0,0
takari_takari-lifecycle,innertype,0,0,0,0,0,0,0,0
takari_takari-lifecycle,innertyperef,0,0,0,0,0,0,0,0
takari_takari-lifecycle,main,0,0,0,0,0,0,0,0
takari_takari-lifecycle,other,0,0,0,0,0,0,0,0
takari_takari-lifecycle,parameters,0,0,0,0,0,0,0,0
takari_takari-lifecycle,space,0,0,0,0,0,0,0,0
takari_takari-lifecycle,nonjava,0,0,0,0,0,0,0,0
takari_takari-lifecycle,warn,0,0,0,0,0,0,0,0
takari_takari-lifecycle,modulea,0,0,0,0,0,0,0,0
takari_takari-lifecycle,moduleb,0,0,0,0,0,0,0,0
takari_takari-lifecycle,crossref,0,0,0,0,0,0,0,0
takari_takari-lifecycle,delete,0,0,0,0,0,0,0,0
takari_takari-lifecycle,error,0,0,0,0,0,0,0,0
takari_takari-lifecycle,moving,0,0,0,0,0,0,0,0
takari_takari-lifecycle,nested,0,0,0,0,0,0,0,0
takari_takari-lifecycle,circular,0,0,0,0,0,0,0,0
takari_takari-lifecycle,missing,0,0,0,0,0,0,0,0
takari_takari-lifecycle,multifile,0,0,0,0,0,0,0,0
takari_takari-lifecycle,reference,0,0,0,0,1,0,0,1
takari_takari-lifecycle,secondary,0,0,0,0,1,0,0,1
takari_takari-lifecycle,removed,0,0,0,0,0,0,0,0
takari_takari-lifecycle,supertype,0,0,0,0,0,0,0,0
takari_takari-lifecycle,reactor.modulea,0,0,0,0,0,0,0,0
takari_takari-lifecycle,reactor.moduleb,0,0,0,0,0,0,0,0
takari_takari-lifecycle,record.reference,0,0,0,0,1,0,0,1
takari_takari-lifecycle,multiround,0,0,0,0,0,0,0,0
takari_takari-lifecycle,typeindex,0,0,0,0,0,0,0,0
takari_takari-lifecycle,proc,0,0,0,0,1,0,0,1
takari_takari-lifecycle,sourcepath.dependency,0,0,0,0,0,0,0,0
takari_takari-lifecycle,sourcepath.project,0,0,0,0,0,0,0,0
takari_takari-lifecycle,sourcepath.projecta,0,0,0,0,0,0,0,0
takari_takari-lifecycle,sourcepath.projectb,0,0,0,0,0,0,0,0
takari_takari-lifecycle,sourcepath.nestedtype.dependency,0,0,0,0,0,0,0,0
takari_takari-lifecycle,sourcepath.nestedtype.project,0,0,0,0,0,0,0,0
takari_takari-lifecycle,sourcepath.secondarytype,0,0,0,0,0,0,0,0
takari_takari-lifecycle,processor,0,0,0,0,1,0,0,1
takari_takari-lifecycle,reprocess,0,0,0,0,0,0,0,0
takari_takari-lifecycle,io.takari.lifecycle.uts.plugindescriptor,0,0,0,0,1,0,0,1
takari_takari-lifecycle,sisu,0,0,0,0,0,0,0,0
takari_takari-lifecycle,org.codehaus.foo,0,0,0,0,1,0,0,1
takari_takari-lifecycle,io.takari.maven.plugins.plugin.model.io.xpp3,0,0,0,0,0,0,0,0
takari_takari-lifecycle,io.takari.maven.plugins.plugin.model,0,0,0,0,0,0,0,0
takari_takari-lifecycle,io.takari,0,0,0,0,0,0,0,0
takari_takari-lifecycle,basic.plugin,0,0,0,0,0,0,0,0
takari_takari-local-repository,io.takari.aether.concurrency,0,0,0,0,0,0,0,0
takari_takari-local-repository,io.takari.aether.localrepo,0,0,0,0,1,0,0,1
takari_takari-local-repository,io.takari.filemanager,0,0,0,0,1,0,0,1
takari_takari-local-repository,io.takari.filemanager.internal,0,0,0,0,0,0,0,0
takari_takari-local-repository,org.eclipse.aether.internal.impl,0,0,0,0,0,0,0,0
takari_takari-local-repository,io.takari.aether.localrepo.its,0,0,0,0,0,0,0,0
takari_takari-smart-builder,io.takari.maven.builder.smart,0,0,0,0,1,0,0,1
takari_takari-smart-builder,io.takari.maven.builder.smart.its,0,0,0,0,0,0,0,0
takezoe_xlsbeans,com.github.takezoe.xlsbeans.annotation,0,0,0,0,0,0,0,0
takezoe_xlsbeans,com.github.takezoe.xlsbeans.converter,0,0,0,0,0,0,0,0
takezoe_xlsbeans,com.github.takezoe.xlsbeans,2,1,0,0,1,1,0,5
takezoe_xlsbeans,com.github.takezoe.xlsbeans.processor,1,0,0,0,0,0,0,1
takezoe_xlsbeans,com.github.takezoe.xlsbeans.sandbox,0,0,0,0,0,0,0,0
takezoe_xlsbeans,com.github.takezoe.xlsbeans.xml,0,0,0,0,0,1,0,1
takezoe_xlsbeans,com.github.takezoe.xlsbeans.xssfconverter.impl.jxl,0,0,0,0,0,0,0,0
takezoe_xlsbeans,com.github.takezoe.xlsbeans.xssfconverter.impl.xssf,0,0,0,0,1,0,0,1
takezoe_xlsbeans,com.github.takezoe.xlsbeans.xssfconverter,0,0,0,0,1,1,0,2
takezoe_xlsbeans,com.github.takezoe.xlsbeans.publicfield,1,1,0,0,1,0,0,3
tarql_tarql,org.deri.tarql,1,0,0,0,1,0,0,2
tarql_tarql,org.deri.tarql.functions,1,0,0,0,0,0,0,1
tchoulihan_bitpieces_practice,com.highcharts.export.converter,1,1,0,0,0,0,0,2
tchoulihan_bitpieces_practice,com.highcharts.export.pool,1,0,0,0,1,0,0,2
tchoulihan_bitpieces_practice,com.highcharts.export.server,1,0,0,0,0,0,0,1
tchoulihan_bitpieces_practice,com.highcharts.export.util,0,0,0,0,0,0,0,0
tchoulihan_bitpieces_practice,com.highcharts.export.controller,0,0,0,0,0,0,0,0
tchoulihan_bitpieces_practice,com.highcharts.export.filter,0,0,0,0,0,0,0,0
tchoulihan_bitpieces_practice,com.highcharts.export.interceptor,0,0,0,0,0,0,0,0
tchoulihan_bitpieces_practice,com.highcharts.export.service,0,0,0,0,0,0,0,0
TDesjardins_GWT-OL3-Playground,com.github.desjardins.elemental,0,0,0,0,0,0,0,0
TDesjardins_GWT-OL3-Playground,ol.animation,0,0,0,0,0,0,0,0
TDesjardins_GWT-OL3-Playground,ol,10,0,0,1,1,0,0,12
TDesjardins_GWT-OL3-Playground,ol.color,1,1,0,0,0,0,0,2
TDesjardins_GWT-OL3-Playground,ol.control,1,1,0,0,1,0,0,3
TDesjardins_GWT-OL3-Playground,ol.easing,0,0,0,0,0,0,0,0
TDesjardins_GWT-OL3-Playground,ol.event,0,0,0,0,0,0,0,0
TDesjardins_GWT-OL3-Playground,ol.events.condition,0,0,0,0,0,0,0,0
TDesjardins_GWT-OL3-Playground,ol.events,0,0,0,0,0,0,0,0
TDesjardins_GWT-OL3-Playground,ol.featureloader,0,0,0,0,0,0,0,0
TDesjardins_GWT-OL3-Playground,ol.format,2,1,0,0,1,0,0,4
TDesjardins_GWT-OL3-Playground,ol.format.filter,0,0,0,0,1,0,0,1
TDesjardins_GWT-OL3-Playground,ol.geom,2,1,0,0,1,0,0,4
TDesjardins_GWT-OL3-Playground,ol.gwt,0,0,0,0,0,0,0,0
TDesjardins_GWT-OL3-Playground,ol.has,0,0,0,0,0,0,0,0
TDesjardins_GWT-OL3-Playground,ol.interaction,1,1,0,1,1,0,0,4
TDesjardins_GWT-OL3-Playground,ol.layer,1,1,0,0,1,0,0,3
TDesjardins_GWT-OL3-Playground,ol.proj,0,0,0,0,0,0,0,0
TDesjardins_GWT-OL3-Playground,ol.render,0,0,0,0,0,0,0,0
TDesjardins_GWT-OL3-Playground,ol.source,1,1,0,1,1,0,0,4
TDesjardins_GWT-OL3-Playground,ol.sphere,0,0,0,0,0,0,0,0
TDesjardins_GWT-OL3-Playground,ol.style,1,1,0,0,1,0,0,3
TDesjardins_GWT-OL3-Playground,ol.tilegrid,1,1,0,0,1,0,0,3
TDesjardins_GWT-OL3-Playground,ol.webgl,0,0,0,0,0,0,0,0
TDesjardins_GWT-OL3-Playground,proj4,0,0,0,0,0,0,0,0
TDesjardins_GWT-OL3-Playground,com.github.desjardins.gwt.junit.client,0,0,0,0,0,0,0,0
TDesjardins_GWT-OL3-Playground,ol.utils,2,1,0,0,0,0,0,3
TDesjardins_GWT-OL3-Playground,com.github.tdesjardins.ol3.demo.client.constants,0,0,0,0,0,0,0,0
TDesjardins_GWT-OL3-Playground,com.github.tdesjardins.ol3.demo.client.example,0,0,0,0,1,0,0,1
TDesjardins_GWT-OL3-Playground,com.github.tdesjardins.ol3.demo.client,0,0,0,0,0,0,0,0
TDesjardins_GWT-OL3-Playground,com.github.tdesjardins.ol3.demo.client.utils,0,1,0,0,0,0,0,1
tdunning_t-digest,com.tdunning,0,0,0,0,1,0,0,1
tdunning_t-digest,com.tdunning.generated,0,0,0,1,0,0,0,1
tdunning_t-digest,com.tdunning.math.stats,0,0,0,1,0,0,0,1
tdunning_t-digest,com.tdunning.scale,0,0,0,0,0,0,0,0
tdunning_t-digest,com.tdunning.tdigest.quality,0,0,0,0,1,0,0,1
teamed_qulice,com.qulice.foo,0,0,0,0,1,0,0,1
teamed_qulice,com.qulice.ant,0,0,0,0,0,0,0,0
teamed_qulice,com.qulice.checkstyle,0,0,0,1,1,0,0,2
teamed_qulice,com.qulice.checkstyle.parameters,0,0,0,0,0,0,0,0
teamed_qulice,foo,0,0,0,1,1,0,0,2
teamed_qulice,(default package),0,0,0,1,1,0,0,2
teamed_qulice,foo.bar,0,0,0,0,1,0,0,1
teamed_qulice,com.qulice.findbugs,0,0,0,0,0,0,0,0
teamed_qulice,com.qulice.gradle,0,0,0,0,0,0,0,0
teamed_qulice,com.qulice.plugin.violations,0,0,0,0,1,0,0,1
teamed_qulice,com.qulice.entity.model,0,0,0,0,0,0,0,0
teamed_qulice,com.qulice.plugin.alpha,0,0,0,0,0,0,0,0
teamed_qulice,com.qulice.maven,0,0,0,0,1,0,0,1
teamed_qulice,com.qulice.pmd,0,0,0,0,1,0,0,1
teamed_qulice,com.qulice.pmd.rules,0,0,0,0,0,0,0,0
teamed_qulice,emp,0,0,0,0,1,0,0,1
teamed_qulice,com.qulice.spi,0,0,0,0,1,0,0,1
teamed_qulice,com.qulice.spotbugs,0,0,0,0,0,0,0,0
teamed_requs,org.requs,0,0,0,0,1,0,0,1
teamed_requs,org.requs.facet,0,0,0,0,0,0,0,0
teamed_requs,org.requs.facet.sa,0,0,0,0,1,0,0,1
teamed_requs,org.requs.facet.syntax,0,0,0,0,1,0,0,1
teamed_requs,org.requs.facet.syntax.ontology,0,0,0,1,1,0,0,2
teamed_requs,org.requs.facet.uml,0,0,0,0,0,0,0,0
teamed_requs,org.requs.rest,0,0,0,0,1,0,0,1
teamed_requs,org.requs.exec,0,0,0,0,0,0,0,0
teamed_requs,org.requs.maven,0,0,0,0,0,0,0,0
TEAMMATES_repo,teammates.client.remoteapi,0,0,0,0,0,0,1,1
TEAMMATES_repo,teammates.client.scripts,0,0,0,0,1,0,1,2
TEAMMATES_repo,teammates.client.scripts.statistics,0,0,0,0,0,0,1,1
TEAMMATES_repo,teammates.client.util,0,0,0,0,0,0,1,1
TEAMMATES_repo,teammates.e2e.cases,0,0,0,0,0,0,1,1
TEAMMATES_repo,teammates.e2e.cases.e2e,0,0,0,0,0,0,1,1
TEAMMATES_repo,teammates.e2e.cases.lnp,0,0,0,0,0,0,1,1
TEAMMATES_repo,teammates.e2e.cases.util,0,0,0,0,0,0,1,1
TEAMMATES_repo,teammates.e2e.pageobjects,0,1,0,0,0,0,1,2
TEAMMATES_repo,teammates.e2e.util,0,1,0,0,1,0,1,3
TEAMMATES_repo,teammates.common.datatransfer.attributes,15,1,0,1,0,0,1,18
TEAMMATES_repo,teammates.common.datatransfer,6,0,0,0,1,0,1,8
TEAMMATES_repo,teammates.common.datatransfer.questions,20,1,0,0,0,0,1,22
TEAMMATES_repo,teammates.common.exception,2,0,0,0,1,0,1,4
TEAMMATES_repo,teammates.common.util,16,1,0,1,1,0,1,20
TEAMMATES_repo,teammates.common.util.retry,0,0,0,0,0,0,1,1
TEAMMATES_repo,teammates.logic.api,0,0,0,0,0,0,1,1
TEAMMATES_repo,teammates.logic.core,5,0,0,0,0,0,1,6
TEAMMATES_repo,teammates.storage.api,4,1,0,0,0,0,1,6
TEAMMATES_repo,teammates.storage.entity,4,0,0,0,0,0,1,5
TEAMMATES_repo,teammates.storage.search,2,0,0,0,1,0,1,4
TEAMMATES_repo,teammates.ui.automated,0,1,0,0,0,0,1,2
TEAMMATES_repo,teammates.ui.controller,0,0,0,0,0,0,1,1
TEAMMATES_repo,teammates.ui.pagedata,5,1,0,0,0,0,1,7
TEAMMATES_repo,teammates.ui.template,5,0,0,0,1,0,1,7
TEAMMATES_repo,teammates.ui.webapi.action,0,1,0,1,0,0,1,3
TEAMMATES_repo,teammates.ui.webapi.output,0,1,0,1,0,0,1,3
TEAMMATES_repo,teammates.ui.webapi.request,0,1,0,0,0,0,1,2
tech-advantage_sonar-gerrit-plugin,fr.techad.sonar.gerrit.factory,1,0,0,0,0,0,0,1
tech-advantage_sonar-gerrit-plugin,fr.techad.sonar.gerrit,1,0,0,0,0,0,0,1
tech-advantage_sonar-gerrit-plugin,fr.techad.sonar.gerrit.network.rest,0,0,0,0,0,0,0,0
tech-advantage_sonar-gerrit-plugin,fr.techad.sonar.gerrit.network.ssh,0,0,0,0,0,0,0,0
tech-advantage_sonar-gerrit-plugin,fr.techad.sonar.gerrit.review,1,1,0,0,1,0,0,3
tech-advantage_sonar-gerrit-plugin,fr.techad.sonar.gerrit.utils,1,0,0,0,0,0,0,1
tech-advantage_sonar-gerrit-plugin,fr.techad.sonar,3,1,0,0,1,0,0,5
tech-advantage_sonar-gerrit-plugin,fr.techad.sonar.utils,1,0,0,0,0,0,0,1
tech-advantage_sonar-gerrit-plugin,fr.techad.sonar.mockito,0,0,0,0,0,0,0,0
techdev-solutions_trackr-backend,de.techdev.trackr.core.mail,0,0,0,0,0,0,0,0
techdev-solutions_trackr-backend,de.techdev.trackr.core.mail.support,0,0,0,0,0,0,0,0
techdev-solutions_trackr-backend,de.techdev.trackr.core.pdf,0,0,0,0,0,0,0,0
techdev-solutions_trackr-backend,de.techdev.trackr.core.security,0,0,0,0,1,0,0,1
techdev-solutions_trackr-backend,de.techdev.trackr.core.web.api,0,0,0,0,1,0,0,1
techdev-solutions_trackr-backend,de.techdev.trackr.core.web.converters,0,0,0,0,0,0,0,0
techdev-solutions_trackr-backend,de.techdev.trackr.domain,0,0,0,0,0,0,0,0
techdev-solutions_trackr-backend,de.techdev.trackr.domain.common,0,0,0,0,1,0,0,1
techdev-solutions_trackr-backend,de.techdev.trackr.domain.company,0,0,0,0,1,0,0,1
techdev-solutions_trackr-backend,de.techdev.trackr.domain.employee.addressbook,0,0,0,0,0,0,0,0
techdev-solutions_trackr-backend,de.techdev.trackr.domain.employee,1,1,0,0,1,0,0,3
techdev-solutions_trackr-backend,de.techdev.trackr.domain.employee.expenses.reports.comments,0,0,0,0,0,0,0,0
techdev-solutions_trackr-backend,de.techdev.trackr.domain.employee.expenses.reports,0,0,0,0,0,0,0,0
techdev-solutions_trackr-backend,de.techdev.trackr.domain.employee.expenses,0,0,0,0,1,0,0,1
techdev-solutions_trackr-backend,de.techdev.trackr.domain.employee.login,0,0,0,0,0,0,0,0
techdev-solutions_trackr-backend,de.techdev.trackr.domain.employee.login.support,0,1,0,0,0,0,0,1
techdev-solutions_trackr-backend,de.techdev.trackr.domain.employee.sickdays,0,0,0,0,1,0,0,1
techdev-solutions_trackr-backend,de.techdev.trackr.domain.employee.vacation,1,1,0,0,0,0,0,2
techdev-solutions_trackr-backend,de.techdev.trackr.domain.employee.vacation.support,1,0,0,0,1,0,0,2
techdev-solutions_trackr-backend,de.techdev.trackr.domain.employee.worktimetracking,1,0,0,0,0,0,0,1
techdev-solutions_trackr-backend,de.techdev.trackr.domain.project.billtimes,0,0,0,0,1,0,0,1
techdev-solutions_trackr-backend,de.techdev.trackr.domain.project.invoice,0,0,0,0,0,0,0,0
techdev-solutions_trackr-backend,de.techdev.trackr.domain.project,0,0,0,0,1,0,0,1
techdev-solutions_trackr-backend,de.techdev.trackr.domain.project.worktimes,0,0,0,0,1,0,0,1
techdev-solutions_trackr-backend,de.techdev.trackr.domain.scheduling,0,0,0,0,0,0,0,0
techdev-solutions_trackr-backend,de.techdev.trackr.domain.translations,0,0,0,0,0,0,0,0
techdev-solutions_trackr-backend,de.techdev.trackr.domain.validation,0,0,0,0,0,0,0,0
techdev-solutions_trackr-backend,de.techdev.trackr,0,0,0,0,0,0,0,0
techdev-solutions_trackr-backend,de.techdev.trackr.util,0,0,0,0,0,0,0,0
techdev-solutions_trackr-backend,de.techdev.trackr.domain.employee.expenses.report.comment,0,0,0,0,0,0,0,0
techdev-solutions_trackr-backend,de.techdev.trackr.domain.employee.expenses.report,0,0,0,0,0,0,0,0
TechzoneMC_NPCLib,net.techcable.npclib.ai,0,0,0,0,0,0,0,0
TechzoneMC_NPCLib,net.techcable.npclib,1,0,0,0,1,0,0,2
TechzoneMC_NPCLib,net.techcable.npclib.nms,0,0,0,0,1,0,0,1
TechzoneMC_NPCLib,net.techcable.npclib.utils,0,0,0,0,0,0,0,0
TechzoneMC_NPCLib,net.techcable.npclib.citizens.ai,0,0,0,0,0,0,0,0
TechzoneMC_NPCLib,net.techcable.npclib.citizens,1,1,0,0,1,0,0,3
TechzoneMC_NPCLib,net.techcable.npclib.nms.ai,0,0,0,0,0,0,0,0
TechzoneMC_NPCLib,net.techcable.npclib.nms.versions.v1_7_R3.ai,1,0,0,0,0,0,0,1
TechzoneMC_NPCLib,net.techcable.npclib.nms.versions.v1_7_R3.entity,0,0,0,0,0,0,0,0
TechzoneMC_NPCLib,net.techcable.npclib.nms.versions.v1_7_R3,1,1,0,0,0,0,0,2
TechzoneMC_NPCLib,net.techcable.npclib.nms.versions.v1_7_R3.network,0,0,0,0,0,0,0,0
TechzoneMC_NPCLib,net.techcable.npclib.nms.versions.v1_7_R4.ai,1,0,0,0,0,0,0,1
TechzoneMC_NPCLib,net.techcable.npclib.nms.versions.v1_7_R4.entity,0,0,0,0,0,0,0,0
TechzoneMC_NPCLib,net.techcable.npclib.nms.versions.v1_7_R4,1,1,0,0,1,0,0,3
TechzoneMC_NPCLib,net.techcable.npclib.nms.versions.v1_7_R4.network,0,0,0,0,0,0,0,0
TechzoneMC_NPCLib,net.techcable.npclib.nms.versions.v1_8_R1.ai,1,0,0,0,0,0,0,1
TechzoneMC_NPCLib,net.techcable.npclib.nms.versions.v1_8_R1.entity,0,0,0,0,0,0,0,0
TechzoneMC_NPCLib,net.techcable.npclib.nms.versions.v1_8_R1,1,0,0,0,0,0,0,1
TechzoneMC_NPCLib,net.techcable.npclib.nms.versions.v1_8_R1.network,0,0,0,0,0,0,0,0
TechzoneMC_NPCLib,net.techcable.npclib.nms.versions.v1_8_R2.ai,1,0,0,0,0,0,0,1
TechzoneMC_NPCLib,net.techcable.npclib.nms.versions.v1_8_R2.entity,0,0,0,0,0,0,0,0
TechzoneMC_NPCLib,net.techcable.npclib.nms.versions.v1_8_R2,1,0,0,0,0,0,0,1
TechzoneMC_NPCLib,net.techcable.npclib.nms.versions.v1_8_R2.network,0,0,0,0,0,0,0,0
TechzoneMC_NPCLib,net.techcable.npclib.nms.versions.v1_8_R3.ai,1,0,0,0,0,0,0,1
TechzoneMC_NPCLib,net.techcable.npclib.nms.versions.v1_8_R3.entity,0,0,0,0,0,0,0,0
TechzoneMC_NPCLib,net.techcable.npclib.nms.versions.v1_8_R3,1,0,0,0,0,0,0,1
TechzoneMC_NPCLib,net.techcable.npclib.nms.versions.v1_8_R3.network,0,0,0,0,0,0,0,0
TechzoneMC_NPCLib,net.techcable.npclib.nms.versions.v1_9_R1.entity,0,0,0,0,0,0,0,0
TechzoneMC_NPCLib,net.techcable.npclib.nms.versions.v1_9_R1,0,0,0,0,0,0,0,0
TechzoneMC_NPCLib,net.techcable.npclib.nms.versions.v1_9_R1.network,0,0,0,0,0,0,0,0
tectonicus_tectonicus,tectonicus,27,1,0,1,0,0,1,30
tectonicus_tectonicus,tectonicus.blockTypes,3,0,0,1,1,0,1,6
tectonicus_tectonicus,tectonicus.cache,6,1,0,0,0,0,1,8
tectonicus_tectonicus,tectonicus.cache.swap,2,1,0,0,1,0,1,5
tectonicus_tectonicus,tectonicus.configuration,4,1,0,0,0,0,1,6
tectonicus_tectonicus,tectonicus.gui,3,0,0,0,0,0,1,4
tectonicus_tectonicus,tectonicus.rasteriser,9,1,0,0,1,0,1,12
tectonicus_tectonicus,tectonicus.rasteriser.jpct,0,0,0,0,0,0,1,1
tectonicus_tectonicus,tectonicus.rasteriser.lwjgl,0,0,0,0,0,0,1,1
tectonicus_tectonicus,tectonicus.rasteriser.processing,0,0,0,0,0,0,1,1
tectonicus_tectonicus,tectonicus.raw,11,1,0,0,0,0,1,13
tectonicus_tectonicus,tectonicus.renderer,10,1,0,0,1,0,1,13
tectonicus_tectonicus,tectonicus.texture,3,1,0,0,0,0,1,5
tectonicus_tectonicus,tectonicus.util,9,1,0,0,1,0,1,12
tectonicus_tectonicus,tectonicus.world,4,1,0,0,1,0,1,7
tectonicus_tectonicus,tectonicus.world.filter,4,0,0,0,0,0,1,5
tectonicus_tectonicus,tectonicus.world.subset,5,1,0,0,0,0,1,7
tesis-dynaware_graph-editor,de.tesis.dynaware.grapheditor,1,0,0,0,1,0,0,2
tesis-dynaware_graph-editor,de.tesis.dynaware.grapheditor.utils,1,1,0,0,1,0,0,3
tesis-dynaware_graph-editor,de.tesis.dynaware.grapheditor.window,0,0,0,0,1,0,0,1
tesis-dynaware_graph-editor,de.tesis.dynaware.grapheditor.data,1,0,0,0,0,0,0,1
tesis-dynaware_graph-editor,de.tesis.dynaware.grapheditor.core.connections,0,0,0,0,0,0,0,0
tesis-dynaware_graph-editor,de.tesis.dynaware.grapheditor.core,0,0,0,0,0,0,0,0
tesis-dynaware_graph-editor,de.tesis.dynaware.grapheditor.core.model,0,0,0,0,0,0,0,0
tesis-dynaware_graph-editor,de.tesis.dynaware.grapheditor.core.selections,0,0,0,0,1,0,0,1
tesis-dynaware_graph-editor,de.tesis.dynaware.grapheditor.core.skins.defaults.connection,0,0,0,0,1,0,0,1
tesis-dynaware_graph-editor,de.tesis.dynaware.grapheditor.core.skins.defaults.connection.segment,0,0,0,0,0,0,0,0
tesis-dynaware_graph-editor,de.tesis.dynaware.grapheditor.core.skins.defaults,0,0,0,0,0,0,0,0
tesis-dynaware_graph-editor,de.tesis.dynaware.grapheditor.core.skins.defaults.tail,0,0,0,0,0,0,0,0
tesis-dynaware_graph-editor,de.tesis.dynaware.grapheditor.core.skins.defaults.utils,0,0,0,0,0,0,0,0
tesis-dynaware_graph-editor,de.tesis.dynaware.grapheditor.core.skins,0,0,0,0,0,0,0,0
tesis-dynaware_graph-editor,de.tesis.dynaware.grapheditor.core.utils,0,0,0,0,0,0,0,0
tesis-dynaware_graph-editor,de.tesis.dynaware.grapheditor.core.view,0,0,0,0,1,0,0,1
tesis-dynaware_graph-editor,de.tesis.dynaware.grapheditor.core.data,0,0,0,0,0,0,0,0
tesis-dynaware_graph-editor,de.tesis.dynaware.grapheditor.core.data.skins,0,0,0,0,0,0,0,0
tesis-dynaware_graph-editor,de.tesis.dynaware.grapheditor.demo.customskins,0,0,0,0,0,0,0,0
tesis-dynaware_graph-editor,de.tesis.dynaware.grapheditor.demo.customskins.titled,0,0,0,0,0,0,0,0
tesis-dynaware_graph-editor,de.tesis.dynaware.grapheditor.demo.customskins.tree,0,0,0,0,1,0,0,1
tesis-dynaware_graph-editor,de.tesis.dynaware.grapheditor.demo,0,0,0,0,0,0,0,0
tesis-dynaware_graph-editor,de.tesis.dynaware.grapheditor.model,0,0,0,0,1,0,0,1
tesis-dynaware_graph-editor,de.tesis.dynaware.grapheditor.model.impl,0,0,0,0,1,0,0,1
tesis-dynaware_graph-editor,de.tesis.dynaware.grapheditor.model.util,0,0,0,0,0,0,0,0
tesseradata_RHIPE,org.godhuli.rhipe,0,0,0,1,1,0,0,2
tesseradata_RHIPE,org.godhuli.rhipe.mr,0,0,0,0,0,0,0,0
tesseradata_RHIPE,(default package),0,0,0,0,0,0,0,0
tesseradata_RHIPE,org.godhuli.rhipe,0,0,0,1,1,0,0,2
tesseradata_RHIPE,org.godhuli.rhipe.mr,0,0,0,0,0,0,0,0
tesseradata_RHIPE,(default package),0,0,0,0,0,0,0,0
thatJavaNerd_JRAW,net.dean.jraw.docs,0,0,0,0,0,0,0,0
thatJavaNerd_JRAW,net.dean.jraw.example.script,0,0,0,0,0,0,0,0
thatJavaNerd_JRAW,net.dean.jraw,0,0,0,0,0,0,0,0
thatJavaNerd_JRAW,net.dean.jraw.databind,0,0,0,0,0,0,0,0
thatJavaNerd_JRAW,net.dean.jraw.models,1,1,0,1,1,0,0,4
thatJavaNerd_JRAW,net.dean.jraw.models.internal,1,0,0,0,1,0,0,2
thechunknetwork_RedisBungee,com.imaginarycode.minecraft.redisbungee,1,0,0,0,1,0,0,2
thechunknetwork_RedisBungee,com.imaginarycode.minecraft.redisbungee.events,0,0,0,0,0,0,0,0
thechunknetwork_RedisBungee,com.imaginarycode.minecraft.redisbungee.util,0,0,0,0,0,0,0,0
thechunknetwork_RedisBungee,com.imaginarycode.minecraft.redisbungee.util.uuid,1,0,0,0,1,0,0,2
TheHolyWaffle_League-of-Legends-XMPP-Chat-Library,(default package),0,0,0,0,1,0,0,1
TheHolyWaffle_League-of-Legends-XMPP-Chat-Library,com.github.theholywaffle.lolchatapi,0,0,0,0,1,0,0,1
TheHolyWaffle_League-of-Legends-XMPP-Chat-Library,com.github.theholywaffle.lolchatapi.listeners,0,0,0,0,0,0,0,0
TheHolyWaffle_League-of-Legends-XMPP-Chat-Library,com.github.theholywaffle.lolchatapi.riotapi,0,0,0,0,0,0,0,0
TheHolyWaffle_League-of-Legends-XMPP-Chat-Library,com.github.theholywaffle.lolchatapi.wrapper,0,0,0,0,0,0,0,0
TheHolyWaffle_TeamSpeak-3-Java-API,(default package),0,0,0,0,1,2,0,3
TheHolyWaffle_TeamSpeak-3-Java-API,com.github.theholywaffle.teamspeak3.api,0,0,0,0,0,2,0,2
TheHolyWaffle_TeamSpeak-3-Java-API,com.github.theholywaffle.teamspeak3.api.event,0,0,0,0,0,1,0,1
TheHolyWaffle_TeamSpeak-3-Java-API,com.github.theholywaffle.teamspeak3.api.exception,0,0,0,0,0,0,0,0
TheHolyWaffle_TeamSpeak-3-Java-API,com.github.theholywaffle.teamspeak3.api.reconnect,0,0,0,0,1,0,0,1
TheHolyWaffle_TeamSpeak-3-Java-API,com.github.theholywaffle.teamspeak3.api.wrapper,0,0,0,1,0,4,0,5
TheHolyWaffle_TeamSpeak-3-Java-API,com.github.theholywaffle.teamspeak3,0,0,0,0,0,7,0,7
TheHolyWaffle_TeamSpeak-3-Java-API,com.github.theholywaffle.teamspeak3.commands,1,0,0,0,0,5,0,6
TheHolyWaffle_TeamSpeak-3-Java-API,com.github.theholywaffle.teamspeak3.commands.parameter,1,1,0,0,0,0,0,2
TheHolyWaffle_TeamSpeak-3-Java-API,com.github.theholywaffle.teamspeak3.commands.response,0,0,0,0,0,2,0,2
thelinmichael_spotify-web-api-java,authorization.authorization_code,0,0,0,0,0,0,0,0
thelinmichael_spotify-web-api-java,authorization.client_credentials,0,0,0,0,0,0,0,0
thelinmichael_spotify-web-api-java,data.albums,0,0,0,0,0,0,0,0
thelinmichael_spotify-web-api-java,data.artists,0,0,0,0,0,0,0,0
thelinmichael_spotify-web-api-java,data.browse,0,0,0,0,1,0,0,1
thelinmichael_spotify-web-api-java,data.browse.miscellaneous,0,0,0,0,0,0,0,0
thelinmichael_spotify-web-api-java,data.follow,0,0,0,0,1,0,0,1
thelinmichael_spotify-web-api-java,data.library,0,0,0,0,1,0,0,1
thelinmichael_spotify-web-api-java,data.personalization,0,0,0,0,0,0,0,0
thelinmichael_spotify-web-api-java,data.personalization.simplified,0,0,0,0,0,0,0,0
thelinmichael_spotify-web-api-java,data.player,0,0,0,0,1,0,0,1
thelinmichael_spotify-web-api-java,data.playlists,0,0,0,0,1,0,0,1
thelinmichael_spotify-web-api-java,data.search,0,0,0,0,0,0,0,0
thelinmichael_spotify-web-api-java,data.search.simplified,0,0,0,0,0,0,0,0
thelinmichael_spotify-web-api-java,data.tracks,0,0,0,0,0,0,0,0
thelinmichael_spotify-web-api-java,data.users_profile,0,0,0,0,0,0,0,0
thelinmichael_spotify-web-api-java,com.wrapper.spotify,30,1,0,0,1,0,0,32
thelinmichael_spotify-web-api-java,com.wrapper.spotify.exceptions.detailed,0,0,0,0,1,0,0,1
thelinmichael_spotify-web-api-java,com.wrapper.spotify.exceptions,0,0,0,0,0,0,0,0
thelinmichael_spotify-web-api-java,com.wrapper.spotify.model_objects,6,1,0,0,1,0,0,8
thelinmichael_spotify-web-api-java,com.wrapper.spotify.model_objects.credentials,2,0,0,0,1,0,0,3
thelinmichael_spotify-web-api-java,com.wrapper.spotify.model_objects.credentials.error,0,0,0,0,0,0,0,0
thelinmichael_spotify-web-api-java,com.wrapper.spotify.model_objects.miscellaneous,2,0,0,1,1,0,0,4
thelinmichael_spotify-web-api-java,com.wrapper.spotify.model_objects.special,2,0,0,0,1,0,0,3
thelinmichael_spotify-web-api-java,com.wrapper.spotify.model_objects.specification,13,1,0,1,1,0,0,16
thelinmichael_spotify-web-api-java,com.wrapper.spotify.requests,9,0,0,0,0,0,0,9
thelinmichael_spotify-web-api-java,com.wrapper.spotify.requests.authorization,4,0,0,0,0,0,0,4
thelinmichael_spotify-web-api-java,com.wrapper.spotify.requests.authorization.authorization_code,5,0,0,0,1,0,0,6
thelinmichael_spotify-web-api-java,com.wrapper.spotify.requests.authorization.client_credentials,4,0,0,0,0,0,0,4
thelinmichael_spotify-web-api-java,com.wrapper.spotify.requests.data,6,1,0,0,0,0,0,7
thelinmichael_spotify-web-api-java,com.wrapper.spotify.requests.data.albums,3,0,0,0,1,0,0,4
thelinmichael_spotify-web-api-java,com.wrapper.spotify.requests.data.artists,0,0,0,0,1,0,0,1
thelinmichael_spotify-web-api-java,com.wrapper.spotify.requests.data.browse,0,0,0,0,1,0,0,1
thelinmichael_spotify-web-api-java,com.wrapper.spotify.requests.data.browse.miscellaneous,2,0,0,0,0,0,0,2
thelinmichael_spotify-web-api-java,com.wrapper.spotify.requests.data.follow,0,0,0,0,1,0,0,1
thelinmichael_spotify-web-api-java,com.wrapper.spotify.requests.data.follow.legacy,2,0,0,0,1,0,0,3
thelinmichael_spotify-web-api-java,com.wrapper.spotify.requests.data.library,0,0,0,0,1,0,0,1
thelinmichael_spotify-web-api-java,com.wrapper.spotify.requests.data.personalization,2,0,0,0,0,0,0,2
thelinmichael_spotify-web-api-java,com.wrapper.spotify.requests.data.personalization.interfaces,0,0,0,0,0,0,0,0
thelinmichael_spotify-web-api-java,com.wrapper.spotify.requests.data.personalization.simplified,3,0,0,0,1,0,0,4
thelinmichael_spotify-web-api-java,com.wrapper.spotify.requests.data.player,0,0,0,1,1,0,0,2
thelinmichael_spotify-web-api-java,com.wrapper.spotify.requests.data.playlists,0,0,0,1,1,0,0,2
thelinmichael_spotify-web-api-java,com.wrapper.spotify.requests.data.search.interfaces,0,0,0,0,0,0,0,0
thelinmichael_spotify-web-api-java,com.wrapper.spotify.requests.data.search,3,0,0,0,0,0,0,3
thelinmichael_spotify-web-api-java,com.wrapper.spotify.requests.data.search.simplified,3,0,0,0,1,0,0,4
thelinmichael_spotify-web-api-java,com.wrapper.spotify.requests.data.tracks,0,0,0,0,1,0,0,1
thelinmichael_spotify-web-api-java,com.wrapper.spotify.requests.data.users_profile,3,0,0,0,1,0,0,4
TheLQ_PircBotX,org.pircbotx.cap,0,0,0,0,0,0,0,0
TheLQ_PircBotX,org.pircbotx,5,1,0,1,1,4,0,12
TheLQ_PircBotX,org.pircbotx.dcc,0,0,0,0,1,1,0,2
TheLQ_PircBotX,org.pircbotx.delay,0,0,0,0,0,0,0,0
TheLQ_PircBotX,org.pircbotx.exception,0,0,0,0,0,0,0,0
TheLQ_PircBotX,org.pircbotx.hooks,2,1,0,0,1,4,0,8
TheLQ_PircBotX,org.pircbotx.hooks.events,3,1,0,1,1,3,0,9
TheLQ_PircBotX,org.pircbotx.hooks.managers,4,0,0,0,1,2,0,7
TheLQ_PircBotX,org.pircbotx.hooks.types,0,0,0,0,0,1,0,1
TheLQ_PircBotX,org.pircbotx.output,0,0,0,0,1,3,0,4
TheLQ_PircBotX,org.pircbotx.snapshot,0,0,0,0,0,0,0,0
TheLQ_PircBotX,org.pircbotx.impl,0,0,0,0,0,0,0,0
theupswell_appengine-counter,io.instacount.appengine.counter,2,1,0,0,1,0,0,4
theupswell_appengine-counter,io.instacount.appengine.counter.data,2,1,0,0,1,0,0,4
theupswell_appengine-counter,io.instacount.appengine.counter.data.ofy,0,0,0,0,0,0,0,0
theupswell_appengine-counter,io.instacount.appengine.counter.exceptions,0,0,0,0,0,0,0,0
theupswell_appengine-counter,io.instacount.appengine.counter.ext,0,0,0,0,0,0,0,0
theupswell_appengine-counter,io.instacount.appengine.counter.service,3,0,0,0,1,0,0,4
thm-projects_arsnova-backend,de.thm.arsnova.cache,0,0,0,0,0,0,0,0
thm-projects_arsnova-backend,de.thm.arsnova.config,0,1,0,0,1,0,0,2
thm-projects_arsnova-backend,de.thm.arsnova.config.properties,2,0,0,0,0,0,0,2
thm-projects_arsnova-backend,de.thm.arsnova.controller,0,0,0,0,1,1,0,2
thm-projects_arsnova-backend,de.thm.arsnova.controller.v2,0,0,0,0,1,3,0,4
thm-projects_arsnova-backend,de.thm.arsnova.event,0,0,0,0,1,3,0,4
thm-projects_arsnova-backend,de.thm.arsnova.management,0,0,0,0,0,0,0,0
thm-projects_arsnova-backend,de.thm.arsnova.model,5,1,0,1,1,10,0,18
thm-projects_arsnova-backend,de.thm.arsnova.model.migration,0,0,0,0,0,1,0,1
thm-projects_arsnova-backend,de.thm.arsnova.model.migration.v2,4,0,0,0,1,2,0,7
thm-projects_arsnova-backend,de.thm.arsnova.model.serialization,6,1,0,0,1,0,0,8
thm-projects_arsnova-backend,de.thm.arsnova.model.transport,0,0,0,0,0,0,0,0
thm-projects_arsnova-backend,de.thm.arsnova.persistence,0,0,0,0,1,0,0,1
thm-projects_arsnova-backend,de.thm.arsnova.persistence.couchdb,0,0,0,0,1,0,0,1
thm-projects_arsnova-backend,de.thm.arsnova.persistence.couchdb.migrations,0,0,0,0,0,0,0,0
thm-projects_arsnova-backend,de.thm.arsnova.persistence.couchdb.support,0,0,0,0,1,0,0,1
thm-projects_arsnova-backend,de.thm.arsnova.security,0,0,0,0,1,1,0,2
thm-projects_arsnova-backend,de.thm.arsnova.security.jwt,0,0,0,0,0,0,0,0
thm-projects_arsnova-backend,de.thm.arsnova.security.pac4j,0,0,0,0,0,0,0,0
thm-projects_arsnova-backend,de.thm.arsnova.service,0,0,0,1,1,8,0,10
thm-projects_arsnova-backend,de.thm.arsnova.service.score,0,0,0,0,0,1,0,1
thm-projects_arsnova-backend,de.thm.arsnova.util,0,0,0,0,0,0,0,0
thm-projects_arsnova-backend,de.thm.arsnova.web,0,0,0,0,1,0,0,1
thm-projects_arsnova-backend,de.thm.arsnova.web.exceptions,0,0,0,0,1,0,0,1
thm-projects_arsnova-backend,de.thm.arsnova.websocket,0,0,0,0,0,4,0,4
thm-projects_arsnova-backend,de.thm.arsnova.websocket.handler,0,0,0,0,0,1,0,1
thm-projects_arsnova-backend,de.thm.arsnova.websocket.message,0,0,0,0,1,2,0,3
tiagobento_watertemplate-engine,org.watertemplate.exception,0,0,0,0,0,0,0,0
tiagobento_watertemplate-engine,org.watertemplate.interpreter,2,1,0,0,0,0,0,3
tiagobento_watertemplate-engine,org.watertemplate.interpreter.exception,0,0,0,0,0,0,0,0
tiagobento_watertemplate-engine,org.watertemplate.interpreter.parser,1,0,0,1,0,0,0,2
tiagobento_watertemplate-engine,org.watertemplate.interpreter.parser.exception,0,0,0,0,0,0,0,0
tiagobento_watertemplate-engine,org.watertemplate,2,1,0,0,0,0,0,3
tiagobento_watertemplate-engine,org.watertemplate.commands,0,0,0,0,1,0,0,1
tiagobento_watertemplate-engine,org.watertemplate.nested,0,0,0,0,0,0,0,0
tiagobento_watertemplate-engine,org.watertemplate.example.collection,0,0,0,0,0,0,0,0
tiagobento_watertemplate-engine,org.watertemplate.example.jaxrs,0,0,0,0,0,0,0,0
tiagobento_watertemplate-engine,org.watertemplate.example.mappedobject,0,0,0,0,0,0,0,0
tiagobento_watertemplate-engine,org.watertemplate.example.nestedtemplates,0,0,0,0,0,0,0,0
tiagobento_watertemplate-engine,org.watertemplate.i18n.developer,0,0,0,0,0,0,0,0
tiagobento_watertemplate-engine,org.watertemplate.i18n,0,0,0,0,0,0,0,0
tiagobento_watertemplate-engine,org.watertemplate.uri.exception,0,0,0,0,0,0,0,0
tiagobento_watertemplate-engine,org.watertemplate.uri,0,0,0,0,0,0,0,0
tiagobento_watertemplate-engine,org.watertemplate.exception,0,0,0,0,0,0,0,0
tiagobento_watertemplate-engine,org.watertemplate.interpreter,2,1,0,0,0,0,0,3
tiagobento_watertemplate-engine,org.watertemplate.interpreter.exception,0,0,0,0,0,0,0,0
tiagobento_watertemplate-engine,org.watertemplate.interpreter.parser,1,0,0,1,0,0,0,2
tiagobento_watertemplate-engine,org.watertemplate.interpreter.parser.exception,0,0,0,0,0,0,0,0
tiagobento_watertemplate-engine,org.watertemplate,2,1,0,0,0,0,0,3
tiagobento_watertemplate-engine,org.watertemplate.commands,0,0,0,0,1,0,0,1
tiagobento_watertemplate-engine,org.watertemplate.nested,0,0,0,0,0,0,0,0
tiagobento_watertemplate-engine,org.watertemplate.example.collection,0,0,0,0,0,0,0,0
tiagobento_watertemplate-engine,org.watertemplate.example.jaxrs,0,0,0,0,0,0,0,0
tiagobento_watertemplate-engine,org.watertemplate.example.mappedobject,0,0,0,0,0,0,0,0
tiagobento_watertemplate-engine,org.watertemplate.example.nestedtemplates,0,0,0,0,0,0,0,0
tiagobento_watertemplate-engine,org.watertemplate.i18n.developer,0,0,0,0,0,0,0,0
tiagobento_watertemplate-engine,org.watertemplate.i18n,0,0,0,0,0,0,0,0
tiagobento_watertemplate-engine,org.watertemplate.uri.exception,0,0,0,0,0,0,0,0
tiagobento_watertemplate-engine,org.watertemplate.uri,0,0,0,0,0,0,0,0
timolson_cointrader,org.cryptocoinpartners.bin,0,0,0,0,1,0,0,1
timolson_cointrader,org.cryptocoinpartners.command,3,1,0,1,1,0,0,6
timolson_cointrader,org.cryptocoinpartners.esper,0,0,0,0,1,0,0,1
timolson_cointrader,org.cryptocoinpartners.exceptions,0,0,0,0,0,0,0,0
timolson_cointrader,org.cryptocoinpartners.module,8,0,0,1,1,0,0,10
timolson_cointrader,org.cryptocoinpartners.module.xchange,0,1,0,0,1,0,0,2
timolson_cointrader,org.cryptocoinpartners.report,0,0,0,0,0,0,0,0
timolson_cointrader,org.cryptocoinpartners.schema,6,1,0,1,1,0,0,9
timolson_cointrader,org.cryptocoinpartners.schema.dao,2,0,0,1,1,0,0,4
timolson_cointrader,org.cryptocoinpartners.service,0,0,0,0,1,0,0,1
timolson_cointrader,org.cryptocoinpartners.util,7,1,0,0,1,0,0,9
timtiemens_secretshare,com.tiemens.secretshare,0,0,0,0,1,0,0,1
timtiemens_secretshare,com.tiemens.secretshare.engine,0,0,0,0,0,0,0,0
timtiemens_secretshare,com.tiemens.secretshare.exceptions,0,0,0,0,0,0,0,0
timtiemens_secretshare,com.tiemens.secretshare.main.cli,0,0,0,0,0,0,0,0
timtiemens_secretshare,com.tiemens.secretshare.main.example,0,0,0,0,0,0,0,0
timtiemens_secretshare,com.tiemens.secretshare.math.combination,0,0,0,0,0,0,0,0
timtiemens_secretshare,com.tiemens.secretshare.math.equation,0,0,0,0,1,0,0,1
timtiemens_secretshare,com.tiemens.secretshare.math.matrix,0,0,0,0,0,0,0,0
timtiemens_secretshare,com.tiemens.secretshare.math.type,0,0,0,0,1,0,0,1
timtiemens_secretshare,com.tiemens.secretshare.md5sum,0,0,0,0,0,0,0,0
timtiemens_secretshare,com.tiemens.secretshare.jdeps.model,0,0,0,0,0,0,0,0
tkurz_sesame-vocab-builder,com.github.tkurz.sesame.vocab,0,0,0,0,0,0,0,0
tkurz_sesame-vocab-builder,com.github.tkurz.sesame.vocab.plugin,0,0,0,0,0,0,0,0
tlaukkan_zigbee4java,org.bubblecloud.zigbee.tools,0,0,0,0,0,0,0,0
tlaukkan_zigbee4java,org.bubblecloud.zigbee.tools.zcl,0,0,0,0,1,0,0,1
tlaukkan_zigbee4java,org.bubblecloud.zigbee,2,0,0,1,0,6,0,9
tlaukkan_zigbee4java,org.bubblecloud.zigbee.api.cluster.impl.core,9,1,0,0,1,8,0,19
tlaukkan_zigbee4java,org.bubblecloud.zigbee.api.cluster.impl.general.alarms,1,0,0,0,0,1,0,2
tlaukkan_zigbee4java,org.bubblecloud.zigbee.api.cluster.impl.general,7,1,0,1,1,3,0,13
tlaukkan_zigbee4java,org.bubblecloud.zigbee.api.cluster.impl.general.groups,2,0,0,0,1,1,0,4
tlaukkan_zigbee4java,org.bubblecloud.zigbee.api.cluster.impl.general.level_control,0,0,0,0,0,0,0,0
tlaukkan_zigbee4java,org.bubblecloud.zigbee.api.cluster.impl.global.reporting,1,0,0,0,1,0,0,2
tlaukkan_zigbee4java,org.bubblecloud.zigbee.api.cluster.impl.global.write,0,0,0,0,0,0,0,0
tlaukkan_zigbee4java,org.bubblecloud.zigbee.network.impl,0,1,0,0,1,4,0,6
tlaukkan_zigbee4java,org.bubblecloud.zigbee.network.packet.af,1,0,0,0,1,1,0,3
tlaukkan_zigbee4java,org.bubblecloud.zigbee.network.packet.zdo,1,0,0,1,1,2,0,5
tlaukkan_zigbee4java,org.bubblecloud.zigbee.network.packet,4,1,0,0,1,3,0,9
tlaukkan_zigbee4java,org.bubblecloud.zigbee.network.port,0,0,0,0,1,0,0,1
tlaukkan_zigbee4java,org.bubblecloud.zigbee.util,1,1,0,0,1,8,0,11
tlaukkan_zigbee4java,org.bubblecloud.zigbee.v3.zcl,0,0,0,0,1,3,0,4
tlaukkan_zigbee4java,org.bubblecloud.zigbee.androidconsole,0,0,0,0,0,0,0,0
tlaukkan_zigbee4java,org.bubblecloud.zigbee.v3,2,0,0,1,0,7,0,10
tlaukkan_zigbee4java,org.bubblecloud.zigbee.v3.model,1,0,0,0,0,3,0,4
tlaukkan_zigbee4java,org.bubblecloud.zigbee.v3.rpc,1,1,0,0,1,0,0,3
tlaukkan_zigbee4java,org.bubblecloud.zigbee.v3.serialization,0,0,0,0,0,8,0,8
tlaukkan_zigbee4java,org.bubblecloud.zigbee.v3.zcl.field,0,0,0,0,1,5,0,6
tlaukkan_zigbee4java,org.bubblecloud.zigbee.v3.zcl.protocol.command.alarms,0,0,0,0,1,0,0,1
tlaukkan_zigbee4java,org.bubblecloud.zigbee.v3.zcl.protocol.command.basic,0,0,0,0,0,0,0,0
tlaukkan_zigbee4java,org.bubblecloud.zigbee.v3.zcl.protocol.command.color.control,0,0,0,0,1,0,0,1
tlaukkan_zigbee4java,org.bubblecloud.zigbee.v3.zcl.protocol.command.commissioning,0,0,0,0,1,0,0,1
tlaukkan_zigbee4java,org.bubblecloud.zigbee.v3.zcl.protocol.command.door.lock,0,0,0,0,0,0,0,0
tlaukkan_zigbee4java,org.bubblecloud.zigbee.v3.zcl.protocol.command.general,0,0,0,0,1,4,0,5
tlaukkan_zigbee4java,org.bubblecloud.zigbee.v3.zcl.protocol.command.groups,0,0,0,0,1,2,0,3
tlaukkan_zigbee4java,org.bubblecloud.zigbee.v3.zcl.protocol.command.ias.ace,0,0,0,0,1,0,0,1
tlaukkan_zigbee4java,org.bubblecloud.zigbee.v3.zcl.protocol.command.ias.wd,0,0,0,0,0,0,0,0
tlaukkan_zigbee4java,org.bubblecloud.zigbee.v3.zcl.protocol.command.ias.zone,0,0,0,0,0,0,0,0
tlaukkan_zigbee4java,org.bubblecloud.zigbee.v3.zcl.protocol.command.identify,0,0,0,0,0,0,0,0
tlaukkan_zigbee4java,org.bubblecloud.zigbee.v3.zcl.protocol.command.level.control,0,0,0,0,1,0,0,1
tlaukkan_zigbee4java,org.bubblecloud.zigbee.v3.zcl.protocol.command.on.off,0,0,0,0,0,0,0,0
tlaukkan_zigbee4java,org.bubblecloud.zigbee.v3.zcl.protocol.command.rssi.location,0,0,0,0,1,0,0,1
tlaukkan_zigbee4java,org.bubblecloud.zigbee.v3.zcl.protocol.command.scenes,0,0,0,0,1,0,0,1
tlaukkan_zigbee4java,org.bubblecloud.zigbee.v3.zcl.protocol.command.thermostat,0,0,0,0,0,0,0,0
tlaukkan_zigbee4java,org.bubblecloud.zigbee.v3.zcl.protocol,0,0,0,0,0,0,0,0
tlaukkan_zigbee4java,org.bubblecloud.zigbee.v3.zdo.command,0,0,0,0,1,0,0,1
tlaukkan_zigbee4java,org.bubblecloud.zigbee.v3.zdo,0,0,0,0,0,0,0,0
tlaukkan_zigbee4java,org.bubblecloud.zigbee.api,6,1,0,0,1,7,0,15
tlaukkan_zigbee4java,org.bubblecloud.zigbee.api.cluster,0,0,0,0,0,4,0,4
tlaukkan_zigbee4java,org.bubblecloud.zigbee.api.cluster.general,0,0,0,1,1,1,0,3
tlaukkan_zigbee4java,org.bubblecloud.zigbee.api.cluster.general.event,0,0,0,0,1,0,0,1
tlaukkan_zigbee4java,org.bubblecloud.zigbee.api.cluster.impl,9,0,0,1,1,5,0,16
tlaukkan_zigbee4java,org.bubblecloud.zigbee.api.cluster.impl.api.closures,0,0,0,0,0,0,0,0
tlaukkan_zigbee4java,org.bubblecloud.zigbee.api.cluster.impl.api.core,0,0,0,0,1,9,0,10
tlaukkan_zigbee4java,org.bubblecloud.zigbee.api.cluster.impl.api.general.alarms,0,0,0,0,0,0,0,0
tlaukkan_zigbee4java,org.bubblecloud.zigbee.api.cluster.impl.api.general,0,0,0,0,1,0,0,1
tlaukkan_zigbee4java,org.bubblecloud.zigbee.api.cluster.impl.api.general.commissioning,0,0,0,0,1,0,0,1
tlaukkan_zigbee4java,org.bubblecloud.zigbee.api.cluster.impl.api.general.groups,0,0,0,0,0,0,0,0
tlaukkan_zigbee4java,org.bubblecloud.zigbee.api.cluster.impl.api.general.identify,0,0,0,0,0,0,0,0
tlaukkan_zigbee4java,org.bubblecloud.zigbee.api.cluster.impl.api.general.scenes,0,0,0,0,1,0,0,1
tlaukkan_zigbee4java,org.bubblecloud.zigbee.api.cluster.impl.api.general.security,0,0,0,0,0,1,0,1
tlaukkan_zigbee4java,org.bubblecloud.zigbee.api.cluster.impl.api.global,0,0,0,0,1,2,0,3
tlaukkan_zigbee4java,org.bubblecloud.zigbee.api.cluster.impl.api.HVAC,0,0,0,0,0,0,0,0
tlaukkan_zigbee4java,org.bubblecloud.zigbee.api.cluster.impl.api.lighting,0,0,0,0,0,0,0,0
tlaukkan_zigbee4java,org.bubblecloud.zigbee.api.cluster.impl.api.measurement_sensing,0,0,0,0,1,0,0,1
tlaukkan_zigbee4java,org.bubblecloud.zigbee.api.cluster.impl.api.protocol_interfaces,0,0,0,0,0,0,0,0
tlaukkan_zigbee4java,org.bubblecloud.zigbee.api.cluster.impl.api.security_safety,0,0,0,0,0,0,0,0
tlaukkan_zigbee4java,org.bubblecloud.zigbee.api.cluster.impl.api.security_safety.ias_ace,0,0,0,0,1,0,0,1
tlaukkan_zigbee4java,org.bubblecloud.zigbee.api.cluster.impl.api.security_safety.ias_wd,0,0,0,0,0,1,0,1
tlaukkan_zigbee4java,org.bubblecloud.zigbee.api.cluster.impl.api.security_safety.ias_zone,0,0,0,0,1,1,0,2
tlaukkan_zigbee4java,org.bubblecloud.zigbee.api.cluster.impl.api.smart_energy,0,0,0,0,0,0,0,0
tlaukkan_zigbee4java,org.bubblecloud.zigbee.api.cluster.impl.attribute,0,0,0,0,0,1,0,1
tlaukkan_zigbee4java,org.bubblecloud.zigbee.api.cluster.impl.event,0,0,0,0,1,1,0,2
tlaukkan_zigbee4java,org.bubblecloud.zigbee.api.cluster.impl.general.commissioning,0,0,0,0,0,1,0,1
tlaukkan_zigbee4java,org.bubblecloud.zigbee.api.cluster.impl.general.identify,0,0,0,0,0,0,0,0
tlaukkan_zigbee4java,org.bubblecloud.zigbee.api.cluster.impl.general.scenes,1,0,0,0,1,1,0,3
tlaukkan_zigbee4java,org.bubblecloud.zigbee.api.cluster.impl.general.security,1,0,0,0,0,0,0,1
tlaukkan_zigbee4java,org.bubblecloud.zigbee.api.cluster.impl.global,1,0,0,0,0,0,0,1
tlaukkan_zigbee4java,org.bubblecloud.zigbee.api.cluster.impl.global.read,0,0,0,0,0,0,0,0
tlaukkan_zigbee4java,org.bubblecloud.zigbee.api.cluster.impl.measurement_sensing,1,0,0,0,0,1,0,2
tlaukkan_zigbee4java,org.bubblecloud.zigbee.api.cluster.impl.protocol_interfaces,0,0,0,0,0,0,0,0
tlaukkan_zigbee4java,org.bubblecloud.zigbee.api.cluster.impl.security_safety,1,1,0,0,0,0,0,2
tlaukkan_zigbee4java,org.bubblecloud.zigbee.api.cluster.impl.security_safety.ias_ace,0,0,0,0,1,1,0,2
tlaukkan_zigbee4java,org.bubblecloud.zigbee.api.cluster.impl.security_safety.ias_wd,0,0,0,0,0,1,0,1
tlaukkan_zigbee4java,org.bubblecloud.zigbee.api.cluster.impl.security_safety.ias_zone,1,0,0,0,1,2,0,4
tlaukkan_zigbee4java,org.bubblecloud.zigbee.api.cluster.measurement_sensing,0,0,0,0,0,0,0,0
tlaukkan_zigbee4java,org.bubblecloud.zigbee.api.cluster.measurement_sensing.event,0,0,0,0,1,0,0,1
tlaukkan_zigbee4java,org.bubblecloud.zigbee.api.cluster.protocol_interfaces,0,0,0,0,0,0,0,0
tlaukkan_zigbee4java,org.bubblecloud.zigbee.api.cluster.security_safety,0,0,0,0,0,0,0,0
tlaukkan_zigbee4java,org.bubblecloud.zigbee.api.device.generic,1,1,0,0,0,0,0,2
tlaukkan_zigbee4java,org.bubblecloud.zigbee.api.device.hvac,1,1,0,0,0,0,0,2
tlaukkan_zigbee4java,org.bubblecloud.zigbee.api.device.impl,0,0,0,0,1,0,0,1
tlaukkan_zigbee4java,org.bubblecloud.zigbee.api.device.lighting,1,1,0,0,1,0,0,3
tlaukkan_zigbee4java,org.bubblecloud.zigbee.api.device.security_safety,1,1,0,0,0,0,0,2
tlaukkan_zigbee4java,org.bubblecloud.zigbee.network,0,0,1,0,1,5,0,7
tlaukkan_zigbee4java,org.bubblecloud.zigbee.network.discovery,0,0,0,0,1,1,0,2
tlaukkan_zigbee4java,org.bubblecloud.zigbee.network.packet.simple,1,0,0,1,1,1,0,4
tlaukkan_zigbee4java,org.bubblecloud.zigbee.network.packet.system,1,0,0,1,1,0,0,3
tlaukkan_zigbee4java,org.bubblecloud.zigbee.network.packet.util,0,0,0,0,1,0,0,1
tltv_gantt,org.tltv.gantt,0,0,0,1,1,0,0,2
tltv_gantt,org.tltv.gantt.client,0,0,0,1,1,0,0,2
tltv_gantt,org.tltv.gantt.client.shared,0,0,0,0,1,0,0,1
tltv_gantt,org.tltv.gantt.demo,0,0,0,0,0,0,0,0
tltv_gantt,org.tltv.gantt.demo.util,0,0,0,0,1,0,0,1
tltv_gantt,com.google.gwt.i18n.client.constants,0,0,0,0,0,0,0,0
tltv_gantt,com.google.gwt.i18n.client,0,0,0,0,0,0,0,0
tltv_gantt,com.google.gwt.i18n.client.impl,0,0,0,0,0,0,0,0
tltv_gantt,com.google.gwt.lang,0,0,0,0,0,0,0,0
tltv_gantt,com.google.gwt.user.client,0,0,0,0,0,0,0,0
tltv_gantt,com.google.gwt.user.client.ui,0,0,0,0,0,0,0,0
tltv_gantt,com.google.gwt.user.client.ui.impl,0,0,0,0,0,0,0,0
tltv_gantt,com.vaadin.client.debug.internal.theme,0,0,0,0,0,0,0,0
tltv_gantt,com.vaadin.client.metadata,0,0,0,0,0,0,0,0
tltv_gantt,com.vaadin.client.ui.dd,0,0,0,0,0,0,0,0
tltv_gantt,com.vaadin.client.ui.richtextarea,0,0,0,0,0,0,0,0
tmullender_ansible-maven-plugin,co.escapeideas.maven.ansible,0,0,0,0,1,0,0,1
ToastShaman_dropwizard-auth-jwt,com.github.toastshaman.dropwizard.auth.jwt,0,0,0,0,1,0,0,1
ToastShaman_dropwizard-auth-jwt,com.github.toastshaman.dropwizard.auth.jwt.example,0,0,0,0,1,0,0,1
TomasMikula_EasyBind,org.fxmisc.easybind,1,0,0,1,0,0,0,2
TomasMikula_EasyBind,org.fxmisc.easybind.monadic,1,1,0,0,0,0,0,2
TomasMikula_EasyBind,org.fxmisc.easybind.select,0,0,0,0,0,0,0,0
TomasMikula_ReactFX,org.reactfx,4,1,0,1,0,0,0,6
TomasMikula_ReactFX,org.reactfx.collection,5,0,0,1,0,0,0,6
TomasMikula_ReactFX,org.reactfx.inhibeans.binding,0,0,0,0,0,0,0,0
TomasMikula_ReactFX,org.reactfx.inhibeans.collection,0,0,0,0,0,0,0,0
TomasMikula_ReactFX,org.reactfx.inhibeans,0,0,0,0,0,0,0,0
TomasMikula_ReactFX,org.reactfx.inhibeans.property,0,0,0,1,0,0,0,1
TomasMikula_ReactFX,org.reactfx.inhibeans.value,0,0,0,0,0,0,0,0
TomasMikula_ReactFX,org.reactfx.util,5,1,0,1,0,0,0,7
TomasMikula_ReactFX,org.reactfx.value,4,1,0,1,0,0,0,6
TomasMikula_ReactFX,org.reactfx.demo,0,0,0,0,0,0,0,0
TomasMikula_ReactFX,org.reactfx.inhibeans.demo,0,0,0,0,1,0,0,1
TomasMikula_RichTextFX,org.fxmisc.richtext.api.caret,0,0,0,0,0,0,0,0
TomasMikula_RichTextFX,org.fxmisc.richtext.api,0,0,0,0,1,0,0,1
TomasMikula_RichTextFX,org.fxmisc.richtext.api.selection,0,0,0,0,0,0,0,0
TomasMikula_RichTextFX,org.fxmisc.richtext,1,1,0,1,0,0,0,3
TomasMikula_RichTextFX,org.fxmisc.richtext.keyboard,0,0,0,0,1,0,0,1
TomasMikula_RichTextFX,org.fxmisc.richtext.keyboard.navigation,0,0,0,0,1,0,0,1
TomasMikula_RichTextFX,org.fxmisc.richtext.mouse,0,0,0,0,1,0,0,1
TomasMikula_RichTextFX,org.fxmisc.richtext.style,0,0,0,0,0,0,0,0
TomasMikula_RichTextFX,org.fxmisc.richtext.event,0,0,0,0,0,0,0,0
TomasMikula_RichTextFX,org.fxmisc.richtext.model,0,0,0,1,0,0,0,1
TomasMikula_RichTextFX,org.fxmisc.richtext.util,1,0,0,0,0,0,0,1
TomasMikula_RichTextFX,org.fxmisc.richtext.demo,0,0,0,0,1,0,0,1
TomasMikula_RichTextFX,org.fxmisc.richtext.demo.hyperlink,0,0,0,0,0,0,0,0
TomasMikula_RichTextFX,org.fxmisc.richtext.demo.lineindicator,0,0,0,0,0,0,0,0
TomasMikula_RichTextFX,org.fxmisc.richtext.demo.richtext,0,0,0,0,0,0,0,0
tomaswolf_gerrit-gitblit-plugin,com.gitblit.client,0,0,0,0,0,0,0,0
tomaswolf_gerrit-gitblit-plugin,com.gitblit.models,0,0,0,0,0,0,0,0
tomaswolf_gerrit-gitblit-plugin,com.gitblit.service,0,0,0,0,0,0,0,0
tomaswolf_gerrit-gitblit-plugin,com.gitblit.servlet,0,0,0,0,0,0,0,0
tomaswolf_gerrit-gitblit-plugin,com.gitblit.tickets,0,0,0,0,0,0,0,0
tomaswolf_gerrit-gitblit-plugin,com.gitblit.utils,0,0,0,0,1,0,0,1
tomaswolf_gerrit-gitblit-plugin,com.gitblit.wicket,0,0,0,0,0,0,0,0
tomaswolf_gerrit-gitblit-plugin,com.gitblit.wicket.pages,0,0,0,0,1,0,0,1
tomaswolf_gerrit-gitblit-plugin,com.gitblit.wicket.panels,0,0,0,0,1,0,0,1
tomaswolf_gerrit-gitblit-plugin,com.googlesource.gerrit.plugins.gitblit.app,2,1,0,0,1,0,0,4
tomaswolf_gerrit-gitblit-plugin,com.googlesource.gerrit.plugins.gitblit.auth,2,1,0,0,0,0,0,3
tomaswolf_gerrit-gitblit-plugin,com.googlesource.gerrit.plugins.gitblit,3,0,0,0,1,0,0,4
tomaswolf_gerrit-gitblit-plugin,com.syntevo.bugtraq,0,0,0,0,0,0,0,0
tomitribe_crest,org.tomitribe.crest.maven,0,0,0,0,1,0,0,1
tomitribe_crest,org.tomitribe.crest.cmds,0,0,0,0,0,0,0,0
tomitribe_crest,org.tomitribe.crest.cmds.processors,0,0,0,0,1,0,0,1
tomitribe_crest,org.tomitribe.crest.cmds.targets,0,0,0,0,0,0,0,0
tomitribe_crest,org.tomitribe.crest.cmds.utils,0,0,0,0,0,0,0,0
tomitribe_crest,org.tomitribe.crest.contexts,0,0,0,0,0,0,0,0
tomitribe_crest,org.tomitribe.crest.converters,0,0,0,0,0,0,0,0
tomitribe_crest,org.tomitribe.crest,0,1,0,1,1,0,0,3
tomitribe_crest,org.tomitribe.crest.environments,0,0,0,0,0,0,0,0
tomitribe_crest,org.tomitribe.crest.interceptor.internal,0,0,0,0,0,0,0,0
tomitribe_crest,org.tomitribe.crest.interceptor.security,0,0,0,0,0,0,0,0
tomitribe_crest,org.tomitribe.crest.lang,0,0,0,0,0,0,0,0
tomitribe_crest,org.tomitribe.crest.val,0,0,0,0,1,0,0,1
tomitribe_crest,org.tomitribe.crest.util,0,0,0,0,1,0,0,1
tomitribe_crest,org.tomitribe.crest.api,0,0,0,0,0,0,0,0
tomitribe_crest,org.tomitribe.crest.api.interceptor,0,0,0,0,0,0,0,0
tomitribe_crest,$groupId,0,0,0,0,1,0,0,1
tomitribe_crest,org.tomitribe.crest.cli.api,0,0,0,0,1,0,0,1
tomitribe_crest,org.tomitribe.crest.cli.api.format,0,0,0,0,0,0,0,0
tomitribe_crest,org.tomitribe.crest.cli.api.interceptor.base,0,0,0,0,0,0,0,0
tomitribe_crest,org.tomitribe.crest.cli.api.interceptor.interactive,0,0,0,0,0,0,0,0
tomitribe_crest,org.tomitribe.crest.cli.impl,0,0,0,0,0,0,0,0
tomitribe_crest,org.tomitribe.crest.cli.impl.command,0,0,0,0,0,0,0,0
tomitribe_crest,org.tomitribe.crest.generator,0,0,0,0,0,0,0,0
tomitribe_crest,org.tomitribe.crest.generator.generated,0,0,0,0,0,0,0,0
tomitribe_crest,org.tomitribe.crest.xbean,0,0,0,0,0,0,0,0
tomitribe_crest,org.example.toolz,0,0,0,0,0,0,0,0
tomsteele_burpbuddy,burp,0,0,0,1,1,0,0,2
tracee_tracee,io.tracee,1,1,0,0,0,7,0,9
tracee_tracee,io.tracee.configuration,1,0,0,0,1,7,0,9
tracee_tracee,io.tracee.spi,0,0,0,0,0,0,0,0
tracee_tracee,io.tracee.backend.threadlocalstore,0,0,0,0,1,0,0,1
tracee_tracee,io.tracee.binding.cxf.interceptor,0,0,0,0,1,0,0,1
tracee_tracee,io.tracee.binding.cxf,0,0,0,0,1,0,0,1
tracee_tracee,io.tracee.binding.httpclient,0,0,0,0,0,0,0,0
tracee_tracee,io.tracee.binding.httpcomponents,0,0,0,0,1,2,0,3
tracee_tracee,io.tracee.binding.jaxrs2,0,0,0,0,1,2,0,3
tracee_tracee,io.tracee.binding.jaxws,0,0,0,0,1,0,0,1
tracee_tracee,io.tracee.binding.jms,0,0,0,0,1,1,0,2
tracee_tracee,io.tracee.binding.quartz,0,0,0,0,1,1,0,2
tracee_tracee,io.tracee.binding.servlet,0,0,0,0,1,0,0,1
tracee_tracee,io.tracee.spring.autoconfigure,0,0,0,0,1,0,0,1
tracee_tracee,io.tracee.binding.spring.context.async.config,0,0,0,0,0,0,0,0
tracee_tracee,io.tracee.binding.spring.context.async,0,0,0,0,1,0,0,1
tracee_tracee,io.tracee.binding.spring.context.config,0,0,0,0,0,0,0,0
tracee_tracee,io.tracee.binding.springhttpclient.config,0,0,0,0,0,0,0,0
tracee_tracee,io.tracee.binding.springhttpclient,0,0,0,0,1,0,0,1
tracee_tracee,io.tracee.binding.springmvc.config,0,1,0,0,0,0,0,1
tracee_tracee,io.tracee.binding.springmvc,0,0,0,0,0,0,0,0
tracee_tracee,io.tracee.binding.springrabbitmq,0,0,0,0,0,1,0,1
tracee_tracee,io.tracee.binding.springws,0,0,0,0,0,0,0,0
tracee_tracee,io.tracee.binding.springws.config,0,0,0,0,0,0,0,0
tracee_tracee,io.tracee.backend.slf4j,0,0,0,0,1,0,0,1
tracee_tracee,io.tracee.transport,0,1,0,0,1,2,0,4
tracee_tracee,io.tracee.transport.jaxb,0,0,0,0,0,0,0,0
TrsstProject_trsst,com.trsst.client,1,0,0,0,0,0,0,1
TrsstProject_trsst,com.trsst,3,1,0,0,0,0,0,4
TrsstProject_trsst,com.trsst.server,1,0,0,0,1,0,0,2
TrsstProject_trsst,com.trsst.ui,1,0,0,0,0,0,0,1
trulia_trulia-java-rets-client,org.realtors.rets.client,0,0,0,1,1,0,0,2
trulia_trulia-java-rets-client,org.realtors.rets.common.metadata.attrib,0,0,0,1,1,0,0,2
trulia_trulia-java-rets-client,org.realtors.rets.common.metadata,0,0,0,0,1,0,0,1
trulia_trulia-java-rets-client,org.realtors.rets.common.metadata.types,0,0,0,1,1,0,0,2
trulia_trulia-java-rets-client,org.realtors.rets.common.util,0,0,0,0,0,0,0,0
trulia_trulia-java-rets-client,org.realtors.rets.examples,0,0,0,0,0,0,0,0
tuenti_SmsRadar,com.tuenti.smsradar,0,0,0,0,1,0,0,1
twitter_cloudhopper-commons,com.cloudhopper.commons.charset,0,0,0,0,0,0,0,0
twitter_cloudhopper-commons,com.cloudhopper.commons.charset.demo,0,0,0,0,1,0,0,1
twitter_cloudhopper-commons,com.cloudhopper.commons.gsm,0,0,0,0,1,0,0,1
twitter_cloudhopper-commons,com.cloudhopper.commons.gsm.demo,0,0,0,0,0,0,0,0
twitter_cloudhopper-commons,com.cloudhopper.commons.io,0,0,0,0,1,0,0,1
twitter_cloudhopper-commons,com.cloudhopper.commons.io.demo,0,0,0,0,0,0,0,0
twitter_cloudhopper-commons,com.cloudhopper.commons.locale,0,0,0,0,1,0,0,1
twitter_cloudhopper-commons,com.cloudhopper.commons.rfs,0,0,0,0,0,0,0,0
twitter_cloudhopper-commons,com.cloudhopper.commons.rfs.provider,0,0,0,0,0,0,0,0
twitter_cloudhopper-commons,com.cloudhopper.commons.sql,1,1,0,0,0,0,0,2
twitter_cloudhopper-commons,com.cloudhopper.commons.sql.adapter,1,0,0,0,0,0,0,1
twitter_cloudhopper-commons,com.cloudhopper.commons.sql.c3p0,0,0,0,0,0,0,0,0
twitter_cloudhopper-commons,com.cloudhopper.commons.sql.proxool,0,0,0,0,0,0,0,0
twitter_cloudhopper-commons,com.cloudhopper.commons.ssl,0,0,0,0,0,0,0,0
twitter_cloudhopper-commons,com.cloudhopper.commons.util,0,0,0,1,0,0,0,1
twitter_cloudhopper-commons,com.cloudhopper.commons.util.codec,0,0,0,0,0,0,0,0
twitter_cloudhopper-commons,com.cloudhopper.commons.util.filefilter,0,0,0,0,0,0,0,0
twitter_cloudhopper-commons,com.cloudhopper.commons.util.time,0,0,0,0,0,0,0,0
twitter_cloudhopper-commons,com.cloudhopper.commons.util.windowing,0,0,0,0,0,0,0,0
twitter_cloudhopper-commons,com.cloudhopper.commons.util.demo,0,0,0,0,1,0,0,1
twitter_cloudhopper-commons,com.cloudhopper.commons.xbean,0,0,0,1,0,0,0,1
twitter_cloudhopper-commons,com.cloudhopper.commons.xbean.type,0,0,0,0,1,0,0,1
twitter_cloudhopper-commons,com.cloudhopper.commons.xbean.util,0,0,0,0,1,0,0,1
twitter_cloudhopper-commons,com.cloudhopper.commons.xml,0,0,0,0,1,0,0,1
twitter_cloudhopper-commons,com.cloudhopper.commons.xbean.demo,0,0,0,0,1,0,0,1
twitter_cloudhopper-commons,com.cloudhopper.httpclient.util,0,0,0,0,1,0,0,1
twitter_cloudhopper-commons,com.cloudhopper.jetty,0,0,0,0,1,0,0,1
twitter_cloudhopper-commons,com.cloudhopper.jetty.demo,0,0,0,0,0,0,0,0
twitter_cloudhopper-commons,com.cloudhopper.sxmp,1,0,0,1,0,0,0,2
twitter_cloudhopper-commons,com.cloudhopper.sxmp.servlet,0,0,0,0,0,0,0,0
twitter_cloudhopper-commons,com.cloudhopper.sxmp.util,1,1,0,0,0,0,0,2
twitter_cloudhopper-commons,com.cloudhopper.sxmp.demo,0,0,0,0,0,0,0,0
twitter_hpack,com.twitter.hpack,0,0,0,0,0,0,0,0
twitter_hpack,com.twitter.hpack.microbench,0,0,0,0,0,0,0,0
twitter_hpack,com.twitter.hpack.microbench.generated,0,0,0,0,1,0,0,1
twitter_hpack,org.openjdk.jmh.infra.generated,0,0,0,0,0,0,0,0
twitter_netty-http2,com.twitter.http2,0,0,0,1,1,0,0,2
tynamo_tapestry-resteasy,org.tynamo.resteasy,2,1,0,0,1,0,0,4
tynamo_tapestry-resteasy,org.tynamo.resteasy.integration,0,0,0,0,0,0,0,0
tynamo_tapestry-resteasy,org.tynamo.resteasy.modules,1,0,0,0,0,0,0,1
tynamo_tapestry-resteasy,org.tynamo.resteasy.rest,0,0,1,0,0,0,0,1
tynamo_tapestry-resteasy,org.tynamo.resteasy.services,1,0,0,0,0,0,0,1
tynamo_tapestry-resteasy,org.tynamo.resteasy.ws.autobuild,0,0,0,0,0,0,0,0
tynamo_tapestry-resteasy,org.tynamo.resteasy.ws,0,0,0,0,0,0,0,0
tynamo_tapestry-security,org.tynamo.security,0,1,0,0,1,0,0,2
tynamo_tapestry-security,org.tynamo.security.components,0,0,0,0,1,0,0,1
tynamo_tapestry-security,org.tynamo.security.internal,0,0,0,0,0,0,0,0
tynamo_tapestry-security,org.tynamo.security.internal.services.impl,0,0,0,0,0,0,0,0
tynamo_tapestry-security,org.tynamo.security.internal.services,0,0,0,0,0,0,0,0
tynamo_tapestry-security,org.tynamo.security.pages,0,0,0,0,0,0,0,0
tynamo_tapestry-security,org.tynamo.security.services,0,0,0,0,0,0,0,0
tynamo_tapestry-security,org.tynamo.security.services.impl,0,0,0,0,1,0,0,1
tynamo_tapestry-security,org.tynamo.security.shiro,0,0,0,0,0,0,0,0
tynamo_tapestry-security,org.tynamo.security.shiro.authc,0,0,0,0,1,0,0,1
tynamo_tapestry-security,org.tynamo.security.shiro.authz,0,0,0,0,1,0,0,1
tynamo_tapestry-security,org.tynamo.shiro.extension.authc.pam,0,0,0,0,0,0,0,0
tynamo_tapestry-security,org.tynamo.shiro.extension.authz.annotations.utils.casters.method,0,0,0,0,0,0,0,0
tynamo_tapestry-security,org.tynamo.shiro.extension.authz.aop,0,0,0,0,0,0,0,0
tynamo_tapestry-security,org.tynamo.shiro.extension.realm.text,0,0,0,0,0,0,0,0
ui4j_ui4j,io.webfolder.ui4j.api.browser,0,0,0,0,1,0,0,1
ui4j_ui4j,io.webfolder.ui4j.api.dialog,0,0,0,0,1,0,0,1
ui4j_ui4j,io.webfolder.ui4j.api.dom,0,0,0,0,1,1,0,2
ui4j_ui4j,io.webfolder.ui4j.api.event,0,0,0,0,0,1,0,1
ui4j_ui4j,io.webfolder.ui4j.api.util,0,0,0,0,1,0,0,1
ui4j_ui4j,io.webfolder.ui4j.spi,0,0,0,0,1,0,0,1
ui4j_ui4j,io.webfolder.ui4j.webkit,0,0,0,0,1,0,0,1
ui4j_ui4j,io.webfolder.ui4j.webkit.aspect,0,0,0,0,0,0,0,0
ui4j_ui4j,io.webfolder.ui4j.webkit.browser,3,1,0,0,1,1,0,6
ui4j_ui4j,io.webfolder.ui4j.webkit.dom,4,0,0,0,1,0,0,5
ui4j_ui4j,io.webfolder.ui4j.webkit.spi,3,1,0,0,0,0,0,4
unitsofmeasurement_unit-ri,tec.units.ri,10,1,0,0,1,0,0,12
unitsofmeasurement_unit-ri,tec.units.ri.format,6,0,0,0,1,0,0,7
unitsofmeasurement_unit-ri,tec.units.ri.function,2,0,0,0,1,0,0,3
unitsofmeasurement_unit-ri,tec.units.ri.internal,1,0,0,0,0,0,0,1
unitsofmeasurement_unit-ri,tec.units.ri.internal.format,2,0,0,0,0,0,0,2
unitsofmeasurement_unit-ri,tec.units.ri.internal.format.l10n,0,0,0,0,0,0,0,0
unitsofmeasurement_unit-ri,tec.units.ri.quantity,8,1,0,0,0,0,0,9
unitsofmeasurement_unit-ri,tec.units.ri.spi,5,0,0,0,1,0,0,6
unitsofmeasurement_unit-ri,tec.units.ri.unit,4,1,0,0,1,0,0,6
usc-isi-i2_Web-Karma,edu.isi.karma.controller.command.alignment,0,0,0,1,1,1,1,4
usc-isi-i2_Web-Karma,edu.isi.karma.controller.command,16,1,0,1,1,5,1,25
usc-isi-i2_Web-Karma,edu.isi.karma.controller.command.worksheet,0,0,0,1,1,2,1,5
usc-isi-i2_Web-Karma,edu.isi.karma.kr2rml,1,0,0,0,1,5,1,8
usc-isi-i2_Web-Karma,edu.isi.karma.util,11,1,0,0,1,0,1,14
usc-isi-i2_Web-Karma,edu.isi.karma.er.helper,7,1,0,0,1,1,1,11
usc-isi-i2_Web-Karma,edu.isi.karma.kr2rml.writer,0,0,0,0,1,2,1,4
usc-isi-i2_Web-Karma,edu.isi.karma.controller.command.importdata,0,0,0,0,1,0,1,2
usc-isi-i2_Web-Karma,edu.isi.karma.controller.history,3,0,0,0,1,0,1,5
usc-isi-i2_Web-Karma,edu.isi.karma.controller.update,9,1,0,1,0,9,1,21
usc-isi-i2_Web-Karma,edu.isi.karma.imp.database,0,0,0,0,0,0,1,1
usc-isi-i2_Web-Karma,edu.isi.karma.imp.mdb,0,0,0,0,0,0,1,1
usc-isi-i2_Web-Karma,edu.isi.karma.geospatial,1,0,0,0,1,0,1,3
usc-isi-i2_Web-Karma,edu.isi.karma.webserver,43,1,0,0,1,0,1,46
usc-isi-i2_Web-Karma,edu.isi.karma.imp.json,0,0,0,0,0,0,1,1
usc-isi-i2_Web-Karma,edu.isi.karma.controller.command.publish,5,0,0,0,1,0,1,7
usc-isi-i2_Web-Karma,edu.isi.karma.controller.command.service,0,0,0,0,1,1,1,3
usc-isi-i2_Web-Karma,edu.isi.karma.model.serialization,12,1,0,0,1,0,1,15
usc-isi-i2_Web-Karma,edu.isi.karma.controller.command.publish.avro,0,0,0,0,0,0,1,1
usc-isi-i2_Web-Karma,edu.isi.karma.controller.command.publish.json,0,0,0,0,0,0,1,1
usc-isi-i2_Web-Karma,edu.isi.karma.controller.command.transformation,0,0,0,0,1,0,1,2
usc-isi-i2_Web-Karma,edu.isi.karma.kr2rml.mapping,2,1,0,0,1,1,1,6
usc-isi-i2_Web-Karma,edu.isi.karma.kr2rml.template,0,1,0,0,0,4,1,6
usc-isi-i2_Web-Karma,edu.isi.karma.metadata,7,0,0,0,1,0,1,9
usc-isi-i2_Web-Karma,edu.isi.karma.transformation.tokenizer,0,0,0,0,1,0,1,2
usc-isi-i2_Web-Karma,edu.isi.karma.controller.command.worksheet.selection,0,0,0,0,1,1,1,3
usc-isi-i2_Web-Karma,edu.isi.karma.common,0,0,0,0,0,0,1,1
usc-isi-i2_Web-Karma,edu.isi.karma.config,21,1,0,0,0,0,1,23
usc-isi-i2_Web-Karma,edu.isi.karma.controller.command.selection,8,1,0,0,1,4,1,15
usc-isi-i2_Web-Karma,edu.isi.karma.imp.avro,0,0,0,0,0,0,1,1
usc-isi-i2_Web-Karma,edu.isi.karma.imp.csv,0,0,0,0,0,0,1,1
usc-isi-i2_Web-Karma,edu.isi.karma.imp,0,0,0,0,0,0,1,1
usc-isi-i2_Web-Karma,edu.isi.karma.kr2rml.affinity,0,0,0,0,0,0,1,1
usc-isi-i2_Web-Karma,edu.isi.karma.kr2rml.exception,0,0,0,0,0,0,1,1
usc-isi-i2_Web-Karma,edu.isi.karma.kr2rml.formatter,0,0,0,0,0,0,1,1
usc-isi-i2_Web-Karma,edu.isi.karma.kr2rml.planning,0,0,0,0,1,5,1,7
usc-isi-i2_Web-Karma,edu.isi.karma.modeling.alignment,16,1,0,0,1,2,1,21
usc-isi-i2_Web-Karma,edu.isi.karma.modeling.alignment.learner,5,0,0,0,1,0,1,7
usc-isi-i2_Web-Karma,edu.isi.karma.modeling,0,0,0,0,0,0,1,1
usc-isi-i2_Web-Karma,edu.isi.karma.modeling.ontology,3,0,0,0,1,0,1,5
usc-isi-i2_Web-Karma,edu.isi.karma.modeling.semantictypes,3,0,0,0,1,1,1,6
usc-isi-i2_Web-Karma,edu.isi.karma.modeling.steiner.topk,2,0,0,0,0,0,1,3
usc-isi-i2_Web-Karma,edu.isi.karma.rdf,0,1,0,1,1,0,1,4
usc-isi-i2_Web-Karma,edu.isi.karma.rep.alignment,7,0,0,0,1,3,1,12
usc-isi-i2_Web-Karma,edu.isi.karma.rep,9,1,0,0,1,11,1,23
usc-isi-i2_Web-Karma,edu.isi.karma.rep.metadata,1,1,0,0,0,2,1,5
usc-isi-i2_Web-Karma,edu.isi.karma.rep.model,4,1,0,0,1,0,1,7
usc-isi-i2_Web-Karma,edu.isi.karma.rep.sources,10,0,0,0,0,1,1,12
usc-isi-i2_Web-Karma,edu.isi.karma.service.json,1,1,0,0,0,0,1,3
usc-isi-i2_Web-Karma,edu.isi.karma.view,2,0,0,0,1,3,1,7
usc-isi-i2_Web-Karma,com.github.jsonldjava.core,1,1,0,0,1,0,1,4
usc-isi-i2_Web-Karma,com.github.jsonldjava.impl,1,0,0,0,1,0,1,3
usc-isi-i2_Web-Karma,com.github.jsonldjava.utils,0,0,0,0,0,0,1,1
usc-isi-i2_Web-Karma,edu.isi.karma.jsonld.helper,0,0,0,0,0,0,1,1
usc-isi-i2_Web-Karma,edu.isi.karma.jsonld.spark,0,0,0,0,0,0,1,1
usc-isi-i2_Web-Karma,edu.isi.karma.mapreduce.driver,0,0,0,1,1,0,1,3
usc-isi-i2_Web-Karma,edu.isi.karma.mapreduce.function,0,0,0,0,1,0,1,2
usc-isi-i2_Web-Karma,edu.isi.karma.mapreduce.inputformat,0,0,0,0,1,0,1,2
usc-isi-i2_Web-Karma,edu.isi.karma.mapreduce.tripleparser,0,0,0,0,0,0,1,1
usc-isi-i2_Web-Karma,edu.isi.karma.rdf.bloom,0,0,0,0,0,0,1,1
usc-isi-i2_Web-Karma,edu.isi.karma.research.misc,0,0,0,0,0,0,1,1
usc-isi-i2_Web-Karma,edu.isi.karma.research.modeling,0,0,0,0,1,1,1,3
usc-isi-i2_Web-Karma,edu.isi.karma.reserach.alignment,0,0,0,0,0,0,1,1
usc-isi-i2_Web-Karma,edu.isi.karma.spark,0,0,0,0,0,0,1,1
usc-isi-i2_Web-Karma,edu.isi.karma.storm.bolt,0,0,0,0,0,0,1,1
usc-isi-i2_Web-Karma,edu.isi.karma.storm.function,0,0,0,0,0,0,1,1
usc-isi-i2_Web-Karma,edu.isi.karma.storm.strategy,0,0,0,0,1,0,1,2
usc-isi-i2_Web-Karma,edu.isi.karma.storm,0,0,0,0,0,0,1,1
usc-isi-i2_Web-Karma,edu.isi.karma.semantictypes.evaluation,0,0,0,0,0,0,1,1
usc-isi-i2_Web-Karma,edu.isi.karma.semantictypes.numeric,0,0,0,0,0,0,1,1
usc-isi-i2_Web-Karma,edu.isi.karma.semantictypes.tfIdf,1,1,0,0,0,0,1,3
usc-isi-i2_Web-Karma,edu.isi.karma.semantictypes.typinghandler,3,0,0,0,0,0,1,4
usc-isi-i2_Web-Karma,edu.isi.karma.imp.excel,0,0,0,0,0,0,1,1
usc-isi-i2_Web-Karma,edu.isi.karma.linkedapi.server,0,0,0,0,0,0,1,1
usc-isi-i2_Web-Karma,edu.isi.karma.modeling.research,0,0,0,0,0,0,1,1
usc-isi-i2_Web-Karma,edu.isi.karma.web.services.publish.es,0,0,0,0,0,0,1,1
usc-isi-i2_Web-Karma,edu.isi.karma.web.services.rdf,0,0,0,0,0,0,1,1
uwolfer_gerrit-rest-java-client,com.google.gerrit.extensions.api.access,0,0,0,0,0,0,0,0
uwolfer_gerrit-rest-java-client,com.google.gerrit.extensions.api.accounts,0,0,0,0,1,0,0,1
uwolfer_gerrit-rest-java-client,com.google.gerrit.extensions.api.changes,0,0,0,1,1,0,0,2
uwolfer_gerrit-rest-java-client,com.google.gerrit.extensions.api.config,0,0,0,0,1,0,0,1
uwolfer_gerrit-rest-java-client,com.google.gerrit.extensions.api,0,0,0,0,0,0,0,0
uwolfer_gerrit-rest-java-client,com.google.gerrit.extensions.api.groups,0,0,0,0,1,0,0,1
uwolfer_gerrit-rest-java-client,com.google.gerrit.extensions.api.plugins,0,0,0,0,0,0,0,0
uwolfer_gerrit-rest-java-client,com.google.gerrit.extensions.api.projects,0,0,0,1,1,0,0,2
uwolfer_gerrit-rest-java-client,com.google.gerrit.extensions.client,0,0,0,0,1,0,0,1
uwolfer_gerrit-rest-java-client,com.google.gerrit.extensions.common,0,0,0,1,1,0,0,2
uwolfer_gerrit-rest-java-client,com.google.gerrit.extensions.restapi,0,0,0,0,1,0,0,1
uwolfer_gerrit-rest-java-client,com.google.gwtorm.server,0,0,0,0,0,0,0,0
uwolfer_gerrit-rest-java-client,com.urswolfer.gerrit.client.rest.accounts,0,0,0,0,0,0,0,0
uwolfer_gerrit-rest-java-client,com.urswolfer.gerrit.client.rest,1,0,0,0,1,0,0,2
uwolfer_gerrit-rest-java-client,com.urswolfer.gerrit.client.rest.gson,0,0,0,0,1,0,0,1
uwolfer_gerrit-rest-java-client,com.urswolfer.gerrit.client.rest.http.accounts,0,0,0,0,1,0,0,1
uwolfer_gerrit-rest-java-client,com.urswolfer.gerrit.client.rest.http.changes,0,0,0,1,1,0,0,2
uwolfer_gerrit-rest-java-client,com.urswolfer.gerrit.client.rest.http.config,0,0,0,0,0,0,0,0
uwolfer_gerrit-rest-java-client,com.urswolfer.gerrit.client.rest.http,1,1,0,0,1,0,0,3
uwolfer_gerrit-rest-java-client,com.urswolfer.gerrit.client.rest.http.groups,0,0,0,0,1,0,0,1
uwolfer_gerrit-rest-java-client,com.urswolfer.gerrit.client.rest.http.projects,0,0,0,0,1,0,0,1
uwolfer_gerrit-rest-java-client,com.urswolfer.gerrit.client.rest.http.tools,0,0,0,0,0,0,0,0
uwolfer_gerrit-rest-java-client,com.urswolfer.gerrit.client.rest.http.util,0,0,0,0,0,0,0,0
uwolfer_gerrit-rest-java-client,com.urswolfer.gerrit.client.rest.tools,0,0,0,0,0,0,0,0
uwolfer_gerrit-rest-java-client,com.urswolfer.gerrit.client.rest.http.common,0,0,0,0,1,0,0,1
valchkou_cassandra-driver-mapping,com.datastax.driver.mapping.builder,1,1,0,0,0,0,0,2
valchkou_cassandra-driver-mapping,com.datastax.driver.mapping,2,0,0,0,1,0,0,3
valchkou_cassandra-driver-mapping,com.datastax.driver.mapping.meta,0,0,0,0,0,0,0,0
valchkou_cassandra-driver-mapping,com.datastax.driver.mapping.option,0,0,0,0,0,0,0,0
valchkou_cassandra-driver-mapping,com.datastax.driver.mapping.schemasync,1,1,0,0,1,0,0,3
valchkou_cassandra-driver-mapping,com.datastax.driver.mapping.entity,0,0,0,0,1,0,0,1
vbauer_avconv4java,com.github.vbauer.avconv4java.core,0,1,0,0,0,0,0,1
vbauer_avconv4java,com.github.vbauer.avconv4java.option.advanced,0,0,0,0,0,0,0,0
vbauer_avconv4java,com.github.vbauer.avconv4java.option,0,0,0,0,1,0,0,1
vbauer_avconv4java,com.github.vbauer.avconv4java.type,0,0,0,0,1,0,0,1
vbauer_avconv4java,com.github.vbauer.avconv4java.util,0,0,0,0,0,0,0,0
vbauer_avconv4java,com.github.vbauer.avconv4java.util.process,0,0,0,0,0,0,0,0
vbauer_caesar,com.github.vbauer.caesar.annotation,0,0,0,0,0,0,0,0
vbauer_caesar,com.github.vbauer.caesar.callback,0,0,0,0,0,0,0,0
vbauer_caesar,com.github.vbauer.caesar.exception,0,0,0,0,0,0,0,0
vbauer_caesar,com.github.vbauer.caesar.proxy,0,0,0,0,0,0,0,0
vbauer_caesar,com.github.vbauer.caesar.runner,1,0,0,0,0,0,0,1
vbauer_caesar,com.github.vbauer.caesar.runner.impl,0,0,0,0,1,0,0,1
vbauer_caesar,com.github.vbauer.caesar.runner.impl.base,0,0,0,0,0,0,0,0
vbauer_caesar,com.github.vbauer.caesar.runner.task,0,0,0,0,0,0,0,0
vbauer_caesar,com.github.vbauer.caesar.util,1,1,0,0,0,0,0,2
vbauer_caesar,com.github.vbauer.caesar.basic,0,0,0,0,0,0,0,0
vbauer_caesar,com.github.vbauer.caesar.bean,0,0,0,0,1,0,0,1
vbauer_houdini,com.github.vbauer.houdini.exception.base,0,0,0,0,0,0,0,0
vbauer_houdini,com.github.vbauer.houdini.exception,0,0,0,0,0,0,0,0
vbauer_houdini,com.github.vbauer.houdini.ext.guice,0,0,0,0,0,0,0,0
vbauer_houdini,com.github.vbauer.houdini.ext.spring,0,0,0,0,0,0,0,0
vbauer_houdini,com.github.vbauer.houdini.model,0,0,0,0,0,0,0,0
vbauer_houdini,com.github.vbauer.houdini.service.impl,0,1,0,0,0,0,0,1
vbauer_houdini,com.github.vbauer.houdini.service,0,0,0,0,0,0,0,0
vbauer_houdini,com.github.vbauer.houdini.converter,0,0,0,0,0,0,0,0
vbauer_houdini,com.github.vbauer.houdini.core,0,0,0,0,0,0,0,0
vbence_stream-m,org.czentral.data.binary.annotation,0,0,0,0,0,0,0,0
vbence_stream-m,org.czentral.data.binary,0,0,0,0,1,0,0,1
vbence_stream-m,org.czentral.data.binary.serializer,0,0,0,0,1,0,0,1
vbence_stream-m,org.czentral.event,0,0,0,0,0,0,0,0
vbence_stream-m,org.czentral.format.flv,0,0,0,0,0,0,0,0
vbence_stream-m,org.czentral.format.mp4,0,0,0,1,0,0,0,1
vbence_stream-m,org.czentral.incubator.streamm,3,1,0,0,0,0,0,4
vbence_stream-m,org.czentral.incubator.streamm.web,2,0,0,0,0,0,0,2
vbence_stream-m,org.czentral.minihttp,0,0,0,0,0,0,0,0
vbence_stream-m,org.czentral.minirtmp,0,0,0,0,0,0,0,0
vbence_stream-m,org.czentral.util.stream,2,1,0,0,1,0,0,4
vert-x3_codegen,io.vertx.codegen,5,1,0,1,0,3,0,10
vert-x3_codegen,io.vertx.codegen.doc,2,1,0,0,0,2,0,5
vert-x3_codegen,io.vertx.codegen.generators.cheatsheet,0,0,0,0,0,1,0,1
vert-x3_codegen,io.vertx.codegen.generators.dataobjecthelper,0,0,0,0,0,1,0,1
vert-x3_codegen,io.vertx.codegen.generators.mvel,2,0,0,0,0,0,0,2
vert-x3_codegen,io.vertx.codegen.overloadcheck,0,0,0,0,0,0,0,0
vert-x3_codegen,io.vertx.codegen.type,3,1,0,0,0,3,0,7
vert-x3_codegen,io.vertx.codegen.writer,0,0,0,0,0,0,0,0
vert-x3_codegen,io.vertx.core,0,0,0,0,0,0,0,0
vert-x3_codegen,io.vertx.core.buffer,0,0,0,0,0,0,0,0
vert-x3_codegen,io.vertx.core.json,0,0,0,0,0,0,0,0
vert-x3_codegen,io.vertx.core.streams,0,0,0,0,0,0,0,0
vert-x3_codegen,com.acme.pkg,0,0,0,0,0,0,0,0
vert-x3_codegen,com.acme.pkg.sub,0,0,0,0,0,0,0,0
vert-x3_service-proxy,examples,0,0,0,0,0,0,0,0
vert-x3_service-proxy,io.vertx.serviceproxy.generator,0,0,0,0,0,0,0,0
vert-x3_service-proxy,io.vertx.serviceproxy.generator.model,0,0,0,0,0,0,0,0
vert-x3_service-proxy,io.vertx.serviceproxy,0,0,0,0,1,0,0,1
vert-x3_service-proxy,io.vertx.serviceproxy.clustered,0,0,0,0,1,0,0,1
vert-x3_service-proxy,io.vertx.serviceproxy.codegen,0,0,0,0,0,0,0,0
vert-x3_vertx-codegen,io.vertx.codegen,5,1,0,1,0,3,0,10
vert-x3_vertx-codegen,io.vertx.codegen.doc,2,1,0,0,0,2,0,5
vert-x3_vertx-codegen,io.vertx.codegen.generators.cheatsheet,0,0,0,0,0,1,0,1
vert-x3_vertx-codegen,io.vertx.codegen.generators.dataobjecthelper,0,0,0,0,0,1,0,1
vert-x3_vertx-codegen,io.vertx.codegen.generators.mvel,2,0,0,0,0,0,0,2
vert-x3_vertx-codegen,io.vertx.codegen.overloadcheck,0,0,0,0,0,0,0,0
vert-x3_vertx-codegen,io.vertx.codegen.type,3,1,0,0,0,3,0,7
vert-x3_vertx-codegen,io.vertx.codegen.writer,0,0,0,0,0,0,0,0
vert-x3_vertx-codegen,io.vertx.core,0,0,0,0,0,0,0,0
vert-x3_vertx-codegen,io.vertx.core.buffer,0,0,0,0,0,0,0,0
vert-x3_vertx-codegen,io.vertx.core.json,0,0,0,0,0,0,0,0
vert-x3_vertx-codegen,io.vertx.core.streams,0,0,0,0,0,0,0,0
vert-x3_vertx-codegen,com.acme.pkg,0,0,0,0,0,0,0,0
vert-x3_vertx-codegen,com.acme.pkg.sub,0,0,0,0,0,0,0,0
vert-x3_vertx-groovy,io.vertx.lang.groovy,0,0,0,0,1,0,1,2
vert-x3_vertx-groovy,io.vertx.groovy.discovery.service,0,0,0,0,0,0,1,1
vert-x3_vertx-groovy,io.vertx.groovy.discovery,0,0,0,0,0,0,1,1
vert-x3_vertx-groovy,io.vertx.lang.groovy.basescripts,0,0,0,0,0,0,1,1
vert-x3_vertx-groovy,io.vertx.lang.groovy.support,0,0,0,0,0,0,1,1
vert-x3_vertx-groovy,examples,0,0,0,1,1,0,1,3
vert-x3_vertx-groovy,examples.cli,0,0,0,0,1,0,1,2
vert-x3_vertx-groovy,examples.hystrix,0,0,0,0,0,0,1,1
vert-x3_vertx-groovy,examples.junit,0,0,0,0,1,0,1,2
vert-x3_vertx-groovy,examples.limited,0,0,0,0,0,0,1,1
vert-x3_vertx-groovy,examples.pack,0,0,0,0,0,0,1,1
vert-x3_vertx-groovy,io.vertx.cassandra,0,0,0,0,1,0,1,2
vert-x3_vertx-groovy,io.vertx.circuitbreaker,0,0,0,0,1,0,1,2
vert-x3_vertx-groovy,io.vertx.config,0,0,0,0,0,0,1,1
vert-x3_vertx-groovy,io.vertx.config.spi,0,0,0,0,0,0,1,1
vert-x3_vertx-groovy,io.vertx.config.spi.utils,0,0,0,0,0,0,1,1
vert-x3_vertx-groovy,io.vertx.core,25,1,0,0,0,0,1,27
vert-x3_vertx-groovy,io.vertx.core.buffer,7,1,0,0,0,0,1,9
vert-x3_vertx-groovy,io.vertx.core.cli,1,1,0,0,0,0,1,3
vert-x3_vertx-groovy,io.vertx.core.cli.annotations,1,0,0,0,0,0,1,2
vert-x3_vertx-groovy,io.vertx.core.cli.converters,0,0,0,0,0,0,1,1
vert-x3_vertx-groovy,io.vertx.core.datagram,4,0,0,0,0,0,1,5
vert-x3_vertx-groovy,io.vertx.core.dns,4,0,0,0,1,0,1,6
vert-x3_vertx-groovy,io.vertx.core.eventbus,2,0,0,0,1,0,1,4
vert-x3_vertx-groovy,io.vertx.core.file,2,0,0,0,1,0,1,4
vert-x3_vertx-groovy,io.vertx.core.http,3,1,0,1,1,0,1,7
vert-x3_vertx-groovy,io.vertx.core.json,23,1,0,0,1,0,1,26
vert-x3_vertx-groovy,io.vertx.core.json.jackson,2,0,0,0,0,0,1,3
vert-x3_vertx-groovy,io.vertx.core.json.pointer,0,0,0,0,0,0,1,1
vert-x3_vertx-groovy,io.vertx.core.logging,0,0,0,0,1,0,1,2
vert-x3_vertx-groovy,io.vertx.core.metrics,2,1,0,0,0,0,1,4
vert-x3_vertx-groovy,io.vertx.core.net,4,0,0,1,0,0,1,6
vert-x3_vertx-groovy,io.vertx.core.parsetools,0,0,0,0,0,0,1,1
vert-x3_vertx-groovy,io.vertx.core.shareddata,0,0,0,0,1,0,1,2
vert-x3_vertx-groovy,io.vertx.core.spi.cluster,1,0,0,0,0,0,1,2
vert-x3_vertx-groovy,io.vertx.core.spi,11,1,0,0,0,0,1,13
vert-x3_vertx-groovy,io.vertx.core.spi.json,1,0,0,0,0,0,1,2
vert-x3_vertx-groovy,io.vertx.core.spi.launcher,0,0,0,0,1,0,1,2
vert-x3_vertx-groovy,io.vertx.core.spi.logging,0,0,0,0,0,0,1,1
vert-x3_vertx-groovy,io.vertx.core.spi.metrics,0,0,0,0,1,0,1,2
vert-x3_vertx-groovy,io.vertx.core.spi.resolver,0,0,0,0,0,0,1,1
vert-x3_vertx-groovy,io.vertx.core.spi.tracing,0,0,0,0,0,0,1,1
vert-x3_vertx-groovy,io.vertx.core.streams,0,0,0,0,0,0,1,1
vert-x3_vertx-groovy,io.vertx.core.tracing,3,0,0,0,0,0,1,4
vert-x3_vertx-groovy,io.vertx.ext.auth,1,0,0,0,1,0,1,3
vert-x3_vertx-groovy,io.vertx.ext.auth.authentication,0,0,0,0,0,0,1,1
vert-x3_vertx-groovy,io.vertx.ext.auth.authorization,1,1,0,0,1,0,1,4
vert-x3_vertx-groovy,io.vertx.ext.auth.htdigest,0,0,0,0,0,0,1,1
vert-x3_vertx-groovy,io.vertx.ext.auth.htpasswd,0,0,0,0,0,0,1,1
vert-x3_vertx-groovy,io.vertx.ext.auth.jdbc,0,0,0,0,1,0,1,2
vert-x3_vertx-groovy,io.vertx.ext.auth.jwt.authorization,0,0,0,0,0,0,1,1
vert-x3_vertx-groovy,io.vertx.ext.auth.jwt,0,1,0,0,0,0,1,2
vert-x3_vertx-groovy,io.vertx.ext.auth.mongo,0,0,0,0,1,0,1,2
vert-x3_vertx-groovy,io.vertx.ext.auth.oauth2,0,1,0,0,1,0,1,3
vert-x3_vertx-groovy,io.vertx.ext.auth.oauth2.authorization,0,0,0,0,0,0,1,1
vert-x3_vertx-groovy,io.vertx.ext.auth.oauth2.providers,0,0,0,0,1,0,1,2
vert-x3_vertx-groovy,io.vertx.ext.auth.oauth2.rbac,0,0,0,0,0,0,1,1
vert-x3_vertx-groovy,io.vertx.ext.auth.shiro,0,0,0,0,0,0,1,1
vert-x3_vertx-groovy,io.vertx.ext.bridge,0,0,0,0,0,0,1,1
vert-x3_vertx-groovy,io.vertx.ext.consul,0,0,0,1,0,0,1,2
vert-x3_vertx-groovy,io.vertx.ext.dropwizard,0,0,0,0,1,0,1,2
vert-x3_vertx-groovy,io.vertx.ext.dropwizard.reporters,0,0,0,0,0,0,1,1
vert-x3_vertx-groovy,io.vertx.ext.eventbus.bridge.tcp,0,0,0,0,0,0,1,1
vert-x3_vertx-groovy,io.vertx.ext.healthchecks,0,0,0,0,0,0,1,1
vert-x3_vertx-groovy,io.vertx.ext.jdbc,0,0,0,0,0,0,1,1
vert-x3_vertx-groovy,io.vertx.ext.jdbc.spi,0,0,0,0,0,0,1,1
vert-x3_vertx-groovy,io.vertx.ext.jwt,0,0,0,0,0,0,1,1
vert-x3_vertx-groovy,io.vertx.ext.mail,0,0,0,0,1,0,1,2
vert-x3_vertx-groovy,io.vertx.ext.mail.mailencoder,0,0,0,0,0,0,1,1
vert-x3_vertx-groovy,io.vertx.ext.mongo,0,0,0,0,1,0,1,2
vert-x3_vertx-groovy,io.vertx.ext.shell.cli,0,0,0,0,0,0,1,1
vert-x3_vertx-groovy,io.vertx.ext.shell.command,0,1,0,0,1,0,1,3
vert-x3_vertx-groovy,io.vertx.ext.shell.command.base,0,0,0,0,0,0,1,1
vert-x3_vertx-groovy,io.vertx.ext.shell,0,0,0,0,1,0,1,2
vert-x3_vertx-groovy,io.vertx.ext.shell.session,0,0,0,0,0,0,1,1
vert-x3_vertx-groovy,io.vertx.ext.shell.spi,0,0,0,0,0,0,1,1
vert-x3_vertx-groovy,io.vertx.ext.shell.system,0,1,0,0,0,0,1,2
vert-x3_vertx-groovy,io.vertx.ext.shell.term,0,1,0,0,1,0,1,3
vert-x3_vertx-groovy,io.vertx.ext.sql,0,0,0,0,1,0,1,2
vert-x3_vertx-groovy,io.vertx.ext.stomp,0,0,0,0,0,0,1,1
vert-x3_vertx-groovy,io.vertx.ext.stomp.utils,0,0,0,0,0,0,1,1
vert-x3_vertx-groovy,io.vertx.ext.unit,0,1,0,0,1,0,1,3
vert-x3_vertx-groovy,io.vertx.ext.unit.collect,0,0,0,0,0,0,1,1
vert-x3_vertx-groovy,io.vertx.ext.unit.junit,0,0,0,0,1,0,1,2
vert-x3_vertx-groovy,io.vertx.ext.unit.report,0,0,0,0,1,0,1,2
vert-x3_vertx-groovy,io.vertx.ext.web.api.contract,0,1,0,0,0,0,1,2
vert-x3_vertx-groovy,io.vertx.ext.web.api.contract.openapi3,0,0,0,0,0,0,1,1
vert-x3_vertx-groovy,io.vertx.ext.web.api,0,0,0,0,1,0,1,2
vert-x3_vertx-groovy,io.vertx.ext.web.api.validation,0,0,0,0,1,0,1,2
vert-x3_vertx-groovy,io.vertx.ext.web.client,0,0,0,0,1,0,1,2
vert-x3_vertx-groovy,io.vertx.ext.web.client.predicate,0,0,0,0,0,0,1,1
vert-x3_vertx-groovy,io.vertx.ext.web.client.spi,0,0,0,0,0,0,1,1
vert-x3_vertx-groovy,io.vertx.ext.web.codec,0,0,0,0,0,0,1,1
vert-x3_vertx-groovy,io.vertx.ext.web.codec.spi,0,0,0,0,0,0,1,1
vert-x3_vertx-groovy,io.vertx.ext.web.common,0,0,0,0,0,0,1,1
vert-x3_vertx-groovy,io.vertx.ext.web.common.template,0,0,0,0,0,0,1,1
vert-x3_vertx-groovy,io.vertx.ext.web,0,1,0,0,1,0,1,3
vert-x3_vertx-groovy,io.vertx.ext.web.handler,0,0,0,0,1,0,1,2
vert-x3_vertx-groovy,io.vertx.ext.web.handler.graphql,0,0,0,0,1,0,1,2
vert-x3_vertx-groovy,io.vertx.ext.web.handler.graphql.dataloader,0,0,0,0,0,0,1,1
vert-x3_vertx-groovy,io.vertx.ext.web.handler.graphql.schema,0,0,0,0,0,0,1,1
vert-x3_vertx-groovy,io.vertx.ext.web.handler.sockjs,0,0,0,0,0,0,1,1
vert-x3_vertx-groovy,io.vertx.ext.web.multipart,0,0,0,0,0,0,1,1
vert-x3_vertx-groovy,io.vertx.ext.web.sstore,0,0,0,0,0,0,1,1
vert-x3_vertx-groovy,io.vertx.ext.web.templ.freemarker,0,0,0,0,0,0,1,1
vert-x3_vertx-groovy,io.vertx.ext.web.templ.handlebars,0,0,0,0,0,0,1,1
vert-x3_vertx-groovy,io.vertx.ext.web.templ.jade,0,0,0,0,0,0,1,1
vert-x3_vertx-groovy,io.vertx.ext.web.templ.mvel,0,0,0,0,0,0,1,1
vert-x3_vertx-groovy,io.vertx.ext.web.templ.pebble,0,0,0,0,0,0,1,1
vert-x3_vertx-groovy,io.vertx.ext.web.templ.rocker,0,0,0,0,0,0,1,1
vert-x3_vertx-groovy,io.vertx.ext.web.templ.thymeleaf,0,0,0,0,0,0,1,1
vert-x3_vertx-groovy,io.vertx.kafka.admin,0,0,0,0,1,0,1,2
vert-x3_vertx-groovy,io.vertx.kafka.client.common,0,0,0,0,1,0,1,2
vert-x3_vertx-groovy,io.vertx.kafka.client.consumer,0,0,0,0,1,0,1,2
vert-x3_vertx-groovy,io.vertx.kafka.client.producer,0,0,0,0,0,0,1,1
vert-x3_vertx-groovy,io.vertx.kafka.client.serialization,0,0,0,0,0,0,1,1
vert-x3_vertx-groovy,io.vertx.micrometer.backends,0,0,0,0,0,0,1,1
vert-x3_vertx-groovy,io.vertx.micrometer,0,0,0,0,1,0,1,2
vert-x3_vertx-groovy,io.vertx.mqtt.messages,0,0,0,0,1,0,1,2
vert-x3_vertx-groovy,io.vertx.mqtt,0,0,0,0,1,0,1,2
vert-x3_vertx-groovy,io.vertx.rabbitmq,0,0,0,0,1,0,1,2
vert-x3_vertx-groovy,io.vertx.redis.client,0,0,0,0,1,0,1,2
vert-x3_vertx-groovy,io.vertx.servicediscovery.backend.consul,0,0,0,0,0,0,1,1
vert-x3_vertx-groovy,io.vertx.servicediscovery.backend.redis,0,0,0,0,0,0,1,1
vert-x3_vertx-groovy,io.vertx.servicediscovery.backend.zookeeper,0,0,0,0,0,0,1,1
vert-x3_vertx-groovy,io.vertx.servicediscovery.consul,0,0,0,0,0,0,1,1
vert-x3_vertx-groovy,io.vertx.servicediscovery.docker,0,0,0,0,0,0,1,1
vert-x3_vertx-groovy,io.vertx.servicediscovery.kubernetes,0,0,0,0,0,0,1,1
vert-x3_vertx-groovy,io.vertx.servicediscovery,1,1,0,0,0,0,1,3
vert-x3_vertx-groovy,io.vertx.servicediscovery.rest,0,0,0,0,0,0,1,1
vert-x3_vertx-groovy,io.vertx.servicediscovery.spi,1,0,0,0,0,0,1,2
vert-x3_vertx-groovy,io.vertx.servicediscovery.types,0,1,0,0,1,0,1,3
vert-x3_vertx-groovy,io.vertx.servicediscovery.utils,0,0,0,0,0,0,1,1
vert-x3_vertx-groovy,io.vertx.servicediscovery.zookeeper,0,0,0,0,0,0,1,1
vert-x3_vertx-metrics,io.vertx.ext.dropwizard,0,0,0,0,1,0,0,1
vert-x3_vertx-metrics,examples,0,0,0,0,0,0,0,0
vert-x3_vertx-metrics,io.vertx.ext.dropwizard.impl,0,0,0,0,1,0,0,1
vert-x3_vertx-metrics,io.vertx.ext.dropwizard.impl.shell,0,0,0,0,0,0,0,0
vert-x3_vertx-metrics,io.vertx.ext.dropwizard.reporters,0,0,0,0,0,0,0,0
vert-x3_vertx-reactive-streams,examples,0,0,0,0,0,0,0,0
vert-x3_vertx-reactive-streams,io.vertx.ext.reactivestreams.impl,0,0,0,0,0,0,0,0
vert-x3_vertx-reactive-streams,io.vertx.ext.reactivestreams,0,0,0,0,0,0,0,0
vert-x3_vertx-reactive-streams,io.vertx.ext.reactivestreams.tck,0,0,0,0,0,0,0,0
vert-x3_vertx-rx,io.vertx.lang.rx,0,0,0,0,0,0,1,1
vert-x3_vertx-rx,io.vertx.lang.rx.it,0,0,0,0,0,0,1,1
vert-x3_vertx-rx,examples,0,0,0,1,1,0,1,3
vert-x3_vertx-rx,io.vertx.rxjava.core,2,1,0,0,1,0,1,5
vert-x3_vertx-rx,io.vertx.rxjava.ext.sql.impl,0,0,0,0,0,0,1,1
vert-x3_vertx-rx,io.vertx.rxjava.ext.sql,0,0,0,0,0,0,1,1
vert-x3_vertx-rx,io.vertx.it,0,0,0,0,1,0,1,2
vert-x3_vertx-rx,io.vertx.it.service,0,0,0,0,0,0,1,1
vert-x3_vertx-rx,io.vertx.rxjava.amqp,0,0,0,0,0,0,1,1
vert-x3_vertx-rx,io.vertx.rxjava.cassandra,0,0,0,0,0,0,1,1
vert-x3_vertx-rx,io.vertx.rxjava.circuitbreaker,0,0,0,0,0,0,1,1
vert-x3_vertx-rx,io.vertx.rxjava.config,0,0,0,0,0,0,1,1
vert-x3_vertx-rx,io.vertx.rxjava.core.buffer,0,0,0,0,0,0,1,1
vert-x3_vertx-rx,io.vertx.rxjava.core.cli,0,0,0,0,0,0,1,1
vert-x3_vertx-rx,io.vertx.rxjava.core.datagram,0,0,0,0,0,0,1,1
vert-x3_vertx-rx,io.vertx.rxjava.core.dns,0,0,0,0,0,0,1,1
vert-x3_vertx-rx,io.vertx.rxjava.core.eventbus,1,0,0,0,0,0,1,2
vert-x3_vertx-rx,io.vertx.rxjava.core.file,0,0,0,0,0,0,1,1
vert-x3_vertx-rx,io.vertx.rxjava.core.http,1,1,0,0,0,0,1,3
vert-x3_vertx-rx,io.vertx.rxjava.core.json.pointer,0,0,0,0,0,0,1,1
vert-x3_vertx-rx,io.vertx.rxjava.core.metrics,0,0,0,0,0,0,1,1
vert-x3_vertx-rx,io.vertx.rxjava.core.net,0,0,0,0,0,0,1,1
vert-x3_vertx-rx,io.vertx.rxjava.core.parsetools,0,0,0,0,0,0,1,1
vert-x3_vertx-rx,io.vertx.rxjava.core.shareddata,0,0,0,0,0,0,1,1
vert-x3_vertx-rx,io.vertx.rxjava.core.streams,0,0,0,0,1,0,1,2
vert-x3_vertx-rx,io.vertx.rxjava.ext.auth.authentication,1,1,0,0,0,0,1,3
vert-x3_vertx-rx,io.vertx.rxjava.ext.auth.authorization,1,0,0,0,1,0,1,3
vert-x3_vertx-rx,io.vertx.rxjava.ext.auth,2,1,0,0,1,0,1,5
vert-x3_vertx-rx,io.vertx.rxjava.ext.auth.htdigest,0,0,0,0,0,0,1,1
vert-x3_vertx-rx,io.vertx.rxjava.ext.auth.htpasswd,0,0,0,0,0,0,1,1
vert-x3_vertx-rx,io.vertx.rxjava.ext.auth.jdbc,0,0,0,0,0,0,1,1
vert-x3_vertx-rx,io.vertx.rxjava.ext.auth.jwt.authorization,0,0,0,0,0,0,1,1
vert-x3_vertx-rx,io.vertx.rxjava.ext.auth.jwt,0,0,0,0,0,0,1,1
vert-x3_vertx-rx,io.vertx.rxjava.ext.auth.mongo,0,0,0,0,0,0,1,1
vert-x3_vertx-rx,io.vertx.rxjava.ext.auth.oauth2,0,1,0,0,0,0,1,2
vert-x3_vertx-rx,io.vertx.rxjava.ext.auth.oauth2.authorization,0,0,0,0,0,0,1,1
vert-x3_vertx-rx,io.vertx.rxjava.ext.auth.oauth2.providers,0,0,0,0,1,0,1,2
vert-x3_vertx-rx,io.vertx.rxjava.ext.auth.oauth2.rbac,0,0,0,0,0,0,1,1
vert-x3_vertx-rx,io.vertx.rxjava.ext.auth.shiro,0,0,0,0,0,0,1,1
vert-x3_vertx-rx,io.vertx.rxjava.ext.bridge,0,0,0,0,0,0,1,1
vert-x3_vertx-rx,io.vertx.rxjava.ext.consul,0,0,0,0,0,0,1,1
vert-x3_vertx-rx,io.vertx.rxjava.ext.dropwizard,0,0,0,0,0,0,1,1
vert-x3_vertx-rx,io.vertx.rxjava.ext.eventbus.bridge.tcp,0,0,0,0,0,0,1,1
vert-x3_vertx-rx,io.vertx.rxjava.ext.healthchecks,0,0,0,0,0,0,1,1
vert-x3_vertx-rx,io.vertx.rxjava.ext.jdbc,0,0,0,0,0,0,1,1
vert-x3_vertx-rx,io.vertx.rxjava.ext.mail,0,0,0,0,0,0,1,1
vert-x3_vertx-rx,io.vertx.rxjava.ext.mongo,0,0,0,0,0,0,1,1
vert-x3_vertx-rx,io.vertx.rxjava.ext.shell.cli,0,0,0,0,0,0,1,1
vert-x3_vertx-rx,io.vertx.rxjava.ext.shell.command,0,0,0,0,0,0,1,1
vert-x3_vertx-rx,io.vertx.rxjava.ext.shell.session,0,0,0,0,0,0,1,1
vert-x3_vertx-rx,io.vertx.rxjava.ext.shell,0,0,0,0,0,0,1,1
vert-x3_vertx-rx,io.vertx.rxjava.ext.shell.system,0,1,0,0,0,0,1,2
vert-x3_vertx-rx,io.vertx.rxjava.ext.shell.term,0,1,0,0,0,0,1,2
vert-x3_vertx-rx,io.vertx.rxjava.ext.stomp,0,0,0,0,1,0,1,2
vert-x3_vertx-rx,io.vertx.rxjava.ext.unit,0,0,0,0,1,0,1,2
vert-x3_vertx-rx,io.vertx.rxjava.ext.unit.collect,0,0,0,0,0,0,1,1
vert-x3_vertx-rx,io.vertx.rxjava.ext.unit.report,0,0,0,0,0,0,1,1
vert-x3_vertx-rx,io.vertx.rxjava.ext.web.api.contract,0,0,0,0,0,0,1,1
vert-x3_vertx-rx,io.vertx.rxjava.ext.web.api.contract.openapi3,0,0,0,0,0,0,1,1
vert-x3_vertx-rx,io.vertx.rxjava.ext.web.api,0,0,0,0,0,0,1,1
vert-x3_vertx-rx,io.vertx.rxjava.ext.web.api.validation,0,0,0,0,1,0,1,2
vert-x3_vertx-rx,io.vertx.rxjava.ext.web.client,0,0,0,0,0,0,1,1
vert-x3_vertx-rx,io.vertx.rxjava.ext.web.client.predicate,0,0,0,0,0,0,1,1
vert-x3_vertx-rx,io.vertx.rxjava.ext.web.codec,0,1,0,0,0,0,1,2
vert-x3_vertx-rx,io.vertx.rxjava.ext.web.common.template,0,0,0,0,0,0,1,1
vert-x3_vertx-rx,io.vertx.rxjava.ext.web.common,0,0,0,0,0,0,1,1
vert-x3_vertx-rx,io.vertx.rxjava.ext.web,0,1,0,0,0,0,1,2
vert-x3_vertx-rx,io.vertx.rxjava.ext.web.handler,0,0,0,0,1,0,1,2
vert-x3_vertx-rx,io.vertx.rxjava.ext.web.handler.graphql,0,0,0,0,0,0,1,1
vert-x3_vertx-rx,io.vertx.rxjava.ext.web.handler.graphql.dataloader,0,0,0,0,0,0,1,1
vert-x3_vertx-rx,io.vertx.rxjava.ext.web.handler.graphql.schema,0,0,0,0,0,0,1,1
vert-x3_vertx-rx,io.vertx.rxjava.ext.web.handler.sockjs,0,0,0,0,0,0,1,1
vert-x3_vertx-rx,io.vertx.rxjava.ext.web.multipart,0,0,0,0,0,0,1,1
vert-x3_vertx-rx,io.vertx.rxjava.ext.web.sstore,0,0,0,0,0,0,1,1
vert-x3_vertx-rx,io.vertx.rxjava.ext.web.templ.freemarker,0,0,0,0,0,0,1,1
vert-x3_vertx-rx,io.vertx.rxjava.ext.web.templ.handlebars,0,0,0,0,0,0,1,1
vert-x3_vertx-rx,io.vertx.rxjava.ext.web.templ.jade,0,0,0,0,0,0,1,1
vert-x3_vertx-rx,io.vertx.rxjava.ext.web.templ.mvel,0,0,0,0,0,0,1,1
vert-x3_vertx-rx,io.vertx.rxjava.ext.web.templ.pebble,0,0,0,0,0,0,1,1
vert-x3_vertx-rx,io.vertx.rxjava.ext.web.templ.rocker,0,0,0,0,0,0,1,1
vert-x3_vertx-rx,io.vertx.rxjava.ext.web.templ.thymeleaf,0,0,0,0,0,0,1,1
vert-x3_vertx-rx,io.vertx.rxjava.kafka.admin,0,0,0,0,0,0,1,1
vert-x3_vertx-rx,io.vertx.rxjava.kafka.client.consumer,0,0,0,0,0,0,1,1
vert-x3_vertx-rx,io.vertx.rxjava.kafka.client.producer,0,0,0,0,0,0,1,1
vert-x3_vertx-rx,io.vertx.rxjava.micrometer,0,0,0,0,0,0,1,1
vert-x3_vertx-rx,io.vertx.rxjava.mqtt.messages,1,1,0,0,1,0,1,4
vert-x3_vertx-rx,io.vertx.rxjava.mqtt,1,0,0,0,0,0,1,2
vert-x3_vertx-rx,io.vertx.rxjava.mysqlclient,0,0,0,0,0,0,1,1
vert-x3_vertx-rx,io.vertx.rxjava.pgclient,0,0,0,0,0,0,1,1
vert-x3_vertx-rx,io.vertx.rxjava.pgclient.pubsub,0,0,0,0,0,0,1,1
vert-x3_vertx-rx,io.vertx.rxjava.rabbitmq,0,0,0,0,0,0,1,1
vert-x3_vertx-rx,io.vertx.rxjava.redis.client,0,0,0,0,1,0,1,2
vert-x3_vertx-rx,io.vertx.rxjava.servicediscovery,0,0,0,0,0,0,1,1
vert-x3_vertx-rx,io.vertx.rxjava.servicediscovery.spi,0,0,0,0,0,0,1,1
vert-x3_vertx-rx,io.vertx.rxjava.servicediscovery.types,0,0,0,0,1,0,1,2
vert-x3_vertx-rx,io.vertx.rxjava.sqlclient,0,0,0,0,0,0,1,1
vert-x3_vertx-rx,examples.cli,0,0,0,0,1,0,1,2
vert-x3_vertx-rx,examples.hystrix,0,0,0,0,0,0,1,1
vert-x3_vertx-rx,examples.junit,0,0,0,0,1,0,1,2
vert-x3_vertx-rx,examples.limited,0,0,0,0,0,0,1,1
vert-x3_vertx-rx,examples.pack,0,0,0,0,0,0,1,1
vert-x3_vertx-rx,io.vertx.amqp,0,0,0,0,1,0,1,2
vert-x3_vertx-rx,io.vertx.cassandra,0,0,0,0,1,0,1,2
vert-x3_vertx-rx,io.vertx.circuitbreaker,0,0,0,0,1,0,1,2
vert-x3_vertx-rx,io.vertx.config,0,0,0,0,0,0,1,1
vert-x3_vertx-rx,io.vertx.config.spi,0,0,0,0,0,0,1,1
vert-x3_vertx-rx,io.vertx.config.spi.utils,0,0,0,0,0,0,1,1
vert-x3_vertx-rx,io.vertx.core,25,1,0,0,0,0,1,27
vert-x3_vertx-rx,io.vertx.core.buffer,7,1,0,0,0,0,1,9
vert-x3_vertx-rx,io.vertx.core.cli,1,1,0,0,0,0,1,3
vert-x3_vertx-rx,io.vertx.core.cli.annotations,1,0,0,0,0,0,1,2
vert-x3_vertx-rx,io.vertx.core.cli.converters,0,0,0,0,0,0,1,1
vert-x3_vertx-rx,io.vertx.core.datagram,4,0,0,0,0,0,1,5
vert-x3_vertx-rx,io.vertx.core.dns,4,0,0,0,1,0,1,6
vert-x3_vertx-rx,io.vertx.core.eventbus,2,0,0,0,1,0,1,4
vert-x3_vertx-rx,io.vertx.core.file,2,0,0,0,1,0,1,4
vert-x3_vertx-rx,io.vertx.core.http,3,1,0,1,1,0,1,7
vert-x3_vertx-rx,io.vertx.core.json,23,1,0,0,1,0,1,26
vert-x3_vertx-rx,io.vertx.core.json.jackson,2,0,0,0,0,0,1,3
vert-x3_vertx-rx,io.vertx.core.json.pointer,0,0,0,0,0,0,1,1
vert-x3_vertx-rx,io.vertx.core.logging,0,0,0,0,1,0,1,2
vert-x3_vertx-rx,io.vertx.core.metrics,2,1,0,0,0,0,1,4
vert-x3_vertx-rx,io.vertx.core.net,4,0,0,1,0,0,1,6
vert-x3_vertx-rx,io.vertx.core.parsetools,0,0,0,0,0,0,1,1
vert-x3_vertx-rx,io.vertx.core.shareddata,0,0,0,0,1,0,1,2
vert-x3_vertx-rx,io.vertx.core.spi.cluster,1,0,0,0,0,0,1,2
vert-x3_vertx-rx,io.vertx.core.spi,11,0,0,0,0,0,1,12
vert-x3_vertx-rx,io.vertx.core.spi.json,1,0,0,0,0,0,1,2
vert-x3_vertx-rx,io.vertx.core.spi.launcher,0,0,0,0,1,0,1,2
vert-x3_vertx-rx,io.vertx.core.spi.logging,0,0,0,0,0,0,1,1
vert-x3_vertx-rx,io.vertx.core.spi.metrics,0,0,0,0,1,0,1,2
vert-x3_vertx-rx,io.vertx.core.spi.resolver,0,0,0,0,0,0,1,1
vert-x3_vertx-rx,io.vertx.core.spi.tracing,0,0,0,0,0,0,1,1
vert-x3_vertx-rx,io.vertx.core.streams,0,0,0,0,1,0,1,2
vert-x3_vertx-rx,io.vertx.core.tracing,3,0,0,0,0,0,1,4
vert-x3_vertx-rx,io.vertx.ext.auth,1,0,0,0,1,0,1,3
vert-x3_vertx-rx,io.vertx.ext.auth.authentication,0,0,0,0,0,0,1,1
vert-x3_vertx-rx,io.vertx.ext.auth.authorization,1,1,0,0,1,0,1,4
vert-x3_vertx-rx,io.vertx.ext.auth.htdigest,0,0,0,0,0,0,1,1
vert-x3_vertx-rx,io.vertx.ext.auth.htpasswd,0,0,0,0,0,0,1,1
vert-x3_vertx-rx,io.vertx.ext.auth.jdbc,0,0,0,0,1,0,1,2
vert-x3_vertx-rx,io.vertx.ext.auth.jwt.authorization,0,0,0,0,0,0,1,1
vert-x3_vertx-rx,io.vertx.ext.auth.jwt,0,1,0,0,0,0,1,2
vert-x3_vertx-rx,io.vertx.ext.auth.mongo,0,0,0,0,1,0,1,2
vert-x3_vertx-rx,io.vertx.ext.auth.oauth2,0,1,0,0,1,0,1,3
vert-x3_vertx-rx,io.vertx.ext.auth.oauth2.authorization,0,0,0,0,0,0,1,1
vert-x3_vertx-rx,io.vertx.ext.auth.oauth2.providers,0,1,0,0,1,0,1,3
vert-x3_vertx-rx,io.vertx.ext.auth.oauth2.rbac,0,0,0,0,0,0,1,1
vert-x3_vertx-rx,io.vertx.ext.auth.shiro,0,0,0,0,0,0,1,1
vert-x3_vertx-rx,io.vertx.ext.bridge,0,0,0,0,0,0,1,1
vert-x3_vertx-rx,io.vertx.ext.consul,0,0,0,1,0,0,1,2
vert-x3_vertx-rx,io.vertx.ext.dropwizard,0,0,0,0,1,0,1,2
vert-x3_vertx-rx,io.vertx.ext.dropwizard.reporters,0,0,0,0,0,0,1,1
vert-x3_vertx-rx,io.vertx.ext.eventbus.bridge.tcp,0,0,0,0,0,0,1,1
vert-x3_vertx-rx,io.vertx.ext.healthchecks,0,0,0,0,0,0,1,1
vert-x3_vertx-rx,io.vertx.ext.jdbc,0,0,0,0,0,0,1,1
vert-x3_vertx-rx,io.vertx.ext.jdbc.spi,0,0,0,0,0,0,1,1
vert-x3_vertx-rx,io.vertx.ext.jwt,0,0,0,0,0,0,1,1
vert-x3_vertx-rx,io.vertx.ext.mail,0,0,0,0,1,0,1,2
vert-x3_vertx-rx,io.vertx.ext.mail.mailencoder,0,0,0,0,0,0,1,1
vert-x3_vertx-rx,io.vertx.ext.mongo,0,0,0,0,1,0,1,2
vert-x3_vertx-rx,io.vertx.ext.shell.cli,0,0,0,0,0,0,1,1
vert-x3_vertx-rx,io.vertx.ext.shell.command,0,1,0,0,1,0,1,3
vert-x3_vertx-rx,io.vertx.ext.shell.command.base,0,0,0,0,0,0,1,1
vert-x3_vertx-rx,io.vertx.ext.shell,0,0,0,0,1,0,1,2
vert-x3_vertx-rx,io.vertx.ext.shell.session,0,0,0,0,0,0,1,1
vert-x3_vertx-rx,io.vertx.ext.shell.spi,0,0,0,0,0,0,1,1
vert-x3_vertx-rx,io.vertx.ext.shell.system,0,1,0,0,0,0,1,2
vert-x3_vertx-rx,io.vertx.ext.shell.term,0,1,0,0,1,0,1,3
vert-x3_vertx-rx,io.vertx.ext.sql,0,0,0,0,1,0,1,2
vert-x3_vertx-rx,io.vertx.ext.stomp,0,0,0,0,0,0,1,1
vert-x3_vertx-rx,io.vertx.ext.stomp.utils,0,0,0,0,0,0,1,1
vert-x3_vertx-rx,io.vertx.ext.unit,0,1,0,0,1,0,1,3
vert-x3_vertx-rx,io.vertx.ext.unit.collect,0,0,0,0,0,0,1,1
vert-x3_vertx-rx,io.vertx.ext.unit.junit,0,0,0,0,1,0,1,2
vert-x3_vertx-rx,io.vertx.ext.unit.report,0,0,0,0,1,0,1,2
vert-x3_vertx-rx,io.vertx.ext.web.api.contract,0,1,0,0,0,0,1,2
vert-x3_vertx-rx,io.vertx.ext.web.api.contract.openapi3,0,0,0,0,0,0,1,1
vert-x3_vertx-rx,io.vertx.ext.web.api,0,0,0,0,1,0,1,2
vert-x3_vertx-rx,io.vertx.ext.web.api.validation,0,1,0,0,1,0,1,3
vert-x3_vertx-rx,io.vertx.ext.web.client,0,0,0,0,1,0,1,2
vert-x3_vertx-rx,io.vertx.ext.web.client.predicate,0,0,0,0,0,0,1,1
vert-x3_vertx-rx,io.vertx.ext.web.client.spi,0,0,0,0,0,0,1,1
vert-x3_vertx-rx,io.vertx.ext.web.codec,0,0,0,0,0,0,1,1
vert-x3_vertx-rx,io.vertx.ext.web.codec.spi,0,0,0,0,0,0,1,1
vert-x3_vertx-rx,io.vertx.ext.web.common,0,0,0,0,0,0,1,1
vert-x3_vertx-rx,io.vertx.ext.web.common.template,0,0,0,0,0,0,1,1
vert-x3_vertx-rx,io.vertx.ext.web,0,1,0,0,1,0,1,3
vert-x3_vertx-rx,io.vertx.ext.web.handler,0,1,0,0,1,0,1,3
vert-x3_vertx-rx,io.vertx.ext.web.handler.graphql,0,0,0,0,1,0,1,2
vert-x3_vertx-rx,io.vertx.ext.web.handler.graphql.dataloader,0,0,0,0,0,0,1,1
vert-x3_vertx-rx,io.vertx.ext.web.handler.graphql.schema,0,0,0,0,0,0,1,1
vert-x3_vertx-rx,io.vertx.ext.web.handler.sockjs,0,0,0,0,0,0,1,1
vert-x3_vertx-rx,io.vertx.ext.web.multipart,0,0,0,0,0,0,1,1
vert-x3_vertx-rx,io.vertx.ext.web.sstore,0,0,0,0,0,0,1,1
vert-x3_vertx-rx,io.vertx.ext.web.templ.freemarker,0,0,0,0,0,0,1,1
vert-x3_vertx-rx,io.vertx.ext.web.templ.handlebars,0,0,0,0,0,0,1,1
vert-x3_vertx-rx,io.vertx.ext.web.templ.jade,0,0,0,0,0,0,1,1
vert-x3_vertx-rx,io.vertx.ext.web.templ.mvel,0,0,0,0,0,0,1,1
vert-x3_vertx-rx,io.vertx.ext.web.templ.pebble,0,0,0,0,0,0,1,1
vert-x3_vertx-rx,io.vertx.ext.web.templ.rocker,0,0,0,0,0,0,1,1
vert-x3_vertx-rx,io.vertx.ext.web.templ.thymeleaf,0,0,0,0,0,0,1,1
vert-x3_vertx-rx,io.vertx.kafka.admin,0,0,0,0,1,0,1,2
vert-x3_vertx-rx,io.vertx.kafka.client.common,0,0,0,0,1,0,1,2
vert-x3_vertx-rx,io.vertx.kafka.client.consumer,0,1,0,0,1,0,1,3
vert-x3_vertx-rx,io.vertx.kafka.client.producer,0,1,0,0,0,0,1,2
vert-x3_vertx-rx,io.vertx.kafka.client.serialization,0,0,0,0,0,0,1,1
vert-x3_vertx-rx,io.vertx.micrometer.backends,0,0,0,0,0,0,1,1
vert-x3_vertx-rx,io.vertx.micrometer,0,0,0,0,1,0,1,2
vert-x3_vertx-rx,io.vertx.mqtt.messages,0,0,0,0,1,0,1,2
vert-x3_vertx-rx,io.vertx.mqtt,0,0,0,0,1,0,1,2
vert-x3_vertx-rx,io.vertx.mysqlclient,0,0,0,0,1,0,1,2
vert-x3_vertx-rx,io.vertx.pgclient.data,0,0,0,0,0,0,1,1
vert-x3_vertx-rx,io.vertx.pgclient,0,0,0,0,1,0,1,2
vert-x3_vertx-rx,io.vertx.pgclient.pubsub,0,1,0,0,0,0,1,2
vert-x3_vertx-rx,io.vertx.rabbitmq,0,0,0,0,1,0,1,2
vert-x3_vertx-rx,io.vertx.redis.client,0,0,0,0,1,0,1,2
vert-x3_vertx-rx,io.vertx.servicediscovery.backend.consul,0,0,0,0,0,0,1,1
vert-x3_vertx-rx,io.vertx.servicediscovery.backend.redis,0,0,0,0,0,0,1,1
vert-x3_vertx-rx,io.vertx.servicediscovery.backend.zookeeper,0,0,0,0,0,0,1,1
vert-x3_vertx-rx,io.vertx.servicediscovery.consul,0,0,0,0,0,0,1,1
vert-x3_vertx-rx,io.vertx.servicediscovery.docker,0,0,0,0,0,0,1,1
vert-x3_vertx-rx,io.vertx.servicediscovery.kubernetes,0,0,0,0,0,0,1,1
vert-x3_vertx-rx,io.vertx.servicediscovery,1,1,0,0,0,0,1,3
vert-x3_vertx-rx,io.vertx.servicediscovery.rest,0,0,0,0,0,0,1,1
vert-x3_vertx-rx,io.vertx.servicediscovery.spi,1,0,0,0,0,0,1,2
vert-x3_vertx-rx,io.vertx.servicediscovery.types,0,1,0,0,1,0,1,3
vert-x3_vertx-rx,io.vertx.servicediscovery.utils,0,0,0,0,0,0,1,1
vert-x3_vertx-rx,io.vertx.servicediscovery.zookeeper,0,0,0,0,0,0,1,1
vert-x3_vertx-rx,io.vertx.sqlclient,0,0,0,0,1,0,1,2
vert-x3_vertx-rx,io.vertx.sqlclient.data,0,0,0,0,0,0,1,1
vert-x3_vertx-rx,io.vertx.lang.rxjava,0,0,0,0,0,0,1,1
vert-x3_vertx-rx,io.vertx.rx.java,0,1,0,0,1,0,1,3
vert-x3_vertx-rx,io.vertx.rx.java.impl,0,0,0,0,0,0,1,1
vert-x3_vertx-rx,com.acme.pkg,0,0,0,0,0,0,1,1
vert-x3_vertx-rx,com.acme.pkg.sub,0,0,0,0,0,0,1,1
vert-x3_vertx-rx,io.vertx.codegen.extra,0,0,0,0,1,0,1,2
vert-x3_vertx-rx,io.vertx.codegen.extra.sub,0,0,0,0,0,0,1,1
vert-x3_vertx-rx,com.acme.rxjava.pkg,0,1,0,0,0,0,1,2
vert-x3_vertx-rx,com.acme.rxjava.pkg.sub,0,0,0,0,0,0,1,1
vert-x3_vertx-rx,io.vertx.rxjava.codegen.extra,0,0,0,0,1,0,1,2
vert-x3_vertx-rx,io.vertx.rxjava.codegen.extra.sub,0,0,0,0,0,0,1,1
vert-x3_vertx-rx,io.vertx.reactivex.core,0,0,0,0,1,0,1,2
vert-x3_vertx-rx,io.vertx.reactivex.ext.sql.impl,0,0,0,0,0,0,1,1
vert-x3_vertx-rx,io.vertx.reactivex.ext.sql,0,0,0,0,0,0,1,1
vert-x3_vertx-rx,io.vertx.it.discovery,0,0,0,0,0,0,1,1
vert-x3_vertx-rx,io.vertx.it.discovery.service,0,0,0,0,0,0,1,1
vert-x3_vertx-rx,io.vertx.lang.reactivex,0,0,0,0,0,0,1,1
vert-x3_vertx-rx,io.vertx.reactivex,0,0,0,0,1,0,1,2
vert-x3_vertx-rx,io.vertx.reactivex.impl,0,1,0,0,1,0,1,3
vert-x3_vertx-rx,io.vertx.codegen.rxjava2,0,0,0,0,1,0,1,2
vert-x3_vertx-rx,com.acme.reactivex.pkg,0,0,0,0,0,0,1,1
vert-x3_vertx-rx,com.acme.reactivex.pkg.sub,0,0,0,0,0,0,1,1
vert-x3_vertx-rx,io.vertx.reactivex.codegen.extra,0,0,0,0,1,0,1,2
vert-x3_vertx-rx,io.vertx.reactivex.codegen.extra.sub,0,0,0,0,0,0,1,1
vert-x3_vertx-rx,io.vertx.reactivex.codegen.rxjava2,0,0,0,0,1,0,1,2
vert-x3_vertx-rx,io.vertx.reactivex.core.streams,0,0,0,0,1,0,1,2
vibe-project_vibe-java-server,org.atmosphere.vibe,0,0,0,0,1,0,0,1
vibe-project_vibe-java-server,org.atmosphere.vibe.transport,0,0,0,0,0,0,0,0
vibe-project_vibe-java-server,org.atmosphere.vibe.transport.http,0,0,0,0,0,0,0,0
vibe-project_vibe-java-server,org.atmosphere.vibe.transport.websocket,0,0,0,0,0,0,0,0
Vincentyification_JavaBot,com.gmail.inverseconduit,1,1,0,0,1,2,0,5
Vincentyification_JavaBot,com.gmail.inverseconduit.bot,1,1,0,0,0,0,0,2
Vincentyification_JavaBot,com.gmail.inverseconduit.bot.interactions,0,0,0,0,0,0,0,0
Vincentyification_JavaBot,com.gmail.inverseconduit.chat,0,0,0,0,0,1,0,1
Vincentyification_JavaBot,com.gmail.inverseconduit.commands,0,0,0,0,0,3,0,3
Vincentyification_JavaBot,com.gmail.inverseconduit.commands.providers.javadoc,0,0,0,0,0,1,0,1
Vincentyification_JavaBot,com.gmail.inverseconduit.commands.providers.scripts,0,0,0,0,0,0,0,0
Vincentyification_JavaBot,com.gmail.inverseconduit.commands.providers.scripts.security,0,0,0,0,0,0,0,0
Vincentyification_JavaBot,com.gmail.inverseconduit.commands.providers.timer,0,0,0,0,0,0,0,0
Vincentyification_JavaBot,com.gmail.inverseconduit.commands.sets,1,0,0,0,0,3,0,4
Vincentyification_JavaBot,com.gmail.inverseconduit.datatype,0,0,0,0,1,3,0,4
Vincentyification_JavaBot,com.gmail.inverseconduit.utils,0,0,0,0,0,0,0,0
virgo47_javasimon,org.javasimon.console.action,4,0,0,1,1,0,0,6
virgo47_javasimon,org.javasimon.console,7,1,0,0,1,0,0,9
virgo47_javasimon,org.javasimon.console.html,2,0,0,0,0,0,0,2
virgo47_javasimon,org.javasimon.console.json,4,0,0,0,0,1,0,5
virgo47_javasimon,org.javasimon.console.plugin,1,0,0,0,0,1,0,2
virgo47_javasimon,org.javasimon.console.reflect,6,1,0,0,0,0,0,7
virgo47_javasimon,org.javasimon.console.text,0,1,0,0,0,0,0,1
virgo47_javasimon,org.javasimon,2,1,0,1,0,4,0,8
virgo47_javasimon,org.javasimon.callback.async,0,0,0,0,0,0,0,0
virgo47_javasimon,org.javasimon.callback,1,0,0,0,0,3,0,4
virgo47_javasimon,org.javasimon.callback.calltree,0,0,0,0,0,1,0,1
virgo47_javasimon,org.javasimon.callback.lastsplits,0,0,0,0,0,0,0,0
virgo47_javasimon,org.javasimon.callback.logging,0,0,0,0,0,0,0,0
virgo47_javasimon,org.javasimon.callback.quantiles,0,0,0,0,0,0,0,0
virgo47_javasimon,org.javasimon.callback.timeline,0,0,0,0,1,0,0,1
virgo47_javasimon,org.javasimon.clock,0,0,0,0,0,1,0,1
virgo47_javasimon,org.javasimon.jmx,0,0,0,0,0,2,0,2
virgo47_javasimon,org.javasimon.proxy,0,0,0,0,0,0,0,0
virgo47_javasimon,org.javasimon.source,0,0,0,0,0,0,0,0
virgo47_javasimon,org.javasimon.utils.bean,0,0,0,1,0,0,0,1
virgo47_javasimon,org.javasimon.utils,1,0,0,0,1,0,0,2
virgo47_javasimon,org.javasimon.demoapp.dao,0,0,0,0,1,0,0,1
virgo47_javasimon,org.javasimon.demoapp.model,0,0,0,0,0,0,0,0
virgo47_javasimon,org.javasimon.demoapp,0,0,0,0,0,0,0,0
virgo47_javasimon,org.javasimon.demoapp.web,0,0,0,0,0,0,0,0
virgo47_javasimon,org.javasimon.examples,0,0,0,0,1,1,0,2
virgo47_javasimon,org.javasimon.examples.jdbc,0,0,0,0,0,0,0,0
virgo47_javasimon,org.javasimon.examples.jmx.custom,0,0,0,0,0,0,0,0
virgo47_javasimon,org.javasimon.examples.jmx,0,0,0,0,1,1,0,2
virgo47_javasimon,org.javasimon.examples.perf,0,0,0,0,1,0,0,1
virgo47_javasimon,org.javasimon.javaee,0,0,0,0,1,0,0,1
virgo47_javasimon,org.javasimon.javaee.reqreporter,0,0,0,0,0,0,0,0
virgo47_javasimon,org.javasimon.jdbc4,0,0,0,0,0,0,0,0
virgo47_javasimon,org.javasimon.jdbc4.jmx,0,0,0,0,0,0,0,0
virgo47_javasimon,org.javasimon.jdbcx4,0,0,0,0,0,0,0,0
virgo47_javasimon,org.javasimon.spring,0,0,0,0,1,0,0,1
virgo47_javasimon,org.javasimon.spring.webmvc,0,0,0,0,0,0,0,0
viritin_viritin,org.vaadin.viritin.button,0,0,0,0,1,0,0,1
viritin_viritin,org.vaadin.viritin.components,0,0,0,0,0,0,0,0
viritin_viritin,org.vaadin.viritin.fields,0,0,0,0,1,0,0,1
viritin_viritin,org.vaadin.viritin.fluency.event,0,0,0,0,0,0,0,0
viritin_viritin,org.vaadin.viritin.fluency.server,0,0,0,0,0,0,0,0
viritin_viritin,org.vaadin.viritin.fluency.ui,0,0,0,0,1,0,0,1
viritin_viritin,org.vaadin.viritin.form,0,0,0,0,0,0,0,0
viritin_viritin,org.vaadin.viritin.grid,0,0,0,0,0,0,0,0
viritin_viritin,org.vaadin.viritin.label,0,0,0,0,0,0,0,0
viritin_viritin,org.vaadin.viritin.layouts,0,0,0,0,1,0,0,1
viritin_viritin,org.vaadin.viritin,2,1,0,1,1,0,0,5
viritin_viritin,org.vaadin.viritin.navigator,0,0,0,0,0,0,0,0
viritin_viritin,org.vaadin.viritin.ui,0,0,0,0,0,0,0,0
viritin_viritin,org.vaadin.viritin.util,0,0,0,0,1,0,0,1
viritin_viritin,org.vaadin.viritin.it,0,0,0,0,1,0,0,1
viritin_viritin,org.vaadin.viritin.it.examples,0,0,0,0,0,0,0,0
viritin_viritin,org.vaadin.viritin.it.issues,0,0,0,0,1,0,0,1
viritin_viritin,org.vaadin.viritin.it.locale,0,0,0,0,0,0,0,0
viritin_viritin,org.vaadin.addonhelpers,0,0,0,0,0,0,0,0
viritin_viritin,org.vaadin.viritinv7,4,0,0,1,1,0,0,6
viritin_viritin,org.vaadin.viritinv7.fields,4,1,0,1,1,0,0,7
viritin_viritin,org.vaadin.viritinv7.fields.config,0,0,0,0,0,0,0,0
viritin_viritin,org.vaadin.viritinv7.fluency.data,0,0,0,0,1,0,0,1
viritin_viritin,org.vaadin.viritinv7.fluency.event,0,0,0,0,1,0,0,1
viritin_viritin,org.vaadin.viritinv7.fluency.ui,0,0,0,0,1,0,0,1
viritin_viritin,org.vaadin.viritinv7.form,2,1,0,0,1,0,0,4
viritin_viritin,org.vaadin.viritinv7.grid,0,0,0,0,1,0,0,1
viritin_viritin,org.vaadin.viritinv7.grid.utils,0,0,0,0,0,0,0,0
viritin_viritin,org.vaadin.viritinv7.label,0,0,0,0,0,0,0,0
viritin_viritin,org.vaadin.viritin.it.aspect,0,0,0,0,0,0,0,0
viritin_viritin,org.vaadin.viritinv7.examples,0,0,0,0,0,0,0,0
viritin_viritin,org.vaadin.viritinv7.locale,0,0,0,0,0,0,0,0
vladimirvivien_clamshell-cli,org.clamshellcli.api,0,0,0,0,1,0,0,1
vladimirvivien_clamshell-cli,org.clamshellcli.impl,0,0,0,0,1,0,0,1
vladimirvivien_clamshell-cli,org.clamshellcli.impl.commands,0,0,0,0,1,0,0,1
vladimirvivien_clamshell-cli,org.clamshellcli.core,0,0,0,0,1,0,0,1
vladimirvivien_clamshell-cli,cli,0,0,0,0,0,0,0,0
vmware_upgrade-framework,com.vmware.upgrade.context,0,0,0,0,0,0,0,0
vmware_upgrade-framework,com.vmware.upgrade.factory,0,0,0,0,0,2,0,2
vmware_upgrade-framework,com.vmware.upgrade.logging,0,0,0,0,0,0,0,0
vmware_upgrade-framework,com.vmware.upgrade,1,1,0,0,1,5,0,8
vmware_upgrade-framework,com.vmware.upgrade.progress,1,0,0,0,1,1,0,3
vmware_upgrade-framework,com.vmware.upgrade.progress.impl,1,1,0,0,0,1,0,3
vmware_upgrade-framework,com.vmware.upgrade.sequencing,1,0,0,0,1,1,0,3
vmware_upgrade-framework,com.vmware.upgrade.task,0,1,0,0,0,4,0,5
vmware_upgrade-framework,com.vmware.upgrade.transformation,0,0,0,0,0,0,0,0
vmware_upgrade-framework,com.vmware.upgrade.dsl,0,0,0,0,0,0,0,0
vmware_upgrade-framework,com.vmware.upgrade.dsl.syntax,0,0,0,0,0,0,0,0
vmware_upgrade-framework,com.vmware.upgrade.dsl.util,0,0,0,0,0,0,0,0
vmware_upgrade-framework,com.vmware.upgrade.sql,0,0,0,0,0,2,0,2
vmware_upgrade-framework,com.vmware.upgrade.sql.script,1,1,0,0,0,0,0,2
vmware_upgrade-framework,com.vmware.upgrade.sql.task,1,0,0,0,0,2,0,3
vmware_upgrade-framework,com.vmware.upgrade.dsl.sql.syntax,0,0,0,0,1,0,0,1
vmware_upgrade-framework,com.vmware.upgrade.dsl.sql.util,0,0,0,0,1,0,0,1
vmware_upgrade-framework,com.vmware.upgrade.dsl.sql.semantics,0,0,0,0,0,0,0,0
vt-middleware_passay,org.passay,1,1,0,1,0,0,0,3
vt-middleware_passay,org.passay.dictionary,1,0,0,1,0,0,0,2
vt-middleware_passay,org.passay.dictionary.sort,1,1,0,0,0,0,0,2
vt-middleware_passay,org.passay.entropy,1,0,0,0,0,0,0,1
vt-middleware_passay,org.passay.spring,0,0,0,0,0,0,0,0
vt-middleware_passay,org.passay.doc,0,0,0,0,0,0,0,0
w3blogfr_zebra-zpl,fr.w3blog.zpl.model.element,0,0,0,0,1,0,0,1
w3blogfr_zebra-zpl,fr.w3blog.zpl.model,1,1,0,0,0,0,0,2
w3blogfr_zebra-zpl,fr.w3blog.zpl.utils,1,0,0,0,0,0,0,1
w3blogfr_zebra-zpl,fr.w3blog.zpl,0,0,0,0,1,0,0,1
w3blogfr_zebra-zpl,fr.w3blog.zpl.model.element,0,0,0,0,1,0,0,1
w3blogfr_zebra-zpl,fr.w3blog.zpl.model,1,1,0,0,0,0,0,2
w3blogfr_zebra-zpl,fr.w3blog.zpl.utils,1,0,0,0,0,0,0,1
w3blogfr_zebra-zpl,fr.w3blog.zpl,0,0,0,0,1,0,0,1
wangzw_CppStyle,org.wangzw.plugin.cppstyle,1,1,0,0,1,0,0,3
wangzw_CppStyle,org.wangzw.plugin.cppstyle.ui,1,0,0,0,1,0,0,2
WASdev_standards.jsr352.jbatch,com.ibm.jbatch.container.api.impl,0,0,0,0,0,1,0,1
WASdev_standards.jsr352.jbatch,com.ibm.jbatch.container.artifact.proxy,0,0,0,0,0,10,0,10
WASdev_standards.jsr352.jbatch,com.ibm.jbatch.container.callback,0,0,0,0,0,0,0,0
WASdev_standards.jsr352.jbatch,com.ibm.jbatch.container.cdi,0,0,0,0,0,0,0,0
WASdev_standards.jsr352.jbatch,com.ibm.jbatch.container.context.impl,0,1,0,0,0,16,0,17
WASdev_standards.jsr352.jbatch,com.ibm.jbatch.container.exception,0,0,0,0,0,0,0,0
WASdev_standards.jsr352.jbatch,com.ibm.jbatch.container,0,0,0,0,0,0,0,0
WASdev_standards.jsr352.jbatch,com.ibm.jbatch.container.impl,7,1,0,0,0,16,0,24
WASdev_standards.jsr352.jbatch,com.ibm.jbatch.container.jobinstance,0,0,0,0,1,15,0,16
WASdev_standards.jsr352.jbatch,com.ibm.jbatch.container.jsl,0,0,0,0,1,1,0,2
WASdev_standards.jsr352.jbatch,com.ibm.jbatch.container.jsl.impl,0,0,0,0,1,0,0,1
WASdev_standards.jsr352.jbatch,com.ibm.jbatch.container.modelresolver.impl,1,1,0,0,0,1,0,3
WASdev_standards.jsr352.jbatch,com.ibm.jbatch.container.modelresolver,1,0,0,0,0,1,0,2
WASdev_standards.jsr352.jbatch,com.ibm.jbatch.container.navigator,0,1,0,0,0,3,0,4
WASdev_standards.jsr352.jbatch,com.ibm.jbatch.container.persistence,0,0,0,0,0,1,0,1
WASdev_standards.jsr352.jbatch,com.ibm.jbatch.container.services,0,0,0,0,0,9,0,9
WASdev_standards.jsr352.jbatch,com.ibm.jbatch.container.services.impl,4,0,0,0,1,1,0,6
WASdev_standards.jsr352.jbatch,com.ibm.jbatch.container.servicesmanager,2,1,0,0,0,2,0,5
WASdev_standards.jsr352.jbatch,com.ibm.jbatch.container.status,2,1,0,0,1,1,0,5
WASdev_standards.jsr352.jbatch,com.ibm.jbatch.container.transaction.impl,0,0,0,0,0,0,0,0
WASdev_standards.jsr352.jbatch,com.ibm.jbatch.container.util,4,1,0,0,1,4,0,10
WASdev_standards.jsr352.jbatch,com.ibm.jbatch.container.validation,0,0,0,0,0,0,0,0
WASdev_standards.jsr352.jbatch,com.ibm.jbatch.jsl.util,0,0,0,0,0,0,0,0
WASdev_standards.jsr352.jbatch,com.ibm.jbatch.spi.services,0,0,0,0,1,1,0,2
WASdev_standards.jsr352.jbatch,com.ibm.jbatch.jsl.model,0,0,0,0,0,8,0,8
WASdev_standards.jsr352.jbatch,com.ibm.jbatch.spi,0,0,0,0,1,0,0,1
WASdev_standards.jsr352.jbatch,javax.batch.api,0,0,0,0,0,1,0,1
WASdev_standards.jsr352.jbatch,javax.batch.api.chunk,0,0,0,0,1,1,0,2
WASdev_standards.jsr352.jbatch,javax.batch.api.chunk.listener,0,0,0,0,1,1,0,2
WASdev_standards.jsr352.jbatch,javax.batch.api.listener,0,0,0,0,0,1,0,1
WASdev_standards.jsr352.jbatch,javax.batch.api.partition,0,0,0,0,1,1,0,2
WASdev_standards.jsr352.jbatch,javax.batch.operations,0,0,0,0,0,0,0,0
WASdev_standards.jsr352.jbatch,javax.batch.runtime,0,0,0,0,0,3,0,3
WASdev_standards.jsr352.jbatch,javax.batch.runtime.context,0,0,0,0,0,0,0,0
webdriverextensions_webdriverextensions,com.github.webdriverextensions,2,0,0,0,1,0,0,3
webdriverextensions_webdriverextensions,com.github.webdriverextensions.exceptions,0,0,0,0,0,0,0,0
webdriverextensions_webdriverextensions,com.github.webdriverextensions.generator,0,0,0,0,0,0,0,0
webdriverextensions_webdriverextensions,com.github.webdriverextensions.internal,3,1,0,0,1,0,0,5
webdriverextensions_webdriverextensions,com.github.webdriverextensions.internal.generator,0,0,0,0,0,0,0,0
webdriverextensions_webdriverextensions,com.github.webdriverextensions.internal.junitrunner,0,0,0,0,0,0,0,0
webdriverextensions_webdriverextensions,com.github.webdriverextensions.internal.utils,2,1,0,0,1,0,0,4
webdriverextensions_webdriverextensions,com.github.webdriverextensions.junitrunner,0,0,0,0,1,0,0,1
webdriverextensions_webdriverextensions,com.github.webdriverextensions.vaadin,0,0,0,0,0,0,0,0
webdriverextensions_webdriverextensions,com.github.webdriverextensions.model.components,0,0,0,0,1,0,0,1
webdriverextensions_webdriverextensions,com.github.webdriverextensions.model.pages,0,0,0,0,0,0,0,0
webdriverextensions_webdriverextensions,com.github.webdriverextensions.model,0,0,0,0,0,0,0,0
webdriverextensions_webdriverextensions,(default package),0,0,0,0,0,0,0,0
welovecoding_editorconfig-netbeans,com.welovecoding.nbeditorconfig.config,0,0,0,0,0,0,0,0
welovecoding_editorconfig-netbeans,com.welovecoding.nbeditorconfig.editor.csl,0,0,0,0,1,0,0,1
welovecoding_editorconfig-netbeans,com.welovecoding.nbeditorconfig.editor.lexer,0,0,0,0,0,0,0,0
welovecoding_editorconfig-netbeans,com.welovecoding.nbeditorconfig.editor.parser,0,0,0,0,0,0,0,0
welovecoding_editorconfig-netbeans,com.welovecoding.nbeditorconfig.filetype,0,0,0,0,0,0,0,0
welovecoding_editorconfig-netbeans,com.welovecoding.nbeditorconfig.io.exception,0,0,0,0,0,0,0,0
welovecoding_editorconfig-netbeans,com.welovecoding.nbeditorconfig.io.model,0,0,0,0,0,1,0,1
welovecoding_editorconfig-netbeans,com.welovecoding.nbeditorconfig.io.reader,0,0,0,0,0,0,0,0
welovecoding_editorconfig-netbeans,com.welovecoding.nbeditorconfig.io.writer,0,0,0,0,0,0,0,0
welovecoding_editorconfig-netbeans,com.welovecoding.nbeditorconfig.listener,0,0,0,0,1,0,0,1
welovecoding_editorconfig-netbeans,com.welovecoding.nbeditorconfig.mapper,0,0,0,0,0,1,0,1
welovecoding_editorconfig-netbeans,com.welovecoding.nbeditorconfig.model,0,0,0,0,0,1,0,1
welovecoding_editorconfig-netbeans,com.welovecoding.nbeditorconfig.options,0,0,0,0,0,0,0,0
welovecoding_editorconfig-netbeans,com.welovecoding.nbeditorconfig.processor,0,1,0,0,1,0,0,2
welovecoding_editorconfig-netbeans,com.welovecoding.nbeditorconfig.processor.operation,0,0,0,0,1,0,0,1
welovecoding_editorconfig-netbeans,com.welovecoding.nbeditorconfig.processor.operation.tobedone,0,0,0,0,0,0,0,0
welovecoding_editorconfig-netbeans,org.antlr4,0,0,0,0,1,0,0,1
welovecoding_editorconfig-netbeans,org.editorconfig.core,0,0,0,0,0,0,0,0
wendykierp_JTransforms,org.jtransforms.dct,0,0,0,0,1,0,0,1
wendykierp_JTransforms,org.jtransforms.dht,0,0,0,0,1,0,0,1
wendykierp_JTransforms,org.jtransforms.dst,0,0,0,0,1,0,0,1
wendykierp_JTransforms,org.jtransforms.fft,0,0,0,1,1,0,0,2
wendykierp_JTransforms,org.jtransforms.utils,0,0,0,0,0,0,0,0
WhisperSystems_BitHub,org.whispersystems.bithub.auth,0,0,0,0,0,0,0,0
WhisperSystems_BitHub,org.whispersystems.bithub,0,0,0,0,0,0,0,0
WhisperSystems_BitHub,org.whispersystems.bithub.client,0,0,0,0,0,0,0,0
WhisperSystems_BitHub,org.whispersystems.bithub.config,0,0,0,0,1,0,0,1
WhisperSystems_BitHub,org.whispersystems.bithub.controllers,0,0,0,0,0,0,0,0
WhisperSystems_BitHub,org.whispersystems.bithub.entities,0,0,0,0,1,0,0,1
WhisperSystems_BitHub,org.whispersystems.bithub.mappers,0,0,0,0,0,0,0,0
WhisperSystems_BitHub,org.whispersystems.bithub.storage,0,0,0,0,0,0,0,0
WhisperSystems_BitHub,org.whispersystems.bithub.util,0,0,0,0,0,0,0,0
WhisperSystems_BitHub,org.whispersystems.bithub.views,0,0,0,0,0,0,0,0
WhisperSystems_libaxolotl-android,org.whispersystems.libsignal,11,1,0,0,1,0,1,14
WhisperSystems_libaxolotl-android,org.whispersystems.libsignal.util,7,1,0,0,1,0,1,10
WhisperSystems_libaxolotl-android,org.whispersystems.libsignal.fingerprint,0,0,0,0,0,0,1,1
WhisperSystems_libaxolotl-android,org.whispersystems.libsignal.protocol,4,1,0,0,0,0,1,6
WhisperSystems_libaxolotl-android,org.whispersystems.libsignal.state,5,1,0,1,0,0,1,8
WhisperSystems_libaxolotl-android,org.whispersystems.libsignal.devices,4,0,0,0,0,0,1,5
WhisperSystems_libaxolotl-android,org.whispersystems.libsignal.ecc,2,1,0,0,0,0,1,4
WhisperSystems_libaxolotl-android,org.whispersystems.libsignal.groups,1,0,0,0,0,0,1,2
WhisperSystems_libaxolotl-android,org.whispersystems.libsignal.groups.ratchet,0,0,0,0,0,0,1,1
WhisperSystems_libaxolotl-android,org.whispersystems.libsignal.groups.state,1,1,0,0,0,0,1,3
WhisperSystems_libaxolotl-android,org.whispersystems.libsignal.kdf,2,1,0,0,1,0,1,5
WhisperSystems_libaxolotl-android,org.whispersystems.libsignal.logging,0,0,0,0,0,0,1,1
WhisperSystems_libaxolotl-android,org.whispersystems.libsignal.ratchet,5,0,0,0,0,0,1,6
WhisperSystems_libaxolotl-android,org.whispersystems.libsignal.state.impl,0,0,0,0,0,0,1,1
WhisperSystems_libaxolotl-android,org.whispersystems.libsignal.util.guava,0,0,0,0,1,0,1,2
WhisperSystems_PushServer,org.whispersystems.pushserver.auth,0,0,0,0,0,1,0,1
WhisperSystems_PushServer,org.whispersystems.pushserver.config,0,0,0,0,0,0,0,0
WhisperSystems_PushServer,org.whispersystems.pushserver.controllers,0,0,0,0,0,1,0,1
WhisperSystems_PushServer,org.whispersystems.pushserver.entities,0,0,0,0,0,0,0,0
WhisperSystems_PushServer,org.whispersystems.pushserver.metrics,0,0,0,0,0,0,0,0
WhisperSystems_PushServer,org.whispersystems.pushserver.providers,0,0,0,0,0,0,0,0
WhisperSystems_PushServer,org.whispersystems.pushserver,0,0,0,0,0,0,0,0
WhisperSystems_PushServer,org.whispersystems.pushserver.senders,0,0,0,0,1,1,0,2
WhisperSystems_PushServer,org.whispersystems.pushserver.util,0,0,0,0,0,0,0,0
WhisperSystems_WebSocket-Resources,org.whispersystems.websocket.auth,0,0,0,0,0,0,0,0
WhisperSystems_WebSocket-Resources,org.whispersystems.websocket.auth.internal,0,0,0,0,0,1,0,1
WhisperSystems_WebSocket-Resources,org.whispersystems.websocket.configuration,0,0,0,0,0,0,0,0
WhisperSystems_WebSocket-Resources,org.whispersystems.websocket.messages,0,0,0,0,0,0,0,0
WhisperSystems_WebSocket-Resources,org.whispersystems.websocket.messages.protobuf,0,0,0,0,0,0,0,0
WhisperSystems_WebSocket-Resources,org.whispersystems.websocket.servlet,0,0,0,0,1,1,0,2
WhisperSystems_WebSocket-Resources,org.whispersystems.websocket.session,0,0,0,0,0,1,0,1
WhisperSystems_WebSocket-Resources,org.whispersystems.websocket.setup,0,0,0,0,0,0,0,0
WhisperSystems_WebSocket-Resources,org.whispersystems.websocket.util,0,0,0,0,0,0,0,0
WhisperSystems_WebSocket-Resources,org.whispersystems.websocket,0,0,0,0,1,0,0,1
WhisperSystems_WebSocket-Resources,org.whispersystems.websocket.client,0,0,0,0,0,0,0,0
whois-server-list_public-suffix-list,de.malkusch.whoisServerList.publicSuffixList.index.array,0,0,0,0,0,0,0,0
whois-server-list_public-suffix-list,de.malkusch.whoisServerList.publicSuffixList.index,0,0,0,0,0,0,0,0
whois-server-list_public-suffix-list,de.malkusch.whoisServerList.publicSuffixList.index.tree,0,0,0,0,0,0,0,0
whois-server-list_public-suffix-list,de.malkusch.whoisServerList.publicSuffixList,2,0,0,0,0,0,0,2
whois-server-list_public-suffix-list,de.malkusch.whoisServerList.publicSuffixList.parser,2,1,0,0,0,0,0,3
whois-server-list_public-suffix-list,de.malkusch.whoisServerList.publicSuffixList.rule,0,0,0,0,0,0,0,0
whois-server-list_public-suffix-list,de.malkusch.whoisServerList.publicSuffixList.util,0,0,0,0,0,0,0,0
whois-server-list_public-suffix-list,de.malkusch.whoisServerList.publicSuffixList.benchmark.index,0,0,0,0,0,0,0,0
wikimedia_search-highlighter,org.wikimedia.search.highlighter.experimental.extern,0,0,0,0,0,2,0,2
wikimedia_search-highlighter,org.wikimedia.search.highlighter.experimental.hit,1,0,0,1,1,3,0,6
wikimedia_search-highlighter,org.wikimedia.search.highlighter.experimental.hit.weight,1,1,0,0,1,1,0,4
wikimedia_search-highlighter,org.wikimedia.search.highlighter.experimental,0,0,0,1,1,3,0,5
wikimedia_search-highlighter,org.wikimedia.search.highlighter.experimental.snippet,0,0,0,1,1,1,0,3
wikimedia_search-highlighter,org.wikimedia.search.highlighter.experimental.source,0,0,0,0,0,0,0,0
wikimedia_search-highlighter,org.wikimedia.search.highlighter.experimental.tools,0,0,0,0,1,1,0,2
wikimedia_search-highlighter,org.wikimedia.highlighter.experimental.elasticsearch,1,0,0,0,1,1,0,3
wikimedia_search-highlighter,org.wikimedia.highlighter.experimental.elasticsearch.plugin,1,1,0,0,0,0,0,2
wikimedia_search-highlighter,org.wikimedia.highlighter.experimental.elasticsearch.integration,0,0,0,0,1,0,0,1
wikimedia_search-highlighter,org.wikimedia.highlighter.experimental.lucene.automaton,0,0,0,0,0,0,0,0
wikimedia_search-highlighter,org.wikimedia.highlighter.experimental.lucene.hit,0,0,0,0,1,0,0,1
wikimedia_search-highlighter,org.wikimedia.highlighter.experimental.lucene.hit.weight,0,0,0,0,1,0,0,1
wikimedia_search-highlighter,org.wikimedia.highlighter.experimental.lucene,0,0,0,0,1,0,0,1
wikimedia_search-highlighter,org.wikimedia.highlighter.experimental,0,0,0,0,1,0,0,1
wildfly-extras_wildfly-camel,$,0,0,0,0,1,0,0,1
wildfly-extras_wildfly-camel,org.wildfly.camel.catalog,0,0,0,0,0,0,0,0
wildfly-extras_wildfly-camel,org.wildfly.camel.proxy,0,0,0,0,0,0,0,0
wildfly-extras_wildfly-camel,org.wildfly.camel.utils,0,0,0,0,0,0,0,0
wildfly-extras_wildfly-camel,org.wildfly.extension.camel,6,1,0,0,1,0,0,8
wildfly-extras_wildfly-camel,org.wildfly.extension.camel.config,0,0,0,0,0,0,0,0
wildfly-extras_wildfly-camel,org.wildfly.extras.config,1,1,0,0,1,0,0,3
wildfly-extras_wildfly-camel,org.wildfly.extras.config.internal,1,0,0,0,0,0,0,1
wildfly-extras_wildfly-camel,org.apache.cxf.transport.undertow,0,0,0,0,1,0,0,1
wildfly-extras_wildfly-camel,org.apache.cxf.transport.undertow.wildfly.subsystem.extension,0,0,0,0,0,0,0,0
wildfly-extras_wildfly-camel,org.apache.cxf.transport.undertow.wildfly,0,0,0,0,0,0,0,0
wildfly-extras_wildfly-camel,org.wildfly.extension.camel.cdi,0,0,0,0,0,0,0,0
wildfly-extras_wildfly-camel,org.wildfly.extension.camel.deployment,3,1,0,0,0,0,0,4
wildfly-extras_wildfly-camel,org.wildfly.extension.camel.handler,1,1,0,0,1,0,0,3
wildfly-extras_wildfly-camel,org.wildfly.extension.camel.parser,2,0,0,0,0,0,0,2
wildfly-extras_wildfly-camel,org.wildfly.extension.camel.service,5,0,0,0,1,0,0,6
wildfly-extras_wildfly-camel,org.wildfly.extension.camel.security,0,0,0,0,1,0,0,1
wildfly-extras_wildfly-camel,org.wildfly.extension.camel.undertow,0,0,0,0,1,0,0,1
wildfly-extras_wildfly-camel,org.wildfly.camel.arquillian,0,0,0,0,0,0,0,0
wildfly_wildfly-core,org.jboss.as.cli.accesscontrol,4,1,0,0,0,1,1,7
wildfly_wildfly-core,org.jboss.as.cli,30,1,0,1,1,15,1,49
wildfly_wildfly-core,org.jboss.as.cli.batch,0,0,0,0,0,3,1,4
wildfly_wildfly-core,org.jboss.as.cli.batch.impl,0,0,0,0,0,0,1,1
wildfly_wildfly-core,org.jboss.as.cli.embedded,2,0,0,0,1,0,1,4
wildfly_wildfly-core,org.jboss.as.cli.gui,4,0,0,1,1,3,1,10
wildfly_wildfly-core,org.jboss.as.cli.gui.component,2,1,0,0,1,2,1,7
wildfly_wildfly-core,org.jboss.as.cli.gui.metacommand,3,1,0,0,1,3,1,9
wildfly_wildfly-core,org.jboss.as.cli.handlers,12,0,0,1,1,3,1,18
wildfly_wildfly-core,org.jboss.as.cli.handlers.batch,0,0,0,0,1,3,1,5
wildfly_wildfly-core,org.jboss.as.cli.handlers.ifelse,0,0,0,0,1,2,1,4
wildfly_wildfly-core,org.jboss.as.cli.handlers.jca,3,0,0,0,0,0,1,4
wildfly_wildfly-core,org.jboss.as.cli.handlers.loop,0,0,0,0,0,1,1,2
wildfly_wildfly-core,org.jboss.as.cli.handlers.module,0,0,0,0,1,0,1,2
wildfly_wildfly-core,org.jboss.as.cli.handlers.report,0,0,0,0,0,0,1,1
wildfly_wildfly-core,org.jboss.as.cli.handlers.trycatch,0,0,0,0,0,1,1,2
wildfly_wildfly-core,org.jboss.as.cli.impl.aesh,3,0,0,1,1,0,1,6
wildfly_wildfly-core,org.jboss.as.cli.impl.aesh.cmd,0,0,0,0,1,0,1,2
wildfly_wildfly-core,org.jboss.as.cli.impl.aesh.cmd.deployment,2,0,0,0,1,0,1,4
wildfly_wildfly-core,org.jboss.as.cli.impl.aesh.cmd.deployment.security,3,1,0,0,1,0,1,6
wildfly_wildfly-core,org.jboss.as.cli.impl.aesh.cmd.operation,0,0,0,0,1,0,1,2
wildfly_wildfly-core,org.jboss.as.cli.impl.aesh.cmd.security,1,1,0,0,1,0,1,4
wildfly_wildfly-core,org.jboss.as.cli.impl.aesh.cmd.security.auth,0,0,0,1,1,0,1,3
wildfly_wildfly-core,org.jboss.as.cli.impl.aesh.cmd.security.model,1,1,0,0,1,0,1,4
wildfly_wildfly-core,org.jboss.as.cli.impl.aesh.cmd.security.ssl,0,0,0,0,1,0,1,2
wildfly_wildfly-core,org.jboss.as.cli.impl,19,1,0,1,1,6,1,29
wildfly_wildfly-core,org.jboss.as.cli.operation,7,1,0,0,1,9,1,19
wildfly_wildfly-core,org.jboss.as.cli.operation.impl,5,1,0,0,1,3,1,11
wildfly_wildfly-core,org.jboss.as.cli.parsing.arguments,4,0,0,0,0,0,1,5
wildfly_wildfly-core,org.jboss.as.cli.parsing,12,1,0,1,0,4,1,19
wildfly_wildfly-core,org.jboss.as.cli.parsing.command,4,0,0,0,1,0,1,6
wildfly_wildfly-core,org.jboss.as.cli.parsing.operation,2,0,0,0,1,0,1,4
wildfly_wildfly-core,org.jboss.as.cli.parsing.operation.header,0,0,0,0,1,1,1,3
wildfly_wildfly-core,org.jboss.as.cli.scriptsupport,0,0,0,0,0,0,1,1
wildfly_wildfly-core,org.jboss.as.cli.util,2,1,0,0,1,0,1,5
wildfly_wildfly-core,org.wildfly.core.cli.command.aesh.activator,0,0,0,0,1,0,1,2
wildfly_wildfly-core,org.wildfly.core.cli.command.aesh,0,0,0,0,0,0,1,1
wildfly_wildfly-core,org.wildfly.core.cli.command,0,0,0,0,0,0,1,1
wildfly_wildfly-core,org.jboss.as.cli.completion.mock,0,1,0,0,1,0,1,3
wildfly_wildfly-core,org.jboss.as.controller,49,1,0,2,1,1,1,55
wildfly_wildfly-core,org.jboss.as.controller.access,9,1,0,0,1,2,1,14
wildfly_wildfly-core,org.jboss.as.controller.access.constraint,6,0,0,1,1,1,1,10
wildfly_wildfly-core,org.jboss.as.controller.access.management,15,1,0,0,1,2,1,20
wildfly_wildfly-core,org.jboss.as.controller.access.permission,2,0,0,0,1,0,1,4
wildfly_wildfly-core,org.jboss.as.controller.access.rbac,5,1,0,1,1,1,1,10
wildfly_wildfly-core,org.jboss.as.controller.audit,5,1,0,1,1,0,1,9
wildfly_wildfly-core,org.jboss.as.controller.capability,3,1,0,0,1,0,1,6
wildfly_wildfly-core,org.jboss.as.controller.capability.registry,2,0,0,0,1,0,1,4
wildfly_wildfly-core,org.jboss.as.controller.descriptions.common,2,0,0,0,0,0,1,3
wildfly_wildfly-core,org.jboss.as.controller.descriptions,12,1,0,0,1,0,1,15
wildfly_wildfly-core,org.jboss.as.controller.extension,5,0,0,0,1,0,1,7
wildfly_wildfly-core,org.jboss.as.controller.interfaces,3,0,0,1,0,0,1,5
wildfly_wildfly-core,org.jboss.as.controller.logging,26,1,0,0,0,0,1,28
wildfly_wildfly-core,org.jboss.as.controller.management,0,0,0,0,1,0,1,2
wildfly_wildfly-core,org.jboss.as.controller.notification,3,0,0,0,1,1,1,6
wildfly_wildfly-core,org.jboss.as.controller.operations.common,10,1,0,0,1,0,1,13
wildfly_wildfly-core,org.jboss.as.controller.operations,3,0,0,0,1,0,1,5
wildfly_wildfly-core,org.jboss.as.controller.operations.global,2,0,0,1,1,0,1,5
wildfly_wildfly-core,org.jboss.as.controller.operations.validation,3,0,0,0,1,0,1,5
wildfly_wildfly-core,org.jboss.as.controller.parsing,3,1,0,0,1,0,1,6
wildfly_wildfly-core,org.jboss.as.controller.persistence,4,1,0,1,1,0,1,8
wildfly_wildfly-core,org.jboss.as.controller.registry,33,1,0,1,1,1,1,38
wildfly_wildfly-core,org.jboss.as.controller.remote,3,0,0,1,1,0,1,6
wildfly_wildfly-core,org.jboss.as.controller.resource,4,0,0,0,0,0,1,5
wildfly_wildfly-core,org.jboss.as.controller.security,3,0,0,0,0,0,1,4
wildfly_wildfly-core,org.jboss.as.controller.services.path,0,0,0,1,1,0,1,3
wildfly_wildfly-core,org.jboss.as.controller.transform,2,1,0,1,1,0,1,6
wildfly_wildfly-core,org.jboss.as.controller.transform.description,0,0,0,1,1,0,1,3
wildfly_wildfly-core,org.jboss.as.controller._private,0,0,0,0,0,0,1,1
wildfly_wildfly-core,org.jboss.as.controller.operation.global,0,0,0,0,0,0,1,1
wildfly_wildfly-core,org.jboss.as.controller.operation.validation,0,0,0,0,0,0,1,1
wildfly_wildfly-core,org.jboss.as.controller.support,0,0,0,0,0,0,1,1
wildfly_wildfly-core,org.jboss.as.controller.client.helpers,0,1,0,0,1,0,1,3
wildfly_wildfly-core,org.jboss.as.controller.client.helpers.domain,1,0,0,1,1,0,1,4
wildfly_wildfly-core,org.jboss.as.controller.client.helpers.domain.impl,0,0,0,0,1,0,1,2
wildfly_wildfly-core,org.jboss.as.controller.client.helpers.standalone,1,1,0,0,1,0,1,4
wildfly_wildfly-core,org.jboss.as.controller.client.helpers.standalone.impl,1,0,0,0,1,0,1,3
wildfly_wildfly-core,org.jboss.as.controller.client.impl,1,0,0,0,1,0,1,3
wildfly_wildfly-core,org.jboss.as.controller.client.logging,1,1,0,0,0,0,1,3
wildfly_wildfly-core,org.jboss.as.controller.client,1,1,0,0,1,0,1,4
wildfly_wildfly-core,org.wildfly.extension.core.management.client,0,0,0,0,1,0,1,2
wildfly_wildfly-core,org.wildfly.extension.core.management,0,0,0,0,1,0,1,2
wildfly_wildfly-core,org.wildfly.extension.core.management.logging,0,0,0,0,0,0,1,1
wildfly_wildfly-core,org.jboss.as.core.model.bridge.impl,1,0,0,0,0,0,1,2
wildfly_wildfly-core,org.jboss.as.core.model.bridge.local,1,1,0,0,0,0,1,3
wildfly_wildfly-core,org.jboss.as.core.model.bridge.shared,0,0,0,0,0,0,1,1
wildfly_wildfly-core,org.jboss.as.core.security.api,0,0,0,0,0,0,1,1
wildfly_wildfly-core,org.jboss.as.core.security,0,0,0,0,1,0,1,2
wildfly_wildfly-core,org.jboss.as.repository,1,0,0,0,1,0,1,3
wildfly_wildfly-core,org.jboss.as.repository.logging,1,1,0,0,0,0,1,3
wildfly_wildfly-core,org.jboss.as.server.deployment.scanner.api,0,0,0,0,0,0,1,1
wildfly_wildfly-core,org.jboss.as.server.deployment.scanner,0,0,0,1,1,0,1,3
wildfly_wildfly-core,org.jboss.as.server.deployment.scanner.logging,0,0,0,0,0,0,1,1
wildfly_wildfly-core,org.wildfly.extension.discovery,0,0,0,0,1,0,1,2
wildfly_wildfly-core,org.jboss.as.domain.http.server,1,1,0,1,1,0,1,5
wildfly_wildfly-core,org.jboss.as.domain.http.server.cors,0,0,0,0,0,0,1,1
wildfly_wildfly-core,org.jboss.as.domain.http.server.logging,0,0,0,0,0,0,1,1
wildfly_wildfly-core,org.jboss.as.domain.http.server.security,1,0,0,0,1,0,1,3
wildfly_wildfly-core,org.jboss.as.domain.management.access,1,1,0,1,1,0,1,5
wildfly_wildfly-core,org.jboss.as.domain.management.audit,2,1,0,1,1,0,1,6
wildfly_wildfly-core,org.jboss.as.domain.management.audit.validators,0,0,0,0,0,0,1,1
wildfly_wildfly-core,org.jboss.as.domain.management,5,1,0,0,1,0,1,8
wildfly_wildfly-core,org.jboss.as.domain.management.connections.ldap,2,0,0,0,1,0,1,4
wildfly_wildfly-core,org.jboss.as.domain.management.controller,0,0,0,0,1,0,1,2
wildfly_wildfly-core,org.jboss.as.domain.management.logging,0,0,0,0,0,1,1,2
wildfly_wildfly-core,org.jboss.as.domain.management.parsing,0,0,0,0,1,0,1,2
wildfly_wildfly-core,org.jboss.as.domain.management.plugin,0,0,0,0,1,0,1,2
wildfly_wildfly-core,org.jboss.as.domain.management.security,4,1,0,1,1,0,1,8
wildfly_wildfly-core,org.jboss.as.domain.management.security.adduser,0,0,0,1,0,1,1,3
wildfly_wildfly-core,org.jboss.as.domain.management.security.password,1,1,0,0,1,1,1,5
wildfly_wildfly-core,org.jboss.as.domain.management.security.password.simple,1,0,0,0,1,0,1,3
wildfly_wildfly-core,org.jboss.as.domain.management._private,0,0,0,0,0,0,1,1
wildfly_wildfly-core,org.jboss.as.domain.management.security.auditlog,0,0,0,0,1,0,1,2
wildfly_wildfly-core,org.jboss.as.domain.management.security.operations,0,0,0,0,0,0,1,1
wildfly_wildfly-core,org.jboss.as.domain.management.security.realms,0,0,0,0,0,0,1,1
wildfly_wildfly-core,org.jboss.as.domain.management.security.util,0,0,0,0,1,0,1,2
wildfly_wildfly-core,org.wildfly.extension.elytron,0,0,0,1,1,0,1,3
wildfly_wildfly-core,org.wildfly.extension.elytron.capabilities,0,0,0,0,0,0,1,1
wildfly_wildfly-core,org.wildfly.extension.elytron.capabilities._private,0,0,0,0,0,0,1,1
wildfly_wildfly-core,org.wildfly.extension.elytron._private,0,0,0,0,0,0,1,1
wildfly_wildfly-core,org.wildfly.core.embedded,0,1,0,0,1,0,1,3
wildfly_wildfly-core,org.wildfly.core.embedded.logging,0,0,0,0,0,0,1,1
wildfly_wildfly-core,org.wildfly.event.logger,0,0,0,0,0,0,1,1
wildfly_wildfly-core,org.jboss.as.domain.controller,0,0,0,0,1,0,1,2
wildfly_wildfly-core,org.jboss.as.domain.controller.logging,0,0,0,0,0,0,1,1
wildfly_wildfly-core,org.jboss.as.domain.controller.operations,16,1,0,1,1,0,1,20
wildfly_wildfly-core,org.jboss.as.domain.controller.operations.coordination,11,1,0,1,1,0,1,15
wildfly_wildfly-core,org.jboss.as.domain.controller.operations.deployment,3,0,0,0,1,0,1,5
wildfly_wildfly-core,org.jboss.as.domain.controller.plan,0,0,0,0,1,0,1,2
wildfly_wildfly-core,org.jboss.as.domain.controller.resources,8,1,0,0,1,0,1,11
wildfly_wildfly-core,org.jboss.as.domain.controller.transformers,2,0,0,0,0,0,1,3
wildfly_wildfly-core,org.jboss.as.host.controller,14,0,0,1,1,0,1,17
wildfly_wildfly-core,org.jboss.as.host.controller.descriptions,0,0,0,0,0,0,1,1
wildfly_wildfly-core,org.jboss.as.host.controller.discovery,2,1,0,1,1,0,1,6
wildfly_wildfly-core,org.jboss.as.host.controller.ignored,0,0,0,0,1,0,1,2
wildfly_wildfly-core,org.jboss.as.host.controller.jvm,0,0,0,0,0,0,1,1
wildfly_wildfly-core,org.jboss.as.host.controller.logging,0,0,0,0,0,0,1,1
wildfly_wildfly-core,org.jboss.as.host.controller.mgmt,12,1,0,1,1,0,1,16
wildfly_wildfly-core,org.jboss.as.host.controller.model.host,6,1,0,0,0,0,1,8
wildfly_wildfly-core,org.jboss.as.host.controller.model.jvm,0,0,0,0,1,0,1,2
wildfly_wildfly-core,org.jboss.as.host.controller.operations,8,1,0,1,1,0,1,12
wildfly_wildfly-core,org.jboss.as.host.controller.parsing,0,0,0,0,0,0,1,1
wildfly_wildfly-core,org.jboss.as.host.controller.resources,2,1,0,0,1,0,1,5
wildfly_wildfly-core,org.jboss.as.host.controller.util,0,0,0,0,1,0,1,2
wildfly_wildfly-core,org.wildfly.extension.io,2,0,0,1,1,0,1,5
wildfly_wildfly-core,org.wildfly.extension.io.logging,0,0,0,0,0,0,1,1
wildfly_wildfly-core,org.jboss.as.jmx,0,1,0,1,1,0,1,4
wildfly_wildfly-core,org.jboss.as.jmx.logging,0,0,0,0,0,0,1,1
wildfly_wildfly-core,org.jboss.as.jmx.model,0,0,0,1,1,0,1,3
wildfly_wildfly-core,org.jboss.as.jmx.auditlog,0,0,0,0,0,0,1,1
wildfly_wildfly-core,org.jboss.as.jmx.rbac,0,0,0,0,1,0,1,2
wildfly_wildfly-core,org.wildfly.core.launcher,0,0,0,0,0,0,1,1
wildfly_wildfly-core,org.wildfly.core.launcher.logger,0,0,0,0,0,0,1,1
wildfly_wildfly-core,org.jboss.as.logging,18,1,0,1,1,0,1,22
wildfly_wildfly-core,org.jboss.as.logging.capabilities,3,1,0,0,0,0,1,5
wildfly_wildfly-core,org.jboss.as.logging.correctors,0,0,0,0,0,0,1,1
wildfly_wildfly-core,org.jboss.as.logging.deployments,0,0,0,0,1,0,1,2
wildfly_wildfly-core,org.jboss.as.logging.deployments.resources,2,0,0,0,1,0,1,4
wildfly_wildfly-core,org.jboss.as.logging.filters,2,1,0,0,0,0,1,4
wildfly_wildfly-core,org.jboss.as.logging.formatters,8,1,0,0,1,0,1,11
wildfly_wildfly-core,org.jboss.as.logging.handlers,8,1,0,0,1,0,1,11
wildfly_wildfly-core,org.jboss.as.logging.loggers,3,1,0,0,1,0,1,6
wildfly_wildfly-core,org.jboss.as.logging.logging,6,1,0,0,0,0,1,8
wildfly_wildfly-core,org.jboss.as.logging.logmanager,2,1,0,0,1,0,1,5
wildfly_wildfly-core,org.jboss.as.logging.resolvers,3,1,0,0,1,0,1,6
wildfly_wildfly-core,org.jboss.as.logging.stdio,0,0,0,0,0,0,1,1
wildfly_wildfly-core,org.jboss.as.logging.validators,1,0,0,0,1,0,1,3
wildfly_wildfly-core,org.jboss.as.management.client.content,0,0,0,0,1,0,1,2
wildfly_wildfly-core,org.jboss.as.network,0,0,0,0,0,0,1,1
wildfly_wildfly-core,org.jboss.as.network.logging,0,0,0,0,0,0,1,1
wildfly_wildfly-core,org.jboss.as.patching.cli,0,0,0,0,1,1,1,3
wildfly_wildfly-core,org.jboss.as.patching,3,1,0,0,1,4,1,10
wildfly_wildfly-core,org.jboss.as.patching.installation,4,1,0,1,1,5,1,13
wildfly_wildfly-core,org.jboss.as.patching.logging,7,1,0,0,0,1,1,10
wildfly_wildfly-core,org.jboss.as.patching.management,0,0,0,0,1,0,1,2
wildfly_wildfly-core,org.jboss.as.patching.metadata,10,1,0,1,0,6,1,19
wildfly_wildfly-core,org.jboss.as.patching.metadata.impl,2,0,0,0,0,1,1,4
wildfly_wildfly-core,org.jboss.as.patching.runner,10,1,0,1,0,5,1,18
wildfly_wildfly-core,org.jboss.as.patching.tool,3,1,0,0,1,2,1,8
wildfly_wildfly-core,org.jboss.as.patching.validation,6,1,0,1,0,0,1,9
wildfly_wildfly-core,org.jboss.as.platform.mbean,0,0,0,1,0,0,1,2
wildfly_wildfly-core,org.jboss.as.platform.mbean.logging,0,0,0,0,0,0,1,1
wildfly_wildfly-core,org.jboss.as.process,2,0,0,0,1,0,1,4
wildfly_wildfly-core,org.jboss.as.process.logging,2,1,0,0,0,0,1,4
wildfly_wildfly-core,org.jboss.as.process.protocol,1,0,0,0,1,0,1,3
wildfly_wildfly-core,org.jboss.as.process.stdin,0,0,0,0,0,0,1,1
wildfly_wildfly-core,org.jboss.as.protocol,0,0,0,0,1,0,1,2
wildfly_wildfly-core,org.jboss.as.protocol.logging,0,0,0,0,0,0,1,1
wildfly_wildfly-core,org.jboss.as.protocol.mgmt,1,1,0,1,1,0,1,5
wildfly_wildfly-core,org.jboss.as.protocol.mgmt.support,1,0,0,0,1,0,1,3
wildfly_wildfly-core,org.jboss.as.remoting,7,1,0,1,0,0,1,10
wildfly_wildfly-core,org.jboss.as.remoting.logging,0,0,0,0,0,0,1,1
wildfly_wildfly-core,org.jboss.as.remoting.management,3,1,0,0,0,0,1,5
wildfly_wildfly-core,org.wildfly.extension.requestcontroller,0,0,0,0,1,0,1,2
wildfly_wildfly-core,org.wildfly.extension.requestcontroller.logging,0,0,0,0,0,0,1,1
wildfly_wildfly-core,org.wildfly.extension.security.manager,0,0,0,0,0,0,1,1
wildfly_wildfly-core,org.wildfly.extension.security.manager.deployment,0,0,0,0,0,0,1,1
wildfly_wildfly-core,org.wildfly.extension.security.manager.logging,0,0,0,0,0,0,1,1
wildfly_wildfly-core,org.jboss.as.server,24,1,0,1,1,0,1,28
wildfly_wildfly-core,org.jboss.as.server.controller.descriptions,0,0,0,0,0,0,1,1
wildfly_wildfly-core,org.jboss.as.server.controller.git,1,0,0,0,1,0,1,3
wildfly_wildfly-core,org.jboss.as.server.controller.resources,8,1,0,0,1,0,1,11
wildfly_wildfly-core,org.jboss.as.server.deployment,19,1,0,1,1,0,1,23
wildfly_wildfly-core,org.jboss.as.server.deployment.annotation,4,0,0,0,1,0,1,6
wildfly_wildfly-core,org.jboss.as.server.deployment.client,0,0,0,0,0,0,1,1
wildfly_wildfly-core,org.jboss.as.server.deployment.dependencies,2,0,0,0,0,0,1,3
wildfly_wildfly-core,org.jboss.as.server.deployment.integration,0,0,0,0,0,0,1,1
wildfly_wildfly-core,org.jboss.as.server.deployment.jbossallxml,0,0,0,0,1,0,1,2
wildfly_wildfly-core,org.jboss.as.server.deployment.module,4,1,0,1,1,0,1,8
wildfly_wildfly-core,org.jboss.as.server.deployment.module.descriptor,4,0,0,0,1,0,1,6
wildfly_wildfly-core,org.jboss.as.server.deployment.reflect,0,0,0,0,1,0,1,2
wildfly_wildfly-core,org.jboss.as.server.deployment.service,0,0,0,0,0,0,1,1
wildfly_wildfly-core,org.jboss.as.server.deploymentoverlay,1,0,0,0,1,0,1,3
wildfly_wildfly-core,org.jboss.as.server.jmx,0,0,0,0,0,0,1,1
wildfly_wildfly-core,org.jboss.as.server.logging,0,1,0,0,0,0,1,2
wildfly_wildfly-core,org.jboss.as.server.mgmt.domain,3,1,0,0,1,0,1,6
wildfly_wildfly-core,org.jboss.as.server.mgmt,3,1,0,0,1,0,1,6
wildfly_wildfly-core,org.jboss.as.server.moduleservice,3,1,0,0,1,0,1,6
wildfly_wildfly-core,org.jboss.as.server.operations,13,1,0,1,1,0,1,17
wildfly_wildfly-core,org.jboss.as.server.parsing,0,1,0,0,1,0,1,3
wildfly_wildfly-core,org.jboss.as.server.security,0,0,0,0,0,0,1,1
wildfly_wildfly-core,org.jboss.as.server.services.net,0,1,0,1,1,0,1,4
wildfly_wildfly-core,org.jboss.as.server.services.security,3,1,0,0,1,0,1,6
wildfly_wildfly-core,org.jboss.as.server.suspend,0,0,0,0,0,0,1,1
wildfly_wildfly-core,org.jboss.as.subsystem.bridge.impl,1,0,0,0,0,0,1,2
wildfly_wildfly-core,org.jboss.as.subsystem.bridge.local,1,0,0,0,0,0,1,2
wildfly_wildfly-core,org.jboss.as.subsystem.bridge.shared,0,0,0,0,0,0,1,1
wildfly_wildfly-core,org.wildfly.client.old.server,0,0,0,0,0,0,1,1
wildfly_wildfly-core,org.wildfly.client.old.server.util,0,0,0,0,0,0,1,1
wildfly_wildfly-core,org.jboss.byteman,0,0,0,0,0,0,1,1
wildfly_wildfly-core,org.jboss.as.threads,0,0,0,1,0,0,1,2
wildfly_wildfly-core,org.jboss.as.version,0,0,0,0,0,0,1,1
wix_petri,com.wixpress.common.petri.e2e,0,0,0,0,0,1,0,1
wix_petri,com.wixpress.guineapig,0,0,0,0,1,0,0,1
wix_petri,com.wixpress.guineapig.drivers,0,0,0,0,0,0,0,0
wix_petri,com.wixpress.guineapig.entities.auth,0,0,0,0,0,0,0,0
wix_petri,com.wixpress.guineapig.services,0,0,0,0,1,0,0,1
wix_petri,com.wixpress.guineapig.spring,0,0,0,0,0,0,0,0
wix_petri,com.wixpress.guineapig.topology,0,0,0,0,0,0,0,0
wix_petri,com.wixpress.guineapig.velocity,0,0,0,0,0,0,0,0
wix_petri,com.wixpress.guineapig.web,0,0,0,0,1,0,0,1
wix_petri,com.wixpress.petri,1,1,0,0,1,0,0,3
wix_petri,com.wixpress.petri.laboratory,4,0,0,1,1,0,0,6
wix_petri,com.wixpress.petri.laboratory.http,0,0,0,0,1,0,0,1
wix_petri,com.wixpress.guineapig.util,0,0,0,0,1,0,0,1
wix_petri,com.wixpress.guineapig.entities.ui,1,0,0,0,1,0,0,2
wix_petri,com.wixpress.guineapig.spi,0,0,0,0,0,0,0,0
wix_petri,com.wixpress.guineapig.dsl,1,1,0,0,0,0,0,2
wix_petri,com.wixpress.guineapig.entities,0,0,0,0,0,0,0,0
wix_petri,com.wixpress.petri.petri,6,1,0,0,1,0,0,8
wix_petri,com.wixpress.petri.fakeserver,0,0,0,0,0,0,0,0
wix_petri,dynamic.filters,0,0,0,0,0,0,0,0
wix_petri,filters,0,0,0,0,0,0,0,0
wix_petri,com.wixpress.common.petri,0,0,0,0,0,0,0,0
wix_petri,com.wixpress.petri.experiments.domain,5,1,0,1,1,1,0,9
wix_petri,com.wixpress.petri.laboratory.dsl,5,1,0,0,0,0,0,6
wix_petri,com.wixpress.petri.util,0,0,0,0,0,0,0,0
wix_petri,specs.abstracts,0,0,0,0,0,0,0,0
wix_petri,specs.invalid,0,0,0,0,0,0,0,0
wix_petri,specs.valid,0,0,0,0,0,0,0,0
wix_petri,com.wixpress.petri.experiments.jackson,0,0,0,0,0,0,0,0
wix_petri,com.wixpress.petri.laboratory.converters,0,0,0,0,0,0,0,0
wiztools_rest-client,org.wiztools.restclient.cli,0,0,0,0,0,0,1,1
wiztools_rest-client,org.wiztools.restclient.jfx,0,0,0,0,0,0,1,1
wiztools_rest-client,org.wiztools.restclient.jfx.req,0,0,0,0,0,0,1,1
wiztools_rest-client,org.wiztools.restclient,4,1,0,0,1,0,1,7
wiztools_rest-client,org.wiztools.restclient.bean,5,1,0,1,0,0,1,8
wiztools_rest-client,org.wiztools.restclient.http,0,0,0,0,0,0,1,1
wiztools_rest-client,org.wiztools.restclient.persistence,3,0,0,0,0,0,1,4
wiztools_rest-client,org.wiztools.restclient.util,7,1,0,0,1,0,1,10
wiztools_rest-client,org.wiztools.restclient.server,0,0,0,0,0,0,1,1
wiztools_rest-client,org.wiztools.restclient.ui,13,1,0,1,0,0,1,16
wiztools_rest-client,org.wiztools.restclient.ui.component,2,0,0,0,0,0,1,3
wiztools_rest-client,org.wiztools.restclient.ui.dnd,0,0,0,0,0,0,1,1
wiztools_rest-client,org.wiztools.restclient.ui.history,1,0,0,0,0,0,1,2
wiztools_rest-client,org.wiztools.restclient.ui.lifecycle,0,0,0,0,0,0,1,1
wiztools_rest-client,org.wiztools.restclient.ui.option,1,0,0,0,0,0,1,2
wiztools_rest-client,org.wiztools.restclient.ui.reqauth,1,0,0,0,0,0,1,2
wiztools_rest-client,org.wiztools.restclient.ui.reqbody,2,0,0,0,0,0,1,3
wiztools_rest-client,org.wiztools.restclient.ui.reqetc,0,0,0,0,0,0,1,1
wiztools_rest-client,org.wiztools.restclient.ui.reqgo,2,1,0,0,0,0,1,4
wiztools_rest-client,org.wiztools.restclient.ui.reqmethod,1,0,0,0,0,0,1,2
wiztools_rest-client,org.wiztools.restclient.ui.reqssl,1,0,0,0,0,0,1,2
wiztools_rest-client,org.wiztools.restclient.ui.resbody,2,0,0,0,0,0,1,3
wiztools_rest-client,org.wiztools.restclient.ui.resheader,1,0,0,0,0,0,1,2
wiztools_rest-client,org.wiztools.restclient.ui.resstats,1,1,0,0,0,0,1,3
wiztools_rest-client,org.wiztools.restclient.ui.resstatus,1,1,0,0,0,0,1,3
wiztools_rest-client,org.wiztools.restclient.ui.update,0,0,0,0,0,0,1,1
Wolfgang-Schuetzelhofer_jcypher,iot.jcypher.concurrency,0,0,0,0,0,1,1,2
Wolfgang-Schuetzelhofer_jcypher,iot.jcypher.database,4,1,0,0,0,6,1,12
Wolfgang-Schuetzelhofer_jcypher,iot.jcypher.database.embedded,0,0,0,0,1,0,1,2
Wolfgang-Schuetzelhofer_jcypher,iot.jcypher.database.internal,1,0,0,0,0,1,1,3
Wolfgang-Schuetzelhofer_jcypher,iot.jcypher.database.remote,4,0,0,0,1,0,1,6
Wolfgang-Schuetzelhofer_jcypher,iot.jcypher.database.util,1,0,0,0,0,0,1,2
Wolfgang-Schuetzelhofer_jcypher,iot.jcypher.domain,2,1,0,0,1,1,1,6
Wolfgang-Schuetzelhofer_jcypher,iot.jcypher.domain.genericmodel,2,1,0,0,1,3,1,8
Wolfgang-Schuetzelhofer_jcypher,iot.jcypher.domain.genericmodel.internal,4,0,0,0,1,9,1,15
Wolfgang-Schuetzelhofer_jcypher,iot.jcypher.domain.internal,23,0,0,1,0,30,1,55
Wolfgang-Schuetzelhofer_jcypher,iot.jcypher.domain.mapping,4,0,0,0,0,14,1,19
Wolfgang-Schuetzelhofer_jcypher,iot.jcypher.domain.mapping.surrogate,2,1,0,0,1,4,1,9
Wolfgang-Schuetzelhofer_jcypher,iot.jcypher.domainquery,3,0,0,0,0,6,1,10
Wolfgang-Schuetzelhofer_jcypher,iot.jcypher.domainquery.api,3,1,0,0,0,15,1,20
Wolfgang-Schuetzelhofer_jcypher,iot.jcypher.domainquery.ast,5,0,0,0,0,12,1,18
Wolfgang-Schuetzelhofer_jcypher,iot.jcypher.domainquery.internal,29,1,0,1,0,28,1,60
Wolfgang-Schuetzelhofer_jcypher,iot.jcypher.facade,0,0,0,0,0,0,1,1
Wolfgang-Schuetzelhofer_jcypher,iot.jcypher.graph,2,1,0,0,0,11,1,15
Wolfgang-Schuetzelhofer_jcypher,iot.jcypher.graph.internal,2,1,0,0,0,1,1,5
Wolfgang-Schuetzelhofer_jcypher,iot.jcypher.query.api,0,0,0,0,0,14,1,15
Wolfgang-Schuetzelhofer_jcypher,iot.jcypher.query.api.cases,0,0,0,0,0,3,1,4
Wolfgang-Schuetzelhofer_jcypher,iot.jcypher.query.api.collection,6,1,0,0,0,9,1,17
Wolfgang-Schuetzelhofer_jcypher,iot.jcypher.query.api.index,0,0,0,0,0,1,1,2
Wolfgang-Schuetzelhofer_jcypher,iot.jcypher.query.api.modify,3,0,0,0,0,4,1,8
Wolfgang-Schuetzelhofer_jcypher,iot.jcypher.query.api.nativ,0,0,0,0,0,0,1,1
Wolfgang-Schuetzelhofer_jcypher,iot.jcypher.query.api.pattern,12,1,0,0,0,16,1,30
Wolfgang-Schuetzelhofer_jcypher,iot.jcypher.query.api.predicate,4,0,0,0,0,12,1,17
Wolfgang-Schuetzelhofer_jcypher,iot.jcypher.query.api.returns,2,0,0,0,0,11,1,14
Wolfgang-Schuetzelhofer_jcypher,iot.jcypher.query.api.start,0,0,0,0,0,1,1,2
Wolfgang-Schuetzelhofer_jcypher,iot.jcypher.query.api.union,0,0,0,0,0,1,1,2
Wolfgang-Schuetzelhofer_jcypher,iot.jcypher.query.api.using,0,0,0,0,0,1,1,2
Wolfgang-Schuetzelhofer_jcypher,iot.jcypher.query.ast,0,0,0,0,0,12,1,13
Wolfgang-Schuetzelhofer_jcypher,iot.jcypher.query.ast.cases,0,0,0,0,0,1,1,2
Wolfgang-Schuetzelhofer_jcypher,iot.jcypher.query.ast.collection,0,0,0,0,1,4,1,6
Wolfgang-Schuetzelhofer_jcypher,iot.jcypher.query.ast.index,0,0,0,0,0,0,1,1
Wolfgang-Schuetzelhofer_jcypher,iot.jcypher.query.ast.modify,0,0,0,0,0,2,1,3
Wolfgang-Schuetzelhofer_jcypher,iot.jcypher.query.ast.nativ,0,0,0,0,0,0,1,1
Wolfgang-Schuetzelhofer_jcypher,iot.jcypher.query.ast.pattern,0,0,0,0,1,1,1,3
Wolfgang-Schuetzelhofer_jcypher,iot.jcypher.query.ast.predicate,0,0,0,0,1,5,1,7
Wolfgang-Schuetzelhofer_jcypher,iot.jcypher.query.ast.returns,0,0,0,0,1,5,1,7
Wolfgang-Schuetzelhofer_jcypher,iot.jcypher.query.ast.separate,0,0,0,0,0,0,1,1
Wolfgang-Schuetzelhofer_jcypher,iot.jcypher.query.ast.start,0,0,0,0,0,1,1,2
Wolfgang-Schuetzelhofer_jcypher,iot.jcypher.query.ast.union,0,0,0,0,0,0,1,1
Wolfgang-Schuetzelhofer_jcypher,iot.jcypher.query.ast.using,0,0,0,0,0,1,1,2
Wolfgang-Schuetzelhofer_jcypher,iot.jcypher.query.factories.clause,9,1,0,0,1,36,1,48
Wolfgang-Schuetzelhofer_jcypher,iot.jcypher.query.factories,0,0,0,0,0,0,1,1
Wolfgang-Schuetzelhofer_jcypher,iot.jcypher.query.factories.xpression,9,1,0,0,0,7,1,18
Wolfgang-Schuetzelhofer_jcypher,iot.jcypher.query,3,1,0,0,1,15,1,21
Wolfgang-Schuetzelhofer_jcypher,iot.jcypher.query.result,0,0,0,0,0,0,1,1
Wolfgang-Schuetzelhofer_jcypher,iot.jcypher.query.result.util,7,0,0,0,1,0,1,9
Wolfgang-Schuetzelhofer_jcypher,iot.jcypher.query.values,21,1,0,0,0,29,1,52
Wolfgang-Schuetzelhofer_jcypher,iot.jcypher.query.values.functions,0,0,0,0,0,0,1,1
Wolfgang-Schuetzelhofer_jcypher,iot.jcypher.query.values.operators,0,0,0,0,0,0,1,1
Wolfgang-Schuetzelhofer_jcypher,iot.jcypher.query.writer,11,1,0,0,0,9,1,22
Wolfgang-Schuetzelhofer_jcypher,iot.jcypher.transaction.internal,0,0,0,0,0,1,1,2
Wolfgang-Schuetzelhofer_jcypher,iot.jcypher.transaction,0,0,0,0,0,1,1,2
Wolfgang-Schuetzelhofer_jcypher,iot.jcypher.util,5,1,0,0,0,0,1,7
Wolfgang-Schuetzelhofer_jcypher,util,0,0,0,0,0,0,1,1
wso2_balana,org.wso2.balana,39,1,0,1,1,12,1,55
wso2_balana,org.wso2.balana.attr,17,1,0,1,0,10,1,30
wso2_balana,org.wso2.balana.attr.proxy,1,0,0,0,0,0,1,2
wso2_balana,org.wso2.balana.attr.proxy.xacml3,2,1,0,0,0,0,1,4
wso2_balana,org.wso2.balana.attr.xacml3,4,0,0,0,0,2,1,7
wso2_balana,org.wso2.balana.combine,6,0,0,0,1,3,1,11
wso2_balana,org.wso2.balana.combine.xacml2,3,0,0,0,1,1,1,6
wso2_balana,org.wso2.balana.combine.xacml3,3,0,0,0,1,1,1,6
wso2_balana,org.wso2.balana.cond,9,1,0,1,0,7,1,19
wso2_balana,org.wso2.balana.cond.cluster,1,0,0,0,0,0,1,2
wso2_balana,org.wso2.balana.cond.cluster.xacml3,2,0,0,0,0,0,1,3
wso2_balana,org.wso2.balana.cond.xacml3,2,0,0,0,0,1,1,4
wso2_balana,org.wso2.balana.ctx,8,1,0,0,1,12,1,23
wso2_balana,org.wso2.balana.ctx.xacml2,7,1,0,0,0,2,1,11
wso2_balana,org.wso2.balana.ctx.xacml3,2,0,0,0,0,3,1,6
wso2_balana,org.wso2.balana.finder,7,1,0,0,1,4,1,14
wso2_balana,org.wso2.balana.finder.impl,5,1,0,0,0,1,1,8
wso2_balana,org.wso2.balana.xacml2,2,0,0,0,0,0,1,3
wso2_balana,org.wso2.balana.xacml3,6,0,0,0,1,3,1,11
wso2_balana,org.wso2.balana.advance,2,0,0,0,0,0,1,3
wso2_balana,org.wso2.balana.basic,2,0,0,0,0,1,1,4
wso2_balana,org.wso2.balana.conformance,4,0,0,0,0,1,1,6
wso2_balana,org.wso2.balana.utils.Constants,0,0,0,0,1,0,1,2
wso2_balana,org.wso2.balana.utils.exception,0,0,0,0,0,0,1,1
wso2_balana,org.wso2.balana.utils.policy,0,0,0,0,0,0,1,1
wso2_balana,org.wso2.balana.utils.policy.dto,0,0,0,0,1,0,1,2
wso2_balana,org.wso2.balana.utils,0,0,0,0,0,0,1,1
wso2_product-esb,org.wso2.esb.integration.common.clients.aar.services,0,0,0,0,0,0,0,0
wso2_product-esb,org.wso2.esb.integration.common.clients.application.mgt,0,0,0,0,0,0,0,0
wso2_product-esb,org.wso2.esb.integration.common.clients.client.utils,0,0,0,0,0,0,0,0
wso2_product-esb,org.wso2.esb.integration.common.clients.connector,0,0,0,0,0,0,0,0
wso2_product-esb,org.wso2.esb.integration.common.clients.endpoint,0,0,0,0,0,0,0,0
wso2_product-esb,org.wso2.esb.integration.common.clients.executor,0,0,0,0,0,0,0,0
wso2_product-esb,org.wso2.esb.integration.common.clients.inbound.endpoint,0,0,0,0,0,0,0,0
wso2_product-esb,org.wso2.esb.integration.common.clients.localentry,0,0,0,0,0,0,0,0
wso2_product-esb,org.wso2.esb.integration.common.clients.logging,0,0,0,0,0,0,0,0
wso2_product-esb,org.wso2.esb.integration.common.clients.mediation,0,0,0,0,1,0,0,1
wso2_product-esb,org.wso2.esb.integration.common.clients.proxy.admin,0,0,0,0,0,0,0,0
wso2_product-esb,org.wso2.esb.integration.common.clients.registry,0,0,0,0,1,0,0,1
wso2_product-esb,org.wso2.esb.integration.common.clients.rest.api,0,0,0,0,0,0,0,0
wso2_product-esb,org.wso2.esb.integration.common.clients.sequences,0,0,0,0,0,0,0,0
wso2_product-esb,org.wso2.esb.integration.common.clients.service.mgt,0,0,0,0,0,0,0,0
wso2_product-esb,org.wso2.esb.integration.common.clients.tasks,0,0,0,0,0,0,0,0
wso2_product-esb,org.wso2.esb.integration.common.clients.template,0,0,0,0,0,0,0,0
wso2_product-esb,org.wso2.esb.integration.common.extensions.axis2server,0,0,0,0,0,0,0,0
wso2_product-esb,org.wso2.esb.integration.common.utils,0,0,0,0,1,1,0,2
wso2_product-esb,org.wso2.esb.integration.common.utils.clients.axis2client,0,0,0,0,0,0,0,0
wso2_product-esb,org.wso2.esb.integration.common.utils.clients,0,0,0,0,1,0,0,1
wso2_product-esb,org.wso2.esb.integration.common.utils.clients.rabbitmqclient,0,0,0,0,0,0,0,0
wso2_product-esb,org.wso2.esb.integration.common.utils.clients.stockquoteclient,0,0,0,0,0,0,0,0
wso2_product-esb,org.wso2.esb.integration.common.utils.common,0,0,0,0,1,0,0,1
wso2_product-esb,org.wso2.esb.integration.common.utils.exception,0,0,0,0,0,0,0,0
wso2_product-esb,org.wso2.esb.integration.common.utils.servers,0,0,0,0,1,1,0,2
wso2_product-esb,org.wso2.esb.integration.common.utils.servers.axis2,0,0,0,0,0,0,0,0
wso2_product-esb,org.wso2.esb.integration.common.ui.page,0,0,0,0,0,0,0,0
wso2_product-esb,org.wso2.esb.integration.common.ui.page.main,0,0,0,0,0,0,0,0
wso2_product-esb,org.wso2.esb.integration.common.ui.page.util,0,0,0,0,0,0,0,0
wso2_product-esb,fastXslt,0,0,0,0,1,0,0,1
wso2_product-esb,org.wso2.carbon.esb.contenttype.json,0,0,0,0,1,0,0,1
wso2_product-esb,org.wso2.carbon.esb.eager.loading,0,0,0,0,0,0,0,0
wso2_product-esb,org.wso2.carbon.esb,0,0,0,0,0,0,0,0
wso2_product-esb,org.wso2.carbon.esb.statistics,0,0,0,0,0,0,0,0
wso2_product-esb,org.wso2.carbon.esb.synapse.common.formatters,0,0,0,0,0,0,0,0
wso2_product-esb,org.wso2.carbon.esb.template,0,0,0,0,0,0,0,0
wso2_product-esb,org.wso2.carbon.esb.api.apidefinition,0,0,0,0,0,0,0,0
wso2_product-esb,org.wso2.carbon.esb.datamapper.common,0,0,0,0,0,0,0,0
wso2_product-esb,org.wso2.carbon.esb.datamapper,0,0,0,0,0,0,0,0
wso2_product-esb,org.wso2.carbon.esb.header.preserve,0,0,0,0,0,1,0,1
wso2_product-esb,org.wso2.carbon.esb.json,0,0,0,0,1,0,0,1
wso2_product-esb,org.wso2.carbon.esb.mediators.cache,0,0,0,0,0,0,0,0
wso2_product-esb,org.wso2.carbon.esb.mediators.call,0,0,0,0,0,0,0,0
wso2_product-esb,org.wso2.carbon.esb.mediators.callout,0,0,0,0,0,0,0,0
wso2_product-esb,org.wso2.carbon.esb.mediators.clone,0,0,0,0,0,0,0,0
wso2_product-esb,org.wso2.carbon.esb.mediators.enrich,0,0,0,0,0,0,0,0
wso2_product-esb,org.wso2.carbon.esb.mediators.payloadFactory,0,0,0,0,0,0,0,0
wso2_product-esb,org.wso2.carbon.esb.mediators.rule,0,0,0,0,0,0,0,0
wso2_product-esb,org.wso2.carbon.esb.mediators.script,0,0,0,0,0,0,0,0
wso2_product-esb,org.wso2.carbon.esb.mediators.store,0,0,0,0,0,0,0,0
wso2_product-esb,org.wso2.carbon.esb.ntask,0,0,0,0,0,0,0,0
wso2_product-esb,org.wso2.carbon.esb.registry.caching,0,0,0,0,0,0,0,0
wso2_product-esb,org.wso2.carbon.esb.registry.task,0,0,0,0,0,0,0,0
wso2_product-esb,org.wso2.carbon.esb.security.policy,0,0,0,0,0,0,0,0
wso2_product-esb,org.wso2.carbon.esb.util,0,0,0,0,0,0,0,0
wso2_product-esb,org.wso2.carbon.esb.rabbitmq.message.store.jira,0,0,0,0,0,0,0,0
wso2_product-esb,org.wso2.carbon.esb.rabbitmq.multiple.listner,0,0,0,0,0,0,0,0
wso2_product-esb,org.wso2.carbon.esb.rabbitmq.qos.jira,0,0,0,0,0,0,0,0
wso2_product-esb,org.wso2.carbon.esb.rabbitmq.securevault,0,0,0,0,0,0,0,0
wso2_product-esb,org.wso2.carbon.esb.rabbitmq.utils,0,1,0,0,0,0,0,1
wso2_product-esb,org.wso2.carbon.esb.extension,0,0,0,0,0,0,0,0
wso2_product-esb,org.wso2.carbon.esb.jms.utils,0,0,0,0,0,0,0,0
wso2_product-esb,org.wso2.stratos.esb.login.ui.clients,0,0,0,0,0,0,0,0
wso2_product-esb,org.wso2.stratos.esb.login.ui.utils,0,0,0,0,0,0,0,0
wso2_product-esb,org.wso2.rest,0,0,0,0,0,0,0,0
wso2_product-esb,com.starbucks.apps,0,0,0,0,0,0,0,0
wso2_product-esb,com.starbucks.ws,0,0,0,0,0,0,0,0
wso2_siddhi,io.siddhi.annotation.processor,0,0,0,0,0,0,1,1
wso2_siddhi,io.siddhi.annotation.util,0,0,0,0,0,0,1,1
wso2_siddhi,io.siddhi.core.aggregation,4,0,0,0,1,3,1,9
wso2_siddhi,io.siddhi.core.config,10,1,0,0,1,16,1,29
wso2_siddhi,io.siddhi.core.debugger,4,1,0,0,0,3,1,9
wso2_siddhi,io.siddhi.core.event,11,1,0,0,0,21,1,34
wso2_siddhi,io.siddhi.core.event.state,0,0,0,0,0,16,1,17
wso2_siddhi,io.siddhi.core.event.state.populater,0,0,0,0,0,1,1,2
wso2_siddhi,io.siddhi.core.event.stream.converter,2,0,0,0,1,5,1,9
wso2_siddhi,io.siddhi.core.event.stream.holder,0,0,0,0,0,2,1,3
wso2_siddhi,io.siddhi.core.event.stream,21,1,0,0,0,29,1,52
wso2_siddhi,io.siddhi.core.event.stream.populater,0,0,0,0,0,0,1,1
wso2_siddhi,io.siddhi.core.exception,0,1,0,0,1,0,1,3
wso2_siddhi,io.siddhi.core.executor.condition,0,0,0,0,0,0,1,1
wso2_siddhi,io.siddhi.core.executor.condition.compare,0,0,0,0,0,0,1,1
wso2_siddhi,io.siddhi.core.executor.condition.compare.equal,0,0,0,0,0,0,1,1
wso2_siddhi,io.siddhi.core.executor.condition.compare.greaterthan,0,0,0,0,0,0,1,1
wso2_siddhi,io.siddhi.core.executor.condition.compare.greaterthanequal,0,0,0,0,0,0,1,1
wso2_siddhi,io.siddhi.core.executor.condition.compare.lessthan,0,0,0,0,0,0,1,1
wso2_siddhi,io.siddhi.core.executor.condition.compare.lessthanequal,0,0,0,0,0,0,1,1
wso2_siddhi,io.siddhi.core.executor.condition.compare.notequal,0,0,0,0,0,0,1,1
wso2_siddhi,io.siddhi.core.executor,0,0,0,0,0,9,1,10
wso2_siddhi,io.siddhi.core.executor.function,2,0,0,0,1,0,1,4
wso2_siddhi,io.siddhi.core.executor.incremental,1,0,0,0,1,0,1,3
wso2_siddhi,io.siddhi.core.executor.math.add,0,0,0,0,0,0,1,1
wso2_siddhi,io.siddhi.core.executor.math.divide,0,0,0,0,0,0,1,1
wso2_siddhi,io.siddhi.core.executor.math.mod,0,0,0,0,0,0,1,1
wso2_siddhi,io.siddhi.core.executor.math.multiply,0,0,0,0,0,0,1,1
wso2_siddhi,io.siddhi.core.executor.math.subtract,0,0,0,0,0,0,1,1
wso2_siddhi,io.siddhi.core.function,0,0,0,0,0,0,1,1
wso2_siddhi,io.siddhi.core.partition.executor,0,0,0,0,0,1,1,2
wso2_siddhi,io.siddhi.core.partition,4,0,0,0,1,3,1,9
wso2_siddhi,io.siddhi.core.query,4,0,0,0,1,5,1,11
wso2_siddhi,io.siddhi.core.query.input,5,0,0,0,0,2,1,8
wso2_siddhi,io.siddhi.core.query.input.stream.join,0,0,0,0,0,0,1,1
wso2_siddhi,io.siddhi.core.query.input.stream.single,1,0,0,0,0,0,1,2
wso2_siddhi,io.siddhi.core.query.input.stream.state,3,0,0,0,0,5,1,9
wso2_siddhi,io.siddhi.core.query.input.stream.state.receiver,0,0,0,0,0,0,1,1
wso2_siddhi,io.siddhi.core.query.input.stream.state.runtime,0,0,0,0,0,0,1,1
wso2_siddhi,io.siddhi.core.query.input.stream,0,0,0,0,0,0,1,1
wso2_siddhi,io.siddhi.core.query.output.callback,4,0,0,0,1,1,1,7
wso2_siddhi,io.siddhi.core.query.output.ratelimit.event,1,0,0,0,1,1,1,4
wso2_siddhi,io.siddhi.core.query.output.ratelimit,1,0,0,0,0,2,1,4
wso2_siddhi,io.siddhi.core.query.output.ratelimit.snapshot,2,0,0,0,1,0,1,4
wso2_siddhi,io.siddhi.core.query.output.ratelimit.time,2,1,0,0,1,0,1,5
wso2_siddhi,io.siddhi.core.query.processor.filter,1,0,0,0,0,0,1,2
wso2_siddhi,io.siddhi.core.query.processor,0,0,0,0,0,0,1,1
wso2_siddhi,io.siddhi.core.query.processor.stream,0,0,0,0,0,0,1,1
wso2_siddhi,io.siddhi.core.query.processor.stream.function,0,0,0,0,0,0,1,1
wso2_siddhi,io.siddhi.core.query.processor.stream.window,18,1,0,1,1,1,1,23
wso2_siddhi,io.siddhi.core.query.selector.attribute.aggregator,0,0,0,1,1,1,1,4
wso2_siddhi,io.siddhi.core.query.selector.attribute.aggregator.incremental,0,0,0,0,0,1,1,2
wso2_siddhi,io.siddhi.core.query.selector.attribute.processor,0,0,0,0,0,0,1,1
wso2_siddhi,io.siddhi.core.query.selector,2,1,0,0,0,2,1,6
wso2_siddhi,io.siddhi.core,7,1,0,0,1,5,1,15
wso2_siddhi,io.siddhi.core.stream.input,0,0,0,0,0,4,1,5
wso2_siddhi,io.siddhi.core.stream.input.source,4,0,0,0,1,0,1,6
wso2_siddhi,io.siddhi.core.stream.output.sink.distributed,1,1,0,0,1,0,1,4
wso2_siddhi,io.siddhi.core.stream.output.sink,3,0,0,0,1,1,1,6
wso2_siddhi,io.siddhi.core.stream.output,2,1,0,0,0,0,1,4
wso2_siddhi,io.siddhi.core.stream,9,1,0,0,1,3,1,15
wso2_siddhi,io.siddhi.core.table,4,1,0,0,1,13,1,20
wso2_siddhi,io.siddhi.core.table.holder,0,0,0,0,1,5,1,7
wso2_siddhi,io.siddhi.core.table.record,6,1,0,0,1,4,1,13
wso2_siddhi,io.siddhi.core.trigger,3,0,0,0,0,2,1,6
wso2_siddhi,io.siddhi.core.util,72,1,0,0,1,6,1,81
wso2_siddhi,io.siddhi.core.util.cache,0,0,0,0,0,1,1,2
wso2_siddhi,io.siddhi.core.util.collection,0,0,0,0,0,1,1,2
wso2_siddhi,io.siddhi.core.util.collection.executor,3,0,0,0,0,3,1,7
wso2_siddhi,io.siddhi.core.util.collection.expression,0,0,0,0,0,0,1,1
wso2_siddhi,io.siddhi.core.util.collection.operator,3,0,0,0,1,12,1,17
wso2_siddhi,io.siddhi.core.util.config,0,0,0,0,0,0,1,1
wso2_siddhi,io.siddhi.core.util.config.model,0,0,0,0,0,0,1,1
wso2_siddhi,io.siddhi.core.util.event.handler,0,0,0,0,0,0,1,1
wso2_siddhi,io.siddhi.core.util.extension.holder,2,0,0,0,0,0,1,3
wso2_siddhi,io.siddhi.core.util.extension.validator,2,0,0,0,0,0,1,3
wso2_siddhi,io.siddhi.core.util.lock,0,0,0,0,0,0,1,1
wso2_siddhi,io.siddhi.core.util.parser,52,1,0,0,0,7,1,61
wso2_siddhi,io.siddhi.core.util.parser.helper,30,1,0,0,0,2,1,34
wso2_siddhi,io.siddhi.core.util.persistence,0,0,0,0,0,1,1,2
wso2_siddhi,io.siddhi.core.util.persistence.util,4,1,0,0,0,1,1,7
wso2_siddhi,io.siddhi.core.util.snapshot,6,0,0,0,1,5,1,13
wso2_siddhi,io.siddhi.core.util.snapshot.state,2,1,0,0,1,13,1,18
wso2_siddhi,io.siddhi.core.util.statistics,0,0,0,0,1,3,1,5
wso2_siddhi,io.siddhi.core.util.statistics.memory,9,0,0,0,0,0,1,10
wso2_siddhi,io.siddhi.core.util.statistics.metrics,9,1,0,0,1,2,1,14
wso2_siddhi,io.siddhi.core.util.timestamp,0,0,0,0,0,4,1,5
wso2_siddhi,io.siddhi.core.util.transport,8,1,0,0,1,1,1,12
wso2_siddhi,io.siddhi.core.window,2,0,0,0,1,1,1,5
wso2_siddhi,io.siddhi.core.managment,0,0,0,0,1,1,1,3
wso2_siddhi,io.siddhi.core.query.aggregator,0,0,0,0,0,0,1,1
wso2_siddhi,io.siddhi.core.query.extension,0,0,0,0,0,0,1,1
wso2_siddhi,io.siddhi.core.query.extension.util,0,0,0,0,0,0,1,1
wso2_siddhi,io.siddhi.core.query.function,0,0,0,0,1,0,1,2
wso2_siddhi,io.siddhi.core.query.join,0,0,0,0,0,0,1,1
wso2_siddhi,io.siddhi.core.query.partition,0,0,0,0,1,0,1,2
wso2_siddhi,io.siddhi.core.query.pattern.absent,0,0,0,0,0,0,1,1
wso2_siddhi,io.siddhi.core.query.pattern,0,0,0,0,0,0,1,1
wso2_siddhi,io.siddhi.core.query.ratelimit,0,0,0,0,0,0,1,1
wso2_siddhi,io.siddhi.core.query.sequence.absent,0,0,0,0,0,0,1,1
wso2_siddhi,io.siddhi.core.query.sequence,0,0,0,0,0,0,1,1
wso2_siddhi,io.siddhi.core.query.streamfunction,0,0,0,0,0,0,1,1
wso2_siddhi,io.siddhi.core.query.table.cache,0,0,0,0,1,0,1,2
wso2_siddhi,io.siddhi.core.query.table,0,0,0,0,1,0,1,2
wso2_siddhi,io.siddhi.core.query.table.set,0,0,0,0,0,0,1,1
wso2_siddhi,io.siddhi.core.query.table.store,0,0,0,0,1,0,1,2
wso2_siddhi,io.siddhi.core.query.table.util,0,0,0,0,1,8,1,10
wso2_siddhi,io.siddhi.core.query.trigger,0,0,0,0,0,0,1,1
wso2_siddhi,io.siddhi.core.query.window,0,0,0,0,1,0,1,2
wso2_siddhi,io.siddhi.core.store,0,0,0,0,0,0,1,1
wso2_siddhi,io.siddhi.core.stream.event,0,0,0,0,0,3,1,4
wso2_siddhi,io.siddhi.core.transport,4,0,0,0,1,1,1,7
wso2_siddhi,io.siddhi.doc.gen.core.freemarker,0,0,0,0,0,0,1,1
wso2_siddhi,io.siddhi.doc.gen.core,0,0,0,0,0,0,1,1
wso2_siddhi,io.siddhi.doc.gen.core.utils,0,0,0,0,0,0,1,1
wso2_siddhi,io.siddhi.doc.gen.metadata,0,0,0,0,1,0,1,2
wso2_siddhi,io.siddhi.query.api.aggregation,0,0,0,0,0,3,1,4
wso2_siddhi,io.siddhi.query.api.annotation,0,0,0,0,0,4,1,5
wso2_siddhi,io.siddhi.query.api.definition,0,1,0,0,1,16,1,19
wso2_siddhi,io.siddhi.query.api.exception,1,1,0,0,0,0,1,3
wso2_siddhi,io.siddhi.query.api.execution,0,0,0,0,0,0,1,1
wso2_siddhi,io.siddhi.query.api.execution.partition,0,0,0,0,0,1,1,2
wso2_siddhi,io.siddhi.query.api.execution.query.input.handler,0,0,0,0,0,0,1,1
wso2_siddhi,io.siddhi.query.api.execution.query.input.state,0,0,0,0,0,2,1,3
wso2_siddhi,io.siddhi.query.api.execution.query.input.store,0,0,0,0,0,4,1,5
wso2_siddhi,io.siddhi.query.api.execution.query.input.stream,0,0,0,0,0,12,1,13
wso2_siddhi,io.siddhi.query.api.execution.query,0,0,0,0,0,14,1,15
wso2_siddhi,io.siddhi.query.api.execution.query.output.ratelimit,0,0,0,0,0,1,1,2
wso2_siddhi,io.siddhi.query.api.execution.query.output.stream,0,1,0,0,0,4,1,6
wso2_siddhi,io.siddhi.query.api.execution.query.selection,0,0,0,0,0,14,1,15
wso2_siddhi,io.siddhi.query.api.expression,0,0,0,0,0,17,1,18
wso2_siddhi,io.siddhi.query.api.expression.condition,0,1,0,0,1,0,1,3
wso2_siddhi,io.siddhi.query.api.expression.constant,0,0,0,0,0,1,1,2
wso2_siddhi,io.siddhi.query.api.expression.math,0,0,0,0,0,0,1,1
wso2_siddhi,io.siddhi.query.api.extension,0,0,0,0,0,0,1,1
wso2_siddhi,io.siddhi.query.api,0,0,0,0,1,16,1,18
wso2_siddhi,io.siddhi.query.api.util,1,0,0,0,0,0,1,2
wso2_siddhi,io.siddhi.query.compiler.exception,0,0,0,0,0,0,1,1
wso2_siddhi,io.siddhi.query.compiler.internal,1,0,0,0,0,0,1,2
wso2_siddhi,io.siddhi.query.compiler,1,1,0,1,0,1,1,5
wso2_siddhi,io.siddhi.performance,0,0,0,0,1,3,1,5
wso2_siddhi,io.siddhi.service.api,0,0,0,0,1,0,1,2
wso2_siddhi,io.siddhi.service.model,0,0,0,0,0,0,1,1
wso2_siddhi,io.siddhi.service.factories,0,0,0,0,0,0,1,1
wso2_siddhi,io.siddhi.service.impl,0,0,0,0,0,0,1,1
wso2_siddhi,io.siddhi.service.util,0,0,0,0,0,0,1,1
wso2_siddhi,io.siddhi.service,0,0,0,0,0,0,1,1
xerial_sqlite-jdbc,(default package),0,0,0,0,0,0,0,0
xerial_sqlite-jdbc,org.sqlite,1,0,0,1,1,2,0,5
xerial_sqlite-jdbc,org.sqlite.core,1,1,0,0,1,2,0,5
xerial_sqlite-jdbc,org.sqlite.date,0,0,0,1,0,1,0,2
xerial_sqlite-jdbc,org.sqlite.javax,0,0,0,0,0,0,0,0
xerial_sqlite-jdbc,org.sqlite.jdbc3,0,0,0,0,1,2,0,3
xerial_sqlite-jdbc,org.sqlite.jdbc4,0,0,0,0,1,0,0,1
xerial_sqlite-jdbc,org.sqlite.util,0,0,0,0,0,0,0,0
xhanin_jarup,io.github.xhanin.jarup,1,1,0,0,1,0,0,3
xhanin_jarup,io.github.xhanin.jarup.commands,1,0,0,0,1,0,0,2
XiaoMi_chronos,com.xiaomi.infra.chronos.benchmark,0,0,0,0,0,0,0,0
XiaoMi_chronos,com.xiaomi.infra.chronos.client,0,0,0,0,0,0,0,0
XiaoMi_chronos,com.xiaomi.infra.chronos,0,0,0,0,1,0,0,1
XiaoMi_chronos,com.xiaomi.infra.chronos.exception,0,0,0,0,0,0,0,0
XiaoMi_chronos,com.xiaomi.infra.chronos.generated,0,0,0,1,0,0,0,1
XiaoMi_chronos,com.xiaomi.infra.chronos.zookeeper,0,0,0,0,1,0,0,1
XiaoMi_themis,org.apache.hadoop.hbase.themis.cache,0,0,0,0,0,0,0,0
XiaoMi_themis,org.apache.hadoop.hbase.themis,4,1,0,1,1,0,0,7
XiaoMi_themis,org.apache.hadoop.hbase.themis.example,0,0,0,0,0,0,0,0
XiaoMi_themis,org.apache.hadoop.hbase.themis.exception,1,1,0,0,1,0,0,3
XiaoMi_themis,org.apache.hadoop.hbase.themis.index,1,0,0,0,0,0,0,1
XiaoMi_themis,org.apache.hadoop.hbase.themis.lockcleaner,1,0,0,0,1,0,0,2
XiaoMi_themis,org.apache.hadoop.hbase.themis.mapreduce,0,0,0,0,1,0,0,1
XiaoMi_themis,org.apache.hadoop.hbase.themis.timestamp,1,0,0,0,1,0,0,2
XiaoMi_themis,org.apache.hadoop.hbase.master,2,0,0,0,0,0,0,2
XiaoMi_themis,org.apache.hadoop.hbase.regionserver,2,0,0,0,0,0,0,2
XiaoMi_themis,org.apache.hadoop.hbase.themis.columns,0,0,0,0,1,0,0,1
XiaoMi_themis,org.apache.hadoop.hbase.themis.cp,3,1,0,0,1,0,0,5
XiaoMi_themis,org.apache.hadoop.hbase.themis.lock,0,0,0,0,1,0,0,1
XiaoMi_themis,org.apache.hadoop.hbase.themis.index.cp,0,0,0,0,1,0,0,1
xmlunit_xmlunit,org.xmlunit.assertj,0,0,0,1,1,0,1,3
xmlunit_xmlunit,org.xmlunit.assertj.error,0,0,0,0,1,0,1,2
xmlunit_xmlunit,org.xmlunit.builder,10,1,0,0,0,4,1,16
xmlunit_xmlunit,org.xmlunit,0,0,0,0,0,0,1,1
xmlunit_xmlunit,org.xmlunit.diff,3,1,0,1,0,4,1,10
xmlunit_xmlunit,org.xmlunit.input,2,1,0,0,1,0,1,5
xmlunit_xmlunit,org.xmlunit.transform,4,0,0,0,0,0,1,5
xmlunit_xmlunit,org.xmlunit.util,6,1,0,0,0,4,1,12
xmlunit_xmlunit,org.xmlunit.validation,0,0,0,0,0,0,1,1
xmlunit_xmlunit,org.xmlunit.xpath,3,0,0,0,0,1,1,5
xmlunit_xmlunit,org.xmlunit.builder.jaxb,0,0,0,0,0,0,1,1
xmlunit_xmlunit,org.custommonkey.xmlunit,2,1,0,1,0,0,1,5
xmlunit_xmlunit,org.custommonkey.xmlunit.examples,1,0,0,0,1,0,1,3
xmlunit_xmlunit,org.custommonkey.xmlunit.exceptions,0,0,0,0,0,0,1,1
xmlunit_xmlunit,org.custommonkey.xmlunit.jaxp13,1,0,0,0,1,0,1,3
xmlunit_xmlunit,org.custommonkey.xmlunit.util,0,0,0,0,0,0,1,1
xmlunit_xmlunit,org.xmlunit.matchers,0,0,0,0,1,1,1,3
xmlunit_xmlunit,org.xmlunit.bugreports,0,0,0,0,0,0,1,1
xmlunit_xmlunit,org.xmlunit.placeholder,0,0,0,0,1,2,1,4
xored_yang-ide,com.cisco.yangide.core.buffer,1,0,0,0,1,0,0,2
xored_yang-ide,com.cisco.yangide.core,4,1,0,0,1,0,0,6
xored_yang-ide,com.cisco.yangide.core.dom,0,0,0,1,0,0,0,1
xored_yang-ide,com.cisco.yangide.core.indexing,1,0,0,0,1,1,0,3
xored_yang-ide,com.cisco.yangide.core.model,4,1,0,0,1,0,0,6
xored_yang-ide,com.cisco.yangide.core.parser,1,0,0,0,1,0,0,2
xored_yang-ide,com.cisco.yangide.editor.actions,2,0,0,0,1,0,0,3
xored_yang-ide,com.cisco.yangide.editor.compare,0,0,0,0,0,0,0,0
xored_yang-ide,com.cisco.yangide.editor.dialogs,0,0,0,0,0,0,0,0
xored_yang-ide,com.cisco.yangide.editor.editors,5,1,0,1,1,0,0,8
xored_yang-ide,com.cisco.yangide.editor.editors.text,2,0,0,0,1,0,0,3
xored_yang-ide,com.cisco.yangide.editor.editors.text.help,0,0,0,0,1,0,0,1
xored_yang-ide,com.cisco.yangide.editor.editors.text.hover,0,0,0,0,0,0,0,0
xored_yang-ide,com.cisco.yangide.editor,0,0,0,0,0,0,0,0
xored_yang-ide,com.cisco.yangide.editor.preferences,3,1,0,0,1,0,0,5
xored_yang-ide,com.cisco.yangide.editor.templates,0,0,0,0,0,0,0,0
xored_yang-ide,com.cisco.yangide.ext.model,0,0,0,1,1,1,0,3
xored_yang-ide,com.cisco.yangide.ext.model.impl,0,0,0,0,1,0,0,1
xored_yang-ide,com.cisco.yangide.ext.model.util,0,0,0,0,0,0,0,0
xored_yang-ide,com.cisco.yangide.ext.model.validation,0,0,0,1,1,0,0,2
xored_yang-ide,com.cisco.yangide.ext.model.editor,0,0,0,0,0,0,0,0
xored_yang-ide,com.cisco.yangide.ext.model.editor.diagram,0,0,0,0,0,0,0,0
xored_yang-ide,com.cisco.yangide.ext.model.editor.dialog,0,0,0,0,1,1,0,2
xored_yang-ide,com.cisco.yangide.ext.model.editor.editors,0,0,0,0,1,0,0,1
xored_yang-ide,com.cisco.yangide.ext.model.editor.features,0,0,0,0,1,0,0,1
xored_yang-ide,com.cisco.yangide.ext.model.editor.figures,0,0,0,0,0,0,0,0
xored_yang-ide,com.cisco.yangide.ext.model.editor.patterns.connections,0,0,0,0,0,0,0,0
xored_yang-ide,com.cisco.yangide.ext.model.editor.patterns.objects,0,0,0,0,1,0,0,1
xored_yang-ide,com.cisco.yangide.ext.model.editor.preferences,0,0,0,0,0,0,0,0
xored_yang-ide,com.cisco.yangide.ext.model.editor.property,0,0,0,0,1,0,0,1
xored_yang-ide,com.cisco.yangide.ext.model.editor.sync,0,0,0,0,1,0,0,1
xored_yang-ide,com.cisco.yangide.ext.model.editor.util,0,1,0,0,1,0,0,2
xored_yang-ide,com.cisco.yangide.ext.model.editor.util.connection,0,0,0,0,1,0,0,1
xored_yang-ide,com.cisco.yangide.ext.model.editor.widget,0,0,0,0,0,0,0,0
xored_yang-ide,com.cisco.yangide.ext.refactoring.actions,1,1,0,0,1,0,0,3
xored_yang-ide,com.cisco.yangide.ext.refactoring.code,0,0,0,0,0,0,0,0
xored_yang-ide,com.cisco.yangide.ext.refactoring,0,1,0,0,1,0,0,2
xored_yang-ide,com.cisco.yangide.ext.refactoring.nls,0,0,0,0,0,0,0,0
xored_yang-ide,com.cisco.yangide.ext.refactoring.rename,0,0,0,0,1,0,0,1
xored_yang-ide,com.cisco.yangide.ext.refactoring.scripting,0,0,0,0,0,0,0,0
xored_yang-ide,com.cisco.yangide.ext.refactoring.ui,1,0,0,0,1,0,0,2
xored_yang-ide,com.cisco.yangide.m2e.yang,0,0,0,0,1,0,0,1
xored_yang-ide,com.cisco.yangide.ui.internal,0,0,0,0,0,0,0,0
xored_yang-ide,com.cisco.yangide.ui.internal.preferences,0,0,0,0,0,0,0,0
xored_yang-ide,com.cisco.yangide.ui.nls,0,0,0,0,0,0,0,0
xored_yang-ide,com.cisco.yangide.ui.preferences,0,0,0,0,1,0,0,1
xored_yang-ide,com.cisco.yangide.ui.wizards,0,0,0,0,1,0,0,1
xored_yang-ide,com.cisco.yangide.ui,0,0,0,0,0,0,0,0
xpqiu_fnlp,org.fnlp.app.keyword,0,0,0,0,0,0,1,1
xpqiu_fnlp,org.fnlp.app.lucene.demo,0,0,0,0,0,0,1,1
xpqiu_fnlp,org.fnlp.app.lucene,0,0,0,0,1,0,1,2
xpqiu_fnlp,org.fnlp.app.num,0,0,0,0,1,0,1,2
xpqiu_fnlp,org.fnlp.app.tc,0,0,0,0,0,0,1,1
xpqiu_fnlp,org.fnlp.data.reader,0,0,0,0,0,0,1,1
xpqiu_fnlp,org.fnlp.ml.classifier,0,0,0,0,0,5,1,6
xpqiu_fnlp,org.fnlp.ml.classifier.bayes,0,0,0,0,0,0,1,1
xpqiu_fnlp,org.fnlp.ml.classifier.hier.inf,0,0,0,0,0,0,1,1
xpqiu_fnlp,org.fnlp.ml.classifier.hier,0,0,0,0,1,0,1,2
xpqiu_fnlp,org.fnlp.ml.classifier.knn,0,0,0,0,0,1,1,2
xpqiu_fnlp,org.fnlp.ml.classifier.linear,0,0,0,0,0,3,1,4
xpqiu_fnlp,org.fnlp.ml.classifier.linear.inf,0,0,0,0,0,1,1,2
xpqiu_fnlp,org.fnlp.ml.classifier.linear.update,0,0,0,0,0,0,1,1
xpqiu_fnlp,org.fnlp.ml.classifier.struct.inf,0,0,0,0,1,0,1,2
xpqiu_fnlp,(default package),0,0,0,0,0,0,1,1
xpqiu_fnlp,org.fnlp.ml.classifier.struct.update,0,0,0,0,0,0,1,1
xpqiu_fnlp,org.fnlp.ml.cluster,0,0,0,0,0,1,1,2
xpqiu_fnlp,org.fnlp.ml.eval,0,0,0,0,1,0,1,2
xpqiu_fnlp,org.fnlp.ml.feature,0,0,0,0,0,0,1,1
xpqiu_fnlp,org.fnlp.ml.loss,0,0,0,0,0,1,1,2
xpqiu_fnlp,org.fnlp.ml.loss.struct,0,0,0,0,0,0,1,1
xpqiu_fnlp,org.fnlp.ml.nmf,0,0,0,0,0,0,1,1
xpqiu_fnlp,org.fnlp.ml.types.alphabet,0,0,0,0,1,8,1,10
xpqiu_fnlp,org.fnlp.ml.types,0,0,0,0,1,9,1,11
xpqiu_fnlp,org.fnlp.ml.types.featurecluster,0,0,0,0,0,0,1,1
xpqiu_fnlp,org.fnlp.ml.types.sv,0,0,0,0,1,1,1,3
xpqiu_fnlp,org.fnlp.nlp.cn.anaphora,0,0,0,0,1,0,1,2
xpqiu_fnlp,org.fnlp.nlp.cn.anaphora.rule,0,0,0,0,0,0,1,1
xpqiu_fnlp,org.fnlp.nlp.cn.anaphora.train,0,0,0,0,1,0,1,2
xpqiu_fnlp,org.fnlp.nlp.cn,4,1,0,0,1,4,1,11
xpqiu_fnlp,org.fnlp.nlp.cn.ner,0,0,0,0,0,0,1,1
xpqiu_fnlp,org.fnlp.nlp.cn.ner.ne,0,0,0,0,0,0,1,1
xpqiu_fnlp,org.fnlp.nlp.cn.tag,4,1,0,0,1,1,1,8
xpqiu_fnlp,org.fnlp.nlp.cn.tag.format,1,1,0,0,0,1,1,4
xpqiu_fnlp,org.fnlp.nlp.corpus,1,0,0,0,1,1,1,4
xpqiu_fnlp,org.fnlp.nlp.corpus.ctbconvert,0,0,0,0,1,0,1,2
xpqiu_fnlp,org.fnlp.nlp.corpus.fnlp.filter,0,0,0,0,0,0,1,1
xpqiu_fnlp,org.fnlp.nlp.corpus.fnlp,1,1,0,0,0,1,1,4
xpqiu_fnlp,org.fnlp.nlp.corpus.third,0,0,0,0,0,0,1,1
xpqiu_fnlp,org.fnlp.nlp.duplicate,0,0,0,0,1,0,1,2
xpqiu_fnlp,org.fnlp.nlp.langmodel.lda,0,0,0,0,0,0,1,1
xpqiu_fnlp,org.fnlp.nlp.langmodel,0,0,0,0,0,0,1,1
xpqiu_fnlp,org.fnlp.nlp.parser.dep.analysis,0,0,0,0,0,0,1,1
xpqiu_fnlp,org.fnlp.nlp.parser.dep,1,0,0,0,1,2,1,5
xpqiu_fnlp,org.fnlp.nlp.parser.dep.reader,0,0,0,0,0,0,1,1
xpqiu_fnlp,org.fnlp.nlp.parser.dep.train,0,0,0,0,0,0,1,1
xpqiu_fnlp,org.fnlp.nlp.parser,0,0,0,0,0,1,1,2
xpqiu_fnlp,org.fnlp.nlp.pipe,0,1,0,0,1,2,1,5
xpqiu_fnlp,org.fnlp.nlp.pipe.nlp,0,0,0,0,0,0,1,1
xpqiu_fnlp,org.fnlp.nlp.pipe.seq,2,0,0,0,1,2,1,6
xpqiu_fnlp,org.fnlp.nlp.pipe.seq.templet,1,1,0,0,0,3,1,6
xpqiu_fnlp,org.fnlp.nlp.pipe.templet,0,0,0,0,1,0,1,2
xpqiu_fnlp,org.fnlp.nlp.similarity,1,1,0,0,1,0,1,4
xpqiu_fnlp,org.fnlp.nlp.similarity.train,0,0,0,0,1,0,1,2
xpqiu_fnlp,org.fnlp.nlp.tag,0,0,0,0,1,3,1,5
xpqiu_fnlp,org.fnlp.ontology,0,0,0,0,0,1,1,2
xpqiu_fnlp,org.fnlp.ontology.graph,0,0,0,0,0,0,1,1
xpqiu_fnlp,org.fnlp.util,0,0,0,0,1,1,1,3
xpqiu_fnlp,org.fnlp.util.exception,0,0,0,0,0,0,1,1
xpqiu_fnlp,org.fnlp.util.hash,0,0,0,0,0,0,1,1
xpqiu_fnlp,org.fnlp.nlp.ner.time,0,0,0,0,0,0,1,1
xpqiu_fnlp,org.fnlp.nlp.parser.dep.yamada,0,0,0,0,0,0,1,1
xpqiu_fnlp,org.fnlp.nlp.sighen,0,0,0,0,0,0,1,1
xpqiu_fnlp,org.fnlp.demo.ml,0,0,0,0,0,0,1,1
xpqiu_fnlp,org.fnlp.demo.nlp,0,0,0,0,1,0,1,2
xpqiu_fnlp,org.fnlp.demo.nlp.tc,0,0,0,0,1,0,1,2
xpqiu_fnlp,org.fnlp.demo,0,0,0,0,0,0,1,1
xpqiu_fnlp,org.fnlp.dev,0,0,0,0,0,0,1,1
xpqiu_fnlp,org.fnlp.nlp.cn.rl,0,0,0,0,0,0,1,1
xpqiu_fnlp,org.fnlp.train.corpus,0,0,0,0,0,0,1,1
xpqiu_fnlp,org.fnlp.train.parsing,1,1,0,0,0,0,1,3
xpqiu_fnlp,org.fnlp.train.pos,1,0,0,0,1,2,1,5
xpqiu_fnlp,org.fnlp.train.seg,1,0,0,0,1,2,1,5
xpqiu_fnlp,org.fnlp.train.tag,3,1,0,0,1,3,1,9
xvik_dropwizard-guicey,ru.vyarus.dropwizard.guice.admin,0,0,0,0,0,0,0,0
xvik_dropwizard-guicey,ru.vyarus.dropwizard.guice.admin.rest,0,0,0,0,0,0,0,0
xvik_dropwizard-guicey,ru.vyarus.dropwizard.guice.bundle,0,0,0,0,0,0,0,0
xvik_dropwizard-guicey,ru.vyarus.dropwizard.guice.bundle.lookup,0,0,0,0,0,0,0,0
xvik_dropwizard-guicey,ru.vyarus.dropwizard.guice.debug,0,0,0,0,1,0,0,1
xvik_dropwizard-guicey,ru.vyarus.dropwizard.guice.debug.hook,0,0,0,0,0,0,0,0
xvik_dropwizard-guicey,ru.vyarus.dropwizard.guice.debug.report.diagnostic,1,1,0,0,0,0,0,2
xvik_dropwizard-guicey,ru.vyarus.dropwizard.guice.debug.report.guice,4,1,0,0,0,0,0,5
xvik_dropwizard-guicey,ru.vyarus.dropwizard.guice.debug.report.guice.model,2,1,0,0,0,0,0,3
xvik_dropwizard-guicey,ru.vyarus.dropwizard.guice.debug.report.guice.util,4,0,0,0,0,0,0,4
xvik_dropwizard-guicey,ru.vyarus.dropwizard.guice.debug.report.guice.util.visitor,2,1,0,0,0,0,0,3
xvik_dropwizard-guicey,ru.vyarus.dropwizard.guice.debug.report.option,1,1,0,0,0,0,0,2
xvik_dropwizard-guicey,ru.vyarus.dropwizard.guice.debug.report,0,0,0,0,0,0,0,0
xvik_dropwizard-guicey,ru.vyarus.dropwizard.guice.debug.report.stat,0,0,0,0,0,0,0,0
xvik_dropwizard-guicey,ru.vyarus.dropwizard.guice.debug.report.tree,4,0,0,0,0,0,0,4
xvik_dropwizard-guicey,ru.vyarus.dropwizard.guice.debug.report.yaml,0,0,0,0,0,0,0,0
xvik_dropwizard-guicey,ru.vyarus.dropwizard.guice.debug.util,1,1,0,0,0,0,0,2
xvik_dropwizard-guicey,ru.vyarus.dropwizard.guice,6,1,0,0,0,0,0,7
xvik_dropwizard-guicey,ru.vyarus.dropwizard.guice.hook,2,1,0,0,0,0,0,3
xvik_dropwizard-guicey,ru.vyarus.dropwizard.guice.injector,0,0,0,0,0,0,0,0
xvik_dropwizard-guicey,ru.vyarus.dropwizard.guice.injector.lookup,0,0,0,0,0,0,0,0
xvik_dropwizard-guicey,ru.vyarus.dropwizard.guice.module.context.bootstrap,1,0,0,0,0,0,0,1
xvik_dropwizard-guicey,ru.vyarus.dropwizard.guice.module.context,36,1,0,0,0,0,0,37
xvik_dropwizard-guicey,ru.vyarus.dropwizard.guice.module.context.info,0,0,0,0,0,0,0,0
xvik_dropwizard-guicey,ru.vyarus.dropwizard.guice.module.context.info.impl,4,1,0,0,0,0,0,5
xvik_dropwizard-guicey,ru.vyarus.dropwizard.guice.module.context.info.sign,0,0,0,0,0,0,0,0
xvik_dropwizard-guicey,ru.vyarus.dropwizard.guice.module.context.option.internal,1,0,0,0,0,0,0,1
xvik_dropwizard-guicey,ru.vyarus.dropwizard.guice.module.context.option.mapper,0,0,0,0,0,0,0,0
xvik_dropwizard-guicey,ru.vyarus.dropwizard.guice.module.context.option,1,1,0,0,0,0,0,2
xvik_dropwizard-guicey,ru.vyarus.dropwizard.guice.module.context.stat,0,0,0,0,0,0,0,0
xvik_dropwizard-guicey,ru.vyarus.dropwizard.guice.module.context.unique,0,0,0,0,0,0,0,0
xvik_dropwizard-guicey,ru.vyarus.dropwizard.guice.module.context.unique.item,0,0,0,0,0,0,0,0
xvik_dropwizard-guicey,ru.vyarus.dropwizard.guice.module,10,1,0,0,0,0,0,11
xvik_dropwizard-guicey,ru.vyarus.dropwizard.guice.module.installer.bundle,8,1,0,0,0,0,0,9
xvik_dropwizard-guicey,ru.vyarus.dropwizard.guice.module.installer,14,0,0,0,0,0,0,14
xvik_dropwizard-guicey,ru.vyarus.dropwizard.guice.module.installer.feature.eager,1,0,0,0,0,0,0,1
xvik_dropwizard-guicey,ru.vyarus.dropwizard.guice.module.installer.feature.health,1,0,0,0,0,0,0,1
xvik_dropwizard-guicey,ru.vyarus.dropwizard.guice.module.installer.feature.jersey,1,0,0,0,0,0,0,1
xvik_dropwizard-guicey,ru.vyarus.dropwizard.guice.module.installer.feature.jersey.provider,1,0,0,0,0,0,0,1
xvik_dropwizard-guicey,ru.vyarus.dropwizard.guice.module.installer.feature,1,0,0,0,0,0,0,1
xvik_dropwizard-guicey,ru.vyarus.dropwizard.guice.module.installer.feature.plugin,1,0,0,0,0,0,0,1
xvik_dropwizard-guicey,ru.vyarus.dropwizard.guice.module.installer.feature.web,1,0,0,0,0,0,0,1
xvik_dropwizard-guicey,ru.vyarus.dropwizard.guice.module.installer.feature.web.listener,1,0,0,0,0,0,0,1
xvik_dropwizard-guicey,ru.vyarus.dropwizard.guice.module.installer.feature.web.util,0,0,0,0,0,0,0,0
xvik_dropwizard-guicey,ru.vyarus.dropwizard.guice.module.installer.install.binding,0,0,0,0,0,0,0,0
xvik_dropwizard-guicey,ru.vyarus.dropwizard.guice.module.installer.install,0,0,0,0,0,0,0,0
xvik_dropwizard-guicey,ru.vyarus.dropwizard.guice.module.installer.internal,21,1,0,0,1,0,0,23
xvik_dropwizard-guicey,ru.vyarus.dropwizard.guice.module.installer.option,0,0,0,0,0,0,0,0
xvik_dropwizard-guicey,ru.vyarus.dropwizard.guice.module.installer.order,3,0,0,0,0,0,0,3
xvik_dropwizard-guicey,ru.vyarus.dropwizard.guice.module.installer.scanner,0,0,0,0,0,0,0,0
xvik_dropwizard-guicey,ru.vyarus.dropwizard.guice.module.installer.scanner.util,0,0,0,0,0,0,0,0
xvik_dropwizard-guicey,ru.vyarus.dropwizard.guice.module.installer.util,16,1,0,0,1,0,0,18
xvik_dropwizard-guicey,ru.vyarus.dropwizard.guice.module.jersey.debug,0,0,0,0,0,0,0,0
xvik_dropwizard-guicey,ru.vyarus.dropwizard.guice.module.jersey.debug.service,0,0,0,0,0,0,0,0
xvik_dropwizard-guicey,ru.vyarus.dropwizard.guice.module.jersey,0,0,0,0,0,0,0,0
xvik_dropwizard-guicey,ru.vyarus.dropwizard.guice.module.jersey.hk2,0,0,0,0,0,0,0,0
xvik_dropwizard-guicey,ru.vyarus.dropwizard.guice.module.jersey.support,0,0,0,0,0,0,0,0
xvik_dropwizard-guicey,ru.vyarus.dropwizard.guice.module.lifecycle.event.configuration,0,0,0,0,1,0,0,1
xvik_dropwizard-guicey,ru.vyarus.dropwizard.guice.module.lifecycle.event,9,0,0,0,0,0,0,9
xvik_dropwizard-guicey,ru.vyarus.dropwizard.guice.module.lifecycle.event.jersey,0,0,0,0,0,0,0,0
xvik_dropwizard-guicey,ru.vyarus.dropwizard.guice.module.lifecycle.event.run,0,0,0,0,1,0,0,1
xvik_dropwizard-guicey,ru.vyarus.dropwizard.guice.module.lifecycle,2,1,0,0,0,0,0,3
xvik_dropwizard-guicey,ru.vyarus.dropwizard.guice.module.lifecycle.internal,8,1,0,0,0,0,0,9
xvik_dropwizard-guicey,ru.vyarus.dropwizard.guice.module.support,0,0,0,0,0,0,0,0
xvik_dropwizard-guicey,ru.vyarus.dropwizard.guice.module.yaml.bind,0,0,0,0,0,0,0,0
xvik_dropwizard-guicey,ru.vyarus.dropwizard.guice.module.yaml,0,0,0,0,0,0,0,0
xvik_dropwizard-guicey,ru.vyarus.dropwizard.guice.config.unique.support,0,0,0,0,0,0,0,0
xvik_dropwizard-guicey,ru.vyarus.dropwizard.guice.debug.renderer.guice.support,0,0,0,1,1,0,0,2
xvik_dropwizard-guicey,ru.vyarus.dropwizard.guice.debug.renderer.guice.support.exts,0,0,0,0,1,0,0,1
xvik_dropwizard-guicey,ru.vyarus.dropwizard.guice.debug.renderer.guice.support.privt,0,0,0,0,0,0,0,0
xvik_dropwizard-guicey,ru.vyarus.dropwizard.guice.debug.util.support,0,0,0,0,0,0,0,0
xvik_dropwizard-guicey,ru.vyarus.dropwizard.guice.support,0,0,0,0,0,0,0,0
xvik_guice-validator,ru.vyarus.guice.validator.aop,0,1,0,0,0,0,0,1
xvik_guice-validator,ru.vyarus.guice.validator.constraint,0,0,0,0,0,0,0,0
xvik_guice-validator,ru.vyarus.guice.validator.group.annotation,0,0,0,0,0,0,0,0
xvik_guice-validator,ru.vyarus.guice.validator.group.aop,0,0,0,0,0,0,0,0
xvik_guice-validator,ru.vyarus.guice.validator.group,0,0,0,0,1,0,0,1
xvik_guice-validator,ru.vyarus.guice.validator,0,0,0,0,0,0,0,0
xvik_guice-validator,ru.vyarus.guice.validator.compositeannotation,0,0,0,0,0,0,0,0
xvik_guice-validator,ru.vyarus.guice.validator.crossparams,0,0,0,0,0,0,0,0
xvik_guice-validator,ru.vyarus.guice.validator.customann,0,0,0,0,0,0,0,0
xvik_guice-validator,ru.vyarus.guice.validator.customtype,0,0,0,0,0,0,0,0
xvik_guice-validator,ru.vyarus.guice.validator.group.support.groups,0,0,0,0,0,0,0,0
xvik_guice-validator,ru.vyarus.guice.validator.group.support.model,0,0,0,0,0,0,0,0
xvik_guice-validator,ru.vyarus.guice.validator.group.support,0,0,0,0,0,0,0,0
xvik_guice-validator,ru.vyarus.guice.validator.group.support.simple,0,0,0,0,1,0,0,1
xvik_guice-validator,ru.vyarus.guice.validator.matcher,0,0,0,0,0,0,0,0
xvik_guice-validator,ru.vyarus.guice.validator.script,0,0,0,0,0,0,0,0
xvik_guice-validator,ru.vyarus.guice.validator.simple,0,0,0,0,0,0,0,0
yahoo_artifactory_ssh_proxy,com.yahoo.sshd.authentication.file,0,0,0,0,1,0,0,1
yahoo_artifactory_ssh_proxy,com.yahoo.sshd.authentication,0,0,0,0,0,0,0,0
yahoo_artifactory_ssh_proxy,com.yahoo.sshd.authorization,0,0,0,0,0,0,0,0
yahoo_artifactory_ssh_proxy,com.yahoo.sshd.authorization.file,1,1,0,0,0,0,0,2
yahoo_artifactory_ssh_proxy,com.yahoo.sshd.common.forward,0,0,0,0,0,0,0,0
yahoo_artifactory_ssh_proxy,com.yahoo.sshd.server.command,0,0,0,0,1,0,0,1
yahoo_artifactory_ssh_proxy,com.yahoo.sshd.server.filesystem,0,0,0,0,1,0,0,1
yahoo_artifactory_ssh_proxy,com.yahoo.sshd.server.filters,0,0,0,0,0,0,0,0
yahoo_artifactory_ssh_proxy,com.yahoo.sshd.server.jetty,0,0,0,0,0,0,0,0
yahoo_artifactory_ssh_proxy,com.yahoo.sshd.server.logging,0,1,0,0,1,0,0,2
yahoo_artifactory_ssh_proxy,com.yahoo.sshd.server.settings,1,1,0,0,1,0,0,3
yahoo_artifactory_ssh_proxy,com.yahoo.sshd.server.shell,1,0,0,0,1,0,0,2
yahoo_artifactory_ssh_proxy,com.yahoo.sshd.server.shell.groovy,0,0,0,0,0,0,0,0
yahoo_artifactory_ssh_proxy,com.yahoo.sshd.server,0,0,0,0,0,0,0,0
yahoo_artifactory_ssh_proxy,com.yahoo.sshd.tools.artifactory,0,0,0,0,1,0,0,1
yahoo_artifactory_ssh_proxy,com.yahoo.sshd.utils,0,0,0,0,1,0,0,1
yahoo_artifactory_ssh_proxy,com.yahoo.sshd.utils.streams,1,1,0,0,1,0,0,3
yahoo_artifactory_ssh_proxy,org.apache.karaf.shell.ssh,0,0,0,0,0,0,0,0
yahoo_artifactory_ssh_proxy,org.apache.sshd.server.keyprovider,0,0,0,0,0,0,0,0
yahoo_artifactory_ssh_proxy,org.apache.sshd.server.shell,0,0,0,0,0,0,0,0
yahoo_artifactory_ssh_proxy,org.apache.sshd.common.kex,0,0,0,0,0,0,0,0
yahoo_xpath_proto_builder,com.yahoo.xpathproto,0,0,0,0,1,0,0,1
yahoo_xpath_proto_builder,com.yahoo.xpathproto.dataobject,0,0,0,0,0,0,0,0
yahoo_xpath_proto_builder,com.yahoo.xpathproto.handler,0,0,0,0,0,0,0,0
yahoo_xpath_proto_builder,com.yahoo.xpathproto.horoscope,0,0,0,0,0,0,0,0
yammer_breakerbox,com.yammer.breakerbox.azure,0,0,0,0,0,0,0,0
yammer_breakerbox,com.yammer.breakerbox.azure.core,0,0,0,0,0,0,0,0
yammer_breakerbox,com.yammer.breakerbox.azure.healthchecks,0,0,0,0,0,0,0,0
yammer_breakerbox,com.yammer.breakerbox.azure.model,0,0,0,0,0,0,0,0
yammer_breakerbox,com.netflix.hystrix.dashboard.stream,0,0,0,0,0,0,0,0
yammer_breakerbox,com.yammer.breakerbox.dashboard,0,0,0,0,0,0,0,0
yammer_breakerbox,com.yammer.breakerbox.dashboard.bundle,0,0,0,0,0,0,0,0
yammer_breakerbox,com.yammer.breakerbox.jdbi.args,0,0,0,0,0,0,0,0
yammer_breakerbox,com.yammer.breakerbox.jdbi,0,0,0,0,1,0,0,1
yammer_breakerbox,com.yammer.breakerbox.service.archaius,0,0,0,0,0,0,0,0
yammer_breakerbox,com.yammer.breakerbox.service.auth,0,0,0,0,0,0,0,0
yammer_breakerbox,com.yammer.breakerbox.service,0,0,0,0,0,0,0,0
yammer_breakerbox,com.yammer.breakerbox.service.comparable,0,0,0,0,0,0,0,0
yammer_breakerbox,com.yammer.breakerbox.service.config,0,0,0,0,0,0,0,0
yammer_breakerbox,com.yammer.breakerbox.service.core,0,0,0,0,0,0,0,0
yammer_breakerbox,com.yammer.breakerbox.service.resources,0,0,0,0,0,0,0,0
yammer_breakerbox,com.yammer.breakerbox.service.store,0,0,0,0,0,0,0,0
yammer_breakerbox,com.yammer.breakerbox.service.tenacity,0,0,0,0,1,0,0,1
yammer_breakerbox,com.yammer.breakerbox.store,0,0,0,0,0,0,0,0
yammer_breakerbox,com.yammer.breakerbox.store.model,0,0,0,0,0,0,0,0
yammer_breakerbox,com.yammer.breakerbox.turbine.client,0,0,0,0,0,0,0,0
yammer_breakerbox,com.yammer.breakerbox.turbine,0,0,0,0,1,0,0,1
yammer_breakerbox,com.yammer.breakerbox.turbine.config,0,0,0,0,0,0,0,0
yammer_breakerbox,com.yammer.breakerbox.turbine.managed,0,0,0,0,0,0,0,0
yammer_breakerbox,com.yammer.breakerbox.turbine.model.marathon,0,0,0,0,1,0,0,1
yammer_tenacity,com.yammer.tenacity.client,0,0,0,0,0,0,0,0
yammer_tenacity,com.yammer.tenacity.core.auth,0,0,0,0,0,0,0,0
yammer_tenacity,com.yammer.tenacity.core.bundle,0,1,0,0,0,0,0,1
yammer_tenacity,com.yammer.tenacity.core.config,0,0,0,0,0,0,0,0
yammer_tenacity,com.yammer.tenacity.core.core,0,0,0,0,0,1,0,1
yammer_tenacity,com.yammer.tenacity.core.errors,0,0,0,0,0,0,0,0
yammer_tenacity,com.yammer.tenacity.core.healthcheck,0,0,0,0,0,0,0,0
yammer_tenacity,com.yammer.tenacity.core.http,0,0,0,0,0,0,0,0
yammer_tenacity,com.yammer.tenacity.core.logging,0,0,0,0,0,0,0,0
yammer_tenacity,com.yammer.tenacity.core.metrics,0,0,0,0,0,0,0,0
yammer_tenacity,com.yammer.tenacity.core.properties,0,0,0,0,1,1,0,2
yammer_tenacity,com.yammer.tenacity.core.resources,0,0,0,0,0,1,0,1
yammer_tenacity,com.yammer.tenacity.core.servlets,0,0,0,0,0,0,0,0
yammer_tenacity,com.yammer.tenacity.core,0,0,0,0,0,0,0,0
yammer_tenacity,com.yammer.tenacity.dbi,0,0,0,0,0,0,0,0
yandex-qatools_hamcrest-pojo-matcher-generator,ru.yandex.qatools.processors.matcher.gen.bean,0,0,0,0,0,0,0,0
yandex-qatools_hamcrest-pojo-matcher-generator,ru.yandex.qatools.processors.matcher.gen.elements,0,0,0,0,0,0,0,0
yandex-qatools_hamcrest-pojo-matcher-generator,ru.yandex.qatools.processors.matcher.gen,1,1,0,0,0,0,0,2
yandex-qatools_hamcrest-pojo-matcher-generator,ru.yandex.qatools.processors.matcher.gen.processing,1,0,0,0,1,0,0,2
yegor256_netbout,com.netbout.client.cached,0,0,0,0,1,0,0,1
yegor256_netbout,com.netbout.client,0,1,0,0,1,0,0,2
yegor256_netbout,com.netbout.client.retry,0,0,0,0,1,0,0,1
yegor256_netbout,com.netbout.mock,0,0,0,0,1,0,0,1
yegor256_netbout,com.netbout,0,0,0,0,0,0,0,0
yegor256_netbout,com.netbout.spi,0,0,0,1,1,1,0,3
yegor256_netbout,com.netbout.cached,0,0,0,0,1,0,0,1
yegor256_netbout,com.netbout.dynamo,0,0,0,0,1,0,0,1
yegor256_netbout,com.netbout.email,0,0,0,0,1,0,0,1
yegor256_netbout,com.netbout.misc,0,0,0,0,0,0,0,0
yegor256_netbout,com.netbout.rest.account,0,0,0,0,0,0,0,0
yegor256_netbout,com.netbout.rest.bout,0,0,0,0,1,1,0,2
yegor256_netbout,com.netbout.rest,0,0,0,1,1,1,0,3
yegor256_netbout,com.netbout.rest.login,0,0,0,0,0,0,0,0
yfpeng_pengyifan-commons,com.pengyifan.commons.chain,0,0,0,0,0,0,0,0
yfpeng_pengyifan-commons,com.pengyifan.commons.collections.counter,0,0,0,0,0,0,0,0
yfpeng_pengyifan-commons,com.pengyifan.commons.collections.graph,0,0,0,0,1,0,0,1
yfpeng_pengyifan-commons,com.pengyifan.commons.collections.heap,0,0,0,0,0,0,0,0
yfpeng_pengyifan-commons,com.pengyifan.commons.collections,0,0,0,0,1,0,0,1
yfpeng_pengyifan-commons,com.pengyifan.commons.collections.tree,0,0,0,0,1,0,0,1
yfpeng_pengyifan-commons,com.pengyifan.commons.io,0,0,0,0,1,0,0,1
yfpeng_pengyifan-commons,com.pengyifan.commons.lang,0,0,0,0,1,0,0,1
yfpeng_pengyifan-commons,com.pengyifan.commons.math,0,0,0,0,1,0,0,1
yfpeng_pengyifan-commons,com.pengyifan.kernel.svm,0,0,0,0,0,0,0,0
yfpeng_pengyifan-commons,com.pengyifan.util.regex,0,0,0,0,0,0,0,0
Yubico_java-u2flib-server,com.yubico.u2f,7,0,0,0,1,2,0,10
Yubico_java-u2flib-server,com.yubico.u2f.crypto,0,0,0,0,0,0,0,0
Yubico_java-u2flib-server,com.yubico.u2f.data,4,1,0,0,0,1,0,6
Yubico_java-u2flib-server,com.yubico.u2f.data.messages,5,1,0,0,1,2,0,9
Yubico_java-u2flib-server,com.yubico.u2f.data.messages.json,0,0,0,0,0,0,0,0
Yubico_java-u2flib-server,com.yubico.u2f.data.messages.key,9,1,0,0,0,0,0,10
Yubico_java-u2flib-server,com.yubico.u2f.data.messages.key.util,0,0,0,0,0,1,0,1
Yubico_java-u2flib-server,com.yubico.u2f.exceptions,0,0,0,0,1,0,0,1
Yubico_java-u2flib-server,com.yubico.u2f.codec,0,0,0,0,0,0,0,0
Yubico_java-u2flib-server,com.yubico.u2f.json,0,0,0,0,0,0,0,0
Yubico_java-u2flib-server,com.yubico.u2f.softkey.messages,0,0,0,0,0,0,0,0
Yubico_java-u2flib-server,com.yubico.u2f.softkey,6,0,0,0,0,1,0,7
Yubico_java-u2flib-server,demo,0,0,0,0,0,0,0,0
Yubico_java-u2flib-server,demo.view,0,0,0,0,0,0,0,0
zafarkhaja_jsemver,com.github.zafarkhaja.semver.expr,1,0,0,1,0,0,0,2
zafarkhaja_jsemver,com.github.zafarkhaja.semver,1,1,0,1,0,0,0,3
zafarkhaja_jsemver,com.github.zafarkhaja.semver.util,0,0,0,0,0,0,0,0
zillabyte_motherbrain,com.zillabyte.motherbrain.api,3,0,0,0,0,0,0,3
zillabyte_motherbrain,com.zillabyte.motherbrain.benchmarking,2,1,0,0,0,0,0,3
zillabyte_motherbrain,com.zillabyte.motherbrain.container,2,1,0,0,1,1,0,5
zillabyte_motherbrain,com.zillabyte.motherbrain.container.local,2,0,0,0,0,0,0,2
zillabyte_motherbrain,com.zillabyte.motherbrain.coordination,0,0,0,0,1,0,0,1
zillabyte_motherbrain,com.zillabyte.motherbrain.coordination.mock,1,0,0,0,0,0,0,1
zillabyte_motherbrain,com.zillabyte.motherbrain.coordination.redis,0,0,0,0,0,0,0,0
zillabyte_motherbrain,com.zillabyte.motherbrain.flow,9,1,0,0,1,1,0,12
zillabyte_motherbrain,com.zillabyte.motherbrain.flow.aggregation,2,0,0,0,1,1,0,4
zillabyte_motherbrain,com.zillabyte.motherbrain.flow.buffer,0,0,0,0,1,0,0,1
zillabyte_motherbrain,com.zillabyte.motherbrain.flow.buffer.mock,5,0,0,0,1,0,0,6
zillabyte_motherbrain,com.zillabyte.motherbrain.flow.collectors.coordinated,3,0,0,0,1,0,0,4
zillabyte_motherbrain,com.zillabyte.motherbrain.flow.collectors.coordinated.support,0,0,0,0,1,0,0,1
zillabyte_motherbrain,com.zillabyte.motherbrain.flow.collectors.coordinated.support.naive,0,0,0,0,0,0,0,0
zillabyte_motherbrain,com.zillabyte.motherbrain.flow.collectors,0,0,0,0,0,0,0,0
zillabyte_motherbrain,com.zillabyte.motherbrain.flow.components.builtin,2,0,0,0,0,0,0,2
zillabyte_motherbrain,com.zillabyte.motherbrain.flow.components,2,0,0,0,0,0,0,2
zillabyte_motherbrain,com.zillabyte.motherbrain.flow.config,6,0,0,0,0,0,0,6
zillabyte_motherbrain,com.zillabyte.motherbrain.flow.error.strategies,2,0,0,0,1,0,0,3
zillabyte_motherbrain,com.zillabyte.motherbrain.flow.graph,2,0,0,0,0,0,0,2
zillabyte_motherbrain,com.zillabyte.motherbrain.flow.heartbeats,2,0,0,0,0,0,0,2
zillabyte_motherbrain,com.zillabyte.motherbrain.flow.local,3,0,0,0,0,0,0,3
zillabyte_motherbrain,com.zillabyte.motherbrain.flow.operations,17,1,0,0,1,2,0,21
zillabyte_motherbrain,com.zillabyte.motherbrain.flow.operations.builtin,0,0,0,0,0,0,0,0
zillabyte_motherbrain,com.zillabyte.motherbrain.flow.operations.decorators,0,0,0,0,0,0,0,0
zillabyte_motherbrain,com.zillabyte.motherbrain.flow.operations.multilang.builder,12,0,0,0,1,2,0,15
zillabyte_motherbrain,com.zillabyte.motherbrain.flow.operations.multilang,2,0,0,0,1,0,0,3
zillabyte_motherbrain,com.zillabyte.motherbrain.flow.operations.multilang.operations,0,0,0,0,1,0,0,1
zillabyte_motherbrain,com.zillabyte.motherbrain.flow.rpc.queues,2,0,0,0,1,0,0,3
zillabyte_motherbrain,com.zillabyte.motherbrain.flow.rpc,3,1,0,0,0,0,0,4
zillabyte_motherbrain,com.zillabyte.motherbrain.flow.sourcefromrelation,0,0,0,0,0,0,0,0
zillabyte_motherbrain,com.zillabyte.motherbrain.metrics,0,0,0,0,0,0,0,0
zillabyte_motherbrain,com.zillabyte.motherbrain.reactor.lightweight,0,0,0,0,0,0,0,0
zillabyte_motherbrain,com.zillabyte.motherbrain.relational,1,1,0,0,1,0,0,3
zillabyte_motherbrain,com.zillabyte.motherbrain.relational.naivepostgresimpl,0,0,0,0,0,0,0,0
zillabyte_motherbrain,com.zillabyte.motherbrain.relational.redshiftimpl,0,0,0,0,0,0,0,0
zillabyte_motherbrain,com.zillabyte.motherbrain.shell,1,0,0,0,0,0,0,1
zillabyte_motherbrain,com.zillabyte.motherbrain.top,5,0,0,0,1,1,0,7
zillabyte_motherbrain,com.zillabyte.motherbrain.universe,44,1,0,0,0,2,0,47
zillabyte_motherbrain,com.zillabyte.motherbrain.utils.backoff,0,0,0,0,0,0,0,0
zillabyte_motherbrain,com.zillabyte.motherbrain.utils,25,1,0,0,1,0,0,27
zillabyte_motherbrain,com.zillabyte.motherbrain.utils.csv,0,0,0,0,1,0,0,1
zillabyte_motherbrain,com.zillabyte.motherbrain.utils.dfs,1,0,0,0,0,0,0,1
zillabyte_motherbrain,com.zillabyte.motherbrain.utils.queue,0,0,0,0,0,0,0,0
zsoltherpai_fluent-jdbc,org.codejargon.fluentjdbc.api.integration.guicepersist.jpa,0,0,0,0,0,0,0,0
zsoltherpai_fluent-jdbc,org.codejargon.fluentjdbc.api.integration.guicepersist.standalone,0,0,0,0,0,0,0,0
zsoltherpai_fluent-jdbc,org.codejargon.fluentjdbc.api,8,1,0,0,0,0,0,9
zsoltherpai_fluent-jdbc,org.codejargon.fluentjdbc.api.integration,0,0,0,0,0,0,0,0
zsoltherpai_fluent-jdbc,org.codejargon.fluentjdbc.api.integration.providers,0,0,0,0,0,0,0,0
zsoltherpai_fluent-jdbc,org.codejargon.fluentjdbc.api.mapper,0,0,0,0,0,0,0,0
zsoltherpai_fluent-jdbc,org.codejargon.fluentjdbc.api.query,0,0,1,0,1,1,0,3
zsoltherpai_fluent-jdbc,org.codejargon.fluentjdbc.api.query.inspection,0,0,0,0,0,0,0,0
zsoltherpai_fluent-jdbc,org.codejargon.fluentjdbc.api.query.listen,0,0,0,0,0,0,0,0
zsoltherpai_fluent-jdbc,org.codejargon.fluentjdbc.internal,5,1,0,0,0,0,0,6
zsoltherpai_fluent-jdbc,org.codejargon.fluentjdbc.internal.integration,0,0,0,0,0,0,0,0
zsoltherpai_fluent-jdbc,org.codejargon.fluentjdbc.internal.mappers,0,0,0,0,0,0,0,0
zsoltherpai_fluent-jdbc,org.codejargon.fluentjdbc.internal.query,7,0,0,0,1,1,0,9
zsoltherpai_fluent-jdbc,org.codejargon.fluentjdbc.internal.query.namedparameter,4,1,0,0,0,0,0,5
zsoltherpai_fluent-jdbc,org.codejargon.fluentjdbc.internal.support,4,1,0,0,1,1,0,7
zutherb_AppStash,io.github.zutherb.appstash.shop.service.order,0,0,0,0,0,0,0,0
zutherb_AppStash,io.github.zutherb.appstash.dataloader.generator,0,0,0,0,0,0,0,0
zutherb_AppStash,io.github.zutherb.appstash.dataloader.reader,0,0,0,0,0,0,0,0
zutherb_AppStash,io.github.zutherb.appstash.dataloader.impl.reader,0,0,0,0,0,0,0,0
zutherb_AppStash,io.github.zutherb.appstash.common.util,0,0,0,0,0,0,0,0
zutherb_AppStash,io.github.zutherb.appstash.shop.repository.cart.api,0,0,0,0,0,0,0,0
zutherb_AppStash,io.github.zutherb.appstash.shop.repository.cart.impl,0,0,0,0,0,0,0,0
zutherb_AppStash,io.github.zutherb.appstash.shop.repository.cart.model,0,0,0,0,0,0,0,0
zutherb_AppStash,io.github.zutherb.appstash.common.repository,0,0,0,0,0,0,0,0
zutherb_AppStash,io.github.zutherb.appstash.common.repository.model,0,0,0,0,0,0,0,0
zutherb_AppStash,io.github.zutherb.appstash.shop.repository.order.api,0,0,0,0,0,0,0,0
zutherb_AppStash,io.github.zutherb.appstash.shop.repository.order.impl,0,0,0,0,1,0,0,1
zutherb_AppStash,io.github.zutherb.appstash.shop.repository.order.model,0,0,0,0,1,0,0,1
zutherb_AppStash,io.github.zutherb.appstash.shop.repository.product.api,0,0,0,0,0,0,0,0
zutherb_AppStash,io.github.zutherb.appstash.shop.repository.product.impl,0,0,0,0,0,0,0,0
zutherb_AppStash,io.github.zutherb.appstash.shop.repository.product.model,0,0,0,0,0,0,0,0
zutherb_AppStash,io.github.zutherb.appstash.shop.repository.user.api,0,0,0,0,0,0,0,0
zutherb_AppStash,io.github.zutherb.appstash.shop.repository.user.impl,0,0,0,0,0,0,0,0
zutherb_AppStash,io.github.zutherb.appstash.shop.repository.user.model,0,0,0,0,0,0,0,0
zutherb_AppStash,io.github.zutherb.appstash.shop.service.authentication.api,0,0,0,0,0,0,0,0
zutherb_AppStash,io.github.zutherb.appstash.shop.service.authentication.impl,0,0,0,0,0,0,0,0
zutherb_AppStash,io.github.zutherb.appstash.shop.service.authentication.model,0,0,0,0,0,0,0,0
zutherb_AppStash,io.github.zutherb.appstash.shop.service.cart.api,0,1,0,0,0,0,0,1
zutherb_AppStash,io.github.zutherb.appstash.shop.service.cart.impl,0,0,0,0,1,0,0,1
zutherb_AppStash,io.github.zutherb.appstash.shop.service.cart.model,0,0,0,0,0,0,0,0
zutherb_AppStash,io.github.zutherb.appstash.shop.service.checkout.api,0,0,0,0,0,0,0,0
zutherb_AppStash,io.github.zutherb.appstash.shop.service.checkout.impl,0,0,0,0,0,0,0,0
zutherb_AppStash,io.github.zutherb.appstash.shop.ui.service.checkout,0,0,0,0,0,0,0,0
zutherb_AppStash,io.github.zutherb.appstash.common.service,0,0,0,0,0,0,0,0
zutherb_AppStash,io.github.zutherb.appstash.shop.service.order.api,0,0,0,0,0,0,0,0
zutherb_AppStash,io.github.zutherb.appstash.shop.service.order.impl,0,0,0,0,0,0,0,0
zutherb_AppStash,io.github.zutherb.appstash.shop.service.order.model,0,0,0,0,0,0,0,0
zutherb_AppStash,io.github.zutherb.appstash.shop.service.product.api,0,0,0,0,0,0,0,0
zutherb_AppStash,io.github.zutherb.appstash.shop.service.product.impl,0,0,0,0,0,0,0,0
zutherb_AppStash,io.github.zutherb.appstash.shop.service.product.model,0,0,0,0,0,0,0,0
zutherb_AppStash,io.github.zutherb.appstash.shop.service.recommendation.api,0,0,0,0,0,0,0,0
zutherb_AppStash,io.github.zutherb.appstash.shop.service.recommendation.impl,0,0,0,0,0,0,0,0
zutherb_AppStash,io.github.zutherb.appstash.shop.service.user.api,0,0,0,0,0,0,0,0
zutherb_AppStash,io.github.zutherb.appstash.shop.service.user.impl,0,0,0,0,0,0,0,0
zutherb_AppStash,io.github.zutherb.appstash.shop.service.user.model,0,0,0,0,0,0,0,0
zutherb_AppStash,io.github.zutherb.appstash.shop.ui.application,0,1,0,0,0,0,0,1
zutherb_AppStash,io.github.zutherb.appstash.shop.ui.application.security,0,0,0,0,0,0,0,0
zutherb_AppStash,io.github.zutherb.appstash.shop.ui.application.settings,0,0,0,0,0,0,0,0
zutherb_AppStash,io.github.zutherb.appstash.shop.ui.event,0,0,0,0,0,0,0,0
zutherb_AppStash,io.github.zutherb.appstash.shop.ui.event.cart,0,0,0,0,0,0,0,0
zutherb_AppStash,io.github.zutherb.appstash.shop.ui.event.login,0,0,0,0,0,0,0,0
zutherb_AppStash,io.github.zutherb.appstash.shop.ui.mbean,0,0,0,0,0,0,0,0
zutherb_AppStash,io.github.zutherb.appstash.shop.ui.model,0,0,0,0,0,0,0,0
zutherb_AppStash,io.github.zutherb.appstash.shop.ui.navigation,0,0,0,0,1,0,0,1
zutherb_AppStash,io.github.zutherb.appstash.shop.ui.page,0,0,0,0,1,0,0,1
zutherb_AppStash,io.github.zutherb.appstash.shop.ui.page.catalog,0,0,0,0,0,0,0,0
zutherb_AppStash,io.github.zutherb.appstash.shop.ui.page.checkout,0,0,0,0,0,0,0,0
zutherb_AppStash,io.github.zutherb.appstash.shop.ui.page.detail,0,0,0,0,0,0,0,0
zutherb_AppStash,io.github.zutherb.appstash.shop.ui.page.home,0,0,0,0,0,0,0,0
zutherb_AppStash,io.github.zutherb.appstash.shop.ui.page.user,0,0,0,0,0,0,0,0
zutherb_AppStash,io.github.zutherb.appstash.shop.ui.panel.base,0,0,0,0,0,0,0,0
zutherb_AppStash,io.github.zutherb.appstash.shop.ui.panel.cart,0,0,0,0,0,0,0,0
zutherb_AppStash,io.github.zutherb.appstash.shop.ui.panel,0,0,0,0,1,0,0,1
zutherb_AppStash,io.github.zutherb.appstash.shop.ui.panel.login,0,0,0,0,0,0,0,0
zutherb_AppStash,io.github.zutherb.appstash.shop.ui.panel.product,0,0,0,0,0,0,0,0
zutherb_AppStash,io.github.zutherb.appstash.shop.ui.profile,0,0,0,0,0,0,0,0
zutherb_AppStash,io.github.zutherb.appstash.shop.ui.tracking.mixpanel,0,0,0,0,0,0,0,0
zutherb_AppStash,io.github.zutherb.appstash.shop.ui.tracking,0,0,0,0,0,0,0,0
zutherb_AppStash,io.github.zutherb.appstash.shop.runner,0,0,0,0,0,0,0,0
zutherb_AppStash,io.github.zutherb.appstash.shop.ui,0,0,0,0,0,0,0,0
zutherb_AppStash,io.github.zutherb.appstash.shop.ui.service,0,0,0,0,0,0,0,0